chunk_id,strategy,text,length,start_index,end_index
0,recursive,"Product: Intel Core i3-12100 12th Gen Budget Desktop PC. Category: Intel PC. Subcategory: Star PC. Price: 28,300৳30,120৳.

Product: Intel 10th Gen Core i5-10400 Desktop PC. Category: Intel PC. Subcategory: Star PC. Price: 32,150৳.
",231,0,231
1,recursive,"
Product: Intel 12th Gen Core i5-12400 Desktop PC. Category: Intel PC. Subcategory: Star PC. Price: 33,248৳35,750৳.

Product: Intel Core i5 14500 14th Gen Desktop PC. Category: Intel PC. Subcategory: Star PC. Price: 48,500৳51,800৳.
",232,231,463
2,recursive,"
Product: Intel 13th Gen Core i5 13400 Budget Desktop PC with Monitor. Category: Intel PC. Subcategory: Star PC. Price: 58,999৳60,600৳.

Product: Acer Veriton S2690G Core i5 12th Gen Tower Brand PC. Category: Acer. Subcategory: Brand PC. Price: 56,500৳.
",254,463,717
3,recursive,"
Product: Acer Veriton MT M4690G Core i3 14th Gen Tower Brand PC. Category: Acer. Subcategory: Brand PC. Price: 51,500৳.

Product: Acer Veriton MT M4690G Core i5 14th Gen Tower Brand PC. Category: Acer. Subcategory: Brand PC. Price: 61,000৳.
",242,717,959
4,recursive,"
Product: ASUS ExpertCenter D5 D500ME Core i3 13th Gen Brand PC. Category: ASUS. Subcategory: Brand PC. Price: 63,000৳.

Product: ASUS ExpertCenter D5 D500ME Core i5 13th Gen Mini Tower Brand PC. Category: ASUS. Subcategory: Brand PC. Price: 67,000৳.
",251,959,1210
5,recursive,"
Product: ASUS ExpertCenter D5 D500ME Core i7 13th Gen Mini Tower Brand PC. Category: ASUS. Subcategory: Brand PC. Price: 101,850৳.

Product: MSI PRO DP180 13th Gen Core i5 512GB SSD Desktop PC With Monitor. Category: MSI. Subcategory: Brand PC. Price: 67,500৳76,500৳.
",269,1210,1479
6,recursive,"
Product: Intel 13th Gen Core i5 13400F Gaming Desktop PC. Category: Intel PC. Subcategory: Gaming PC. Price: 79,999৳84,500৳.

Product: Intel Core Ultra 5 245K Desktop PC. Category: Intel PC. Subcategory: Gaming PC. Price: 94,499৳99,850৳.
",239,1479,1718
7,recursive,"
Product: Intel Core Ultra 5 245K Gaming Desktop PC. Category: Intel PC. Subcategory: Gaming PC. Price: 109,999৳117,599৳.

Product: Intel Core i5 14400 14th Gen Gaming Desktop PC. Category: Intel PC. Subcategory: Gaming PC. Price: 131,999৳135,950৳.
",249,1718,1967
8,recursive,"
Product: Intel Core i7 14700K 14th Gen Gaming Desktop PC. Category: Intel PC. Subcategory: Gaming PC. Price: 145,999৳153,100৳.

Product: Intel Core Ultra 7 265K Gaming Desktop PC. Category: Intel PC. Subcategory: Gaming PC. Price: 167,999৳172,300৳.
",250,1967,2217
9,recursive,"
Product: Intel Core i7 14700KF 14th Gen Gaming Desktop PC. Category: Intel PC. Subcategory: Gaming PC. Price: 235,999৳245,850৳.

Product: Intel Core Ultra 9 285K Gaming Desktop PC. Category: Intel PC. Subcategory: Gaming PC. Price: 415,000৳425,955৳.
",251,2217,2468
10,recursive,"
Product: AMD Ryzen 5 5600G Desktop PC. Category: Star PC. Subcategory: Desktop. Price: 30,750৳.

Product: AMD Ryzen 5 5600G Budget Desktop PC. Category: Star PC. Subcategory: Desktop. Price: 28,999৳31,350৳.
",208,2468,2676
11,recursive,"
Product: AMD Ryzen 7 5700G Custom Desktop PC. Category: Star PC. Subcategory: Desktop. Price: 30,622৳33,650৳.

Product: AMD Ryzen 5 5600G Budget Desktop PC. Category: Star PC. Subcategory: Desktop. Price: 39,700৳.
",215,2676,2891
12,recursive,"
Product: AMD Ryzen 5 8500G Desktop PC. Category: Star PC. Subcategory: Desktop. Price: 44,500৳46,000৳.

Product: AMD Ryzen 5 3400G Processor Desktop PC. Category: RYZEN PC. Subcategory: Gaming PC. Price: 21,999৳23,950৳.
",221,2891,3112
13,recursive,"
Product: AMD Ryzen 5 5600G Custom Desktop PC. Category: RYZEN PC. Subcategory: Gaming PC. Price: 29,500৳31,700৳.

Product: AMD Ryzen 5 5600GT Budget Desktop PC. Category: RYZEN PC. Subcategory: Gaming PC. Price: 28,704৳31,200৳.
",229,3112,3341
14,recursive,"
Product: AMD Ryzen 5 5500 Gaming PC. Category: RYZEN PC. Subcategory: Gaming PC. Price: 44,252৳48,100৳.

Product: AMD Ryzen 5 7600 Desktop PC. Category: RYZEN PC. Subcategory: Gaming PC. Price: 50,600৳.
",204,3341,3545
15,recursive,"
Product: AMD Ryzen 7 7700 Budget Gaming Desktop PC. Category: RYZEN PC. Subcategory: Gaming PC. Price: 52,780৳56,149৳.

Product: AMD Ryzen 7 8700G Budget Desktop PC. Category: RYZEN PC. Subcategory: Gaming PC. Price: 60,019৳63,850৳.
",234,3545,3779
16,recursive,"
Product: AMD Ryzen 5 9600X Gaming Desktop PC. Category: RYZEN PC. Subcategory: Gaming PC. Price: 63,000৳67,100৳.

Product: AMD Ryzen 5 7500F Gaming PC. Category: RYZEN PC. Subcategory: Gaming PC. Price: 77,499৳81,899৳.
",220,3779,3999
17,recursive,"
Product: AMD Ryzen 5 7500F Gaming Desktop PC. Category: RYZEN PC. Subcategory: Gaming PC. Price: 86,999৳91,800৳.

Product: AMD Ryzen 5 8400F Gaming Desktop PC. Category: RYZEN PC. Subcategory: Gaming PC. Price: 88,999৳94,700৳.
",228,3999,4227
18,recursive,"
Product: AMD Ryzen 5 7500F Budget Gaming PC. Category: RYZEN PC. Subcategory: Gaming PC. Price: 90,499৳95,950৳.

Product: AMD Ryzen 7 9700X Gaming Desktop PC. Category: RYZEN PC. Subcategory: Gaming PC. Price: 134,499৳141,100৳.
",229,4227,4456
19,recursive,"
Product: AMD Ryzen 7 7700X Gaming Desktop PC. Category: RYZEN PC. Subcategory: Gaming PC. Price: 149,999৳155,900৳.

Product: AMD Ryzen 7 9800X3D Gaming Desktop PC. Category: RYZEN PC. Subcategory: Gaming PC. Price: 160,099৳.
",226,4456,4682
20,recursive,"
Product: AMD Ryzen 7 7700 Gaming PC. Category: RYZEN PC. Subcategory: Gaming PC. Price: 162,600৳.

Product: AMD Ryzen 9 9950X3D Gaming PC. Category: RYZEN PC. Subcategory: Gaming PC. Price: 874,999৳884,850৳.
",209,4682,4891
21,recursive,"
Product: AMD Ryzen 7 9700X Gaming PC. Category: RYZEN PC. Subcategory: Gaming PC. Price: Up Coming.

Product: AMD Ryzen 5 2400G Desktop PC. Category: RYZEN PC. Subcategory: Gaming PC. Price: Out Of Stock.
",206,4891,5097
22,recursive,"
Product: AMD Ryzen 5 8600G Desktop PC. Category: RYZEN PC. Subcategory: Gaming PC. Price: Out Of Stock.

Product: Lenovo IdeaCentre 3 07IRB8 Core i3 13th Gen Brand PC. Category: Lenovo. Subcategory: Brand PC. Price: 48,500৳.
",226,5097,5323
23,recursive,"
Product: Lenovo ThinkCentre Neo 50t Gen 4 Core i3 12th Gen Brand PC. Category: Lenovo. Subcategory: Brand PC. Price: 50,000৳.

Product: Lenovo ThinkCentre Neo 50s Gen 4 Core i3 13th Gen 512GB SSD Brand PC. Category: Lenovo. Subcategory: Brand PC. Price: 51,500৳.
",264,5323,5587
24,recursive,"
Product: Lenovo ThinkCentre Neo 50t Gen 4 Core i3 13th Gen Brand PC. Category: Lenovo. Subcategory: Brand PC. Price: 52,500৳.

Product: Lenovo IdeaCentre 3 07IRB8 Core i5 14th Gen Brand PC (Upgraded). Category: Lenovo. Subcategory: Brand PC. Price: 62,000৳.
",259,5587,5846
25,recursive,"
Product: Lenovo ThinkCentre Neo 50t Gen 4 Core i5 13th Gen Brand PC. Category: Lenovo. Subcategory: Brand PC. Price: 62,500৳.

Product: Lenovo ThinkCentre Neo 50s Gen 4 Core i5 12th Gen 512GB SSD Brand PC. Category: Lenovo. Subcategory: Brand PC. Price: 62,500৳.
",264,5846,6110
26,recursive,"
Product: Lenovo ThinkCentre Neo 50t Gen 4 Core i5 13th Gen Brand PC. Category: Lenovo. Subcategory: Brand PC. Price: 65,500৳.

Product: Lenovo ThinkCentre Neo 50t Gen 4 Core i5 13th Gen 512GB SSD Brand PC. Category: Lenovo. Subcategory: Brand PC. Price: 65,500৳.
",264,6110,6374
27,recursive,"
Product: Lenovo ThinkCentre Neo 50s SFF Core i7 12th Gen Brand PC. Category: Lenovo. Subcategory: Brand PC. Price: 71,500৳.

Product: Lenovo ThinkCentre Neo 50s Core i7 12th Gen 1TB SSD Brand PC. Category: Lenovo. Subcategory: Brand PC. Price: 72,500৳.
",254,6374,6628
28,recursive,"
Product: Lenovo IdeaCentre 3 07IAB7 Core i7 12th Gen Desktop PC. Category: Lenovo. Subcategory: Brand PC. Price: 71,500৳73,500৳.

Product: Lenovo ThinkCentre M70s Gen 3 SFF Core i7 12th Gen Brand PC. Category: Lenovo. Subcategory: Brand PC. Price: 83,000৳.
",258,6628,6886
29,recursive,"
Product: Asus NUC 13 Pro Core i3 13th Gen Portable Mini Pc. Category: Desktop. Price: 46,500৳.

Product: Asus NUC 13 Pro Core i5 13th Gen Portable Mini Pc. Category: Desktop. Price: 60,500৳.

Product: Asus PN41 Celeron N5100 Mini PC. Category: Desktop. Price: 26,000৳.
",270,6886,7156
30,recursive,"
Product: Asus Nuc 14 Essential Core 3 N355 Portable Mini Pc. Category: Desktop. Price: 36,000৳.

Product: Asus ExpertCenter PN64 Core i3 12th Gen Portable Mini PC. Category: Desktop. Price: 41,000৳.
",200,7156,7356
31,recursive,"
Product: TECLAST K24 Air Intel Celeron N5095 24"" FHD All-in-One PC. Category: Desktop. Price: 42,000৳.

Product: AOC A33 Intel Celeron N5095 23.8"" FHD All in One PC. Category: Desktop. Price: 46,500৳.
",202,7356,7558
32,recursive,"
Product: HP Pro Tower 280 G9 Core i3 12th Gen 8GB RAM Desktop PC. Category: Brand PC. Subcategory: Desktop. Price: 52,500৳.

Product: Dell OptiPlex 7010 Core i3 12th Gen Tower Desktop PC. Category: Brand PC. Subcategory: Desktop. Price: 53,500৳.
",247,7558,7805
33,recursive,"
Product: Dell VOSTRO 3030 MT Core i5 12th Gen Brand PC (Upgraded). Category: Brand PC. Subcategory: Desktop. Price: 56,000৳.

Product: Dell VOSTRO 3030 MT Core i3 14th Gen Brand PC. Category: Brand PC. Subcategory: Desktop. Price: 50,500৳.
",241,7805,8046
34,recursive,"
Product: Dell VOSTRO 3030 MT Core i3 12th Gen Brand PC (Upgraded). Category: Brand PC. Subcategory: Desktop. Price: 46,500৳.

Product: Dell VOSTRO 3030 MT Core i7 12th Gen Brand PC (Upgraded). Category: Brand PC. Subcategory: Desktop. Price: 76,000৳.
",252,8046,8298
35,recursive,"
Product: DELL OptiPlex 7010 Core i3 13th Gen 8GB RAM Desktop PC. Category: Brand PC. Subcategory: Desktop. Price: 57,500৳.

Product: Dell OptiPlex 7020 Core i3 12th Gen Tower Brand PC. Category: Brand PC. Subcategory: Desktop. Price: 55,000৳.
",244,8298,8542
36,recursive,"
Product: Dell OptiPlex 7020 Core i3 14th Gen Tower Brand PC. Category: Brand PC. Subcategory: Desktop. Price: 63,000৳.

Product: HP 280 Pro G9 MT Core i3 14th Gen Brand PC. Category: Brand PC. Subcategory: Desktop. Price: 60,000৳.
",232,8542,8774
37,recursive,"
Product: Dell OptiPlex 7010 Core i5 12th Gen Tower Desktop PC. Category: Brand PC. Subcategory: Desktop. Price: 64,500৳.

Product: HP 280 Pro G9 MT Core i5 14th Gen Brand PC. Category: HP. Subcategory: Brand PC. Price: 72,500৳.
",229,8774,9003
38,recursive,"
Product: HP Pro Tower 400 G9 Core i7 12th Gen Desktop PC with Windows 11 Pro. Category: HP. Subcategory: Brand PC. Price: 95,000৳.

Product: HP Pro Tower 290 G9 Core i3 12th Gen Brand PC. Category: HP. Subcategory: Brand PC. Price: 49,000৳.
",242,9003,9245
39,recursive,"
Product: HP Pro Tower 290 G9 Core i5 12th Gen Brand PC (Upgraded). Category: HP. Subcategory: Brand PC. Price: 58,000৳.

Product: HP Pro Tower 290 G9 Core i7 12th Gen Brand PC (Upgraded). Category: HP. Subcategory: Brand PC. Price: 76,000৳.
",242,9245,9487
40,recursive,"
Product: HP Pro Tower 400 G9 Core i5 13th Gen Brand PC (Upgraded). Category: HP. Subcategory: Brand PC. Price: 74,000৳.

Product: HP Pro Tower 280 G9 Core i7 12th Gen 16GB RAM 512GB SSD Desktop PC. Category: HP. Subcategory: Brand PC. Price: 83,000৳.
",252,9487,9739
41,recursive,"
Product: HP Pro Tower 280 G9 Core i7 14th Gen Brand PC. Category: HP. Subcategory: Brand PC. Price: Up Coming.

Product: AMD Ryzen 5 8400F Gaming PC. Category: Ryzen PC. Subcategory: Star PC. Price: Out Of Stock.
",214,9739,9953
42,recursive,"
Product: Dell OptiPlex 3000 Core i5 12th Gen Tower Brand PC. Category: Dell. Subcategory: Brand PC. Price: 65,000৳.

Product: Dell OptiPlex 7020 Core i5 12th Gen Tower Brand PC. Category: Dell. Subcategory: Brand PC. Price: 66,500৳.
",234,9953,10187
43,recursive,"
Product: DELL OptiPlex 7010 Tower Core i5 13th Gen 512GB Brand PC. Category: Dell. Subcategory: Brand PC. Price: 70,500৳.

Product: Dell VOSTRO 3030 MT Core i5 14th Gen Brand PC. Category: Dell. Subcategory: Brand PC. Price: 64,000৳.
",235,10187,10422
44,recursive,"
Product: Dell OptiPlex 7020 Core i5 13th Gen Tower Brand PC. Category: Dell. Subcategory: Brand PC. Price: 72,000৳.

Product: Dell Inspiron 3030 MT Core i5 14th Gen Brand PC. Category: Dell. Subcategory: Brand PC. Price: 73,000৳.
",231,10422,10653
45,recursive,"
Product: Dell OptiPlex Tower 7020 Plus Core i5 14th Gen Brand PC. Category: Dell. Subcategory: Brand PC. Price: 75,000৳.

Product: Dell OptiPlex 7010 Core i7 13th Gen Brand PC. Category: Dell. Subcategory: Brand PC. Price: 93,000৳.
",233,10653,10886
46,recursive,"
Product: Dell Vostro 3020T Core i7 13th Gen Desktop PC. Category: Dell. Subcategory: Brand PC. Price: 95,000৳.

Product: Dell OptiPlex 7020 MT Core i7 13th Gen Mini Tower Brand PC. Category: Dell. Subcategory: Brand PC. Price: 95,000৳.
",237,10886,11123
47,recursive,"
Product: Dell OptiPlex 7020 Core i7 12th Gen Tower Brand PC. Category: Dell. Subcategory: Brand PC. Price: 93,000৳.

Product: Dell Inspiron 5430 Intel Core 5 120U 23.8"" FHD All-in-One PC. Category: Dell. Subcategory: All-in-One PC. Price: 92,000৳.
",249,11123,11372
48,recursive,"
Product: Dell Inspiron 5430 Intel Core 7 150U 23.8"" FHD All-in-One PC. Category: Dell. Subcategory: All-in-One PC. Price: 118,000৳.

Product: Dell OptiPlex 7420 Core i5 14th Gen 23.8"" FHD Touch All-in-One PC. Category: Dell. Subcategory: All-in-One PC. Price: Out Of Stock.
",275,11372,11647
49,recursive,"
Product: Dell OptiPlex 7420 Core i7 14th Gen 23.8"" FHD Touch All-in-One PC. Category: Dell. Subcategory: All-in-One PC. Price: Out Of Stock.

Product: Lenovo IdeaCentre AIO 24IRH9 Core i5 13th Gen 23.8"" FHD All-in-One Desktop PC. Category: LENOVO. Subcategory: All-in-One PC. Price: 89,500৳.
",293,11647,11940
50,recursive,"
Product: AOC B911 Intel Celeron N95 23.8"" Full HD All in One PC. Category: All-in-One PC. Subcategory: Desktop. Price: 50,300৳.

Product: AOC A33 Core i5 7th Gen 23.8"" FHD All in One PC. Category: All-in-One PC. Subcategory: Desktop. Price: 55,200৳.
",251,11940,12191
51,recursive,"
Product: AOC B911 Core i5 8th Gen 23.8"" Full HD All in One PC With WebCam. Category: All-in-One PC. Subcategory: Desktop. Price: 58,800৳.

Product: AOC B911 Core i5 8th Gen 27"" Full HD All in One PC With WebCam & Battery. Category: All-in-One PC. Subcategory: Desktop. Price: 61,500৳.
",286,12191,12477
52,recursive,"
Product: TECLAST K24 Air Core i5 12th Gen 24"" FHD All-in-One PC. Category: All-in-One PC. Subcategory: Desktop. Price: 68,000৳.

Product: ASUS ExpertCenter P440VAK Core i3 13th Gen 23.8"" FHD All-in-One PC. Category: All-in-One PC. Subcategory: Desktop. Price: 68,500৳.
",270,12477,12747
53,recursive,"
Product: AOC B911 Core i5 12th Gen 23.8"" Full HD All in One PC With WebCam & Battery. Category: All-in-One PC. Subcategory: Desktop. Price: 71,700৳.

Product: AOC A99 Core i7 13th Gen 27"" Full HD All in One PC With WebCam & Battery. Category: All-in-One PC. Subcategory: Desktop. Price: 85,600৳.
",297,12747,13044
54,recursive,"
Product: HP All-in-One 24-cr0085d Core i5 13th Gen FHD Touch Desktop PC. Category: All-in-One PC. Subcategory: Desktop. Price: 112,000৳.

Product: HP Pro 240 G9 Core i5 12th Gen All-in-One Desktop PC. Category: All-in-One PC. Subcategory: Desktop. Price: 91,000৳94,500৳.
",272,13044,13316
55,recursive,"
Product: ASUS ExpertCenter P440VAK Core i7 13th Gen 23.8"" FHD All-in-One PC. Category: All-in-One PC. Subcategory: Desktop. Price: 95,000৳.

Product: HP All-in-One 24-cr0086d Core i5 13th Gen Desktop PC. Category: All-in-One PC. Subcategory: Desktop. Price: 99,500৳.
",268,13316,13584
56,recursive,"
Product: ASUS ExpertCenter E5 E5202WHAK Core i3 11th Gen 21.5"" FHD All-in-One PC. Category: All-in-One PC. Subcategory: Desktop. Price: Up Coming.

Product: dHP R240 Core i5 4th Gen 23.8"" FHD All-in-One PC. Category: All-in-One PC. Subcategory: Desktop. Price: 40,000৳.
",271,13584,13855
57,recursive,"
Product: dHP E270 Core i5 7th Gen 27"" FHD All-in-One PC. Category: All-in-One PC. Subcategory: Desktop. Price: 46,800৳.

Product: Asus ExpertCenter E3202 Core i3 12th Gen 21.5"" FHD All-in-One PC. Category: ASUS. Subcategory: All-in-One PC. Price: Out Of Stock.
",262,13855,14117
58,recursive,"
Product: HP Pro 240 G9 Core i7 12th Gen All-in-One Desktop PC. Category: HP. Subcategory: All-in-One PC. Price: Out Of Stock.

Product: HP All-in-One 27-cr0051d Core i7 13th Gen FHD Desktop PC. Category: HP. Subcategory: All-in-One PC. Price: 134,000৳.
",254,14117,14371
59,recursive,"
Product: ASUS NUC 12 Pro Core i3 12th Gen Portable Mini PC. Category: Portable Mini PC. Subcategory: Desktop. Price: 48,500৳.

Product: Asus ExpertCenter PN64 Core i5 12th Gen Portable Mini PC. Category: Portable Mini PC. Subcategory: Desktop. Price: 58,000৳.
",261,14371,14632
60,recursive,"
Product: ASUS ROG NUC Core Ultra 7 155H RTX 4060 8GB Graphics Mini Gaming PC. Category: Portable Mini PC. Subcategory: Desktop. Price: Out Of Stock.

Product: ASUS NUC 15 Pro Core Ultra 5 225H Portable Mini PC. Category: Portable Mini PC. Subcategory: Desktop. Price: 76,000৳.
",278,14632,14910
61,recursive,"
Product: ASUS ROG NUC Core Ultra 9 185H RTX 4070 8GB Graphics Mini Gaming PC. Category: Portable Mini PC. Subcategory: Desktop. Price: Out Of Stock.
",150,14910,15060
62,recursive,"
Product: ASUS ROG NUC Core Ultra 9 275HX RTX 5070Ti 12GB Graphics Mini Gaming PC. Category: Portable Mini PC. Subcategory: Desktop. Price: 390,000৳.

Product: Asus PN41 Celeron Dual Core Mini PC. Category: Portable Mini PC. Subcategory: Desktop. Price: 26,000৳.
",263,15060,15323
63,recursive,"
Product: Zotac ZBOX BI322 Intel N3050 Portable Mini PC. Category: Portable Mini PC. Subcategory: Desktop. Price: Up Coming.

Product: Zotac ZBOX PI330 Intel Atom Portable Mini PC. Category: Portable Mini PC. Subcategory: Desktop. Price: Up Coming.
",249,15323,15572
64,recursive,"
Product: Asus PN40 Celeron Dual Core Mini PC. Category: Portable Mini PC. Subcategory: Desktop. Price: Out Of Stock.

Product: ASUS PN50 Ryzen 7 4700U Ultracompact Mini PC. Category: Portable Mini PC. Subcategory: Desktop. Price: Out Of Stock.
",245,15572,15817
65,recursive,"
Product: Apple Mac Studio M2 Ultra chip 24-core CPU 64GB Memory 1TB SSD (MQH63X/A). Category: Apple Mac Studio. Subcategory: Desktop. Price: Up Coming.
",153,15817,15970
66,recursive,"
Product: Apple Mac Studio M2 Max chip 12-core CPU 32GB Memory 512GB SSD (MQH73). Category: Apple Mac Studio. Subcategory: Desktop. Price: Up Coming.

Product: Apple Mac Pro M2 Ultra Tower Desktop PC. Category: Apple Mac Pro. Subcategory: Desktop. Price: Up Coming.
",266,15970,16236
67,recursive,"
Product: Apple iMac M4 Chip 256GB SSD 24"" 4.5K Retina Display All-in-One PC (Late 2024). Category: Apple iMac. Subcategory: Desktop. Price: 210,000৳235,000৳.
",159,16236,16395
68,recursive,"
Product: Apple iMac M4 Chip 10 Core GPU 256GB SSD 24"" 4.5K Retina Display All-in-One PC (Late 2024). Category: Apple iMac. Subcategory: Desktop. Price: 250,000৳.
",163,16395,16558
69,recursive,"
Product: Apple iMac M4 Chip 10 Core GPU 512GB SSD 24"" 4.5K Retina Display All-in-One PC (Late 2024). Category: Apple iMac. Subcategory: Desktop. Price: 279,999৳.
",163,16558,16721
70,recursive,"
Product: Apple iMac M4 Chip 10 Core GPU 24GB RAM 24"" 4.5K Retina Display All-in-One PC (Late 2024). Category: Apple iMac. Subcategory: Desktop. Price: 305,000৳315,000৳.
",170,16721,16891
71,recursive,"
Product: Apple Mac Mini M4 chip with 10-core CPU 10-Core GPU 16GB Memory 256GB Storage. Category: Apple Mac Mini. Subcategory: Desktop. Price: 79,000৳83,000৳.
",160,16891,17051
72,recursive,"
Product: Apple Mac Mini M4 chip with 10-core CPU 10-Core GPU 16GB Memory 512GB Storage. Category: Apple Mac Mini. Subcategory: Desktop. Price: 110,000৳115,000৳.
",162,17051,17213
73,recursive,"
Product: Apple Mac Mini M4 chip with 10-core CPU 10-Core GPU 24GB Memory 512GB Storage. Category: Apple Mac Mini. Subcategory: Desktop. Price: 145,000৳.
",154,17213,17367
74,recursive,"
Product: Apple Mac Mini M4 Pro chip with 12-core CPU 16-Core GPU 24GB Memory 512GB Storage #MCX44ZP/A. Category: Apple Mac Mini. Subcategory: Desktop. Price: 195,000৳.

Product: Asus ExpertBook B1 B1503CVA Core i5 13th Gen 15.6"" FHD Laptop. Category: Asus. Subcategory: All Laptop. Price: 81,000৳.
",299,17367,17666
75,recursive,"
Product: ASUS Vivobook Go 15 L510KA Intel Celeron N4500 15.6"" FHD Laptop. Category: Asus. Subcategory: All Laptop. Price: 36,000৳.

Product: ASUS Vivobook Go 15 L510KA Celeron N4500 15.6"" FHD Laptop Star Black. Category: Asus. Subcategory: All Laptop. Price: 36,800৳.
",269,17666,17935
76,recursive,"
Product: ASUS Vivobook Go 15 E1504GA Core i3 N305 15.6"" FHD Laptop. Category: Asus. Subcategory: All Laptop. Price: 49,000৳.

Product: ASUS Vivobook Go 15 E1504GA Core i3 N305 512GB SSD 15.6"" FHD Laptop. Category: Asus. Subcategory: All Laptop. Price: 52,000৳.
",262,17935,18197
77,recursive,"
Product: ASUS Vivobook 15 F1504ZA Core i3 15.6-inch FHD Laptop. Category: Asus. Subcategory: All Laptop. Price: 52,500৳.

Product: ASUS Vivobook 15 F1504ZA Core i3 12th Gen 15.6"" FHD Laptop Cool Silver. Category: Asus. Subcategory: All Laptop. Price: 52,500৳.
",261,18197,18458
78,recursive,"
Product: ASUS Vivobook 15 F1504ZA Core i3 12th Gen 512GB SSD 15.6"" FHD Laptop. Category: Asus. Subcategory: All Laptop. Price: 52,500৳.

Product: ASUS VivoBook 15 X515EA Core i3 11th Gen 512GB SSD 15.6"" FHD Laptop. Category: Asus. Subcategory: All Laptop. Price: 55,000৳.
",273,18458,18731
79,recursive,"
Product: ASUS Vivobook 15 X1504VA Core i3 13th Gen 15.6"" FHD Laptop. Category: Asus. Subcategory: All Laptop. Price: 54,500৳57,500৳.

Product: ASUS Vivobook 15 X1504VA Core i3 13th Gen 15.6-inch FHD Laptop. Category: Asus. Subcategory: All Laptop. Price: 57,000৳.
",265,18731,18996
80,recursive,"
Product: ASUS Vivobook 15 X1504VA Core i3 13th Gen 16GB RAM 15.6"" FHD Laptop. Category: Asus. Subcategory: All Laptop. Price: 56,000৳58,500৳.

Product: ASUS Vivobook Go 15 L1504FA Ryzen 5 7520U 15.6"" FHD Laptop. Category: Asus. Subcategory: All Laptop. Price: 59,500৳.
",270,18996,19266
81,recursive,"
Product: ASUS Vivobook Go 15 L1504FA Ryzen 5 7520U 15.6"" FHD Laptop Cool Silver. Category: Asus. Subcategory: All Laptop. Price: 59,500৳.

Product: ASUS Vivobook Go 15 L1504FA Ryzen 5 7520U 8GB RAM 15.6"" FHD Laptop. Category: Asus. Subcategory: All Laptop. Price: 59,500৳.
",274,19266,19540
82,recursive,"
Product: ASUS ExpertBook P1 P1403CVA Core i3 13th Gen 14"" FHD Laptop. Category: Asus. Subcategory: All Laptop. Price: 59,500৳.

Product: ASUS Vivobook 15 X1504VA Core i3 15.6-inch FHD Laptop. Category: Asus. Subcategory: All Laptop. Price: 60,800৳.
",250,19540,19790
83,recursive,"
Product: ASUS Vivobook 15 X1504VA Core i3 512GB SSD 15.6-inch FHD Laptop. Category: Asus. Subcategory: All Laptop. Price: 60,800৳.

Product: ASUS VivoBook 15 X1500EA Core i3 11th Gen 15.6"" FHD Laptop. Category: Asus. Subcategory: All Laptop. Price: 58,000৳62,500৳.
",266,19790,20056
84,recursive,"
Product: Asus VivoBook Go 15 OLED E1504FA Ryzen 3 7320U 15.6"" FHD Laptop. Category: Asus. Subcategory: All Laptop. Price: 63,500৳.

Product: Lenovo IdeaPad Slim 3 15AMN8 Ryzen 3 7320U 15.6"" FHD Laptop. Category: All Laptop. Subcategory: Laptop. Price: 51,500৳.
",262,20056,20318
85,recursive,"
Product: Gigabyte A16 GA6H Core i7 13th Gen 16"" FHD+ WUXGA Nvidia RTX 5050 Gaming Laptop. Category: All Laptop. Subcategory: Laptop. Price: 145,000৳154,000৳.

Product: Lenovo IdeaPad Slim 3 15ABR8 Ryzen 5 5625U 15.6"" Laptop. Category: All Laptop. Subcategory: Laptop. Price: 61,500৳.
",285,20318,20603
86,recursive,"
Product: Lenovo IdeaPad Slim 3 15ABR8 Ryzen 5 5625U 15.6"" FHD Laptop. Category: All Laptop. Subcategory: Laptop. Price: 61,500৳.

Product: Lenovo IdeaPad Slim 3 15ABR8 Ryzen 5 5625U Laptop. Category: All Laptop. Subcategory: Laptop. Price: 63,500৳.
",250,20603,20853
87,recursive,"
Product: Lenovo IdeaPad Slim 3 14ABR8 Ryzen 7 5825U 14"" FHD Laptop. Category: All Laptop. Subcategory: Laptop. Price: 67,500৳.

Product: Lenovo IdeaPad Slim 3 15ABR8 Ryzen 7 5825U 15.6 Inch Laptop. Category: All Laptop. Subcategory: Laptop. Price: 66,500৳.
",258,20853,21111
88,recursive,"
Product: Lenovo IdeaPad Slim 3 15ABR8 Ryzen 7 5825U 15.6"" Laptop. Category: All Laptop. Subcategory: Laptop. Price: 72,000৳.

Product: Lenovo IdeaPad Slim 3 15ABR8 Ryzen 7 5825U 15.6"" FHD Laptop. Category: All Laptop. Subcategory: Laptop. Price: 72,000৳.
",256,21111,21367
89,recursive,"
Product: Lenovo IdeaPad Flex 5 14ABR8 Ryzen 5 5625U 14"" WUXZA X360 Touch Laptop. Category: All Laptop. Subcategory: Laptop. Price: 85,000৳.

Product: Lenovo IdeaPad Slim 3 14AHP10 Ryzen 5 8640HS 14"" WUXGA AI Integrated Laptop. Category: All Laptop. Subcategory: Laptop. Price: 89,000৳.
",287,21367,21654
90,recursive,"
Product: Lenovo IdeaPad Slim 5 13ARP10 Ryzen 7 7735HS 13.3"" WUXGA Laptop. Category: All Laptop. Subcategory: Laptop. Price: 93,000৳.

Product: Lenovo IdeaPad Slim 5 16AKP10 Ryzen AI 5 340 16"" 2.8K Laptop. Category: All Laptop. Subcategory: Laptop. Price: 125,000৳.
",266,21654,21920
91,recursive,"
Product: Lenovo IdeaPad Slim 5 14Q8X9 Snapdragon X Plus 14"" WUXGA OLED Copilot+ PC Laptop. Category: All Laptop. Subcategory: Laptop. Price: 125,000৳.

Product: Lenovo IdeaPad Slim 5 14AKP10 Ryzen AI 7 350 14"" OLED Laptop. Category: All Laptop. Subcategory: Laptop. Price: Out Of Stock.
",288,21920,22208
92,recursive,"
Product: Lenovo IdeaPad Slim 5 16AKP10 Ryzen AI 7 350 16"" 2.8K Laptop. Category: All Laptop. Subcategory: Laptop. Price: 160,000৳.

Product: Lenovo Yoga Pro 7 14ASP9 Ryzen AI 9 365 14.5"" 2.8K Laptop. Category: All Laptop. Subcategory: Laptop. Price: 205,000৳.
",261,22208,22469
93,recursive,"
Product: Lenovo IdeaPad Slim 3 15AMN8 Ryzen 5 7520U 15.6"" FHD TN Laptop. Category: All Laptop. Subcategory: Laptop. Price: 61,000৳.
",133,22469,22602
94,recursive,"
Product: Lenovo IdeaPad Slim 3 Ryzen 5 7520U 15.6"" FHD IPS Laptop 16GB DDR5 RAM 512GB SSD with 2 Years Warranty. Category: All Laptop. Subcategory: Laptop. Price: 67,500৳.
",173,22602,22775
95,recursive,"
Product: Lenovo IdeaPad Slim 3 Ryzen 5 7520U 15.6"" FHD Laptop FingerPrint 16GB DDR5 RAM 512GB SSD Abyss Blue with 2 Years Warranty. Category: All Laptop. Subcategory: Laptop. Price: 67,500৳.
",192,22775,22967
96,recursive,"
Product: Dell Inspiron 15 3520 Core i3 12th Gen 15.6"" FHD Laptop. Category: Dell. Subcategory: All Laptop. Price: 54,000৳.

Product: Dell Inspiron 15 3520 Core i3 12th Gen 15.6"" FHD Laptop (For Business). Category: Dell. Subcategory: All Laptop. Price: 53,000৳.
",263,22967,23230
97,recursive,"
Product: Dell Inspiron 15 3530 Core i3 13th Gen 15.6"" FHD Laptop (Business Series). Category: Dell. Subcategory: All Laptop. Price: 59,500৳.

Product: Dell Inspiron 3530 Core i3 13th Gen 15.6"" FHD Laptop. Category: Dell. Subcategory: All Laptop. Price: 57,000৳64,500৳.
",270,23230,23500
98,recursive,"
Product: Dell Inspiron 15 3520 Core i5 12th Gen 15.6"" FHD Laptop (For Business). Category: Dell. Subcategory: All Laptop. Price: 65,500৳.

Product: Dell Latitude 3530 Core i3 12th Gen 15.6"" FHD Touch Laptop. Category: Dell. Subcategory: All Laptop. Price: 68,500৳.
",266,23500,23766
99,recursive,"
Product: Dell Inspiron 15 3530 Core i5 13th Gen 15.6"" FHD Laptop With Finger Print (Business Series). Category: Dell. Subcategory: All Laptop. Price: 67,500৳70,500৳.

Product: Dell Inspiron 3530 Core i5 13th Gen 15.6"" FHD Laptop. Category: Dell. Subcategory: All Laptop. Price: 72,500৳.
",288,23766,24054
100,recursive,"
Product: Dell Latitude 3440 Core i5 12th Gen 14"" FHD Laptop. Category: Dell. Subcategory: All Laptop. Price: 81,000৳84,500৳.

Product: Dell Latitude 3540 Core i5 12th Gen 15.6"" FHD Laptop. Category: Dell. Subcategory: All Laptop. Price: 86,500৳.
",247,24054,24301
101,recursive,"
Product: Dell Inspiron 14 5440 Core 5 120U 14"" FHD Laptop. Category: Dell. Subcategory: All Laptop. Price: 85,000৳.

Product: Dell Inspiron 14 5440 Intel Core i5 13th Gen 14"" FHD Laptop. Category: Dell. Subcategory: All Laptop. Price: 89,500৳.
",245,24301,24546
102,recursive,"
Product: Dell Inspiron 15 3530 Core i7 13th Gen 15.6"" FHD Laptop. Category: Dell. Subcategory: All Laptop. Price: 94,000৳.

Product: Dell Inspiron 14 5440 Core 7 150U 14"" FHD Laptop. Category: Dell. Subcategory: All Laptop. Price: 115,000৳.
",242,24546,24788
103,recursive,"
Product: Dell Latitude 5450 Core Ultra 5 125U 14"" FHD Laptop. Category: Dell. Subcategory: All Laptop. Price: 132,000৳.

Product: Dell XPS 13 9340 Intel Core Ultra 7 155H 13.4"" FHD+ Laptop. Category: Dell. Subcategory: All Laptop. Price: 235,000৳.
",249,24788,25037
104,recursive,"
Product: Dell XPS 13 Plus 9320 Intel Core i7 13th Gen 13.4"" 3.5K OLED Touch Laptop. Category: Dell. Subcategory: All Laptop. Price: 297,000৳.

Product: Dell Inspiron 15 3520 Core i5 12th Gen 15.6"" FHD Laptop. Category: Dell. Subcategory: All Laptop. Price: Up Coming.
",269,25037,25306
105,recursive,"
Product: Dell Latitude 3430 Core i3 12th Gen 14"" FHD Laptop. Category: Dell. Subcategory: All Laptop. Price: Out Of Stock.

Product: Dell Vostro 3530 Core i3 13th Gen 15.6"" FHD Laptop. Category: Dell. Subcategory: All Laptop. Price: Out Of Stock.
",248,25306,25554
106,recursive,"
Product: Lenovo IdeaPad Slim 3 Ryzen 5 7520U 14"" FHD Laptop FingerPrint 16GB DDR5 RAM 512GB SSD with 2 Years Warranty. Category: Lenovo. Subcategory: All Laptop. Price: 67,500৳.

Product: Smart Flairedge Celeron N4020C 15.6"" FHD Laptop. Category: Smart. Subcategory: All Laptop. Price: 29,400৳.
",296,25554,25850
107,recursive,"
Product: Smart Flairedge Ryzen 3 3200U 15.6"" FHD Laptop. Category: Smart. Subcategory: All Laptop. Price: 37,800৳.

Product: Smart Flairedge Ryzen 5 3500U 15.6"" FHD Laptop. Category: Smart. Subcategory: All Laptop. Price: 41,400৳.
",232,25850,26082
108,recursive,"
Product: Smart Flairedge Core i3 12th Gen 15.6"" FHD Laptop. Category: Smart. Subcategory: All Laptop. Price: 44,000৳.

Product: Smart Flairedge Core i3 13th Gen 15.6"" FHD Laptop. Category: Smart. Subcategory: All Laptop. Price: 48,000৳.
",238,26082,26320
109,recursive,"
Product: Smart Flairedge Core i5 12th Gen 15.6"" FHD Laptop. Category: Smart. Subcategory: All Laptop. Price: 53,000৳.

Product: Smart Flairedge Core i5 13th Gen 15.6"" FHD Laptop. Category: Smart. Subcategory: All Laptop. Price: 57,500৳.
",238,26320,26558
110,recursive,"
Product: Smart Flairedge Core i7 12th Gen 15.6"" FHD Laptop. Category: Smart. Subcategory: All Laptop. Price: 66,500৳.

Product: Smart Flairedge Core i7 12th Gen 16"" FHD Laptop. Category: Smart. Subcategory: All Laptop. Price: 66,500৳.
",236,26558,26794
111,recursive,"
Product: Acer Aspire 3 A325-45 Celeron N4500 15.6 Inch HD Laptop. Category: Acer. Subcategory: All Laptop. Price: 32,000৳34,500৳.

Product: Acer Aspire Lite AL15-41 AMD Ryzen 3 5300U 15.6"" FHD Laptop. Category: Acer. Subcategory: All Laptop. Price: 45,500৳47,500৳.
",266,26794,27060
112,recursive,"
Product: Acer Aspire Lite AL15-52 Core i3 12th Gen 16GB RAM 15.6"" FHD Laptop. Category: Acer. Subcategory: All Laptop. Price: 51,900৳.

Product: Acer Aspire 3 A325-53 Core i3 13th Gen 15.6"" FHD Laptop. Category: Acer. Subcategory: All Laptop. Price: 53,900৳.
",260,27060,27320
113,recursive,"
Product: Acer TravelLite TL14-52M Core i3 13th Gen 8GB RAM 512GB Storage 14"" FHD Laptop. Category: Acer. Subcategory: All Laptop. Price: 56,000৳.

Product: Acer Aspire Lite AL15-41 AMD Ryzen 5 5500U 15.6"" FHD Laptop. Category: Acer. Subcategory: All Laptop. Price: 56,000৳.
",275,27320,27595
114,recursive,"
Product: Acer Aspire Lite AL15-41 AMD Ryzen 5 5625U 15.6"" FHD Laptop. Category: Acer. Subcategory: All Laptop. Price: 56,500৳.

Product: Acer Aspire Lite AL15-41 AMD Ryzen 5 7430U 15.6"" FHD Laptop. Category: Acer. Subcategory: All Laptop. Price: 55,000৳58,500৳.
",263,27595,27858
115,recursive,"
Product: Acer Aspire 3 A325-53 Core i5 13th Gen 15.6"" FHD Laptop. Category: Acer. Subcategory: All Laptop. Price: 64,900৳.

Product: Acer TravelMate P2 TMP215-54 Core i5 12th Gen 15.6"" FHD Laptop. Category: Acer. Subcategory: All Laptop. Price: 66,500৳.
",255,27858,28113
116,recursive,"
Product: Acer TravelMate TMP214-54 Core i5 12th Gen 14"" FHD Laptop. Category: Acer. Subcategory: All Laptop. Price: 66,800৳.

Product: Acer TravelLite TL14-52M Core i5 13th Gen 8GB RAM 512GB Storage 14"" FHD Laptop. Category: Acer. Subcategory: All Laptop. Price: 75,500৳.
",273,28113,28386
117,recursive,"
Product: Acer Aspire Vero AV14-52P Core i5 13th Gen 14"" FHD Laptop. Category: Acer. Subcategory: All Laptop. Price: 94,000৳.

Product: Acer Nitro V 15 ANV15-51 Core i5 13th Gen 15.6"" FHD Gaming Laptop. Category: Acer. Subcategory: All Laptop. Price: 125,000৳.
",261,28386,28647
118,recursive,"
Product: Acer Swift Go 14 SFG14-73 Core Ultra 5 125H 14"" WQXGA+ OLED AI Laptop. Category: Acer. Subcategory: All Laptop. Price: 121,000৳.

Product: Acer Swift Go 14 SFG14-73T Core Ultra 7 155H 16GB RAM 1TB SSD 14"" WUXGA Touch Laptop. Category: Acer. Subcategory: All Laptop. Price: 141,000৳.
",293,28647,28940
119,recursive,"
Product: Acer Swift Go 14 SFG14-73 Core Ultra 7 155H 14"" WQXGA+ OLED AI Laptop. Category: Acer. Subcategory: All Laptop. Price: 148,500৳.

Product: Acer Predator Helios Neo 16 PH16-72-74W1 Core i7 14th Gen 16"" Gaming Laptop. Category: Acer. Subcategory: All Laptop. Price: 205,000৳.
",284,28940,29224
120,recursive,"
Product: Acer Aspire Lite AL15-52 Core i3 12th Gen 15.6"" FHD Laptop. Category: Acer. Subcategory: All Laptop. Price: Out Of Stock.

Product: Acer Aspire Lite AL15-52 Core i5 12th Gen 15.6"" FHD Laptop With Backlit Keyboard. Category: Acer. Subcategory: All Laptop. Price: Out Of Stock.
",286,29224,29510
121,recursive,"
Product: MSI Modern 15 F13MG Core i3 13th Gen 16GB RAM 15.6"" FHD Laptop Platinum Gray. Category: MSI. Subcategory: All Laptop. Price: 55,500৳58,500৳.

Product: MSI Modern 15 F13MG Core i3 13th Gen 15.6"" FHD Laptop Platinum Gray. Category: MSI. Subcategory: All Laptop. Price: 56,500৳.
",286,29510,29796
122,recursive,"
Product: MSI Modern 15 F13MG Core i3 13th Gen 15.6"" FHD Laptop Urban Silver. Category: MSI. Subcategory: All Laptop. Price: 56,500৳.

Product: MSI Modern 15 F13MG Core i3 13th Gen 16GB RAM 15.6"" FHD Laptop Urban Silver. Category: MSI. Subcategory: All Laptop. Price: 55,500৳58,500৳.
",284,29796,30080
123,recursive,"
Product: MSI Modern 14 F13MG Core i3 13th Gen 16GB RAM 14"" FHD Laptop Urban Silver. Category: MSI. Subcategory: All Laptop. Price: 55,500৳58,500৳.

Product: MSI Modern 14 F13MG Core i3 13th Gen 14"" FHD Laptop Urban Silver. Category: MSI. Subcategory: All Laptop. Price: 56,500৳.
",280,30080,30360
124,recursive,"
Product: MSI Modern 14 F13MG Core i3 13th Gen 14"" FHD Laptop Platinum Gray. Category: MSI. Subcategory: All Laptop. Price: 56,500৳.

Product: MSI Modern 14 F13MG Core i3 13th Gen 16GB RAM 14"" FHD Laptop Platinum Gray. Category: MSI. Subcategory: All Laptop. Price: 55,500৳58,500৳.
",282,30360,30642
125,recursive,"
Product: MSI Modern 14 C7M AMD Ryzen 5 7430U 14"" FHD Laptop. Category: MSI. Subcategory: All Laptop. Price: 66,000৳68,000৳.

Product: MSI Modern 15 B7M AMD Ryzen 5 7430U 15.6"" FHD Laptop. Category: MSI. Subcategory: All Laptop. Price: 66,000৳68,000৳.
",252,30642,30894
126,recursive,"
Product: MSI Modern 14 F13MG Core i5 13th Gen 14"" FHD Laptop Urban Silver. Category: MSI. Subcategory: All Laptop. Price: 69,500৳.

Product: MSI Modern 15 F13MG Core i5 13th Gen 15.6"" FHD Laptop Urban Silver. Category: MSI. Subcategory: All Laptop. Price: 72,000৳.
",266,30894,31160
127,recursive,"
Product: MSI Modern 15 B7M Ryzen 7 7730U 15.6"" FHD Laptop. Category: MSI. Subcategory: All Laptop. Price: 72,000৳77,500৳.

Product: MSI Modern 15 F1MG Core 5 120U AI Optimized 15.6"" FHD Laptop Urban Silver. Category: MSI. Subcategory: All Laptop. Price: 78,900৳.
",264,31160,31424
128,recursive,"
Product: MSI Modern 14 C7M Ryzen 7 7730U 14"" Laptop. Category: MSI. Subcategory: All Laptop. Price: 77,500৳79,000৳.

Product: MSI Modern 15 B7M Ryzen 7 7730U 16GB RAM 15.6"" FHD Laptop Classic Black. Category: MSI. Subcategory: All Laptop. Price: 77,500৳79,000৳.
",263,31424,31687
129,recursive,"
Product: MSI Modern 15 F1MG Core 5 120U AI Optimized 15.6"" FHD Laptop Platinum Gray. Category: MSI. Subcategory: All Laptop. Price: 79,500৳.

Product: MSI Modern 14 F13MG Core i7 13th Gen 14"" FHD Laptop Platinum Gray. Category: MSI. Subcategory: All Laptop. Price: 87,900৳.
",275,31687,31962
130,recursive,"
Product: MSI Modern 14 F13MG Core i7 13th Gen 14"" FHD Laptop Urban Silver. Category: MSI. Subcategory: All Laptop. Price: 87,900৳.

Product: MSI Thin 15 B13UC Core i5 13th Gen RTX 3050 4GB Graphics 15.6"" FHD Gaming Laptop. Category: MSI. Subcategory: All Laptop. Price: 89,900৳.
",280,31962,32242
131,recursive,"
Product: Apple MacBook Air (2022) M2 Chip 13.6-Inch Liquid Retina Display 16GB RAM 256GB SSD Midnight #MC7X4ZP/A. Category: MacBook. Subcategory: All Laptop. Price: 101,000৳107,000৳.
",184,32242,32426
132,recursive,"
Product: Apple MacBook Air 13 inch M4 Liquid Retina Display 16GB RAM 256GB SSD Midnight #MW123. Category: MacBook. Subcategory: All Laptop. Price: 125,000৳130,000৳.
",166,32426,32592
133,recursive,"
Product: Apple MacBook Air 13 inch M4 Liquid Retina Display 16GB RAM 256GB SSD Sky Blue #MC6T4. Category: MacBook. Subcategory: All Laptop. Price: 125,000৳130,000৳.
",166,32592,32758
134,recursive,"
Product: Apple MacBook Air 13 inch M4 Liquid Retina Display 16GB RAM 256GB SSD Starlight. Category: MacBook. Subcategory: All Laptop. Price: 125,000৳130,000৳.
",160,32758,32918
135,recursive,"
Product: Apple MacBook Air 13 inch M4 Liquid Retina Display 16GB RAM 256GB SSD Silver #MW0W3. Category: MacBook. Subcategory: All Laptop. Price: 130,000৳136,000৳.
",164,32918,33082
136,recursive,"
Product: Apple MacBook Air 13 inch M4 Liquid Retina Display 16GB RAM 512GB SSD Sky Blue. Category: MacBook. Subcategory: All Laptop. Price: 160,000৳162,000৳.
",159,33082,33241
137,recursive,"
Product: Apple MacBook Air 13 inch M4 Liquid Retina Display 16GB RAM 512GB SSD Midnight. Category: MacBook. Subcategory: All Laptop. Price: 159,000৳162,000৳.
",159,33241,33400
138,recursive,"
Product: Apple MacBook Air 15 inch M4 Liquid Retina Display 16GB RAM 256GB SSD Midnight #MW1L3. Category: MacBook. Subcategory: All Laptop. Price: 160,000৳162,000৳.
",166,33400,33566
139,recursive,"
Product: Apple MacBook Air 13 inch M4 Liquid Retina Display 16GB RAM 512GB SSD Silver. Category: MacBook. Subcategory: All Laptop. Price: 159,000৳162,000৳.
",157,33566,33723
140,recursive,"
Product: Apple MacBook Air 15 inch M4 Liquid Retina Display 16GB RAM 256GB SSD Sky Blue. Category: MacBook. Subcategory: All Laptop. Price: 160,000৳162,000৳.
",159,33723,33882
141,recursive,"
Product: Apple MacBook Air 13 inch M4 Liquid Retina Display 16GB RAM 512GB SSD Starlight. Category: MacBook. Subcategory: All Laptop. Price: 168,000৳175,000৳.
",160,33882,34042
142,recursive,"
Product: Apple MacBook Air 15 inch M4 Liquid Retina Display 16GB RAM 512GB SSD Midnight. Category: MacBook. Subcategory: All Laptop. Price: 192,000৳.
",151,34042,34193
143,recursive,"
Product: Apple MacBook Air 15 inch M4 Liquid Retina Display 16GB RAM 512GB SSD Starlight. Category: MacBook. Subcategory: All Laptop. Price: 195,000৳198,000৳.
",160,34193,34353
144,recursive,"
Product: Apple MacBook Air 15 inch M4 Liquid Retina Display 16GB RAM 512GB SSD Sky Blue. Category: MacBook. Subcategory: All Laptop. Price: 192,000৳.
",151,34353,34504
145,recursive,"
Product: Apple MacBook Air 13 inch M4 Liquid Retina Display 24GB RAM 512GB SSD Sky Blue. Category: MacBook. Subcategory: All Laptop. Price: 187,000৳195,000৳.
",159,34504,34663
146,recursive,"
Product: Apple MacBook Air 13 inch M4 Liquid Retina Display 24GB RAM 512GB SSD Starlight. Category: MacBook. Subcategory: All Laptop. Price: 192,000৳199,000৳.
",160,34663,34823
147,recursive,"
Product: Apple MacBook Pro 14 inch M4 Chip Liquid Retina XDR Display 16GB RAM 512GB SSD Space Black. Category: MacBook. Subcategory: All Laptop. Price: 204,500৳215,000৳.
",171,34823,34994
148,recursive,"
Product: Apple MacBook Pro 14 inch M4 Chip Liquid Retina XDR Display 16GB RAM 512GB SSD Silver #MW2W3. Category: MacBook. Subcategory: All Laptop. Price: 204,500৳215,000৳.
",173,34994,35167
149,recursive,"
Product: Apple MacBook Pro 14 inch M4 Chip Liquid Retina XDR Display 16GB RAM 1TB SSD Space Black. Category: MacBook. Subcategory: All Laptop. Price: 238,000৳.
",161,35167,35328
150,recursive,"
Product: Apple MacBook Pro 14 inch M4 Chip Liquid Retina XDR Display 16GB RAM 1TB SSD Silver. Category: MacBook. Subcategory: All Laptop. Price: 238,000৳.

Product: HP 15-fc0266AU Ryzen 3 7320U 15.6"" FHD Laptop. Category: HP. Subcategory: All Laptop. Price: 51,500৳.
",268,35328,35596
151,recursive,"
Product: HP 14s-dq3139TU Intel Celeron N4500 14"" FHD Laptop. Category: HP. Subcategory: All Laptop. Price: 37,500৳39,500৳.

Product: HP 15-fc0239AU AMD Athlon Silver 7120U 15.6"" FHD Laptop. Category: HP. Subcategory: All Laptop. Price: 42,000৳.
",246,35596,35842
152,recursive,"
Product: HP 15-fc0238AU AMD Athlon Silver 7120U 15.6"" FHD Laptop. Category: HP. Subcategory: All Laptop. Price: 43,500৳.

Product: HP 15s-eq2330AU AMD Ryzen 3 5300U 15.6"" FHD Laptop. Category: HP. Subcategory: All Laptop. Price: 51,000৳53,000৳.
",246,35842,36088
153,recursive,"
Product: HP 250 G9 Core i3 12th Gen 15.6"" HD DDR4 RAM Laptop With 1 Year Warranty. Category: HP. Subcategory: All Laptop. Price: 53,500৳.

Product: HP 255 G9 Ryzen 5 5625U 15.6"" HD Laptop With 2 Year Warranty. Category: HP. Subcategory: All Laptop. Price: 57,000৳.
",266,36088,36354
154,recursive,"
Product: HP 15-fc0166AU Ryzen 5 7520U 15.6"" FHD Laptop With Fingerprint. Category: HP. Subcategory: All Laptop. Price: 63,500৳.

Product: HP 15-fc0333AU Ryzen 5 7520U 15.6"" FHD Laptop. Category: HP. Subcategory: All Laptop. Price: 63,500৳.
",241,36354,36595
155,recursive,"
Product: HP 15-fd1108TU Core 3 100U 15.6"" FHD Laptop. Category: HP. Subcategory: All Laptop. Price: 63,800৳.

Product: HP 15-fd1110TU Core 3 100U 15.6"" FHD Laptop. Category: HP. Subcategory: All Laptop. Price: 63,800৳.
",220,36595,36815
156,recursive,"
Product: HP 15-fc0229AU Ryzen 5 7520U 15.6"" FHD Laptop. Category: HP. Subcategory: All Laptop. Price: 59,500৳65,500৳.

Product: HP 15-fd0268TU Core i5 13th Gen 15.6"" FHD Laptop with Original Windows & Office. Category: HP. Subcategory: All Laptop. Price: 70,000৳72,800৳.
",272,36815,37087
157,recursive,"
Product: HP 15-fc0170AU Ryzen 7 7730U 15.6"" FHD Laptop. Category: HP. Subcategory: All Laptop. Price: 72,500৳.

Product: HP 14-ep0200TU Core i5 13th Gen 14"" FHD Laptop With Backlit Keyboard. Category: HP. Subcategory: All Laptop. Price: 70,000৳74,000৳.
",254,37087,37341
158,recursive,"
Product: HP 15-fd1112TU Intel Core 5 120U 15.6"" FHD Laptop. Category: HP. Subcategory: All Laptop. Price: 75,000৳76,500৳.

Product: HP 15-fd1113TU Intel Core 5 120U 15.6"" FHD Laptop. Category: HP. Subcategory: All Laptop. Price: 76,500৳.
",239,37341,37580
159,recursive,"
Product: HP 15-fd1191TU Intel Core 5 120U 15.6"" FHD Laptop. Category: HP. Subcategory: All Laptop. Price: 80,000৳.

Product: HP ProBook 440 G10 Core i5 13th Gen 14"" FHD Laptop. Category: HP. Subcategory: All Laptop. Price: 93,000৳.
",233,37580,37813
160,recursive,"
Product: HP ProBook 450 G10 Core i5 13th Gen 15.6"" FHD Laptop. Category: HP. Subcategory: All Laptop. Price: Out Of Stock.

Product: Infinix INBook X2 Core i5 11th Gen 14"" FHD Laptop. Category: Infinix. Subcategory: All Laptop. Price: Out Of Stock.
",250,37813,38063
161,recursive,"
Product: Walton Prelude N41 Pro Celeron N4120 14"" FHD Laptop. Category: Walton. Subcategory: All Laptop. Price: 25,500৳29,500৳.

Product: Walton Prelude N50 Pro Pentium Silver N5030 14"" FHD Laptop. Category: Walton. Subcategory: All Laptop. Price: 28,550৳32,000৳.
",265,38063,38328
162,recursive,"
Product: Walton Tamarind MX311G Core i3 11th Gen 14"" FHD Laptop. Category: Walton. Subcategory: All Laptop. Price: 39,550৳42,500৳.

Product: Walton Tamarind MX511G Core i5 11th Gen 14"" FHD Laptop. Category: Walton. Subcategory: All Laptop. Price: 55,500৳.
",257,38328,38585
163,recursive,"
Product: Walton Tamarind MX711G Core i7 11th Gen 14"" FHD Laptop. Category: Walton. Subcategory: All Laptop. Price: 58,550৳65,500৳.

Product: Walton Passion BX710U Core i7 10th Gen 15.6"" FHD Laptop. Category: Walton. Subcategory: All Laptop. Price: 67,500৳77,850৳.
",265,38585,38850
164,recursive,"
Product: Walton ACC PASSION BX513U Pro Core i5 13th Gen 16GB RAM 16"" 2.5K IPS Display Laptop. Category: Walton. Subcategory: All Laptop. Price: 85,550৳.

Product: Walton ACC TAMARIND EX514H Core Ultra 5 14"" 2.8K IPS 120Hz Display Laptop. Category: Walton. Subcategory: All Laptop. Price: 112,550৳.
",299,38850,39149
165,recursive,"
Product: Walton ACC KARONDA GX713H Core i7 13th Gen RTX 4050 6GB Graphics 15.3"" 2.5K Gaming Laptop. Category: Walton. Subcategory: All Laptop. Price: 137,750৳.
",161,39149,39310
166,recursive,"
Product: Walton ACC WAXJAMBU GL714HX Core i7 14th Gen RTX 4060 8GB Graphics 16"" 2.5K 240Hz Gaming Laptop. Category: Walton. Subcategory: All Laptop. Price: 162,550৳.
",167,39310,39477
167,recursive,"
Product: Walton Passion BX311G Core i3 11th Gen 15.6"" FHD Laptop. Category: Walton. Subcategory: All Laptop. Price: 36,200৳38,750৳.
",133,39477,39610
168,recursive,"
Product: Microsoft Surface Laptop 5 Core i5 12th Gen 8GB RAM 512GB SSD 13.5"" QHD Multi-Touch Laptop (R1S-00026). Category: Microsoft. Subcategory: All Laptop. Price: 149,500৳.
",177,39610,39787
169,recursive,"
Product: Microsoft Surface Laptop 7 Copilot+ PC 7th Edition Copilot Plus & AI Optimized Platinum Laptop. Category: Microsoft. Subcategory: All Laptop. Price: 195,000৳.
",169,39787,39956
170,recursive,"
Product: Microsoft Surface Laptop 7th Edition Snapdragon X Plus 12 Core Copilot+ & AI Optimized Laptop Black. Category: Microsoft. Subcategory: All Laptop. Price: 195,000৳.
",174,39956,40130
171,recursive,"
Product: Microsoft Surface Laptop 7th Edition Snapdragon X Plus 12 Core 256GB SSD 13.8"" 120Hz Touch Copilot+ PC Laptop. Category: Microsoft. Subcategory: All Laptop. Price: 170,000৳.
",184,40130,40314
172,recursive,"
Product: Microsoft Surface Pro 9 Core i7 12th Gen 16GB RAM 512GB SSD 13"" 120Hz Touch Laptop Graphite (VQ1-00001). Category: Microsoft. Subcategory: All Laptop. Price: 215,000৳.
",178,40314,40492
173,recursive,"
Product: Microsoft Surface Pro 10 Core Ultra 5 135U 13"" 120Hz Touch Laptop. Category: Microsoft. Subcategory: All Laptop. Price: 215,000৳.

Product: Microsoft Surface Pro 9 Core i7 12th Gen 13"" Touch Laptop. Category: Microsoft. Subcategory: All Laptop. Price: Out Of Stock.
",276,40492,40768
174,recursive,"
Product: Microsoft Surface Laptop 7th Edition Snapdragon X Plus 10 Core 13.8"" 120Hz Touch Copilot+ PC Laptop. Category: Microsoft. Subcategory: All Laptop. Price: Out Of Stock.
",178,40768,40946
175,recursive,"
Product: Microsoft Surface Pro 10 Core Ultra 7 165U 13"" 120Hz Touch Laptop. Category: Microsoft. Subcategory: All Laptop. Price: Out Of Stock.
",144,40946,41090
176,recursive,"
Product: Microsoft Surface Pro 11th Edition Snapdragon X Elite 13"" OLED 120Hz Copilot+ PC Touch Laptop. Category: Microsoft. Subcategory: All Laptop. Price: Out Of Stock.
",172,41090,41262
177,recursive,"
Product: Microsoft Surface Laptop Studio 2 Core i7 13th Gen 16GB RAM 512GB SSD 14.4"" Touch Laptop (ZRF-00001). Category: Microsoft. Subcategory: All Laptop. Price: Up Coming.
",176,41262,41438
178,recursive,"
Product: Chuwi HeroBook Pro Intel Celeron N4020 14.1 inch Full HD Laptop with Windows 11. Category: Chuwi. Subcategory: All Laptop. Price: 27,900৳.

Product: Chuwi HeroBook Plus Intel N4020 15.6"" Inch FHD Laptop. Category: Chuwi. Subcategory: All Laptop. Price: 28,000৳30,500৳.
",279,41438,41717
179,recursive,"
Product: Chuwi GemiBook XPro Intel Celeron N150 12th Gen 14.1 inch Full HD Laptop. Category: Chuwi. Subcategory: All Laptop. Price: 34,900৳.

Product: Chuwi GemiBook Plus Intel Celeron N100 15.6 inch Full HD Laptop. Category: Chuwi. Subcategory: All Laptop. Price: 35,000৳.
",275,41717,41992
180,recursive,"
Product: Chuwi GemiBook Plus Intel Celeron N150 15.6 inch Full HD Laptop. Category: Chuwi. Subcategory: All Laptop. Price: 39,900৳.

Product: Chuwi MiniBook X Intel Celeron N150 10.5"" FHD+ Touch Laptop. Category: Chuwi. Subcategory: All Laptop. Price: 49,500৳.
",262,41992,42254
181,recursive,"
Product: Chuwi CoreBook X Core i3 12th Gen 14"" 2K QHD Laptop. Category: Chuwi. Subcategory: All Laptop. Price: 51,900৳.

Product: Chuwi CoreBook X Ryzen 5 7430U 14"" 2K QHD Laptop. Category: Chuwi. Subcategory: All Laptop. Price: 54,900৳.
",239,42254,42493
182,recursive,"
Product: Chuwi FreeBook Celeron N150 13th Gen 13.5"" 2K Touch Laptop. Category: Chuwi. Subcategory: All Laptop. Price: Up Coming.

Product: Chuwi GemiBook XPro Intel Celeron N100 14.1 inch Full HD Laptop. Category: Chuwi. Subcategory: All Laptop. Price: Out Of Stock.
",268,42493,42761
183,recursive,"
Product: Chuwi CoreBook XPro Intel core i3 15.6"" FHD Laptop. Category: Chuwi. Subcategory: All Laptop. Price: Out Of Stock.

Product: Chuwi CoreBook XPro Core i5 12th Gen 15.6"" FHD Laptop. Category: Chuwi. Subcategory: All Laptop. Price: Out Of Stock.
",253,42761,43014
184,recursive,"
Product: Gigabyte G5 MF5 Core i7 13th Gen RTX 4050 6GB Graphics 512GB SSD 15.6"" FHD 144Hz Gaming Laptop. Category: Gigabyte. Subcategory: All Laptop. Price: 129,000৳.
",168,43014,43182
185,recursive,"
Product: Gigabyte G5 MF5 Core i7 13th Gen RTX 4050 6GB Graphics 15.6"" FHD 144Hz Gaming Laptop. Category: Gigabyte. Subcategory: All Laptop. Price: 134,000৳.
",158,43182,43340
186,recursive,"
Product: Gigabyte G6 MF Core i7 13th Gen RTX 4050 6GB Graphics 16"" WUXGA 165Hz Gaming Laptop. Category: Gigabyte. Subcategory: All Laptop. Price: 134,000৳.
",157,43340,43497
187,recursive,"
Product: Gigabyte G6 MF Core i7 13th Gen RTX 4050 6GB Graphics 16"" Gaming Laptop. Category: Gigabyte. Subcategory: All Laptop. Price: 138,000৳.
",145,43497,43642
188,recursive,"
Product: Gigabyte G6 KF Core i7 13th Gen RTX 4060 8GB Graphics 16"" WUXGA 165Hz Gaming Laptop. Category: Gigabyte. Subcategory: All Laptop. Price: 144,500৳.
",157,43642,43799
189,recursive,"
Product: Gigabyte AORUS MASTER 16 BYH Core Ultra 9 RTX 5080 16GB Graphics 16"" OLED Gaming Laptop. Category: Gigabyte. Subcategory: All Laptop. Price: 418,000৳.
",161,43799,43960
190,recursive,"
Product: Gigabyte AERO X16 1VH AMD Ryzen AI 7 350 RTX 5060 8GB Graphics 16"" FHD+ WUXGA Gaming Laptop. Category: Gigabyte. Subcategory: All Laptop. Price: 185,000৳.
",165,43960,44125
191,recursive,"
Product: GIGABYTE G5 KF Core i5 12th Gen RTX 4060 8GB Graphics 15.6'' FHD 144Hz Gaming Laptop. Category: Gigabyte. Subcategory: All Laptop. Price: Out Of Stock.
",162,44125,44287
192,recursive,"
Product: Gigabyte G5 KF5 Core i7 13th Gen RTX 4060 8GB Graphics 15.6"" FHD 144Hz Gaming Laptop. Category: Gigabyte. Subcategory: All Laptop. Price: Out Of Stock.
",162,44287,44449
193,recursive,"
Product: GIGABYTE AORUS 15 BKG Core Ultra 7 RTX 4060 8GB Graphics 15.6"" QHD Gaming Laptop. Category: Gigabyte. Subcategory: All Laptop. Price: Out Of Stock.
",158,44449,44607
194,recursive,"
Product: Gigabyte AORUS 16X AKG 2024 Core i7 14th Gen RTX 4060 8GB Graphics 16"" WQXGA 2K 165Hz Gaming Laptop. Category: Gigabyte. Subcategory: All Laptop. Price: Out Of Stock.
",177,44607,44784
195,recursive,"
Product: Gigabyte AORUS 16X ASG 2024 Core i7 14th Gen 32GB RAM RTX 4070 8GB Graphics 16"" WQXGA 2K 165Hz Gaming Laptop. Category: Gigabyte. Subcategory: All Laptop. Price: Out Of Stock.

Product: AOC N141 Intel N100 12th Gen 14"" FHD Laptop. Category: AOC. Subcategory: All Laptop. Price: 37,000৳.
",297,44784,45081
196,recursive,"
Product: Lenovo Legion Slim 7i Core i7 12th Gen RTX 3060 6GB Graphics 16"" 2.5K 165Hz Gaming Laptop. Category: Lenovo. Subcategory: Gaming Laptop. Price: 165,000৳.
",164,45081,45245
197,recursive,"
Product: Lenovo Legion 5 15IRX10 Core i7 14th Gen RTX 5050 8GB Graphics 15.1"" WQXGA 165Hz Gaming Laptop. Category: Lenovo. Subcategory: Gaming Laptop. Price: 190,000৳.
",169,45245,45414
198,recursive,"
Product: Lenovo Legion 5 15IRX10 Core i7 14th Gen RTX 5050 8GB Graphics 15.1"" WQXGA Gaming Laptop With RGB Backlit Keyboard. Category: Lenovo. Subcategory: Gaming Laptop. Price: 200,000৳.
",189,45414,45603
199,recursive,"
Product: Lenovo Legion 5 15IRX10 Core i7 14th Gen RTX 5060 8GB Graphics 15.1"" WQXGA Gaming Laptop. Category: Lenovo. Subcategory: Gaming Laptop. Price: 204,000৳.
",163,45603,45766
200,recursive,"
Product: Lenovo Legion 5 15IRX10 Core i7 14th Gen RTX 5070 8GB Graphics 15.1"" WQXGA Gaming Laptop. Category: Lenovo. Subcategory: Gaming Laptop. Price: 230,000৳.
",163,45766,45929
201,recursive,"
Product: Lenovo Legion 5 15IRX10 Core i9 14th Gen RTX 5070 8GB Graphics 15.1"" WQXGA Gaming Laptop. Category: Lenovo. Subcategory: Gaming Laptop. Price: 255,000৳.
",163,45929,46092
202,recursive,"
Product: Lenovo Legion 5 15IRX10 Core i9 14th Gen 32GB RAM RTX 5070 8GB Graphics 15.1"" WQXGA Gaming Laptop. Category: Lenovo. Subcategory: Gaming Laptop. Price: 295,000৳.
",172,46092,46264
203,recursive,"
Product: Lenovo Legion Pro 7 16IRX9H Core i9 14th Gen RTX 4080 12GB Graphics 16"" WQXGA 240Hz Gaming Laptop. Category: Lenovo. Subcategory: Gaming Laptop. Price: 450,000৳.
",172,46264,46436
204,recursive,"
Product: Lenovo Legion 9 16IRX9 Core i9 14th Gen RTX 4080 12GB Graphics 16"" 3.2K 165Hz Gaming Laptop. Category: Lenovo. Subcategory: Gaming Laptop. Price: 495,000৳.
",166,46436,46602
205,recursive,"
Product: Lenovo Legion 9 16IRX9 Core i9 14th Gen RTX 4090 16GB Graphics 16"" 3.2K 165Hz Gaming Laptop. Category: Lenovo. Subcategory: Gaming Laptop. Price: 515,000৳.
",166,46602,46768
206,recursive,"
Product: Lenovo LOQ 15IAX9E Core i5 12th Gen RTX 2050 4GB Graphics 15.6"" FHD Gaming Laptop. Category: Lenovo. Subcategory: Gaming Laptop. Price: Out Of Stock.
",160,46768,46928
207,recursive,"
Product: Lenovo LOQ 15ARP9 Ryzen 7 7435HS AI Integrated RTX 4050 6GB Graphics 15.6"" FHD Gaming Laptop. Category: Lenovo. Subcategory: Gaming Laptop. Price: Out Of Stock.
",171,46928,47099
208,recursive,"
Product: Lenovo LOQ 15AHP9 Ryzen 5 8645HS AI Integrated RTX 4050 6GB Graphics 15.6"" Gaming Laptop. Category: Lenovo. Subcategory: Gaming Laptop. Price: Out Of Stock.
",167,47099,47266
209,recursive,"
Product: Lenovo LOQ 15AHP9 Ryzen 7 7435HS AI Integrated RTX 4060 8GB Graphics 15.6"" FHD Gaming Laptop. Category: Lenovo. Subcategory: Gaming Laptop. Price: Out Of Stock.
",171,47266,47437
210,recursive,"
Product: Lenovo LOQ 15IRX9 Core i7 14th Gen RTX 4060 8GB Graphics 15.6"" FHD AI Powered Gaming Laptop. Category: Lenovo. Subcategory: Gaming Laptop. Price: Out Of Stock.
",170,47437,47607
211,recursive,"
Product: Lenovo LOQ 15IRX9 Core i7 13th Gen RTX 3050 6GB Graphics 15.6"" FHD Gaming Laptop. Category: Lenovo. Subcategory: Gaming Laptop. Price: Out Of Stock.

Product: Tecno MEGABOOK K15SDA AMD Ryzen 5 7430U 15.6″ FHD Laptop. Category: Tecno. Subcategory: All Laptop. Price: 53,500৳.
",285,47607,47892
212,recursive,"
Product: HP Victus Gaming 15-fb1053AX Ryzen 5-7535HS RTX 2050 4GB Graphics 15.6"" FHD Gaming Laptop. Category: HP. Subcategory: Gaming Laptop. Price: 98,000৳.
",159,47892,48051
213,recursive,"
Product: HP Victus 16-r1237TX Core i5 14th Gen RTX 3050 6GB Graphics 16"" FHD Gaming Laptop. Category: HP. Subcategory: Gaming Laptop. Price: 130,000৳.
",152,48051,48203
214,recursive,"
Product: HP Victus Gaming 15-fa1251TX Core i7 13th Gen RTX 3050 6GB Graphics 15.6"" FHD Gaming Laptop. Category: HP. Subcategory: Gaming Laptop. Price: 143,500৳.
",162,48203,48365
215,recursive,"
Product: HP Victus 15-fb2132AX Ryzen 7 8845HS RTX 3050 6GB Graphics 15.6"" FHD Gaming Laptop. Category: HP. Subcategory: Gaming Laptop. Price: 153,000৳.
",153,48365,48518
216,recursive,"
Product: HP Victus 16-r1241TX Core i7 14th Gen RTX 4060 8GB Graphics 16"" FHD Gaming Laptop. Category: HP. Subcategory: Gaming Laptop. Price: Out Of Stock.
",156,48518,48674
217,recursive,"
Product: HP OMEN 16-wf1156TX Core i9 14th Gen RTX 4070 8GB Graphics 16.1"" QHD 240Hz Gaming Laptop. Category: HP. Subcategory: Gaming Laptop. Price: Out Of Stock.
",163,48674,48837
218,recursive,"
Product: Asus TUF Gaming A15 FA506NFR Ryzen 7 7435HS RTX 2050 4GB Graphics 15.6"" FHD Gaming Laptop. Category: Asus. Subcategory: Gaming Laptop. Price: 95,500৳.
",161,48837,48998
219,recursive,"
Product: Asus TUF Gaming A15 FA506NCR Ryzen 7 7435HS RTX 3050 4GB Graphics (Up To 75W TGP) Gaming Laptop. Category: Asus. Subcategory: Gaming Laptop. Price: 103,500৳107,000৳.
",176,48998,49174
220,recursive,"
Product: ASUS TUF Gaming F16 FX607VB Core 5 210H RTX 3050A 4GB Graphics 16"" WUXGA Gaming Laptop. Category: Asus. Subcategory: Gaming Laptop. Price: 112,000৳115,800৳.
",167,49174,49341
221,recursive,"
Product: Asus TUF Gaming A15 FA507NUR Ryzen 7 7435HS RTX 4050 6GB Graphics 15.6"" FHD Gaming Laptop. Category: Asus. Subcategory: Gaming Laptop. Price: 140,000৳143,500৳.
",170,49341,49511
222,recursive,"
Product: ASUS TUF Gaming A16 FA617NSR Advantage Edition Ryzen 7 7435HS RX 7600S 8GB Graphics 16"" WUXGA Gaming Laptop. Category: Asus. Subcategory: Gaming Laptop. Price: 144,000৳.
",180,49511,49691
223,recursive,"
Product: ASUS TUF Gaming F16 FX607VU Core 5 210H RTX 4050 6GB Graphics 16"" WUXGA Gaming Laptop. Category: Asus. Subcategory: Gaming Laptop. Price: 148,900৳.
",158,49691,49849
224,recursive,"
Product: Asus Vivobook Pro 16X OLED M7600QE Ryzen 7 5800H RTX 3050Ti 4GB Graphics 16"" 4K Gaming Laptop. Category: Asus. Subcategory: Gaming Laptop. Price: 131,000৳153,900৳.
",174,49849,50023
225,recursive,"
Product: ASUS ROG Strix G16 G614JU Core i5 13th Gen RTX 4050 6GB Graphics 16"" WUXGA Gaming Laptop. Category: Asus. Subcategory: Gaming Laptop. Price: 170,000৳.
",161,50023,50184
226,recursive,"
Product: ASUS TUF Gaming F16 FX608JMR Core i7 14th Gen 16"" FHD+ Gaming Laptop. Category: Asus. Subcategory: Gaming Laptop. Price: 214,000৳.

Product: ASUS TUF Gaming A14 FA401UH Ryzen 7 260 14"" 2.5K WQXGA Gaming Laptop. Category: Asus. Subcategory: Gaming Laptop. Price: 194,000৳.
",282,50184,50466
227,recursive,"
Product: ASUS TUF Gaming A16 FA608UH Ryzen 7 260 16"" FHD+ Gaming Laptop. Category: Asus. Subcategory: Gaming Laptop. Price: 187,000৳.

Product: ASUS TUF Gaming A14 FA401WU Ryzen AI 9 HX 370 RTX 4050 6GB Graphics 14"" 2.5K Laptop. Category: Asus. Subcategory: Gaming Laptop. Price: 220,000৳.
",291,50466,50757
228,recursive,"
Product: ASUS ROG Strix G16  G615LP Ultra 9 275HX 16"" FHD+ Gaming Laptop. Category: Asus. Subcategory: Gaming Laptop. Price: 287,000৳.

Product: ASUS ROG Strix G16 G615LM Ultra 9 275HX RTX 5060 8GB Graphics 16"" WUXGA Gaming Laptop. Category: Asus. Subcategory: Gaming Laptop. Price: 250,000৳.
",294,50757,51051
229,recursive,"
Product: ASUS TUF Gaming A16 FA608WV Ryzen AI 9 HX 370 RTX 4060 8GB Graphics 16"" 2.5K Laptop. Category: Asus. Subcategory: Gaming Laptop. Price: 253,000৳.
",156,51051,51207
230,recursive,"
Product: ASUS ProArt Studiobook 16 OLED H5600QR Ryzen 9 5900HX RTX 3070 8GB Graphics 16"" OLED Laptop. Category: Asus. Subcategory: Gaming Laptop. Price: 298,000৳.
",164,51207,51371
231,recursive,"
Product: ASUS ROG Strix G16 G614FR AMD Ryzen 9 9955HX3D RTX 5070 Ti 12GB Graphics 16"" FHD+ Gaming Laptop. Category: Asus. Subcategory: Gaming Laptop. Price: 330,000৳.
",168,51371,51539
232,recursive,"
Product: Asus ROG Zephyrus G16 GU605CR Core Ultra 9 285H RTX 5070 Ti Graphics 16"" 2.5K QHD+ WQXGA Gaming Laptop. Category: Asus. Subcategory: Gaming Laptop. Price: 385,000৳.
",175,51539,51714
233,recursive,"
Product: ASUS ROG Strix SCAR 16 G635LW Core Ultra 9 RTX 5080 16GB Graphics 16"" WQXGA Copilot+PC Gaming Laptop. Category: Asus. Subcategory: Gaming Laptop. Price: 482,000৳.
",173,51714,51887
234,recursive,"
Product: ASUS ROG Strix SCAR 18 (2025) G835LX Core Ultra 9 RTX 5090 24GB Graphics 18"" 2.5K 240Hz Laptop. Category: Asus. Subcategory: Gaming Laptop. Price: 649,900৳.
",167,51887,52054
235,recursive,"
Product: Acer Aspire 5 A515-58GM-57GF Core i5 13th Gen RTX 2050 4GB GDDR6 15.6"" FHD Gaming Laptop. Category: Acer. Subcategory: Gaming Laptop. Price: Out Of Stock.
",165,52054,52219
236,recursive,"
Product: Acer Nitro V 15 ANV15-51 Core i5 13th Gen RTX 4050 6GB GDDR6 15.6"" FHD IPS Gaming Laptop. Category: Acer. Subcategory: Gaming Laptop. Price: Out Of Stock.
",165,52219,52384
237,recursive,"
Product: Acer Nitro V 15 ANV15-51 Core i7 13th Gen 15.6"" FHD Gaming Laptop. Category: Acer. Subcategory: Gaming Laptop. Price: Out Of Stock.
",142,52384,52526
238,recursive,"
Product: Acer Predator Helios 16 PH16-71-74MN Core i7 13th Gen RTX 4070 8GB GDDR6 16"" 240HZ Gaming Laptop. Category: Acer. Subcategory: Gaming Laptop. Price: Out Of Stock.
",173,52526,52699
239,recursive,"
Product: MSI Thin 15 B13VE Core i5 13th Gen RTX 4050 6GB Graphics 15.6"" FHD Gaming Laptop. Category: Gaming Laptop. Subcategory: Laptop. Price: 102,900৳.
",155,52699,52854
240,recursive,"
Product: MSI Thin A15 B7UC Ryzen 5 7535HS RTX 3050 4GB GDDR6 Graphics 15.6"" FHD Gaming Laptop. Category: Gaming Laptop. Subcategory: Laptop. Price: 95,000৳105,000৳.
",166,52854,53020
241,recursive,"
Product: MSI Thin A15 B7VE Ryzen 7 7735HS RTX 4050 6GB GDDR6 Graphics 15.6"" FHD Gaming Laptop. Category: Gaming Laptop. Subcategory: Laptop. Price: 135,000৳140,000৳.
",167,53020,53187
242,recursive,"
Product: MSI VenturePro 15 A2RWEG Core 5 210H RTX 5050 8GB Graphics 15.6"" FHD Gaming Laptop. Category: MSI. Subcategory: Gaming Laptop. Price: 144,900৳.
",154,53187,53341
243,recursive,"
Product: MSI Katana 15 HX B14WGK Core i7 14th Gen RTX 5070 8GB Graphics 15.6"" FHD Gaming Laptop. Category: MSI. Subcategory: Gaming Laptop. Price: 219,900৳.
",158,53341,53499
244,recursive,"
Product: MSI Katana 15 HX B14WFK Core i7 14th Gen RTX 5060 8GB Graphics 15.6"" FHD Gaming Laptop. Category: MSI. Subcategory: Gaming Laptop. Price: 185,900৳.
",158,53499,53657
245,recursive,"
Product: MSI Katana 15 HX B14WEK Core i7 14th Gen RTX 5050 8GB Graphics 15.6"" FHD Gaming Laptop. Category: MSI. Subcategory: Gaming Laptop. Price: 165,900৳.
",158,53657,53815
246,recursive,"
Product: MSI Raider 18 HX AI A2XWIG Core Ultra 9 200HX RTX 5080 16GB Graphics 18"" UHD+ MiniLED 120Hz Gaming Laptop. Category: MSI. Subcategory: Gaming Laptop. Price: 629,800৳.
",177,53815,53992
247,recursive,"
Product: MSI Titan 18 HX Dragon Edition Norse Myth A2XWJG Core Ultra 9 285HX RTX 5090 24GB Graphics 18"" UHD+ MiniLED 120Hz Gaming Laptop. Category: MSI. Subcategory: Gaming Laptop. Price: 989,900৳.
",199,53992,54191
248,recursive,"
Product: MSI Raider 18 HX A14VIG Core i9 14th Gen RTX 4090 16GB GDDR6 Graphics 18"" Gaming Laptop. Category: MSI. Subcategory: Gaming Laptop. Price: Pre Order.
",160,54191,54351
249,recursive,"
Product: MSI Stealth 17 Studio A13VI Core i9 13th Gen 64GB RAM 4TB SSD RTX 4090 16GB Graphics 17.3"" 4K UHD 144Hz Gaming Laptop. Category: MSI. Subcategory: Gaming Laptop. Price: Up Coming.
",190,54351,54541
250,recursive,"
Product: MSI Sword 16 HX B14VEKG Core i7 14th Gen 14650HX RTX 4050 GDDR6 6GB Graphics 16"" Gaming Laptop. Category: MSI. Subcategory: Gaming Laptop. Price: Up Coming.
",167,54541,54708
251,recursive,"
Product: MSI Sword 16 HX B14VEKG Core i7 14th Gen RTX 4050 GDDR6 6GB Graphics 16"" Gaming Laptop. Category: MSI. Subcategory: Gaming Laptop. Price: Up Coming.
",159,54708,54867
252,recursive,"
Product: MSI Sword 16 HX B14VFKG Core i7 14th Gen RTX 4060 GDDR6 8GB Graphics 16"" Gaming Laptop. Category: MSI. Subcategory: Gaming Laptop. Price: Up Coming.
",159,54867,55026
253,recursive,"
Product: MSI GF63 THIN 12UCX Core i5 12th Gen RTX 2050 4GB Graphics 15.6"" FHD 144hz Gaming Laptop. Category: MSI. Subcategory: Gaming Laptop. Price: Out Of Stock.
",164,55026,55190
254,recursive,"
Product: MSI Cyborg 15 A12UCX Core i5 12th Gen RTX 2050 4GB Graphics 8GB RAM 15.6"" FHD Gaming Laptop. Category: MSI. Subcategory: Gaming Laptop. Price: Out Of Stock.
",167,55190,55357
255,recursive,"
Product: MSI Thin A15 B7UCX Ryzen 5 7535HS RTX 2050 4GB GDDR6 Graphics 16GB RAM 15.6"" Gaming Laptop. Category: MSI. Subcategory: Gaming Laptop. Price: Out Of Stock.
",166,55357,55523
256,recursive,"
Product: MSI Thin 15 B13UC Core i5 13th Gen RTX 3050 4GB Graphics 15.6"" FHD Gaming Laptop. Category: MSI. Subcategory: Gaming Laptop. Price: Out Of Stock.
",156,55523,55679
257,recursive,"
Product: MSI Cyborg 15 A13UDX Core i5 13th Gen RTX 3050 6GB Graphics 15.6"" FHD 144Hz Gaming Laptop. Category: MSI. Subcategory: Gaming Laptop. Price: Out Of Stock.
",165,55679,55844
258,recursive,"
Product: HP Spectre X360 Convertible 14-eu0080TU Core Ultra 7 14"" 3K OLED Touch Laptop. Category: HP. Subcategory: Premium Ultrabook. Price: Out Of Stock.
",156,55844,56000
259,recursive,"
Product: HP ZBook FireFly 14 G10 Core i7 13th Gen RTX A500 4GB Graphics 14"" Workstation Laptop. Category: HP. Subcategory: Premium Ultrabook. Price: Out Of Stock.
",164,56000,56164
260,recursive,"
Product: HP Spectre X360 Convertible 14-eu0089TU Core Ultra 7 14"" 3K OLED Touch Laptop. Category: HP. Subcategory: Premium Ultrabook. Price: Out Of Stock.
",156,56164,56320
261,recursive,"
Product: Lenovo IdeaPad 5 2-in-1 14AHP9 Ryzen 5 8645HS 14"" WUXGA Touch Laptop. Category: Premium Ultrabook. Subcategory: Laptop. Price: 101,000৳.
",147,56320,56467
262,recursive,"
Product: Lenovo IdeaPad 5 2-in-1 14AHP9 Ryzen 5 8645HS 14"" WUXGA Touch Laptop Luna Grey. Category: Premium Ultrabook. Subcategory: Laptop. Price: 101,000৳.
",157,56467,56624
263,recursive,"
Product: Lenovo IdeaPad 5 2-in-1 14IAL10 Core Ultra 5 225H 14"" WUXGA Touch Laptop. Category: Premium Ultrabook. Subcategory: Laptop. Price: 123,000৳.
",151,56624,56775
264,recursive,"
Product: ASUS Zenbook A14 UX3407RA Snapdragon X Elite 14"" OLED Copilot+ PC Laptop. Category: Premium Ultrabook. Subcategory: Laptop. Price: 182,000৳.
",151,56775,56926
265,recursive,"
Product: ASUS Zenbook A14 UX3407RA Snapdragon X Elite 14"" OLED Copilot+ PC Laptop Iceland Gray. Category: Premium Ultrabook. Subcategory: Laptop. Price: 182,000৳.
",164,56926,57090
266,recursive,"
Product: ASUS Zenbook 14 OLED UM3406KA Ryzen AI 7-350 14"" Copilot+ PC Laptop. Category: Premium Ultrabook. Subcategory: Laptop. Price: 185,000৳.
",146,57090,57236
267,recursive,"
Product: ASUS Zenbook S 14 OLED UX5406SA Core Ultra 7 256V 14"" 3K OLED Copilot+ PC Laptop. Category: Premium Ultrabook. Subcategory: Laptop. Price: 214,000৳.
",159,57236,57395
268,recursive,"
Product: ASUS Zenbook S 14 OLED UX5406SA Core Ultra 7 256V 14"" 3K Copilot+ PC Touch Laptop White. Category: Premium Ultrabook. Subcategory: Laptop. Price: 214,000৳.
",166,57395,57561
269,recursive,"
Product: ASUS Zenbook Duo UX8406CA Core Ultra 9 14.0-inch OLED Laptop. Category: Premium Ultrabook. Subcategory: Laptop. Price: 269,900৳.

Product: Lenovo Yoga Slim 7 15ILL9 Core Ultra 7 15.3"" IPS Touch Laptop. Category: Lenovo. Subcategory: Premium Ultrabook. Price: Out Of Stock.
",283,57561,57844
270,recursive,"
Product: Lenovo Yoga Pro 7 14AHP9 Ryzen 7 8845HS AI Integrated RTX 3050 6GB Graphics 14.5"" Gaming Laptop. Category: Lenovo. Subcategory: Premium Ultrabook. Price: Out Of Stock.
",178,57844,58022
271,recursive,"
Product: Lenovo IdeaPad 5 2-in-1 14IAL10 Core Ultra 7 255H 14"" WUXGA IPS Touch Laptop. Category: Lenovo. Subcategory: Premium Ultrabook. Price: Out Of Stock.

Product: ASUS AP4600 Professional Backpack. Category: Asus. Subcategory: Laptop Bag. Price: 1,990৳.
",260,58022,58282
272,recursive,"
Product: Asus ROG BP1501G 17"" Laptop Gaming Backpack. Category: Asus. Subcategory: Laptop Bag. Price: 2,600৳.

Product: ASUS ROG BP1800 18"" Laptop Gaming Backpack. Category: Asus. Subcategory: Laptop Bag. Price: 2,990৳.
",221,58282,58503
273,recursive,"
Product: MSI Summit 13 AI+ Evo A2VMTG Core Ultra 7 258V 13.3"" FHD+ Touch Laptop. Category: MSI. Subcategory: Premium Ultrabook. Price: Out Of Stock.

Product: Star Backpack Blue. Category: Laptop Bag. Subcategory: Laptop. Price: 1,200৳.
",238,58503,58741
274,recursive,"
Product: MaxGreen MGB-455 13.3-inch Laptop Sleeve Bag. Category: Laptop Bag. Subcategory: Laptop. Price: 1,000৳1,700৳.

Product: WiWU iShield Ultra Thin Hard Shell White Frosted Laptop Case for 12 inch Macbook (A1534). Category: Laptop Bag. Subcategory: Laptop. Price: 1,500৳1,700৳.
",284,58741,59025
275,recursive,"
Product: WiWu iShield Ultra Thin Hard Shell Anti-Slip Laptop Case. Category: Laptop Bag. Subcategory: Laptop. Price: 1,500৳1,900৳.

Product: WiWU iSHIELD Ultra Thin Hard Shell Laptop Case for Macbook 16"". Category: Laptop Bag. Subcategory: Laptop. Price: 1,500৳1,950৳.
",270,59025,59295
276,recursive,"
Product: Wiwu Cosmo Slim Case for 13.3"" Laptop Black Color. Category: Laptop Bag. Subcategory: Laptop. Price: 1,800৳2,000৳.

Product: Targus TBS64602GL Cypress 14"" EcoSmart Laptop Sleeve Case. Category: Laptop Bag. Subcategory: Laptop. Price: 1,800৳2,000৳.
",258,59295,59553
277,recursive,"
Product: Targus Intellect Laptop Backpack 15.6""-Black/Grey ( TBB565GL). Category: Laptop Bag. Subcategory: Laptop. Price: 1,900৳2,100৳.

Product: Targus TSB883-72 15.6"" Safire Backpack. Category: Laptop Bag. Subcategory: Laptop. Price: 1,900৳2,100৳.
",251,59553,59804
278,recursive,"
Product: Targus TSS898 15.6"" Business Casual Slipcase Laptop Bag. Category: Laptop Bag. Subcategory: Laptop. Price: 1,800৳2,200৳.

Product: Targus TSB194US-70 Motor 16"" Laptop Backpack. Category: Laptop Bag. Subcategory: Laptop. Price: 2,200৳2,450৳.
",251,59804,60055
279,recursive,"
Product: Wiwu Minimalist Shoulder Laptop Bag 15.6 inch. Category: Laptop Bag. Subcategory: Laptop. Price: 2,600৳.

Product: WiWU Warriors Backpack X Pro 15.6"" Waterproof Laptop Backpack. Category: Laptop Bag. Subcategory: Laptop. Price: 9,900৳.
",246,60055,60301
280,recursive,"
Product: WiWU Minimalist Waterproof Large Capacity Business Laptop Backpack. Category: Laptop Bag. Subcategory: Laptop. Price: 2,250৳2,700৳.

Product: Honor Official Backpack For Tablet. Category: Laptop Bag. Subcategory: Laptop. Price: 3,400৳.
",246,60301,60547
281,recursive,"
Product: WiWU Campus Slim Case 13.3-inch Laptop Bag. Category: Laptop Bag. Subcategory: Laptop. Price: 2,500৳3,000৳.

Product: WiWU Pilot Backpack 15.6-inch Travelling Laptop Business School Backpack. Category: Laptop Bag. Subcategory: Laptop. Price: 2,500৳.
",260,60547,60807
282,recursive,"
Product: Dell ES1520P Essential 15 Backpack for 15.6"" Laptop. Category: Dell. Subcategory: Laptop Bag. Price: 1,800৳.

Product: Fantech BG-984 Waterproof 15.6"" Gaming Backpack. Category: Fantech. Subcategory: Laptop Bag. Price: 3,400৳3,600৳.
",243,60807,61050
283,recursive,"
Product: Targus Terra Black Laptop Backpack (TSB226AP). Category: Targus. Subcategory: Laptop Bag. Price: 3,100৳.

Product: Targus TSB913AP-70 City Smart 15.6"" Professional Back Pack. Category: Targus. Subcategory: Laptop Bag. Price: 3,850৳5,000৳.
",249,61050,61299
284,recursive,"
Product: Targus CN514CA 13-14"" Classic Top Load Laptop Bag. Category: Targus. Subcategory: Laptop Bag. Price: Out Of Stock.

Product: Targus TBB565GL-74 Intellect 15.6"" Laptop Backpack. Category: Targus. Subcategory: Laptop Bag. Price: 1,900৳.
",245,61299,61544
285,recursive,"
Product: Targus TBS64602GL-70 Cypress 14"" EcoSmart Laptop Sleeve Case. Category: Targus. Subcategory: Laptop Bag. Price: 2,000৳.

Product: Targus TBT913EU-72 Citysmart Essential 12 to 14 Inch Laptop Bag. Category: Targus. Subcategory: Laptop Bag. Price: 3,000৳.
",263,61544,61807
286,recursive,"
Product: Targus 15.6"" Element Laptop Backpack (Black). Category: Targus. Subcategory: Laptop Bag. Price: 3,000৳.

Product: WiWU Minimalist Laptop Sleeve for 14"" Macbook Air. Category: WiWU. Subcategory: Laptop Bag. Price: 1,600৳.
",231,61807,62038
287,recursive,"
Product: WiWU Minimalist II 14"" Laptop Bag For MacBook. Category: WiWU. Subcategory: Laptop Bag. Price: 2,150৳.

Product: WiWU Cozy Classic 16"" Waterproof Laptop Bag. Category: WiWU. Subcategory: Laptop Bag. Price: 2,400৳.
",224,62038,62262
288,recursive,"
Product: Wiwu City Commuter 15.6"" Laptop Bag. Category: WiWU. Subcategory: Laptop Bag. Price: 3,150৳.

Product: WiWU Pioneer Shoulder Bag for 14 Inch Laptop. Category: WiWU. Subcategory: Laptop Bag. Price: 2,500৳.
",215,62262,62477
289,recursive,"
Product: WiWU Dual Color iSHIELD TPU Frame Frosted Case for 13.3"" Macbook Air (A2179/A2337). Category: WiWU. Subcategory: Laptop Bag. Price: Up Coming.

Product: WiWU Alpha Double Vertical Layer Bag for 12.9"" Laptop. Category: WiWU. Subcategory: Laptop Bag. Price: Up Coming.
",277,62477,62754
290,recursive,"
Product: WiWU Haliz 15.6"" Laptop Bag. Category: WiWU. Subcategory: Laptop Bag. Price: 2,250৳.

Product: WiWU Elite 15.6 Inch Waterproof Laptop Backpack. Category: WiWU. Subcategory: Laptop Bag. Price: Out Of Stock.
",216,62754,62970
291,recursive,"
Product: WiWU Elite S 15.6 Inch Waterproof Laptop Backpack. Category: WiWU. Subcategory: Laptop Bag. Price: 6,500৳.

Product: Tucano Vario BKVAR BackPack Black. Category: Tucano. Subcategory: Laptop Bag. Price: Up Coming.
",223,62970,63193
292,recursive,"
Product: Arctic Hunter B00346 15.6"" Laptop Backpack. Category: Arctic Hunter. Subcategory: Laptop Bag. Price: Out Of Stock.

Product: Arctic Hunter B00328 15.6"" Laptop Backpack. Category: Arctic Hunter. Subcategory: Laptop Bag. Price: Out Of Stock.
",250,63193,63443
293,recursive,"
Product: Arctic Hunter B00388 15.6"" Laptop Backpack. Category: Arctic Hunter. Subcategory: Laptop Bag. Price: Out Of Stock.

Product: Xiaomi Classic Business Backpack 2. Category: Xiaomi. Subcategory: Laptop Bag. Price: 2,500৳.
",229,63443,63672
294,recursive,"
Product: MaxGreen 19v 2.37a 45W Laptop Charger Adapter For ASUS Laptop. Category: Laptop Accessories. Subcategory: Laptop. Price: Out Of Stock.

Product: Metal Portable Laptop Stand. Category: Laptop Accessories. Subcategory: Laptop. Price: 380৳449৳.
",252,63672,63924
295,recursive,"
Product: Second Hard Disk Drive CADDY-Secondary CD-ROM Storage for Laptop. Category: Laptop Accessories. Subcategory: Laptop. Price: 550৳.

Product: Aluminum Alloy Adjustable and Foldable Air-Ventilated Laptop Stand. Category: Laptop Accessories. Subcategory: Laptop. Price: 370৳600৳.
",286,63924,64210
296,recursive,"
Product: Adjustable & Foldable 10"" to 17.5"" 6 Angles Travel Laptop Stand (10810). Category: Laptop Accessories. Subcategory: Laptop. Price: 480৳790৳.

Product: WiWU S500 Foldable Lightweight Aluminium Alloy Laptop Stand. Category: Laptop Accessories. Subcategory: Laptop. Price: 850৳.
",286,64210,64496
297,recursive,"
Product: BlackCat BC1 14"" Laptop Cooler. Category: Laptop Accessories. Subcategory: Laptop. Price: 790৳850৳.

Product: Acer swift 3 Thin Port 19V 3.42A 65W Laptop Charger Adapter. Category: Laptop Accessories. Subcategory: Laptop. Price: 1,300৳.
",247,64496,64743
298,recursive,"
Product: Lenovo Big Port 20V 3.25A 65W Laptop Charger Adapter. Category: Laptop Accessories. Subcategory: Laptop. Price: 1,000৳.

Product: Lenovo IdeaPad Thin Port 20V 2.25A 45W Laptop Charger Adapter. Category: Laptop Accessories. Subcategory: Laptop. Price: 1,000৳.
",269,64743,65012
299,recursive,"
Product: Havit F2067 Laptop Cooler For Up to 18.3"" Laptop. Category: Laptop Accessories. Subcategory: Laptop. Price: 1,750৳.

Product: Havit F2075 Laptop Cooler for up to 17"" Laptop. Category: Laptop Accessories. Subcategory: Laptop. Price: 990৳1,050৳.
",254,65012,65266
300,recursive,"
Product: Havit F2035 Dual Fan Laptop Cooler. Category: Laptop Accessories. Subcategory: Laptop. Price: 1,070৳.

Product: HP 19.5V 4.62A 90W Laptop Charger Adapter. Category: Laptop Accessories. Subcategory: Laptop. Price: 1,100৳.
",231,65266,65497
301,recursive,"
Product: HP Compaq 510 18.5V 3.5A 65W Laptop Charger Adapter. Category: Laptop Accessories. Subcategory: Laptop. Price: 1,100৳.

Product: Dell 19V 4.62A 90W Laptop Charger Adapter. Category: Laptop Accessories. Subcategory: Laptop. Price: 1,500৳.
",248,65497,65745
302,recursive,"
Product: Yuanxin X-ZJ801 Retractable Adjustable Laptop Stand with Anti Slip Pad. Category: Laptop Accessories. Subcategory: Laptop. Price: 850৳1,120৳.

Product: Laptop Keyboard For Dell 3521. Category: Laptop Accessories. Subcategory: Laptop. Price: 1,200৳.
",259,65745,66004
303,recursive,"
Product: Laptop Keyboard For Acer NAV 50/D260/D255. Category: Laptop Accessories. Subcategory: Laptop. Price: 1,200৳.

Product: Laptop Keyboard For Acer E-725. Category: Laptop Accessories. Subcategory: Laptop. Price: 1,200৳.
",227,66004,66231
304,recursive,"
Product: Foldable Laptop Table with Cup Holder & Tablet Slot. Category: Laptop Desk. Subcategory: Laptop Accessories. Price: 640৳1,550৳.

Product: Trend Bubbles Filled Fleece Cushion LED Light Laptop Lap Desk. Category: Laptop Desk. Subcategory: Laptop Accessories. Price: Out Of Stock.
",288,66231,66519
305,recursive,"
Product: Multifunctional Laptop Desk With Adjustable Folding Stand. Category: Laptop Desk. Subcategory: Laptop Accessories. Price: Out Of Stock.

Product: Ergonomic Laptop Desk With Built In Cooler. Category: Laptop Desk. Subcategory: Laptop Accessories. Price: Out Of Stock.
",277,66519,66796
306,recursive,"
Product: T9 Multifunctional Folding Laptop Table. Category: Laptop Desk. Subcategory: Laptop Accessories. Price: Out Of Stock.

Product: Multifunctional Foldable Laptop Desk. Category: Laptop Desk. Subcategory: Laptop Accessories. Price: Out Of Stock.
",253,66796,67049
307,recursive,"
Product: Portable Folding Double Head Laptop Desk. Category: Laptop Desk. Subcategory: Laptop Accessories. Price: Out Of Stock.

Product: T8 Multifunctional Folding Laptop Table. Category: Laptop Desk. Subcategory: Laptop Accessories. Price: Out Of Stock.
",257,67049,67306
308,recursive,"
Product: Bamboo Wooden Single Fan Laptop Cooler Table Desk. Category: Laptop Desk. Subcategory: Laptop Accessories. Price: Out Of Stock.

Product: Height Adjustable Movable Laptop Desk 1 Layer. Category: Laptop Desk. Subcategory: Laptop Accessories. Price: Out Of Stock.
",272,67306,67578
309,recursive,"
Product: Bamboo Wooden Dual Fan Laptop Cooler Table Desk. Category: Laptop Desk. Subcategory: Laptop Accessories. Price: Out Of Stock.

Product: XGear A8 Laptop Desk with Built-in Cooling Fans. Category: Laptop Desk. Subcategory: Laptop Accessories. Price: Out Of Stock.
",272,67578,67850
310,recursive,"
Product: Height Adjustable Movable Laptop Desk with Storage Shelf. Category: Laptop Desk. Subcategory: Laptop Accessories. Price: Out Of Stock.

Product: Alluminium Foldable Laptop Table with Cup Holder & IPad Slot. Category: Laptop Desk. Subcategory: Laptop Accessories. Price: Out Of Stock.
",294,67850,68144
311,recursive,"
Product: Laptop Battery for Asus 450 and 550 Series. Category: Laptop Battery. Subcategory: Laptop Accessories. Price: 2,000৳.

Product: MaxGreen BP195B Laptop Battery For Fujitsu. Category: Laptop Battery. Subcategory: Laptop Accessories. Price: 2,000৳.
",256,68144,68400
312,recursive,"
Product: Laptop Battery For Fujitsu LH530. Category: Laptop Battery. Subcategory: Laptop Accessories. Price: 2,000৳.

Product: Laptop Battery For Toshiba Satellite 1305. Category: Laptop Battery. Subcategory: Laptop Accessories. Price: 2,100৳.
",245,68400,68645
313,recursive,"
Product: Laptop Battery For Toshiba 3356. Category: Laptop Battery. Subcategory: Laptop Accessories. Price: 2,100৳.

Product: Laptop Battery For Toshiba PA5024. Category: Laptop Battery. Subcategory: Laptop Accessories. Price: 2,100৳.
",236,68645,68881
314,recursive,"
Product: Laptop Battery For Toshiba 3733. Category: Laptop Battery. Subcategory: Laptop Accessories. Price: 2,100৳.

Product: Laptop Battery For Toshiba PA3634U PA3817U. Category: Laptop Battery. Subcategory: Laptop Accessories. Price: 2,100৳.
",245,68881,69126
315,recursive,"
Product: Laptop Battery A Grade for HP. Category: Laptop Battery. Subcategory: Laptop Accessories. Price: 2,200৳.

Product: Laptop Battery A Grade for Dell. Category: Laptop Battery. Subcategory: Laptop Accessories. Price: 2,200৳.
",232,69126,69358
316,recursive,"
Product: Laptop Battery A Grade For FUJITSU Laptop & Notebook. Category: Laptop Battery. Subcategory: Laptop Accessories. Price: 2,200৳.

Product: Laptop Battery for HP Probook 400 G1 Series. Category: Laptop Battery. Subcategory: Laptop Accessories. Price: 2,200৳.
",267,69358,69625
317,recursive,"
Product: Laptop Battery for HP Probook 4440S/4530S. Category: Laptop Battery. Subcategory: Laptop Accessories. Price: 2,200৳.

Product: Laptop Battery A Grade for HP HS04 Laptop. Category: Laptop Battery. Subcategory: Laptop Accessories. Price: 2,200৳.
",254,69625,69879
318,recursive,"
Product: Laptop Battery for Acer Aspire V5 Series. Category: Laptop Battery. Subcategory: Laptop Accessories. Price: 2,200৳.

Product: Laptop Battery for Acer Aspire 4000, 5000 and 7000 Series. Category: Laptop Battery. Subcategory: Laptop Accessories. Price: 2,200৳.
",269,69879,70148
319,recursive,"
Product: JC04 and JC03 A Grade Laptop Battery For HP 15-bs, 15-bw, 14-bw, 255/ 250 G6. Category: Laptop Battery. Subcategory: Laptop Accessories. Price: 2,200৳.
",162,70148,70310
320,recursive,"
Product: Ki04 A Grade Laptop Battery For HP 14-ab, 15-ab, 15-an, 15t-ak, 15t-ab, 17-g0. Category: Laptop Battery. Subcategory: Laptop Accessories. Price: 2,200৳.
",163,70310,70473
321,recursive,"
Product: Ki04 LA04 Laptop Battery For HP 15-f0, 15-f1, 15-f2, 15-f3 and 14-n0 Models. Category: Laptop Battery. Subcategory: Laptop Accessories. Price: 2,200৳.
",161,70473,70634
322,recursive,"
Product: Laptop Battery Ri04 A-Grade HP for ProBook 450 455 470 G3. Category: Laptop Battery. Subcategory: Laptop Accessories. Price: 2,200৳.

Product: Havit F2051 Laptop Cooler Pad. Category: Laptop Cooler. Subcategory: Laptop Accessories. Price: 1,200৳1,350৳.
",263,70634,70897
323,recursive,"
Product: Havit F2081 Gaming Laptop Cooling Pad. Category: Laptop Cooler. Subcategory: Laptop Accessories. Price: 1,290৳1,390৳.

Product: DeepCool U PAL Laptop Cooler. Category: Laptop Cooler. Subcategory: Laptop Accessories. Price: 1,400৳.
",241,70897,71138
324,recursive,"
Product: Fantech NC14 Laptop Cooler. Category: Laptop Cooler. Subcategory: Laptop Accessories. Price: 1,350৳1,450৳.

Product: Havit Gamenote F2069 RGB Gaming Laptop Cooling Pad. Category: Laptop Cooler. Subcategory: Laptop Accessories. Price: 1,690৳1,750৳.
",258,71138,71396
325,recursive,"
Product: Xtrike Me FN-813 Laptop Cooler. Category: Laptop Cooler. Subcategory: Laptop Accessories. Price: 1,250৳1,400৳.

Product: Xtrike Me FN-811 Red Backlit Laptop Cooler. Category: Laptop Cooler. Subcategory: Laptop Accessories. Price: 1,350৳1,500৳.
",254,71396,71650
326,recursive,"
Product: DeepCool Multi Core X6 4-fan Laptop Cooler. Category: Laptop Cooler. Subcategory: Laptop Accessories. Price: 2,000৳2,200৳.

Product: Gamdias AETHER M1 RGB Laptop Cooler With Phone Stand. Category: Laptop Cooler. Subcategory: Laptop Accessories. Price: 2,500৳.
",270,71650,71920
327,recursive,"
Product: Fantech NC21 RGB Laptop Cooler. Category: Laptop Cooler. Subcategory: Laptop Accessories. Price: 2,660৳2,800৳.

Product: Redragon Ingrid GCP511 Laptop Cooler. Category: Laptop Cooler. Subcategory: Laptop Accessories. Price: 2,450৳2,700৳.
",248,71920,72168
328,recursive,"
Product: Redragon GCP500 IVY RGB Backlighting Laptop Cooler. Category: Laptop Cooler. Subcategory: Laptop Accessories. Price: 3,100৳.

Product: Rapoo CF100 Laptop Cooler. Category: Laptop Cooler. Subcategory: Laptop Accessories. Price: 1,100৳.
",245,72168,72413
329,recursive,"
Product: Rapoo CF200 Laptop Cooler. Category: Laptop Cooler. Subcategory: Laptop Accessories. Price: 1,450৳.

Product: Rapoo CF300 Laptop Cooler. Category: Laptop Cooler. Subcategory: Laptop Accessories. Price: 2,350৳.
",220,72413,72633
330,recursive,"
Product: Suntech A8 Duble Fan LED Laptop Cooling Pad. Category: Laptop Cooler. Subcategory: Laptop Accessories. Price: Out Of Stock.

Product: Laptop Keyboard For Acer D730. Category: Laptop Keyboard. Subcategory: Laptop Accessories. Price: 1,200৳.
",250,72633,72883
331,recursive,"
Product: Laptop Keyboard For Lenovo G-430. Category: Laptop Keyboard. Subcategory: Laptop Accessories. Price: 1,300৳.

Product: Laptop Keyboard For Acer Aspire 5749. Category: Laptop Keyboard. Subcategory: Laptop Accessories. Price: 1,300৳.
",242,72883,73125
332,recursive,"
Product: Laptop Keyboard For Dell 3421. Category: Laptop Keyboard. Subcategory: Laptop Accessories. Price: 1,400৳.

Product: Laptop Keyboard For Acer 5736. Category: Laptop Keyboard. Subcategory: Laptop Accessories. Price: 1,400৳.
",232,73125,73357
333,recursive,"
Product: Laptop Keyboard For Acer 4736. Category: Laptop Keyboard. Subcategory: Laptop Accessories. Price: 1,400৳.

Product: 14 inch Keyboard for Laptop & Notebook. Category: Laptop Keyboard. Subcategory: Laptop Accessories. Price: 1,500৳.
",241,73357,73598
334,recursive,"
Product: Laptop Keyboard For HP Probook 4430S 4330S 4331S 4431S 4435S 4436S Series. Category: Laptop Keyboard. Subcategory: Laptop Accessories. Price: 1,500৳.

Product: Laptop Keyboard For HP 240, HP 14-E000. Category: Laptop Keyboard. Subcategory: Laptop Accessories. Price: 1,500৳.
",285,73598,73883
335,recursive,"
Product: Laptop Keyboard For Dell 3442-14-3000. Category: Laptop Keyboard. Subcategory: Laptop Accessories. Price: 1,500৳.

Product: Laptop Keyboard For Dell 4110. Category: Laptop Keyboard. Subcategory: Laptop Accessories. Price: 1,500৳.
",240,73883,74123
336,recursive,"
Product: Laptop Keyboard For Lenovo Ideapad 100-15IBY/IBD. Category: Laptop Keyboard. Subcategory: Laptop Accessories. Price: 1,500৳.

Product: Laptop Keyboard For Toshiba L500. Category: Laptop Keyboard. Subcategory: Laptop Accessories. Price: 1,500৳.
",254,74123,74377
337,recursive,"
Product: Laptop Keyboard For Toshiba Z830. Category: Laptop Keyboard. Subcategory: Laptop Accessories. Price: 1,500৳.

Product: Laptop Keyboard For Toshiba L800. Category: Laptop Keyboard. Subcategory: Laptop Accessories. Price: 1,500৳.
",238,74377,74615
338,recursive,"
Product: Laptop Keyboard For Toshiba C640. Category: Laptop Keyboard. Subcategory: Laptop Accessories. Price: 1,500৳.

Product: Laptop Keyboard For Toshiba C-50. Category: Laptop Keyboard. Subcategory: Laptop Accessories. Price: 1,500৳.
",238,74615,74853
339,recursive,"
Product: UGREEN LP230 Adjustable Laptop Desk Stand #80348. Category: Laptop Stand. Subcategory: Laptop Accessories. Price: 900৳1,375৳.

Product: ORICO MA13 Verticle Adjustable Foldable Laptop Stand. Category: Laptop Stand. Subcategory: Laptop Accessories. Price: 1,500৳.
",272,74853,75125
340,recursive,"
Product: Fantech NS12 Laptop Stand. Category: Laptop Stand. Subcategory: Laptop Accessories. Price: 1,680৳.

Product: UGREEN LP258 Vertical Laptop Stand #20471. Category: Laptop Stand. Subcategory: Laptop Accessories. Price: 1,640৳1,800৳.
",240,75125,75365
341,recursive,"
Product: Ugreen LP451 Foldable Laptop Stand #40289. Category: Laptop Stand. Subcategory: Laptop Accessories. Price: 1,849৳1,980৳.

Product: Vention KDLI0 Foldable and Portable Laptop Stand. Category: Laptop Stand. Subcategory: Laptop Accessories. Price: 1,490৳2,250৳.
",269,75365,75634
342,recursive,"
Product: ORICO LST02 Adjustable Foldable Laptop Stand. Category: Laptop Stand. Subcategory: Laptop Accessories. Price: 2,300৳.

Product: UGREEN LP258 Vertical Dual Slot Laptop Stand #60643. Category: Laptop Stand. Subcategory: Laptop Accessories. Price: 2,200৳2,550৳.
",269,75634,75903
343,recursive,"
Product: Fantech NS10 Laptop Stand. Category: Laptop Stand. Subcategory: Laptop Accessories. Price: 2,390৳3,450৳.

Product: Squire Ergonomic Push-Button Laptop Stand. Category: Laptop Stand. Subcategory: Laptop Accessories. Price: 2,300৳3,600৳.
",246,75903,76149
344,recursive,"
Product: UGREEN LP339 Adjustable Laptop Desk Stand #40291. Category: Laptop Stand. Subcategory: Laptop Accessories. Price: 4,000৳4,349৳.

Product: Ugreen LP592 Adjustable Swivel Laptop Stand #90849. Category: Laptop Stand. Subcategory: Laptop Accessories. Price: 4,920৳.
",272,76149,76421
345,recursive,"
Product: Vyvylabs Wisdom Series VHW06-GY Laptop Stand 6-in-1 Multifunctional HUB Docking Station. Category: Laptop Stand. Subcategory: Laptop Accessories. Price: 10,470৳.
",172,76421,76593
346,recursive,"
Product: Baseus Pro Series Rotatable and Foldable Laptop Stand. Category: Laptop Stand. Subcategory: Laptop Accessories. Price: Up Coming.

Product: Orico PFB-A23 7-Angles Adjustable Foldable Laptop Stand. Category: Laptop Stand. Subcategory: Laptop Accessories. Price: Out Of Stock.
",285,76593,76878
347,recursive,"
Product: ORICO Aluminum Hard Drive Caddy (L95SS). Category: Caddy. Subcategory: Laptop Accessories. Price: Out Of Stock.

Product: Orico M95SS Laptop Hard Drive Caddy for Optical Drive. Category: Caddy. Subcategory: Laptop Accessories. Price: Out Of Stock.
",258,76878,77136
348,recursive,"
Product: Laptop Display for 14"" 40 Pins Connector Laptop. Category: Display. Subcategory: Laptop Accessories. Price: 4,400৳.

Product: LED Laptop Display for 15.6"" Laptop & Notebook. Category: Display. Subcategory: Laptop Accessories. Price: 4,500৳.
",251,77136,77387
349,recursive,"
Product: LCD Display for 14.1"" Laptop & Notebook. Category: Display. Subcategory: Laptop Accessories. Price: 5,000৳.

Product: Laptop Display for 14"" Laptop & Notebook with Ultra Normal Port. Category: Display. Subcategory: Laptop Accessories. Price: 5,000৳.
",260,77387,77647
350,recursive,"
Product: Laptop Display for 15.6"" Ultra Slim High Resolution Laptop. Category: Display. Subcategory: Laptop Accessories. Price: 5,000৳.

Product: Laptop Display for 14"" HD Laptop & Notebook. Category: Display. Subcategory: Laptop Accessories. Price: 5,000৳.
",259,77647,77906
351,recursive,"
Product: Laptop Display for 15.6"" HD Laptop. Category: Display. Subcategory: Laptop Accessories. Price: 5,000৳.

Product: Laptop Display for 14"" Laptop & Notebook with Ultra Micro Port. Category: Display. Subcategory: Laptop Accessories. Price: 6,000৳.
",254,77906,78160
352,recursive,"
Product: LCD Display for 15"" Laptop & Notebook. Category: Display. Subcategory: Laptop Accessories. Price: 6,000৳.

Product: Laptop Display for 15.6"" Full HD Laptop & Notebook. Category: Display. Subcategory: Laptop Accessories. Price: 6,000৳.
",245,78160,78405
353,recursive,"
Product: Laptop Display Full HD 15.6"" Ultra 40pin 144Hz Series. Category: Display. Subcategory: Laptop Accessories. Price: 9,000৳.

Product: Acer Swift 3 SF315-51-54BJ 15.6"" Convertible Display. Category: Display. Subcategory: Laptop Accessories. Price: 25,900৳.
",264,78405,78669
354,recursive,"
Product: Dell Inspiron 13-5368 13.3"" Front Part Convertible Touch Display. Category: Display. Subcategory: Laptop Accessories. Price: 26,900৳.

Product: Dell XPS 13-7391 Front Panel Part With Touch For Notebook. Category: Display. Subcategory: Laptop Accessories. Price: 28,000৳.
",281,78669,78950
355,recursive,"
Product: HP Pavilion X360 14-BA Series 14"" Front Part Convertible Touch Display. Category: Display. Subcategory: Laptop Accessories. Price: 31,800৳.

Product: Asus UX362F Convertible Full Touch Panel For Notebook. Category: Display. Subcategory: Laptop Accessories. Price: 34,400৳.
",283,78950,79233
356,recursive,"
Product: HP Pavilion X360 13-BA Series 13"" Convertible Touch Display. Category: Display. Subcategory: Laptop Accessories. Price: 35,000৳.

Product: HP Spectra X360 Convertible Touch Display. Category: Display. Subcategory: Laptop Accessories. Price: 35,100৳.
",260,79233,79493
357,recursive,"
Product: Lenovo Yoga 520-14IKB 14"" Front Part Convertible Touch Display. Category: Display. Subcategory: Laptop Accessories. Price: 36,800৳.

Product: HP Spectra X360 15-EB1043DX 15.6"" Front Part Convertible Touch Display. Category: Display. Subcategory: Laptop Accessories. Price: 38,200৳.
",292,79493,79785
358,recursive,"
Product: Laptop Charger Adapter A Grade for Acer. Category: Laptop Charger / Adapter. Subcategory: Laptop Accessories. Price: 1,300৳.

Product: Laptop Power Charger Adapter for Asus. Category: Laptop Charger / Adapter. Subcategory: Laptop Accessories. Price: 1,300৳.
",268,79785,80053
359,recursive,"
Product: Laptop Power Charger Adapter for Dell Laptop & Notebook. Category: Laptop Charger / Adapter. Subcategory: Laptop Accessories. Price: 1,300৳.

Product: Laptop Power Charger Adapter A Grade for Fujitsu. Category: Laptop Charger / Adapter. Subcategory: Laptop Accessories. Price: 1,300৳.
",295,80053,80348
360,recursive,"
Product: Laptop Power Charger Adapter A Grade for HP. Category: Laptop Charger / Adapter. Subcategory: Laptop Accessories. Price: 1,300৳.

Product: Laptop Power Charger Adapter Blue Pin 2.31A for HP. Category: Laptop Charger / Adapter. Subcategory: Laptop Accessories. Price: 1,500৳.
",285,80348,80633
361,recursive,"
Product: Laptop Power Charger Adapter 65W Blue Pin 3.33A for HP. Category: Laptop Charger / Adapter. Subcategory: Laptop Accessories. Price: 1,500৳.

Product: Laptop Power Charger Adapter 3.34A for Dell. Category: Laptop Charger / Adapter. Subcategory: Laptop Accessories. Price: 1,500৳.
",289,80633,80922
362,recursive,"
Product: Laptop Power Charger Adapter 65W 3.25A USB for Lenovo. Category: Laptop Charger / Adapter. Subcategory: Laptop Accessories. Price: 1,300৳.

Product: Laptop Power Charger Adapter 3.16A for Samsung. Category: Laptop Charger / Adapter. Subcategory: Laptop Accessories. Price: 1,300৳.
",291,80922,81213
363,recursive,"
Product: MaxGreen 19V 3.42A 65W Laptop Charger Adapter For Acer Laptop. Category: Laptop Charger / Adapter. Subcategory: Laptop Accessories. Price: 1,500৳.
",157,81213,81370
364,recursive,"
Product: MaxGreen 19V 3.42A 65W Common Port Laptop Charger Adapter For Asus Laptop. Category: Laptop Charger / Adapter. Subcategory: Laptop Accessories. Price: 1,500৳.
",169,81370,81539
365,recursive,"
Product: MaxGreen 19.5V 3.34A 65W Big Port Laptop Charger Adapter For Dell Laptop. Category: Laptop Charger / Adapter. Subcategory: Laptop Accessories. Price: 1,500৳.

Product: Intel Pentium Gold G6400 10th gen Coffee Lake Processor. Category: Intel. Subcategory: Processor. Price: 5,700৳6,100৳.
",297,81539,81836
366,recursive,"
Product: Intel 10th Gen Core i3 10100F Processor. Category: Intel. Subcategory: Processor. Price: 6,900৳7,300৳.

Product: Intel Pentium Gold G7400 Alder Lake Processor. Category: Intel. Subcategory: Processor. Price: 7,499৳7,900৳.
",232,81836,82068
367,recursive,"
Product: Intel Pentium Gold G6405 Coffee Lake Processor. Category: Intel. Subcategory: Processor. Price: 7,600৳8,200৳.

Product: Intel 10th Gen Core i5-10400F Processor. Category: Intel. Subcategory: Processor. Price: 8,900৳9,600৳.
",233,82068,82301
368,recursive,"
Product: Intel 11th Gen Core i5-11400F Rocket Lake Processor. Category: Intel. Subcategory: Processor. Price: 9,500৳10,500৳.

Product: Intel 5th Gen Core i7 5930K Processor. Category: Intel. Subcategory: Processor. Price: 9,900৳10,500৳.
",238,82301,82539
369,recursive,"
Product: Intel Core i3-12100 12th Gen Alder Lake Processor (Tray). Category: Intel. Subcategory: Processor. Price: 9,900৳10,500৳.

Product: Intel 10th Gen Core i3 10100 Processor. Category: Intel. Subcategory: Processor. Price: 10,600৳11,500৳.
",245,82539,82784
370,recursive,"
Product: Intel Core i3-12100 12th Gen Alder Lake Processor. Category: Intel. Subcategory: Processor. Price: 11,450৳11,800৳.

Product: Intel Core i3 13100 13th Gen Processor (TRAY). Category: Intel. Subcategory: Processor. Price: 11,900৳.
",239,82784,83023
371,recursive,"
Product: Intel Core i3 10105 10th Gen Comet Lake Processor. Category: Intel. Subcategory: Processor. Price: 10,400৳12,500৳.

Product: Intel 13th Gen Core i3-13100 Raptor Lake Processor. Category: Intel. Subcategory: Processor. Price: 12,500৳13,100৳.
",251,83023,83274
372,recursive,"
Product: Intel 12th Gen Core i5-12400F Alder Lake Processor. Category: Intel. Subcategory: Processor. Price: 12,450৳13,200৳.

Product: Intel 11th Gen Core i5-11500 Rocket Lake Processor. Category: Intel. Subcategory: Processor. Price: 13,000৳13,500৳.
",252,83274,83526
373,recursive,"
Product: Intel 11th Gen Core i5-11400 Rocket Lake Processor. Category: Intel. Subcategory: Processor. Price: 13,500৳14,000৳.

Product: Intel 10th Gen Core i5-10400 Processor. Category: Intel. Subcategory: Processor. Price: 13,800৳14,500৳.
",240,83526,83766
374,recursive,"
Product: Intel Core i3 14100 14th Gen Raptor Lake Processor. Category: Intel. Subcategory: Processor. Price: 13,950৳14,700৳.

Product: Intel 10th Gen Core i5-10500 Processor. Category: Intel. Subcategory: Processor. Price: 13,900৳14,800৳.
",240,83766,84006
375,recursive,"
Product: Intel 13th Gen Core i5 13400F Raptor Lake Processor. Category: Intel. Subcategory: Processor. Price: 16,200৳16,500৳.

Product: AMD Athlon PRO 300GE AM4 Socket Desktop Processor with Radeon Vega 3 Graphics (Rebox). Category: AMD. Subcategory: Processor. Price: 4,900৳5,500৳.
",284,84006,84290
376,recursive,"
Product: AMD Ryzen 5 3400G Processor with Radeon RX Vega 11 Graphics. Category: AMD. Subcategory: Processor. Price: 7,200৳7,700৳.

Product: AMD Ryzen 5 5500 Processor. Category: AMD. Subcategory: Processor. Price: 8,300৳8,900৳.
",229,84290,84519
377,recursive,"
Product: AMD Ryzen 3 4100 Processor. Category: AMD. Subcategory: Processor. Price: 9,300৳10,000৳.

Product: AMD Ryzen Threadripper 1900X Processor. Category: AMD. Subcategory: Processor. Price: 10,000৳10,500৳.
",211,84519,84730
378,recursive,"
Product: AMD Ryzen 5 8400F Processor. Category: AMD. Subcategory: Processor. Price: 11,200৳11,500৳.

Product: AMD Ryzen 5 5600 Processor. Category: AMD. Subcategory: Processor. Price: 11,500৳12,000৳.
",201,84730,84931
379,recursive,"
Product: AMD Ryzen 5 5600X Processor. Category: AMD. Subcategory: Processor. Price: 12,500৳12,900৳.

Product: AMD Ryzen 5 3600 Processor. Category: AMD. Subcategory: Processor. Price: 11,900৳13,500৳.
",201,84931,85132
380,recursive,"
Product: AMD Ryzen 5 5600GT AM4 Processor with Radeon Graphics. Category: AMD. Subcategory: Processor. Price: 13,500৳13,900৳.

Product: AMD Ryzen 7 5700X Processor. Category: AMD. Subcategory: Processor. Price: 13,000৳14,000৳.
",228,85132,85360
381,recursive,"
Product: AMD Ryzen 5 5600G Processor with Radeon Graphics (Tray Box). Category: AMD. Subcategory: Processor. Price: 13,500৳14,500৳.

Product: AMD Ryzen 5 5600G Processor with Radeon Graphics. Category: AMD. Subcategory: Processor. Price: 14,800৳.
",248,85360,85608
382,recursive,"
Product: AMD Ryzen 5 7400F Processor. Category: AMD. Subcategory: Processor. Price: 14,799৳15,800৳.

Product: AMD Ryzen 7 5700G Processor with Radeon Graphics. Category: AMD. Subcategory: Processor. Price: 15,500৳16,500৳.
",223,85608,85831
383,recursive,"
Product: AMD Ryzen 5 7500F Processor. Category: AMD. Subcategory: Processor. Price: 15,800৳17,000৳.

Product: AMD Ryzen 5 7600 Gaming Processor. Category: AMD. Subcategory: Processor. Price: 20,700৳.
",201,85831,86032
384,recursive,"
Product: AMD Ryzen 7 5800X Processor. Category: AMD. Subcategory: Processor. Price: 21,000৳21,500৳.

Product: AMD Ryzen 5 8500G Processor with Radeon Graphics. Category: AMD. Subcategory: Processor. Price: 21,500৳.
",216,86032,86248
385,recursive,"
Product: AMD Ryzen 5 7600X Processor. Category: AMD. Subcategory: Processor. Price: 20,998৳22,000৳.

Product: Netac Basic 8GB DDR4 2666MHZ Desktop RAM. Category: Component. Price: Up Coming.
",192,86248,86440
386,recursive,"
Product: Corsair SF850L 850W 80 PLUS Gold Fully Modular SFX Power Supply. Category: Component. Price: 19,500৳20,000৳.

Product: Gamdias AEOLUS M2 1201 120mm RGB Casing Cooling Fan. Category: Component. Price: 1,150৳.

Product: MaxGreen M19 ARGB 120mm Casing Fan. Category: Component. Price: 450৳.
",298,86440,86738
387,recursive,"
Product: PC Power CFX 120MM ARGB Case Fan White. Category: Component. Price: 375৳490৳.

Product: Deepcool RF 120 B Blue LED Case Fan. Category: Component. Price: 500৳550৳.

Product: Deepcool RF 120 W White LED Case Fan. Category: Component. Price: 500৳550৳.
",259,86738,86997
388,recursive,"
Product: Deepcool RF 120 R Red LED Case Fan. Category: Component. Price: 500৳550৳.

Product: MaxGreen M59 ARGB 120mm Casing Fan. Category: Component. Price: 550৳.

Product: MaxGreen M57 ARGB 120mm Casing Fan. Category: Component. Price: 650৳.
",244,86997,87241
389,recursive,"
Product: upHere U3KC1 120mm ARGB Casing Fan. Category: Component. Price: 700৳.

Product: upHere U3TC1 120mm ARGB Casing Fan. Category: Component. Price: 600৳700৳.

Product: Antec F12 120mm RGB Case Fan (Single Pack). Category: Component. Price: 750৳.
",252,87241,87493
390,recursive,"
Product: Arctic P8 Silent 80mm Low Noise Casing Cooler. Category: Component. Price: 700৳750৳.

Product: EKWB EK-Quantum Torque HDC 12 Black. Category: Component. Price: 300৳799৳.

Product: Cooler Master CF120 ARGB Case Fan. Category: Component. Price: 850৳.
",259,87493,87752
391,recursive,"
Product: Gamdias NOTUS M1-1201 120mm Casing Cooling Fan. Category: Component. Price: 850৳.

Product: Antec I Shape Prism GPU Holder. Category: Component. Price: 900৳.

Product: Arctic F12 120 mm Casing Fan. Category: Component. Price: 900৳.
",242,87752,87994
392,recursive,"
Product: Gamdias NOTUS M1-1201 ARGB 120mm Casing Cooling Fan. Category: Component. Price: 975৳.

Product: EKWB EK-HD Tube Reamer. Category: EKWB. Subcategory: Water / Liquid Cooling. Price: 600৳1,200৳.
",203,87994,88197
393,recursive,"
Product: EKWB EK-CryoFuel Solid Scarlet RED 250ml (Conc.) Non-transparent Coolants. Category: EKWB. Subcategory: Water / Liquid Cooling. Price: 799৳1,700৳.

Product: EKWB EK-DuraClear 11,1/15,9mm 3M Retail. Category: EKWB. Subcategory: Water / Liquid Cooling. Price: 899৳2,000৳.
",280,88197,88477
394,recursive,"
Product: EKWB 6-Pack HDC 12 EK-Quantum Torque. Category: EKWB. Subcategory: Water / Liquid Cooling. Price: 1,999৳4,000৳.

Product: EKWB EK-Loop Soft 12/16mm 3mm Tube. Category: EKWB. Subcategory: Water / Liquid Cooling. Price: 3,600৳4,500৳.
",242,88477,88719
395,recursive,"
Product: EKWB EK-Quantum Velocity D-RGB AMD Nickel + Acetal Water Block. Category: EKWB. Subcategory: Water / Liquid Cooling. Price: 4,000৳11,000৳.

Product: EKWB EK-XTOP DDC 3.2 PWM Elite Plexi. Category: EKWB. Subcategory: Water / Liquid Cooling. Price: 6,000৳12,300৳.
",272,88719,88991
396,recursive,"
Product: EKWB EK-Quantum Velocity Nickel Plexi. Category: EKWB. Subcategory: Water / Liquid Cooling. Price: Up Coming.

Product: EKWB EK-Loop Multi Allen Key. Category: EKWB. Subcategory: Water / Liquid Cooling. Price: Out Of Stock.
",234,88991,89225
397,recursive,"
Product: EKWB PVC 10-12mm Tube Clamp. Category: EKWB. Subcategory: Water / Liquid Cooling. Price: Out Of Stock.

Product: EKWB Filling 1000mL Bottle. Category: EKWB. Subcategory: Water / Liquid Cooling. Price: Out Of Stock.
",225,89225,89450
398,recursive,"
Product: EKWB EK-HD PETG 10/12mm 500mm Tube. Category: EKWB. Subcategory: Water / Liquid Cooling. Price: Out Of Stock.

Product: EKWB EK-Quantum 90Â° Torque Rotary. Category: EKWB. Subcategory: Water / Liquid Cooling. Price: Out Of Stock.
",240,89450,89690
399,recursive,"
Product: EKWB EK-HD 10/12mm 500mm Tube. Category: EKWB. Subcategory: Water / Liquid Cooling. Price: Out Of Stock.

Product: EKWB EK-D-RGB 6-Way Splitter Cable. Category: EKWB. Subcategory: Water / Liquid Cooling. Price: Out Of Stock.
",235,89690,89925
400,recursive,"
Product: EKWB EK-CryoFuel Solid Concentrate Coolant 250mL Cloud White. Category: EKWB. Subcategory: Water / Liquid Cooling. Price: Out Of Stock.

Product: EKWB EK-CryoFuel Solid Concentrate Coolant 250mL Neon Green. Category: EKWB. Subcategory: Water / Liquid Cooling. Price: Out Of Stock.
",291,89925,90216
401,recursive,"
Product: EKWB EK-CryoFuel Dye Pack. Category: EKWB. Subcategory: Water / Liquid Cooling. Price: Out Of Stock.

Product: EKWB EK-CryoFuel Solid Electric Purple Concentrate 250mL Coolant. Category: EKWB. Subcategory: Water / Liquid Cooling. Price: Out Of Stock.
",261,90216,90477
402,recursive,"
Product: DeepCool ICE EDGE MINI FS V2.0 CPU Air Cooler. Category: CPU Cooler. Subcategory: Component. Price: 1,000৳1,100৳.

Product: Arctic Alpine 23 CO Compact AMD CPU Cooler. Category: CPU Cooler. Subcategory: Component. Price: 1,200৳1,250৳.
",245,90477,90722
403,recursive,"
Product: Arctic Alpine 17 CO Low Profile Intel CPU Cooler. Category: CPU Cooler. Subcategory: Component. Price: 1,000৳1,250৳.

Product: Xtreme XJOGOS XJC100A 90W CPU Cooler. Category: CPU Cooler. Subcategory: Component. Price: 1,300৳1,400৳.
",242,90722,90964
404,recursive,"
Product: Arctic Freezer 8i Air CPU Cooler. Category: CPU Cooler. Subcategory: Component. Price: 1,999৳.

Product: Arctic Freezer 8A AMD Air CPU Cooler. Category: CPU Cooler. Subcategory: Component. Price: 1,999৳.
",214,90964,91178
405,recursive,"
Product: Arctic Freezer 8A CO AMD Air CPU Cooler. Category: CPU Cooler. Subcategory: Component. Price: 2,199৳.

Product: Arctic Freezer 8i CO Intel Air CPU Cooler. Category: CPU Cooler. Subcategory: Component. Price: 2,300৳.
",226,91178,91404
406,recursive,"
Product: Thermaltake UX400 ARGB Sync AIR CPU Cooler. Category: CPU Cooler. Subcategory: Component. Price: 2,300৳2,400৳.

Product: upHere UP1K4 120mm Air CPU Cooler. Category: CPU Cooler. Subcategory: Component. Price: 2,300৳2,500৳.
",233,91404,91637
407,recursive,"
Product: Thermaltake UX400 ARGB Sync AIR CPU Cooler White. Category: CPU Cooler. Subcategory: Component. Price: 2,500৳2,600৳.

Product: DeepCool AG400 ARGB CPU Cooler. Category: CPU Cooler. Subcategory: Component. Price: 2,650৳.
",230,91637,91867
408,recursive,"
Product: Huntkey Frozen 400X Fantasy ARGB CPU Cooler. Category: CPU Cooler. Subcategory: Component. Price: 2,400৳2,800৳.

Product: Arctic Freezer 7 X Multi-Compatible Air CPU Cooler. Category: CPU Cooler. Subcategory: Component. Price: 2,423৳2,850৳.
",251,91867,92118
409,recursive,"
Product: DeepCool AG500 ARGB 120mm Single Tower CPU Cooler. Category: CPU Cooler. Subcategory: Component. Price: 2,899৳.

Product: DeepCool AG400 BK ARGB Single Tower 120mm CPU Cooler. Category: CPU Cooler. Subcategory: Component. Price: 2,950৳.
",247,92118,92365
410,recursive,"
Product: upHere UP1KC4C ARGB 120mm Air CPU Cooler. Category: CPU Cooler. Subcategory: Component. Price: 3,000৳3,200৳.

Product: upHere UP1TC4C ARGB 120mm Air CPU Cooler. Category: CPU Cooler. Subcategory: Component. Price: 3,000৳3,200৳.
",238,92365,92603
411,recursive,"
Product: upHere H85KC6 ARGB 120mm Air CPU Cooler. Category: CPU Cooler. Subcategory: Component. Price: 3,200৳3,500৳.

Product: upHere D6SEC ARGB Dual Tower Air CPU Cooler. Category: CPU Cooler. Subcategory: Component. Price: 3,500৳3,700৳.
",240,92603,92843
412,recursive,"
Product: ASROCK H610M-H2/M.2 14th, 13th and 12th Gen mATX DDR4 Motherboard. Category: ASRock (Intel). Subcategory: Motherboard. Price: 9,800৳10,000৳.
",151,92843,92994
413,recursive,"
Product: ASRock B760M PG Lightning DDR5 14th, 13th and 12th Gen Micro ATX Motherboard. Category: ASRock (Intel). Subcategory: Motherboard. Price: 16,300৳.

Product: ASRock B760M Pro-A DDR5 Micro ATX Motherboard. Category: ASRock (Intel). Subcategory: Motherboard. Price: 16,900৳17,500৳.
",288,92994,93282
414,recursive,"
Product: ASRock B760M Pro RS DDR5 mATX Motherboard. Category: ASRock (Intel). Subcategory: Motherboard. Price: 18,900৳.

Product: ASRock B760M Pro-A WiFi DDR5 Micro ATX Motherboard. Category: ASRock (Intel). Subcategory: Motherboard. Price: 19,400৳.
",251,93282,93533
415,recursive,"
Product: ASRock Z890 Pro-A WiFi LGA1851 DDR5 ATX Motherboard. Category: ASRock (Intel). Subcategory: Motherboard. Price: 34,500৳.

Product: ASRock Z890 Pro RS WiFi White LGA1851 DDR5 ATX Motherboard. Category: ASRock (Intel). Subcategory: Motherboard. Price: 40,000৳.
",269,93533,93802
416,recursive,"
Product: ASRock Z890 Steel Legend WiFi LGA1851 DDR5 ATX Motherboard. Category: ASRock (Intel). Subcategory: Motherboard. Price: 44,000৳.

Product: ASRock Z790 PG Lightning/D4 ATX Motherboard. Category: ASRock (Intel). Subcategory: Motherboard. Price: Up Coming.
",263,93802,94065
417,recursive,"
Product: ASRock Z790M PG Lightning/D4 Micro ATX Motherboard. Category: ASRock (Intel). Subcategory: Motherboard. Price: Up Coming.

Product: ASRock Z790 PG Lightning ATX Motherboard. Category: ASRock (Intel). Subcategory: Motherboard. Price: Up Coming.
",254,94065,94319
418,recursive,"
Product: ASRock H610M-HDV/M.2 Micro ATX Motherboard. Category: ASRock (Intel). Subcategory: Motherboard. Price: Out Of Stock.

Product: ASRock B760M-HDV/M.2 D4 Micro ATX Motherboard. Category: ASRock (Intel). Subcategory: Motherboard. Price: Out Of Stock.
",257,94319,94576
419,recursive,"
Product: ASRock B760M-HDV/M.2 DDR5 Micro ATX Motherboard. Category: ASRock (Intel). Subcategory: Motherboard. Price: Out Of Stock.

Product: ASRock B760 Pro RS/D4 ATX Motherboard. Category: ASRock (Intel). Subcategory: Motherboard. Price: Out Of Stock.
",254,94576,94830
420,recursive,"
Product: ASRock Z790 Pro RS/D4 ATX Motherboard. Category: ASRock (Intel). Subcategory: Motherboard. Price: Out Of Stock.

Product: ASRock B450M-HDV R4.0 AMD Motherboard. Category: ASRock (AMD). Subcategory: Motherboard. Price: 7,999৳8,400৳.
",242,94830,95072
421,recursive,"
Product: ASRock A520M-HVS AMD AM4 Micro ATX Motherboard. Category: ASRock (AMD). Subcategory: Motherboard. Price: 7,900৳8,450৳.

Product: ASRock B850M Pro-A WiFi AM5 DDR5 mATX Motherboard. Category: ASRock (AMD). Subcategory: Motherboard. Price: 24,999৳.
",256,95072,95328
422,recursive,"
Product: ASRock B850M-X WiFi AM5 DDR5 Micro ATX Motherboard. Category: ASRock (AMD). Subcategory: Motherboard. Price: 18,500৳.

Product: ASRock B850 Pro-A WiFi AM5 DDR5 ATX Motherboard. Category: ASRock (AMD). Subcategory: Motherboard. Price: 27,500৳.
",253,95328,95581
423,recursive,"
Product: ASRock B850 STEEL LEGEND WIFI AM5 DDR5 ATX Motherboard. Category: ASRock (AMD). Subcategory: Motherboard. Price: 33,999৳.

Product: ASRock B850M STEEL LEGEND WIFI AM5 DDR5 mATX Motherboard. Category: ASRock (AMD). Subcategory: Motherboard. Price: 27,500৳.
",266,95581,95847
424,recursive,"
Product: ASRock X870 Pro RS WiFi AM5 DDR5 ATX Motherboard. Category: ASRock (AMD). Subcategory: Motherboard. Price: 35,500৳36,000৳.

Product: ASRock X870E Nova WiFi AM5 DDR5 ATX Motherboard. Category: ASRock (AMD). Subcategory: Motherboard. Price: 55,500৳.
",258,95847,96105
425,recursive,"
Product: ASRock B650M PG Riptide AMD AM5 Micro ATX Motherboard. Category: ASRock (AMD). Subcategory: Motherboard. Price: Up Coming.

Product: ASRock B650M PG Riptide WiFi AMD AM5 Micro ATX Motherboard. Category: ASRock (AMD). Subcategory: Motherboard. Price: Up Coming.
",271,96105,96376
426,recursive,"
Product: ASRock B650 PG Lightning AMD AM5 ATX Motherboard. Category: ASRock (AMD). Subcategory: Motherboard. Price: Up Coming.

Product: ASRock A620M-HDV/M.2 AM5 DDR5 Micro ATX Motherboard. Category: ASRock (AMD). Subcategory: Motherboard. Price: Out Of Stock.
",262,96376,96638
427,recursive,"
Product: Asrock B450M Steel Legend AMD Micro-ATX Motherboard. Category: ASRock (AMD). Subcategory: Motherboard. Price: 13,300৳.

Product: Asrock B450 Steel Legend AMD Motherboard. Category: ASRock (AMD). Subcategory: Motherboard. Price: Out Of Stock.
",252,96638,96890
428,recursive,"
Product: ASRock B650M PG Lightning AM5 Micro ATX Motherboard. Category: ASRock (AMD). Subcategory: Motherboard. Price: Out Of Stock.

Product: ASRock B650M Pro RS AM5 Micro ATX Motherboard. Category: ASRock (AMD). Subcategory: Motherboard. Price: Out Of Stock.
",262,96890,97152
429,recursive,"
Product: ASRock B650M PG Lightning WiFi AM5 Micro ATX Motherboard. Category: ASRock (AMD). Subcategory: Motherboard. Price: Out Of Stock.

Product: ASRock B650M Pro RS WiFi AM5 Micro ATX Motherboard. Category: ASRock (AMD). Subcategory: Motherboard. Price: Out Of Stock.
",272,97152,97424
430,recursive,"
Product: ASRock X870 Steel Legend WiFi AM5 DDR5 ATX Motherboard. Category: ASRock (AMD). Subcategory: Motherboard. Price: 40,499৳.

Product: Intel Core i5-7640X Processor & Asus TUF X299 MARK 2 Motherboard Combo. Category: Motherboard. Subcategory: Component. Price: 50,000৳.
",277,97424,97701
431,recursive,"
Product: MSI A520M-A Pro AM4 AMD Micro-ATX Motherboard. Category: Motherboard. Subcategory: Component. Price: 8,100৳8,300৳.

Product: GIGABYTE B450M K AMD AM4 Micro ATX Motherboard. Category: Motherboard. Subcategory: Component. Price: 7,650৳8,500৳.
",251,97701,97952
432,recursive,"
Product: GIGABYTE A520M K V2 AM4 Micro ATX Motherboard. Category: Motherboard. Subcategory: Component. Price: 8,100৳8,500৳.

Product: Asus PRIME A520M-R AM4 micro ATX Motherboard. Category: Motherboard. Subcategory: Component. Price: 8,300৳8,500৳.
",249,97952,98201
433,recursive,"
Product: MSI B450M-A PRO MAX II AMD AM4 Motherboard. Category: Motherboard. Subcategory: Component. Price: 8,500৳8,700৳.

Product: GIGABYTE H410M H V2 10th Gen Micro ATX Motherboard. Category: Motherboard. Subcategory: Component. Price: 8,280৳9,000৳.
",252,98201,98453
434,recursive,"
Product: MSI H310M PRO-VDH Intel 9th Gen Motherboard. Category: Motherboard. Subcategory: Component. Price: 8,800৳9,000৳.

Product: Asus H81M-K 4th Gen Motherboard. Category: Motherboard. Subcategory: Component. Price: 9,300৳.
",228,98453,98681
435,recursive,"
Product: GIGABYTE GA-H81M-H 4th Gen Micro ATX Motherboard. Category: Motherboard. Subcategory: Component. Price: 9,000৳9,500৳.

Product: GIGABYTE H510M K Intel Micro ATX Motherboard. Category: Motherboard. Subcategory: Component. Price: 9,300৳9,500৳.
",252,98681,98933
436,recursive,"
Product: Asus PRIME B450M-K II DDR4 AMD AM4 micro ATX Motherboard. Category: Motherboard. Subcategory: Component. Price: 9,100৳9,500৳.

Product: MSI PRO H510M-B II 10th Gen Micro-ATX Motherboard. Category: Motherboard. Subcategory: Component. Price: 9,000৳9,500৳.
",265,98933,99198
437,recursive,"
Product: GIGABYTE H510M H V2 11th/10th Gen Micro ATX Motherboard. Category: Motherboard. Subcategory: Component. Price: 9,118৳9,700৳.

Product: Gigabyte GA-H110M-H Micro ATX Motherboard. Category: Motherboard. Subcategory: Component. Price: 9,200৳9,800৳.
",256,99198,99454
438,recursive,"
Product: Gigabyte H310M M.2 9th Gen Micro ATX Motherboard. Category: Motherboard. Subcategory: Component. Price: 9,200৳9,900৳.

Product: MSI PRO H610M-S DDR4 m-ATX Motherboard. Category: Motherboard. Subcategory: Component. Price: 9,900৳.
",240,99454,99694
439,recursive,"
Product: MSI PRO H610M-E DDR4 mATX Motherboard. Category: Motherboard. Subcategory: Component. Price: 9,950৳.

Product: MSI B550M-A PRO DDR4 AMD AM4 Micro ATX Motherboard. Category: MSI (AMD). Subcategory: Motherboard. Price: 10,900৳.
",236,99694,99930
440,recursive,"
Product: MSI PRO A620M-E AMD AM5 mATX Motherboard. Category: MSI (AMD). Subcategory: Motherboard. Price: 11,300৳11,499৳.

Product: MSI PRO A620M-B AM5 mATX Motherboard. Category: MSI (AMD). Subcategory: Motherboard. Price: 11,800৳.
",233,99930,100163
441,recursive,"
Product: MSI PRO B650M-E AM5 mATX Motherboard. Category: MSI (AMD). Subcategory: Motherboard. Price: 13,100৳.

Product: MSI PRO B650M-B DDR5 AMD AM5 m-ATX Motherboard. Category: MSI (AMD). Subcategory: Motherboard. Price: 13,500৳.
",232,100163,100395
442,recursive,"
Product: MSI B550M Pro-VDH AMD AM4 DDR4 Micro-ATX Motherboard. Category: MSI (AMD). Subcategory: Motherboard. Price: 14,600৳14,800৳.

Product: MSI PRO B650M-P DDR5 AMD AM5 mATX Motherboard. Category: MSI (AMD). Subcategory: Motherboard. Price: 15,700৳15,900৳.
",261,100395,100656
443,recursive,"
Product: MSI B550M Pro-VDH Wi-Fi AM4 AMD Micro-ATX Motherboard. Category: MSI (AMD). Subcategory: Motherboard. Price: 15,900৳16,000৳.

Product: MSI B650M GAMING WIFI AM5 mATX Motherboard. Category: MSI (AMD). Subcategory: Motherboard. Price: 18,800৳19,000৳.
",259,100656,100915
444,recursive,"
Product: MSI B840M GAMING WIFI6E AM5 mATX Motherboard. Category: MSI (AMD). Subcategory: Motherboard. Price: 19,400৳.

Product: MSI PRO B650-S WIFI DDR5 AM5 ATX Motherboard. Category: MSI (AMD). Subcategory: Motherboard. Price: 20,700৳.
",238,100915,101153
445,recursive,"
Product: MSI B650M GAMING PLUS WIFI AM5 Motherboard. Category: MSI (AMD). Subcategory: Motherboard. Price: 20,999৳22,500৳.

Product: MSI PRO B840-P WIFI AMD AM5 ATX Motherboard. Category: MSI (AMD). Subcategory: Motherboard. Price: 22,600৳23,500৳.
",249,101153,101402
446,recursive,"
Product: MSI B840 GAMING PLUS WIFI AMD AM5 ATX Motherboard. Category: MSI (AMD). Subcategory: Motherboard. Price: 23,800৳24,500৳.

Product: MSI B850M GAMING PLUS WIFI6E AM5 mATX Motherboard. Category: MSI (AMD). Subcategory: Motherboard. Price: 25,000৳.
",255,101402,101657
447,recursive,"
Product: MSI B650M PROJECT ZERO AM5 m-ATX Motherboard. Category: MSI (AMD). Subcategory: Motherboard. Price: 24,900৳25,500৳.

Product: MSI PRO B850M-A WIFI AM5 mATX Motherboard. Category: MSI (AMD). Subcategory: Motherboard. Price: 27,200৳.
",242,101657,101899
448,recursive,"
Product: MSI B850 GAMING PLUS WIFI AM5 ATX Motherboard. Category: MSI (AMD). Subcategory: Motherboard. Price: 28,300৳28,500৳.

Product: MSI PRO H610M-E mATX Motherboard. Category: MSI (Intel). Subcategory: Motherboard. Price: 10,700৳.
",236,101899,102135
449,recursive,"
Product: MSI PRO H610M-G DDR4 Micro-ATX Motherboard. Category: MSI (Intel). Subcategory: Motherboard. Price: 10,900৳.

Product: MSI PRO H610M-G DDR5 mATX Motherboard. Category: MSI (Intel). Subcategory: Motherboard. Price: 10,800৳11,200৳.
",240,102135,102375
450,recursive,"
Product: MSI H310M Pro-M2 Intel 9th Gen Motherboard. Category: MSI (Intel). Subcategory: Motherboard. Price: 10,300৳11,200৳.

Product: MSI PRO B760M-E DDR4 mATX Motherboard. Category: MSI (Intel). Subcategory: Motherboard. Price: 13,000৳13,500৳.
",247,102375,102622
451,recursive,"
Product: MSI PRO B760M-E DDR5 m-ATX Motherboard. Category: MSI (Intel). Subcategory: Motherboard. Price: 13,400৳13,500৳.

Product: MSI PRO H610M-G WIFI DDR4 m-ATX Motherboard. Category: MSI (Intel). Subcategory: Motherboard. Price: 13,200৳13,500৳.
",249,102622,102871
452,recursive,"
Product: MSI PRO B760M-P DDR5 mATX Motherboard. Category: MSI (Intel). Subcategory: Motherboard. Price: 15,300৳15,700৳.

Product: MSI PRO H810M-B DDR5 LGA1851 mATX Motherboard. Category: MSI (Intel). Subcategory: Motherboard. Price: 17,000৳.
",243,102871,103114
453,recursive,"
Product: MSI B760M BOMBER WIFI mATX Motherboard. Category: MSI (Intel). Subcategory: Motherboard. Price: 19,200৳19,500৳.

Product: MSI B760M GAMING PLUS WIFI 6E mATX Motherboard. Category: MSI (Intel). Subcategory: Motherboard. Price: 19,200৳19,500৳.
",252,103114,103366
454,recursive,"
Product: MSI PRO B760M-A WIFI mATX Motherboard. Category: MSI (Intel). Subcategory: Motherboard. Price: 19,600৳19,700৳.

Product: MSI B760 GAMING PLUS WIFI ATX Motherboard. Category: MSI (Intel). Subcategory: Motherboard. Price: 22,800৳23,000৳.
",246,103366,103612
455,recursive,"
Product: MSI B760M PROJECT ZERO m-ATX Motherboard. Category: MSI (Intel). Subcategory: Motherboard. Price: 24,500৳24,800৳.

Product: MSI MAG B760M MORTAR WIFI II DDR5 mATX Motherboard. Category: MSI (Intel). Subcategory: Motherboard. Price: 25,800৳26,200৳.
",258,103612,103870
456,recursive,"
Product: MSI MAG B760 TOMAHAWK WIFI DDR5 ATX Motherboard. Category: MSI (Intel). Subcategory: Motherboard. Price: 26,300৳.

Product: ASUS PRIME H510M-F R3.0 LGA1200 Micro-ATX Motherboard. Category: ASUS (Intel). Subcategory: Motherboard. Price: 9,700৳10,200৳.
",261,103870,104131
457,recursive,"
Product: ASUS H110M-K Motherboard. Category: ASUS (Intel). Subcategory: Motherboard. Price: 10,300৳.

Product: Asus PRIME H610M-CS D4 mATX Motherboard. Category: ASUS (Intel). Subcategory: Motherboard. Price: 10,300৳10,400৳.
",226,104131,104357
458,recursive,"
Product: ASUS PRIME H610M-F D4 R2.0 DDR4 LGA1700 mATX Motherboard. Category: ASUS (Intel). Subcategory: Motherboard. Price: 10,000৳10,500৳.

Product: ASUS PRIME H610M-R DDR5 LGA1700 mATX Motherboard. Category: ASUS (Intel). Subcategory: Motherboard. Price: 11,100৳11,450৳.
",274,104357,104631
459,recursive,"
Product: Asus PRIME H610M-CS DDR5 mATX Motherboard. Category: ASUS (Intel). Subcategory: Motherboard. Price: 11,350৳11,700৳.

Product: Asus PRIME N100I-D D4 Mini-ITX Motherboard. Category: ASUS (Intel). Subcategory: Motherboard. Price: 12,800৳12,900৳.
",253,104631,104884
460,recursive,"
Product: Asus PRIME B760M-F mATX Motherboard. Category: ASUS (Intel). Subcategory: Motherboard. Price: 14,400৳15,000৳.

Product: Asus PRIME B760M-K D4 mATX Motherboard. Category: ASUS (Intel). Subcategory: Motherboard. Price: 14,200৳15,200৳.
",243,104884,105127
461,recursive,"
Product: ASUS EX-B760M-V5 D4 mATX Motherboard. Category: ASUS (Intel). Subcategory: Motherboard. Price: 16,000৳16,300৳.

Product: ASUS Pro B660M-C D4-CSM mATX Motherboard. Category: ASUS (Intel). Subcategory: Motherboard. Price: 16,200৳16,900৳.
",246,105127,105373
462,recursive,"
Product: ASUS PRO B760M-C-CSM Micro-ATX Motherboard. Category: ASUS (Intel). Subcategory: Motherboard. Price: 16,900৳17,000৳.

Product: ASUS PRIME H610I-PLUS D4 Mini ITX Motherboard. Category: ASUS (Intel). Subcategory: Motherboard. Price: 16,800৳17,000৳.
",257,105373,105630
463,recursive,"
Product: Asus PRIME B760M-K mATX Motherboard. Category: ASUS (Intel). Subcategory: Motherboard. Price: 16,800৳17,200৳.

Product: ASUS PRIME H610I-PLUS DDR5 Mini ITX Motherboard. Category: ASUS (Intel). Subcategory: Motherboard. Price: 17,500৳.
",245,105630,105875
464,recursive,"
Product: ASUS B760M-AYW WIFI D4 mATX Motherboard. Category: ASUS (Intel). Subcategory: Motherboard. Price: 18,900৳.

Product: ASUS B760M-AYW WIFI mATX Motherboard. Category: ASUS (Intel). Subcategory: Motherboard. Price: 19,000৳.
",231,105875,106106
465,recursive,"
Product: Asus PRIME B760M-A mATX Motherboard. Category: ASUS (Intel). Subcategory: Motherboard. Price: 20,500৳.

Product: Asus PRIME A520M-A II AM4 micro ATX Motherboard. Category: ASUS (AMD). Subcategory: Motherboard. Price: 11,200৳11,300৳.
",243,106106,106349
466,recursive,"
Product: Asus PRIME A620M-K AM5 mATX Motherboard. Category: ASUS (AMD). Subcategory: Motherboard. Price: 11,700৳.

Product: Asus TUF GAMING A520M-PLUS II AMD AM4 microATX Motherboard. Category: ASUS (AMD). Subcategory: Motherboard. Price: 12,200৳12,300৳.
",256,106349,106605
467,recursive,"
Product: Asus PRIME A620M-K-CSM AM5 mATX Motherboard. Category: ASUS (AMD). Subcategory: Motherboard. Price: 12,900৳13,000৳.

Product: Asus PRIME B650M-F AM5 mATX Motherboard. Category: ASUS (AMD). Subcategory: Motherboard. Price: 14,200৳.
",241,106605,106846
468,recursive,"
Product: Asus EX-B650M-V7 AM5 micro-ATX Motherboard. Category: ASUS (AMD). Subcategory: Motherboard. Price: 16,300৳16,500৳.

Product: Asus PRIME B650M-A II AM5 mATX Motherboard. Category: ASUS (AMD). Subcategory: Motherboard. Price: 16,800৳17,200৳.
",250,106846,107096
469,recursive,"
Product: Asus TUF GAMING B550M Plus WIFI II AMD AM4 microATX Motherboard. Category: ASUS (AMD). Subcategory: Motherboard. Price: 19,500৳.

Product: ASUS TUF GAMING A620M-PLUS AMD AM5 Micro-ATX Motherboard. Category: ASUS (AMD). Subcategory: Motherboard. Price: 19,206৳19,800৳.
",278,107096,107374
470,recursive,"
Product: ASUS TUF GAMING A620M-PLUS WIFI AMD AM5 Micro-ATX Motherboard. Category: ASUS (AMD). Subcategory: Motherboard. Price: 19,300৳19,800৳.

Product: ASUS B650M-AYW WIFI AMD AM5 DDR5 Micro-ATX Motherboard. Category: ASUS (AMD). Subcategory: Motherboard. Price: 19,400৳20,200৳.
",281,107374,107655
471,recursive,"
Product: Asus B850M AYW GAMING WIFI AM5 m-ATX Motherboard. Category: ASUS (AMD). Subcategory: Motherboard. Price: 26,200৳26,400৳.

Product: Asus TUF GAMING B650M-E AMD AM5 micro-ATX Motherboard. Category: ASUS (AMD). Subcategory: Motherboard. Price: 27,500৳.
",260,107655,107915
472,recursive,"
Product: Asus TUF GAMING B650-E WIFI DDR5 AM5 ATX Motherboard. Category: ASUS (AMD). Subcategory: Motherboard. Price: 27,500৳.

Product: Asus PRIME B840M-A WIFI-CSM AM5 mATX Motherboard. Category: ASUS (AMD). Subcategory: Motherboard. Price: 29,500৳.
",252,107915,108167
473,recursive,"
Product: Asus TUF GAMING B850-E WIFI AM5 ATX Motherboard. Category: ASUS (AMD). Subcategory: Motherboard. Price: 34,100৳34,500৳.

Product: Asus B850 MAX GAMING WIFI W AM5 ATX Motherboard. Category: ASUS (AMD). Subcategory: Motherboard. Price: 34,200৳34,500৳.
",260,108167,108427
474,recursive,"
Product: Asus ROG STRIX B850-G GAMING WIFI mATX Motherboard. Category: ASUS (AMD). Subcategory: Motherboard. Price: 38,800৳39,000৳.

Product: GIGABYTE H510M H Intel 10th and 11th Gen Micro ATX Motherboard. Category: GIGABYTE (Intel). Subcategory: Motherboard. Price: 9,500৳10,000৳.
",283,108427,108710
475,recursive,"
Product: GIGABYTE H610M H V3 DDR4 Micro ATX Motherboard. Category: GIGABYTE (Intel). Subcategory: Motherboard. Price: 9,900৳10,600৳.

Product: GIGABYTE H610M K DDR4 Micro ATX Motherboard. Category: GIGABYTE (Intel). Subcategory: Motherboard. Price: 9,999৳10,700৳.
",265,108710,108975
476,recursive,"
Product: GIGABYTE H610M K DDR5 Micro ATX Motherboard. Category: GIGABYTE (Intel). Subcategory: Motherboard. Price: 10,200৳11,000৳.

Product: GIGABYTE H610M H DDR5 mATX Motherboard. Category: GIGABYTE (Intel). Subcategory: Motherboard. Price: 10,600৳11,200৳.
",259,108975,109234
477,recursive,"
Product: GIGABYTE H610M S2H DDR5 mATX Motherboard. Category: GIGABYTE (Intel). Subcategory: Motherboard. Price: 11,300৳12,500৳.

Product: GIGABYTE B760M H DDR4 mATX Motherboard. Category: GIGABYTE (Intel). Subcategory: Motherboard. Price: 13,700৳14,200৳.
",256,109234,109490
478,recursive,"
Product: GIGABYTE B760M D2H DDR4 mATX Motherboard. Category: GIGABYTE (Intel). Subcategory: Motherboard. Price: 14,500৳15,500৳.

Product: GIGABYTE B760M D3HP DDR5 Micro ATX Motherboard. Category: GIGABYTE (Intel). Subcategory: Motherboard. Price: 16,500৳16,900৳.
",264,109490,109754
479,recursive,"
Product: GIGABYTE B760M D3HP DDR4 Micro ATX Motherboard. Category: GIGABYTE (Intel). Subcategory: Motherboard. Price: 16,300৳17,000৳.

Product: GIGABYTE B760M DS3H DDR4 mATX Motherboard. Category: GIGABYTE (Intel). Subcategory: Motherboard. Price: 16,600৳17,200৳.
",265,109754,110019
480,recursive,"
Product: GIGABYTE B760 DS3H ATX Motherboard. Category: GIGABYTE (Intel). Subcategory: Motherboard. Price: 18,200৳20,000৳.

Product: GIGABYTE B760M GAMING PLUS WIFI DDR4 Micro ATX Motherboard. Category: GIGABYTE (Intel). Subcategory: Motherboard. Price: 20,000৳20,200৳.
",270,110019,110289
481,recursive,"
Product: GIGABYTE B760M GAMING X DDR4 mATX Motherboard. Category: GIGABYTE (Intel). Subcategory: Motherboard. Price: 19,800৳20,500৳.

Product: Gigabyte A520M DS3H V2 Micro-ATX DDR4 AMD AM4 Motherboard. Category: GIGABYTE (AMD). Subcategory: Motherboard. Price: 9,200৳10,000৳.
",277,110289,110566
482,recursive,"
Product: GIGABYTE A520M DS3H AC Ultra Durable AM4 Micro-ATX Motherboard. Category: GIGABYTE (AMD). Subcategory: Motherboard. Price: 10,010৳11,000৳.

Product: Gigabyte B450M DS3H V2 AMD AM4 Micro ATX Motherboard. Category: GIGABYTE (AMD). Subcategory: Motherboard. Price: 9,680৳11,000৳.
",287,110566,110853
483,recursive,"
Product: GIGABYTE A620M H AM5 Micro-ATX Motherboard. Category: GIGABYTE (AMD). Subcategory: Motherboard. Price: 10,208৳11,600৳.

Product: GIGABYTE B450M DS3H WIFI AM4 AMD Micro ATX Motherboard. Category: GIGABYTE (AMD). Subcategory: Motherboard. Price: 11,000৳12,200৳.
",270,110853,111123
484,recursive,"
Product: GIGABYTE B650M H AM5 Micro-ATX Motherboard. Category: GIGABYTE (AMD). Subcategory: Motherboard. Price: 12,834৳13,800৳.

Product: GIGABYTE B650M S2H AM5 Micro-ATX Motherboard. Category: GIGABYTE (AMD). Subcategory: Motherboard. Price: 13,299৳14,300৳.
",260,111123,111383
485,recursive,"
Product: GIGABYTE B650M K AMD AM5 Micro-ATX Motherboard. Category: GIGABYTE (AMD). Subcategory: Motherboard. Price: 14,065৳14,500৳.

Product: GIGABYTE B650M GAMING WIFI mATX AM5 Motherboard. Category: GIGABYTE (AMD). Subcategory: Motherboard. Price: 16,500৳17,000৳.
",267,111383,111650
486,recursive,"
Product: GIGABYTE B650M D3HP DDR5 AM5 Motherboard. Category: GIGABYTE (AMD). Subcategory: Motherboard. Price: 17,500৳18,500৳.

Product: GIGABYTE B650M GAMING PLUS WIFI DDR5 AM5 Motherboard. Category: GIGABYTE (AMD). Subcategory: Motherboard. Price: 20,500৳21,500৳.
",266,111650,111916
487,recursive,"
Product: GIGABYTE B850M D3HP AMD AM5 DDR5 Micro ATX Motherboard. Category: GIGABYTE (AMD). Subcategory: Motherboard. Price: 21,000৳21,500৳.

Product: GIGABYTE B650M D3HP AX DDR5 AM5 Motherboard. Category: GIGABYTE (AMD). Subcategory: Motherboard. Price: 18,500৳23,800৳.
",271,111916,112187
488,recursive,"
Product: GIGABYTE B650 UD AC AM5 ATX Motherboard. Category: GIGABYTE (AMD). Subcategory: Motherboard. Price: 23,999৳25,500৳.

Product: GIGABYTE B650M GAMING X AX DDR5 AM5 Motherboard. Category: GIGABYTE (AMD). Subcategory: Motherboard. Price: 25,000৳26,000৳.
",260,112187,112447
489,recursive,"
Product: GIGABYTE B650 EAGLE AX DDR5 AM5 Motherboard. Category: GIGABYTE (AMD). Subcategory: Motherboard. Price: 25,500৳26,000৳.

Product: GIGABYTE B850M EAGLE WIFI6E AMD AM5 DDR5 Micro ATX Motherboard. Category: GIGABYTE (AMD). Subcategory: Motherboard. Price: 26,000৳27,500৳.
",279,112447,112726
490,recursive,"
Product: GIGABYTE B850M GAMING X WIFI6E AMD AM5 DDR5 Micro ATX Motherboard. Category: GIGABYTE (AMD). Subcategory: Motherboard. Price: 29,700৳30,500৳.

Product: Colorful BATTLE-AX H610M-E WIFI V20 mATX Motherboard. Category: Colorful (Intel). Subcategory: Motherboard. Price: 10,200৳.
",286,112726,113012
491,recursive,"
Product: Colorful BATTLE-AX B760M-T PRO V20 mATX Motherboard. Category: Colorful (Intel). Subcategory: Motherboard. Price: 11,300৳11,500৳.

Product: Colorful BATTLE-AX B760M-PLUS V20 M-ATX Motherboard. Category: Colorful (Intel). Subcategory: Motherboard. Price: 17,000৳.
",273,113012,113285
492,recursive,"
Product: Colorful BATTLE-AX B760M-PLUS D5 V20 mATX Motherboard. Category: Colorful (Intel). Subcategory: Motherboard. Price: 17,500৳18,000৳.

Product: Colorful CVN B760I FROZEN WIFI V20 ITX Motherboard. Category: Colorful (Intel). Subcategory: Motherboard. Price: 19,500৳20,000৳.
",281,113285,113566
493,recursive,"
Product: Colorful CVN B760M FROZEN WIFI V20 mATX Motherboard. Category: Colorful (Intel). Subcategory: Motherboard. Price: 21,500৳22,000৳.

Product: Colorful BATTLE-AX B550M-T PRO V14 AM4 mATX Motherboard. Category: Colorful (AMD). Subcategory: Motherboard. Price: Out Of Stock.
",280,113566,113846
494,recursive,"
Product: Colorful CVN B550M GAMING FROZEN V15 AM4 mATX Motherboard. Category: Colorful (AMD). Subcategory: Motherboard. Price: Out Of Stock.

Product: Colorful GeForce GT710-2GD3-V 2GB Graphics Card. Category: Graphics Card. Subcategory: Component. Price: 4,900৳5,200৳.
",271,113846,114117
495,recursive,"
Product: PELADN GeForce KaiTian GT 730 4GB GDDR3 Graphics Card. Category: Graphics Card. Subcategory: Component. Price: 5,200৳.

Product: Gigabyte GT 710 2GB DDR3 Graphics Card. Category: Graphics Card. Subcategory: Component. Price: 5,800৳6,200৳.
",249,114117,114366
496,recursive,"
Product: OCPC GeForce GT 730 4GB DDR3 Graphics Card. Category: Graphics Card. Subcategory: Component. Price: 6,200৳6,250৳.

Product: ASUS GeForce GT 710 2GB GDDR5 EVO Low-profile Graphics Card. Category: Graphics Card. Subcategory: Component. Price: 6,800৳.
",259,114366,114625
497,recursive,"
Product: MSI GeForce GT 730 2GB DDR3 Graphics Card. Category: Graphics Card. Subcategory: Component. Price: 6,800৳6,900৳.

Product: Asus Geforce Gt 730 2GB GDDR5 Graphics Card. Category: Graphics Card. Subcategory: Component. Price: 9,100৳9,300৳.
",248,114625,114873
498,recursive,"
Product: Gigabyte GT 1030 Low Profile D4 2GB DDR4 Graphics Card. Category: Graphics Card. Subcategory: Component. Price: 9,300৳.

Product: Colorful GeForce GT1030 V3 2GB Graphics Card. Category: Graphics Card. Subcategory: Component. Price: 9,300৳9,700৳.
",256,114873,115129
499,recursive,"
Product: OCPC Radeon RX 550 4GB SE GDDR5 Graphics Card. Category: Graphics Card. Subcategory: Component. Price: 9,750৳.

Product: PELADN RX 550 4G Gaming GDDR5 128 Bit Black Graphics Card. Category: Graphics Card. Subcategory: Component. Price: 9,900৳.
",254,115129,115383
500,recursive,"
Product: ASUS GeForce GT 1030 2GB GDDR5 low Profile Graphics Card. Category: Graphics Card. Subcategory: Component. Price: 10,800৳.

Product: PowerColor Red Dragon Radeon RX 550 4GB GDDR5 Graphics Card. Category: Graphics Card. Subcategory: Component. Price: 11,000৳11,500৳.
",276,115383,115659
501,recursive,"
Product: PELADN RX 580 8G 256Bit Dual Fans Gaming Graphics Card. Category: Graphics Card. Subcategory: Component. Price: 11,500৳12,000৳.

Product: OCPC Radeon RX 580 8GB XE GDDR5 Graphics Card. Category: Graphics Card. Subcategory: Component. Price: 13,500৳13,700৳.
",267,115659,115926
502,recursive,"
Product: GIGABYTE Intel Arc A310 WINDFORCE 4G GDDR6 Graphics Card. Category: Graphics Card. Subcategory: Component. Price: 14,300৳15,000৳.

Product: Asus Geforce GT 730 2GB GDDR5 Graphics Card with 4 HDMI Ports. Category: Graphics Card. Subcategory: Component. Price: 15,400৳.
",278,115926,116204
503,recursive,"
Product: GUNNIR Intel Arc A380 Index 6G GDDR6 Graphics Card. Category: Graphics Card. Subcategory: Component. Price: 15,000৳15,800৳.

Product: GUNNIR Intel Arc A380 Photon 6G OC GDDR6 Graphics Card. Category: Graphics Card. Subcategory: Component. Price: 16,000৳17,000৳.
",272,116204,116476
504,recursive,"
Product: GUNNIR Intel Arc A380 Photon 6G OC W GDDR6 Graphics Card. Category: Graphics Card. Subcategory: Component. Price: 16,500৳17,000৳.

Product: ASUS Dual Radeon RX 6500 XT V2 OC Edition 4GB GDDR6 Graphics Card. Category: ASUS. Subcategory: Graphics Card. Price: 20,500৳20,900৳.
",284,116476,116760
505,recursive,"
Product: ASUS Dual GeForce RTX 3050 6GB GDDR6 Graphics Card. Category: ASUS. Subcategory: Graphics Card. Price: 28,300৳30,000৳.

Product: ASUS Dual GeForce RTX 5060 8GB GDDR7 Graphics Card. Category: ASUS. Subcategory: Graphics Card. Price: 50,300৳50,500৳.
",258,116760,117018
506,recursive,"
Product: ASUS Dual GeForce RTX 5060 8GB GDDR7 OC Edition Graphics Card. Category: ASUS. Subcategory: Graphics Card. Price: 50,300৳52,000৳.

Product: ASUS Dual GeForce RTX 4060 Ti EVO OC Edition 8GB GDDR6 Graphics Card. Category: ASUS. Subcategory: Graphics Card. Price: 57,900৳63,500৳.
",287,117018,117305
507,recursive,"
Product: ASUS TUF Gaming GeForce RTX 5070 12GB GDDR7 OC Edition Graphics Card. Category: ASUS. Subcategory: Graphics Card. Price: 118,000৳.

Product: ASUS PRIME GeForce RTX 5070 Ti 16GB GDDR7 OC Edition Graphics Card. Category: ASUS. Subcategory: Graphics Card. Price: 141,000৳.
",280,117305,117585
508,recursive,"
Product: ASUS TUF Gaming GeForce RTX 4070 Ti SUPER BTF White OC Edition 16GB GDDR6X Graphics Card. Category: ASUS. Subcategory: Graphics Card. Price: 157,000৳161,000৳.
",169,117585,117754
509,recursive,"
Product: ASUS TUF Gaming GeForce RTX 5070 Ti 16GB GDDR7 OC Edition Graphics Card. Category: ASUS. Subcategory: Graphics Card. Price: 161,000৳165,000৳.

Product: ASUS ROG Strix GeForce RTX 5070 Ti 16GB GDDR7 OC Edition Graphics Card. Category: ASUS. Subcategory: Graphics Card. Price: 168,000৳.
",295,117754,118049
510,recursive,"
Product: ASUS PRIME GeForce RTX 5070 12GB GDDR7 OC Edition Graphics Card. Category: ASUS. Subcategory: Graphics Card. Price: Up Coming.

Product: ASUS TUF Gaming GeForce RTX 5080 16GB GDDR7 OC Edition Graphics Card. Category: ASUS. Subcategory: Graphics Card. Price: 239,000৳.
",278,118049,118327
511,recursive,"
Product: ASUS ROG Astral GeForce RTX 5080 16GB GDDR7 OC Edition Graphics Card. Category: ASUS. Subcategory: Graphics Card. Price: 239,000৳.

Product: ASUS TUF Gaming GeForce RTX 5090 32GB GDDR7 OC Edition Graphics Card. Category: ASUS. Subcategory: Graphics Card. Price: 453,000৳.
",282,118327,118609
512,recursive,"
Product: ASUS ROG Astral GeForce RTX 5090 32GB GDDR7 OC Edition Graphics Card. Category: ASUS. Subcategory: Graphics Card. Price: 496,000৳.

Product: ASUS KO NVIDIA GeForce RTX 3060 Ti OC Edition 8GB GDDR6 Graphics Card. Category: ASUS. Subcategory: Graphics Card. Price: Up Coming.
",284,118609,118893
513,recursive,"
Product: Colorful GeForce RTX 3050 6GB-V GDDR6 Graphics Card. Category: Colorful. Subcategory: Graphics Card. Price: 24,900৳.

Product: Colorful GeForce RTX 3050 NB DUO V2-V 8GB GDDR6 Graphics Card. Category: Colorful. Subcategory: Graphics Card. Price: 28,500৳29,000৳.
",271,118893,119164
514,recursive,"
Product: Colorful iGame GeForce RTX 3050 Ultra W DUO OC V2-V 8GB GDDR6 Graphics Card. Category: Colorful. Subcategory: Graphics Card. Price: 30,000৳30,500৳.

Product: Colorful GeForce RTX 3060 NB DUO 12G V4 L-V GDDR6 Graphics Card. Category: Colorful. Subcategory: Graphics Card. Price: 39,500৳.
",297,119164,119461
515,recursive,"
Product: Colorful iGame GeForce RTX 5050 Ultra W DUO OC 8GB-V GDDR6 Graphics Card. Category: Colorful. Subcategory: Graphics Card. Price: 39,900৳.

Product: Colorful iGame GeForce RTX 5060 Ultra W DUO OC 8GB-V GDDR7 Graphics Card. Category: Colorful. Subcategory: Graphics Card. Price: 49,500৳.
",296,119461,119757
516,recursive,"
Product: Colorful iGame GeForce RTX 5060 Ultra W OC 8GB-V GDDR7 Graphics Card. Category: Colorful. Subcategory: Graphics Card. Price: 51,500৳52,500৳.

Product: Colorful GeForce RTX 5060 Ti Battle AX DUO 8GB-V GDDR7 Graphics Card. Category: Colorful. Subcategory: Graphics Card. Price: 59,900৳.
",295,119757,120052
517,recursive,"
Product: Colorful iGame GeForce RTX 5060 Ti Ultra W DUO OC 8GB-V GDDR7 Graphics Card. Category: Colorful. Subcategory: Graphics Card. Price: 59,800৳62,900৳.
",158,120052,120210
518,recursive,"
Product: Colorful iGame GeForce RTX 5060 Ti Ultra W OC 8GB-V GDDR7 Graphics Card. Category: Colorful. Subcategory: Graphics Card. Price: 62,900৳65,000৳.
",154,120210,120364
519,recursive,"
Product: Colorful iGame GeForce RTX 5060 Ti Ultra W DUO OC 16GB-V GDDR7 Graphics Card. Category: Colorful. Subcategory: Graphics Card. Price: 69,900৳.

Product: Colorful GeForce RTX 5070 NB EX 12GB V2-V GDDR7 Graphics Card. Category: Colorful. Subcategory: Graphics Card. Price: 85,000৳87,000৳.
",296,120364,120660
520,recursive,"
Product: Colorful iGame GeForce RTX 5070 Ultra W OC 12GB-V GDDR7 Graphics Card. Category: Colorful. Subcategory: Graphics Card. Price: 91,900৳94,000৳.
",152,120660,120812
521,recursive,"
Product: Colorful iGame GeForce RTX 5070 Vulcan OC 12GB-V GDDR7 Graphics Card. Category: Colorful. Subcategory: Graphics Card. Price: 109,900৳118,000৳.

Product: Colorful GeForce RTX 5070 Ti Battle AX 16GB-V GDDR7 Graphics Card. Category: Colorful. Subcategory: Graphics Card. Price: 124,000৳.
",295,120812,121107
522,recursive,"
Product: Colorful iGame GeForce RTX 5070 Ti Ultra W OC 16GB-V GDDR7 Graphics Card. Category: Colorful. Subcategory: Graphics Card. Price: 129,900৳133,000৳.
",157,121107,121264
523,recursive,"
Product: Colorful iGame GeForce RTX 5080 Ultra W OC 16GB-V GDDR7 Graphics Card. Category: Colorful. Subcategory: Graphics Card. Price: 182,500৳193,000৳.
",154,121264,121418
524,recursive,"
Product: Colorful iGame GeForce RTX 5080 Vulcan OC 16GB-V GDDR7 Graphics Card. Category: Colorful. Subcategory: Graphics Card. Price: 199,900৳225,000৳.

Product: Intel Arc A750 8GB GDDR6 Graphics Card. Category: INTEL. Subcategory: Graphics Card. Price: Out Of Stock.
",269,121418,121687
525,recursive,"
Product: Intel Arc A750 Limited Edition 8GB GDDR6 Graphics Card. Category: INTEL. Subcategory: Graphics Card. Price: Out Of Stock.

Product: Sapphire Pulse AMD Radeon RX 9060 XT Gaming OC 8GB GDDR6 Graphics Card. Category: Sapphire. Subcategory: Graphics Card. Price: 47,500৳.
",278,121687,121965
526,recursive,"
Product: Sapphire Pulse AMD Radeon RX 9060 XT GAMING OC 16GB GDDR6 Graphics Card. Category: Sapphire. Subcategory: Graphics Card. Price: 55,400৳.

Product: Sapphire PULSE AMD Radeon RX 9070 Gaming 16GB GDDR6 Graphics Card. Category: Sapphire. Subcategory: Graphics Card. Price: 94,900৳.
",288,121965,122253
527,recursive,"
Product: Sapphire PURE AMD Radeon RX 9070 Gaming OC 16GB GDDR6 Graphics Card. Category: Sapphire. Subcategory: Graphics Card. Price: 98,000৳98,900৳.

Product: Sapphire Pulse AMD Radeon RX 9070 XT Gaming 16GB GDDR6 Graphics Card. Category: Sapphire. Subcategory: Graphics Card. Price: 106,900৳.
",295,122253,122548
528,recursive,"
Product: Sapphire NITRO+ AMD Radeon RX 9070 Gaming OC 16GB GDDR6 Graphics Card. Category: Sapphire. Subcategory: Graphics Card. Price: 101,900৳.

Product: Sapphire NITRO+ AMD Radeon RX 9070 XT 16GB Gaming OC GDDR6 Graphics Card. Category: Sapphire. Subcategory: Graphics Card. Price: 110,900৳.
",295,122548,122843
529,recursive,"
Product: Sapphire NITRO+ AMD Radeon RX 7900 XTX Vapor-X 24GB GDDR6 Gaming Graphics Card. Category: Sapphire. Subcategory: Graphics Card. Price: 155,900৳.

Product: Sapphire Pulse Radeon RX 550 4GB GDDR5 Graphics Card. Category: Sapphire. Subcategory: Graphics Card. Price: Up Coming.
",285,122843,123128
530,recursive,"
Product: Sapphire Pulse Radeon RX 570 4GB GDDR5 HDMI DP Graphics card. Category: Sapphire. Subcategory: Graphics Card. Price: Up Coming.

Product: Sapphire Pulse Radeon RX 570 8GB GDDR5 Graphics Card. Category: Sapphire. Subcategory: Graphics Card. Price: Up Coming.
",268,123128,123396
531,recursive,"
Product: Sapphire Pulse Radeon RX 5600 XT 6GB GDDR6 Graphics Card. Category: Sapphire. Subcategory: Graphics Card. Price: Up Coming.

Product: Sapphire Pulse Radeon RX 5600 XT BE 6GB Graphics Card. Category: Sapphire. Subcategory: Graphics Card. Price: Up Coming.
",265,123396,123661
532,recursive,"
Product: Sapphire Radeon RX 5700 8GB GDDR6 Graphics Card. Category: Sapphire. Subcategory: Graphics Card. Price: Up Coming.

Product: Sapphire NITRO+ AMD Radeon RX 6800 XT 16GB GDDR6 Graphics Card. Category: Sapphire. Subcategory: Graphics Card. Price: Up Coming.
",265,123661,123926
533,recursive,"
Product: Sapphire Pulse AMD Radeon RX 6500 XT Gaming OC 4GB GDDR6 Graphics Card. Category: Sapphire. Subcategory: Graphics Card. Price: Out Of Stock.

Product: Sapphire PULSE AMD Radeon RX 6500 XT 8GB GDDR6 Graphics Card. Category: Sapphire. Subcategory: Graphics Card. Price: Out Of Stock.
",292,123926,124218
534,recursive,"
Product: Sapphire PULSE AMD Radeon RX 6500XT OC 8GB GDDR6 Graphics Card. Category: Sapphire. Subcategory: Graphics Card. Price: Out Of Stock.

Product: Sapphire Pulse AMD Radeon RX 6600 8GB GDDR6 Graphics Card. Category: Sapphire. Subcategory: Graphics Card. Price: Out Of Stock.
",281,124218,124499
535,recursive,"
Product: Sapphire PULSE AMD Radeon RX 7600 Gaming OC 8GB GDDR6 Graphics Card. Category: Sapphire. Subcategory: Graphics Card. Price: Out Of Stock.

Product: Zotac GAMING GeForce RTX 3050 Twin Edge OC 6GB GDDR6 Graphics Card. Category: ZOTAC. Subcategory: Graphics Card. Price: 25,900৳.
",287,124499,124786
536,recursive,"
Product: ZOTAC GAMING GEFORCE RTX 3050 ECO 8GB GDDR6 Graphics Card. Category: ZOTAC. Subcategory: Graphics Card. Price: 29,000৳31,500৳.

Product: ZOTAC GAMING GeForce RTX 5050 SOLO 8GB GDDR6 Graphics Card. Category: ZOTAC. Subcategory: Graphics Card. Price: 37,900৳.
",268,124786,125054
537,recursive,"
Product: ZOTAC GAMING GeForce RTX 5050 Twin Edge 8GB GDDR6 Graphics Card. Category: ZOTAC. Subcategory: Graphics Card. Price: 38,900৳.

Product: ZOTAC GAMING GeForce RTX 3060 Twin Edge 12GB GDDR6 Graphics Card. Category: ZOTAC. Subcategory: Graphics Card. Price: 39,000৳40,000৳.
",280,125054,125334
538,recursive,"
Product: ZOTAC GAMING GeForce RTX 5050 Twin Edge OC 8GB GDDR6 Graphics Card. Category: ZOTAC. Subcategory: Graphics Card. Price: 40,900৳.

Product: ZOTAC GAMING GeForce RTX 5060 SOLO 8GB GDDR7 Graphics Card. Category: ZOTAC. Subcategory: Graphics Card. Price: 43,400৳43,900৳.
",277,125334,125611
539,recursive,"
Product: ZOTAC GeForce RTX 5060 AMP 8GB GDDR7 Graphics Card. Category: ZOTAC. Subcategory: Graphics Card. Price: 48,500৳.

Product: ZOTAC GAMING GeForce RTX 5060 Twin Edge OC White Edition 8GB GDDR7 Graphics Card. Category: ZOTAC. Subcategory: Graphics Card. Price: 48,900৳.
",276,125611,125887
540,recursive,"
Product: ZOTAC GAMING GeForce RTX 5060 Ti AMP 16GB GDDR7 Graphics Card. Category: ZOTAC. Subcategory: Graphics Card. Price: 69,900৳.

Product: ZOTAC GAMING GeForce RTX 5070 SOLID 12GB GDDR7 Graphics Card. Category: ZOTAC. Subcategory: Graphics Card. Price: 88,000৳88,900৳.
",274,125887,126161
541,recursive,"
Product: ZOTAC GAMING GeForce RTX 5070 AMP White Edition 12GB GDDR7 Graphics Card. Category: ZOTAC. Subcategory: Graphics Card. Price: 95,900৳96,900৳.
",152,126161,126313
542,recursive,"
Product: ZOTAC GAMING GeForce RTX 5070 Ti SOLID SFF OC 16GB GDDR7 Graphics Card. Category: ZOTAC. Subcategory: Graphics Card. Price: 128,000৳128,900৳.
",152,126313,126465
543,recursive,"
Product: ZOTAC GAMING GeForce RTX 5070 Ti SOLID CORE OC White Edition 16GB GDDR7 Graphics Card. Category: ZOTAC. Subcategory: Graphics Card. Price: 135,900৳.
",159,126465,126624
544,recursive,"
Product: ZOTAC GAMING GeForce RTX 5070 Ti AMP Extreme INFINITY 16GB GDDR7 Graphics Card. Category: ZOTAC. Subcategory: Graphics Card. Price: 142,000৳142,900৳.
",160,126624,126784
545,recursive,"
Product: ZOTAC GAMING GeForce RTX 5070 Ti AMP Extreme INFINITY ULTRA 16GB GDDR7 Graphics Card. Category: ZOTAC. Subcategory: Graphics Card. Price: 148,000৳148,900৳.
",166,126784,126950
546,recursive,"
Product: ZOTAC GAMING GeForce RTX 5080 SOLID CORE OC 16GB GDDR7 Graphics Card. Category: ZOTAC. Subcategory: Graphics Card. Price: 169,000৳169,900৳.

Product: ZOTAC GAMING GeForce RTX 5090 SOLID OC 32GB GDDR7 Graphics Card. Category: ZOTAC. Subcategory: Graphics Card. Price: 347,900৳349,900৳.
",295,126950,127245
547,recursive,"
Product: ZOTAC GAMING GeForce RTX 5090 SOLID OC White Edition 32GB GDDR7 Graphics Card. Category: ZOTAC. Subcategory: Graphics Card. Price: 359,000৳359,900৳.
",159,127245,127404
548,recursive,"
Product: ZOTAC GAMING GeForce RTX 5090 AMP Extreme INFINITY 32GB GDDR7 Graphics Card. Category: ZOTAC. Subcategory: Graphics Card. Price: 375,000৳375,900৳.

Product: GUNNIR Intel Arc A580 Index 8G GDDR6 Graphics Card. Category: GUNNIR. Subcategory: Graphics Card. Price: 23,500৳24,500৳.
",288,127404,127692
549,recursive,"
Product: GUNNIR Intel Arc A750 Index 8GB GDDR6 Graphics Card. Category: GUNNIR. Subcategory: Graphics Card. Price: 26,500৳.

Product: GUNNIR Intel Arc A750 Photon 8G OC W GDDR6 Graphics Card. Category: GUNNIR. Subcategory: Graphics Card. Price: 29,000৳.
",255,127692,127947
550,recursive,"
Product: GUNNIR Intel Arc B570 Index 10G GDDR6 Graphics Card. Category: GUNNIR. Subcategory: Graphics Card. Price: 32,300৳32,400৳.

Product: GUNNIR Intel Arc B570 Tri 10G OC GDDR6 Graphics Card. Category: GUNNIR. Subcategory: Graphics Card. Price: 32,300৳32,999৳.
",265,127947,128212
551,recursive,"
Product: GUNNIR Intel Arc A770 Photon 16G OC W GDDR6 Graphics Card. Category: GUNNIR. Subcategory: Graphics Card. Price: 35,000৳36,500৳.

Product: GUNNIR Intel Arc A770 Photon 16G OC X ELDEN RING Shadow Of The Erdtree Graphics Card. Category: GUNNIR. Subcategory: Graphics Card. Price: 36,500৳.
",296,128212,128508
552,recursive,"
Product: GUNNIR Intel Arc B580 Index 12G GDDR6 Graphics Card. Category: GUNNIR. Subcategory: Graphics Card. Price: 36,500৳37,500৳.

Product: GUNNIR Intel Arc A770 Photon 16G OC GDDR6 Graphics Card (Black). Category: GUNNIR. Subcategory: Graphics Card. Price: 34,500৳38,500৳.
",276,128508,128784
553,recursive,"
Product: GUNNIR Intel Arc B580 Photon 12G OC GDDR6 Graphics Card. Category: GUNNIR. Subcategory: Graphics Card. Price: 39,000৳41,000৳.

Product: GUNNIR Intel Arc B580 Photon 12G OC W GDDR6 Graphics Card. Category: GUNNIR. Subcategory: Graphics Card. Price: 39,500৳41,000৳.
",274,128784,129058
554,recursive,"
Product: GUNNIR Intel Arc A770 Flux 16G OC GDDR6 Graphics Card. Category: GUNNIR. Subcategory: Graphics Card. Price: Up Coming.

Product: GUNNIR Intel Arc A750 Photon 8G OC GDDR6 Graphics Card. Category: GUNNIR. Subcategory: Graphics Card. Price: Out Of Stock.
",262,129058,129320
555,recursive,"
Product: GUNNIR Intel Arc A750 Photon 8G OC WX GDDR6 Asian Games Limited Edition Graphics Card. Category: GUNNIR. Subcategory: Graphics Card. Price: Out Of Stock.
",164,129320,129484
556,recursive,"
Product: GUNNIR Intel Arc A750 Photon 8G OC X ELDEN RING Shadow Of The Erdtree Graphics Card. Category: GUNNIR. Subcategory: Graphics Card. Price: Out Of Stock.
",162,129484,129646
557,recursive,"
Product: GUNNIR Intel Arc A770 Photon 16G OC W GDDR6 Asian Games Limited Edition Graphics Card. Category: GUNNIR. Subcategory: Graphics Card. Price: Out Of Stock.

Product: GUNNIR Intel Arc A770 Photon 8G OC GDDR6 Graphics Card. Category: GUNNIR. Subcategory: Graphics Card. Price: Out Of Stock.
",297,129646,129943
558,recursive,"
Product: PELADN RX 5500 8G GDDR6 Dual Fan Gaming Graphics Card. Category: PELADN. Subcategory: Graphics Card. Price: 17,900৳.

Product: PELADN RX 5500 XT 8G GDDR6 Dual Fan Black Gaming Graphics Card. Category: PELADN. Subcategory: Graphics Card. Price: 18,500৳.
",263,129943,130206
559,recursive,"
Product: PELADN RX 5500 XT 8G GDDR6 Dual Fan Gaming White Graphics Card. Category: PELADN. Subcategory: Graphics Card. Price: Out Of Stock.

Product: PELADN GTX 1660 Ti 6G GDDR6 Black Dual Fan Gaming Graphics Card. Category: PELADN. Subcategory: Graphics Card. Price: Out Of Stock.
",283,130206,130489
560,recursive,"
Product: PELADN GTX 1660 Ti 6G GDDR6 Dual Fan Gaming Graphics Card. Category: PELADN. Subcategory: Graphics Card. Price: Out Of Stock.

Product: MSI GeForce RTX 3050 VENTUS 2X E 6G OC GDDR6 Graphics Card. Category: MSI. Subcategory: Graphics Card. Price: 26,800৳.
",265,130489,130754
561,recursive,"
Product: MSI GeForce RTX 3050 VENTUS 2X 6G OC GDDR6 Graphics Card. Category: MSI. Subcategory: Graphics Card. Price: 23,500৳23,900৳.

Product: MSI GeForce RTX 3050 VENTUS 2X XS 8GB OC GDDR6 Graphics Card. Category: MSI. Subcategory: Graphics Card. Price: 28,900৳29,300৳.
",272,130754,131026
562,recursive,"
Product: MSI GeForce RTX 5050 8G SHADOW 2X OC 8GB GDDR6 Graphics Card. Category: MSI. Subcategory: Graphics Card. Price: 37,900৳.

Product: MSI GeForce RTX 3060 VENTUS 2X OC 12GB Graphics Card. Category: MSI. Subcategory: Graphics Card. Price: 39,500৳.
",254,131026,131280
563,recursive,"
Product: MSI GeForce RTX 5050 8G VENTUS 2X OC 8GB GDDR6 Graphics Card. Category: MSI. Subcategory: Graphics Card. Price: 39,800৳.

Product: MSI GeForce RTX 4060 VENTUS 2X BLACK 8GB OC GDDR6 Graphics Card. Category: MSI. Subcategory: Graphics Card. Price: 45,500৳46,200৳.
",272,131280,131552
564,recursive,"
Product: MSI GeForce RTX 5060 8G SHADOW 2X OC 8GB GDDR7 Graphics Card. Category: MSI. Subcategory: Graphics Card. Price: 44,500৳48,900৳.

Product: MSI GeForce RTX 5060 8G VENTUS 2X OC 8GB GDDR7 Graphics Card. Category: MSI. Subcategory: Graphics Card. Price: 49,900৳.
",269,131552,131821
565,recursive,"
Product: MSI GeForce RTX 5060 8G VENTUS 2X OC WHITE 8GB GDDR7 Graphics Card. Category: MSI. Subcategory: Graphics Card. Price: 50,900৳.

Product: MSI GeForce RTX 5060 8G INSPIRE 2X OC 8GB GDDR7 Graphics Card. Category: MSI. Subcategory: Graphics Card. Price: 51,900৳.
",269,131821,132090
566,recursive,"
Product: MSI GeForce RTX 5060 8G GAMING OC 8GB GDDR7 Graphics Card. Category: MSI. Subcategory: Graphics Card. Price: 54,900৳.

Product: MSI GeForce RTX 5060 8G GAMING TRIO OC 8GB GDDR7 Graphics Card. Category: MSI. Subcategory: Graphics Card. Price: 56,900৳.
",261,132090,132351
567,recursive,"
Product: MSI GeForce RTX 5060 Ti 8G VENTUS 2X PLUS 8GB GDDR7 Graphics Card. Category: MSI. Subcategory: Graphics Card. Price: 61,900৳.

Product: MSI GeForce RTX 5060 Ti 8G SHADOW 2X OC PLUS 8GB GDDR7 Graphics Card. Category: MSI. Subcategory: Graphics Card. Price: 53,900৳62,900৳.
",282,132351,132633
568,recursive,"
Product: MSI GeForce RTX 5060 Ti 8G VENTUS 3X OC 8GB GDDR7 Graphics Card. Category: MSI. Subcategory: Graphics Card. Price: 63,900৳.

Product: MSI GeForce RTX 5060 Ti 8G VENTUS 2X OC PLUS 8GB GDDR7 Graphics Card. Category: MSI. Subcategory: Graphics Card. Price: 55,500৳64,900৳.
",280,132633,132913
569,recursive,"
Product: MSI GeForce RTX 5060 Ti 8G INSPIRE 2X OC 8GB GDDR7 Graphics Card. Category: MSI. Subcategory: Graphics Card. Price: 66,900৳.

Product: MSI GeForce RTX 5060 Ti 8G GAMING OC 8GB GDDR7 Graphics Card. Category: MSI. Subcategory: Graphics Card. Price: 66,900৳.
",266,132913,133179
570,recursive,"
Product: GIGABYTE Intel Arc A380 WINDFORCE OC 6G GDDR6 Graphics Card. Category: GIGABYTE. Subcategory: Graphics Card. Price: 20,000৳.

Product: GIGABYTE GeForce RTX 5050 GAMING OC 8GB GDDR6 Graphics Card. Category: GIGABYTE. Subcategory: Graphics Card. Price: 44,500৳.
",270,133179,133449
571,recursive,"
Product: GIGABYTE GeForce RTX 5050 OC Low Profile 8GB GDDR6 Graphics Card. Category: GIGABYTE. Subcategory: Graphics Card. Price: 41,000৳.

Product: GIGABYTE GeForce RTX 5050 WINDFORCE OC 8GB GDDR6 Graphics Card. Category: GIGABYTE. Subcategory: Graphics Card. Price: 40,500৳.
",278,133449,133727
572,recursive,"
Product: GIGABYTE Radeon RX 9060 XT GAMING OC 8GB GDDR6 Graphics Card. Category: GIGABYTE. Subcategory: Graphics Card. Price: 57,000৳.

Product: GIGABYTE GeForce RTX 5060 WINDFORCE MAX OC 8GB GDDR7 Graphics Card. Category: GIGABYTE. Subcategory: Graphics Card. Price: 49,500৳.
",278,133727,134005
573,recursive,"
Product: GIGABYTE GeForce RTX 5060 OC Low Profile 8GB GDDR7 Graphics Card. Category: GIGABYTE. Subcategory: Graphics Card. Price: 48,000৳.

Product: GIGABYTE GeForce RTX 5060 Ti EAGLE OC ICE 16GB GDDR7 Graphics Card. Category: GIGABYTE. Subcategory: Graphics Card. Price: 74,500৳.
",282,134005,134287
574,recursive,"
Product: GIGABYTE GeForce RTX 5060 Ti WINDFORCE MAX OC 16GB GDDR7 Graphics Card. Category: GIGABYTE. Subcategory: Graphics Card. Price: 72,000৳.

Product: GIGABYTE GeForce RTX 3050 OC Low Profile 6G GDDR6 Graphics Card. Category: GIGABYTE. Subcategory: Graphics Card. Price: 26,200৳27,000৳.
",292,134287,134579
575,recursive,"
Product: GIGABYTE GeForce RTX 3050 WINDFORCE OC 6GB GDDR6 Graphics Card. Category: GIGABYTE. Subcategory: Graphics Card. Price: 26,500৳27,900৳.

Product: GIGABYTE GeForce RTX 3050 WINDFORCE OC V2 8GB GDDR6 Graphics Card. Category: GIGABYTE. Subcategory: Graphics Card. Price: 29,000৳.
",286,134579,134865
576,recursive,"
Product: GIGABYTE GeForce RTX 3050 WINDFORCE OC 8GB GDDR6 Graphics Card. Category: GIGABYTE. Subcategory: Graphics Card. Price: 29,000৳32,000৳.

Product: GIGABYTE GeForce RTX 3060 WINDFORCE OC 12GB GDDR6 Graphics Card. Category: GIGABYTE. Subcategory: Graphics Card. Price: 38,900৳.
",284,134865,135149
577,recursive,"
Product: GIGABYTE GeForce RTX 5060 WINDFORCE 8G GDDR7 Graphics Card. Category: GIGABYTE. Subcategory: Graphics Card. Price: 47,000৳48,500৳.

Product: GIGABYTE GeForce RTX 5060 WINDFORCE OC 8G GDDR7 Graphics Card. Category: GIGABYTE. Subcategory: Graphics Card. Price: 48,000৳.
",278,135149,135427
578,recursive,"
Product: GIGABYTE GeForce RTX 5060 EAGLE OC 8G GDDR7 Graphics Card. Category: GIGABYTE. Subcategory: Graphics Card. Price: 49,500৳51,500৳.

Product: OCPC GeForce GTX 1660 Ti XE 6GB GDDR6 Graphics Card. Category: OCPC. Subcategory: Graphics Card. Price: 24,999৳25,200৳.
",270,135427,135697
579,recursive,"
Product: OCPC Radeon RX 6600 LE 8GB XE GDDR6 Graphics Card. Category: OCPC. Subcategory: Graphics Card. Price: 27,700৳.

Product: OCPC GeForce RTX 3060 12GB XM GDDR6 Graphics Card. Category: OCPC. Subcategory: Graphics Card. Price: 39,000৳.
",242,135697,135939
580,recursive,"
Product: OCPC RX 550 4GB XE GDDR5 Graphics Card. Category: OCPC. Subcategory: Graphics Card. Price: Out Of Stock.

Product: OCPC Radeon RX 580 8GB GDDR5 Graphics Card. Category: OCPC. Subcategory: Graphics Card. Price: Out Of Stock.
",234,135939,136173
581,recursive,"
Product: OCPC RX 5500 XT 8GB GDDR6 Graphics Card. Category: OCPC. Subcategory: Graphics Card. Price: Out Of Stock.

Product: OCPC GeForce RTX 3060 12GB GDDR6 Graphics Card. Category: OCPC. Subcategory: Graphics Card. Price: Out Of Stock.
",239,136173,136412
582,recursive,"
Product: OCPC GeForce RTX 4060 8GB GDDR6 Graphics Card. Category: OCPC. Subcategory: Graphics Card. Price: Out Of Stock.

Product: Palit GeForce RTX 3050 Dual 8GB GDDR6 Graphics Card. Category: Palit. Subcategory: Graphics Card. Price: Out Of Stock.
",251,136412,136663
583,recursive,"
Product: Palit GeForce RTX 5060 Ti Infinity 3 16GB GDDR7 Graphics Card. Category: Palit. Subcategory: Graphics Card. Price: Out Of Stock.

Product: Deepcool GH-01 A-RGB Graphics Card Holder. Category: VGA Holder. Subcategory: Graphics Card. Price: 1,200৳.
",257,136663,136920
584,recursive,"
Product: Cooler Master Universal VGA Holder for all size Tower Chassis. Category: VGA Holder. Subcategory: Graphics Card. Price: Out Of Stock.

Product: Manli GeForce RTX 3050 6GB Nebula Twin GDDR6 Graphics Card. Category: Manli. Subcategory: Graphics Card. Price: 24,999৳.
",275,136920,137195
585,recursive,"
Product: Manli Nebula GeForce RTX 5050 8GB GDDR6 Graphics Card. Category: Manli. Subcategory: Graphics Card. Price: 37,500৳.

Product: Manli Polar Fox GeForce RTX 5050 OC 8GB GDDR6 Graphics Card. Category: Manli. Subcategory: Graphics Card. Price: 40,500৳.
",258,137195,137453
586,recursive,"
Product: Manli Nebula GeForce RTX 5060 8GB GDDR7 Graphics Card. Category: Manli. Subcategory: Graphics Card. Price: 44,999৳.

Product: Manli Polar Fox GeForce RTX 5060 OC 8GB GDDR7 Graphics Card. Category: Manli. Subcategory: Graphics Card. Price: 47,500৳.
",258,137453,137711
587,recursive,"
Product: Manli Nebula GeForce RTX 5060 OC 8GB GDDR7 Graphics Card. Category: Manli. Subcategory: Graphics Card. Price: 51,999৳.

Product: Manli Nebula GeForce RTX 5060 Ti 8GB GDDR7 Graphics Card. Category: Manli. Subcategory: Graphics Card. Price: 56,000৳56,999৳.
",265,137711,137976
588,recursive,"
Product: Manli Nebula GeForce RTX 5060 Ti 16GB GDDR7 Graphics Card. Category: Manli. Subcategory: Graphics Card. Price: 66,500৳.

Product: Manli Polar Fox GeForce RTX 5060 Ti OC 16GB GDDR7 Graphics Card. Category: Manli. Subcategory: Graphics Card. Price: 69,000৳.
",266,137976,138242
589,recursive,"
Product: Manli Polar Fox GeForce RTX 5060 Ti OC Triple Fan 16GB GDDR7 Graphics Card. Category: Manli. Subcategory: Graphics Card. Price: 71,500৳.

Product: Manli Nebula GeForce RTX 5070 12GB GDDR7 Graphics Card. Category: Manli. Subcategory: Graphics Card. Price: 87,500৳.
",274,138242,138516
590,recursive,"
Product: Manli Polar Fox V2 GeForce RTX 5070 OC 12GB GDDR7 Graphics Card. Category: Manli. Subcategory: Graphics Card. Price: 91,000৳.

Product: Manli Nebula GeForce RTX 5070 Ti 16GB GDDR7 Graphics Card. Category: Manli. Subcategory: Graphics Card. Price: 120,999৳.
",267,138516,138783
591,recursive,"
Product: Manli Polar Fox GeForce RTX 5070 Ti OC 16GB GDDR7 Graphics Card. Category: Manli. Subcategory: Graphics Card. Price: 129,000৳.

Product: Manli Nebula GeForce RTX 5080 16GB GDDR7 Graphics Card. Category: Manli. Subcategory: Graphics Card. Price: 153,500৳.
",265,138783,139048
592,recursive,"
Product: Manli Polar Fox V2 GeForce RTX 5080 OC 16GB GDDR7 Graphics Card. Category: Manli. Subcategory: Graphics Card. Price: 159,000৳.

Product: Manli Gallardo GeForce RTX 5090 OC 32GB GDDR7 Graphics Card. Category: Manli. Subcategory: Graphics Card. Price: Up Coming.
",271,139048,139319
593,recursive,"
Product: PowerColor Fighter AMD Radeon RX 7600 8GB GDDR6 Graphics Card. Category: PowerColor. Subcategory: Graphics Card. Price: 35,500৳.

Product: PowerColor Reaper AMD Radeon RX 9060 XT 8GB GDDR6 Graphics Card. Category: PowerColor. Subcategory: Graphics Card. Price: 49,000৳50,000৳.
",287,139319,139606
594,recursive,"
Product: PowerColor Hellhound AMD Radeon RX 9060 XT 8GB GDDR6 Graphics Card. Category: PowerColor. Subcategory: Graphics Card. Price: 51,500৳.

Product: PowerColor Reaper AMD Radeon RX 9060 XT 16GB GDDR6 Graphics Card. Category: PowerColor. Subcategory: Graphics Card. Price: 55,400৳.
",286,139606,139892
595,recursive,"
Product: PowerColor Hellhound Spectral White AMD Radeon RX 9060 XT 16GB Graphics Card. Category: PowerColor. Subcategory: Graphics Card. Price: 58,990৳.
",154,139892,140046
596,recursive,"
Product: PowerColor Fighter AMD Radeon RX 7700 XT 12GB GDDR6 Graphics Card. Category: PowerColor. Subcategory: Graphics Card. Price: 66,500৳67,500৳.

Product: PowerColor AMD Radeon RX 7800 XT 16GB GDDR6 Graphics Card. Category: PowerColor. Subcategory: Graphics Card. Price: 68,500৳69,500৳.
",292,140046,140338
597,recursive,"
Product: PowerColor Fighter AMD Radeon RX 7800 XT 16GB GDDR6 Graphics Card. Category: PowerColor. Subcategory: Graphics Card. Price: 71,000৳.
",143,140338,140481
598,recursive,"
Product: PowerColor Hellhound Sakura AMD Radeon RX 7800 XT 16GB GDDR6 Limited Edition Graphics Card. Category: PowerColor. Subcategory: Graphics Card. Price: 72,800৳75,000৳.
",175,140481,140656
599,recursive,"
Product: PowerColor Hellhound Spectral White AMD Radeon RX 7800 XT 16GB GDDR6 Graphics Card. Category: PowerColor. Subcategory: Graphics Card. Price: 73,500৳75,000৳.
",167,140656,140823
600,recursive,"
Product: PowerColor Reaper AMD Radeon RX 9070 16GB GDDR6 Graphics Card. Category: PowerColor. Subcategory: Graphics Card. Price: 87,000৳88,000৳.

Product: PowerColor Reaper AMD Radeon RX 9070 XT 16GB GDDR6 Graphics Card. Category: PowerColor. Subcategory: Graphics Card. Price: 99,900৳.
",288,140823,141111
601,recursive,"
Product: PowerColor Red Devil Spectral White AMD Radeon RX 9070 XT 16GB GDDR6 Graphics Card. Category: PowerColor. Subcategory: Graphics Card. Price: 115,000৳.
",161,141111,141272
602,recursive,"
Product: PowerColor Red Devil AMD Radeon RX 9070 XT 16GB GDDR6 Graphics Card. Category: PowerColor. Subcategory: Graphics Card. Price: 115,900৳.

Product: PowerColor Fighter AMD Radeon RX 6500 XT 4GB GDDR6 Graphics Card. Category: PowerColor. Subcategory: Graphics Card. Price: Out Of Stock.
",293,141272,141565
603,recursive,"
Product: PowerColor Hellhound AMD Radeon RX 9060 XT 16GB GDDR6 Graphics Card. Category: PowerColor. Subcategory: Graphics Card. Price: Out Of Stock.

Product: PowerColor AMD Radeon RX 7700 XT 12GB GDDR6 Graphics Card. Category: PowerColor. Subcategory: Graphics Card. Price: Out Of Stock.
",290,141565,141855
604,recursive,"
Product: PowerColor Hellhound AMD Radeon RX 7700 XT 12GB GDDR6 Graphics Card. Category: PowerColor. Subcategory: Graphics Card. Price: Out Of Stock.
",150,141855,142005
605,recursive,"
Product: PowerColor Hellhound AMD Radeon RX 7800 XT 16GB GDDR6 Graphics Card. Category: PowerColor. Subcategory: Graphics Card. Price: Out Of Stock.

Product: Netac Basic DDR3 4GB 1600MHZ Desktop RAM. Category: RAM (Desktop). Subcategory: Component. Price: 950৳1,000৳.
",270,142005,142275
606,recursive,"
Product: Netac Basic 4GB DDR4 2666MHZ Desktop RAM. Category: RAM (Desktop). Subcategory: Component. Price: 1,300৳.

Product: Netac Shadow II 8GB DDR4 3200MHz Desktop RAM. Category: RAM (Desktop). Subcategory: Component. Price: 2,650৳.
",236,142275,142511
607,recursive,"
Product: Colorful Battle-AX DDR4 8GB 3200MHz Desktop RAM White. Category: RAM (Desktop). Subcategory: Component. Price: 3,300৳.

Product: Colorful Battle-AX 8GB DDR4 3200MHz U-DIMM Desktop RAM. Category: RAM (Desktop). Subcategory: Component. Price: 3,100৳.
",259,142511,142770
608,recursive,"
Product: Colorful Battle-AX DDR4 8GB 3200MHz Desktop RAM. Category: RAM (Desktop). Subcategory: Component. Price: 3,100৳.

Product: OCPC XT II DDR4 3200MHz 8GB Desktop RAM White. Category: RAM (Desktop). Subcategory: Component. Price: 3,200৳.
",244,142770,143014
609,recursive,"
Product: Gigabyte AORUS RGB 8GB DDR4 3733MHz Desktop RAM. Category: RAM (Desktop). Subcategory: Component. Price: 2,976৳3,200৳.

Product: G.SKILL Aegis 8GB DDR4 3200Mhz Desktop RAM. Category: RAM (Desktop). Subcategory: Component. Price: 3,000৳3,400৳.
",253,143014,143267
610,recursive,"
Product: OCPC XT II DDR4 3200MHz 8GB Desktop RAM. Category: RAM (Desktop). Subcategory: Component. Price: 3,200৳3,400৳.

Product: Kingston FURY Beast 8GB 3200MHz DDR4 Desktop RAM. Category: RAM (Desktop). Subcategory: Component. Price: 3,300৳3,550৳.
",251,143267,143518
611,recursive,"
Product: TEAM VULCAN RED 8GB DDR5 5200MHz Gaming Desktop RAM. Category: RAM (Desktop). Subcategory: Component. Price: 3,500৳.

Product: TEAM VULCAN Black 8GB DDR5 5200MHz Gaming Desktop RAM. Category: RAM (Desktop). Subcategory: Component. Price: 3,550৳.
",256,143518,143774
612,recursive,"
Product: G.Skill Trident Z 8GB DDR4 3200MHz Desktop RAM. Category: RAM (Desktop). Subcategory: Component. Price: 3,500৳3,600৳.

Product: Team T-Force Vulcan Z 8GB DDR4 3200MHz CL16 Gaming RAM. Category: RAM (Desktop). Subcategory: Component. Price: 3,300৳.
",258,143774,144032
613,recursive,"
Product: Team T-CREATE CLASSIC 8GB DDR4 3200MHz Desktop RAM. Category: RAM (Desktop). Subcategory: Component. Price: 3,600৳.

Product: Team T-Force VULCAN RED 8GB DDR5 5600MHz Desktop RAM. Category: RAM (Desktop). Subcategory: Component. Price: 3,650৳.
",254,144032,144286
614,recursive,"
Product: TEAM T-Force VULCAN 8GB DDR5 5600MHz Desktop RAM. Category: RAM (Desktop). Subcategory: Component. Price: 3,650৳.

Product: TEAM VULCAN RED 8GB DDR5 6000MHz Gaming Desktop RAM. Category: RAM (Desktop). Subcategory: Component. Price: 3,750৳.
",251,144286,144537
615,recursive,"
Product: PNY GeForce RTX 5060 8GB OC Dual Fan GDDR7 Graphics Card. Category: PNY. Subcategory: Graphics Card. Price: 44,900৳47,500৳.

Product: PNY GeForce RTX 5060 Ti 8GB OC Dual Fan GDDR7 Graphics Card. Category: PNY. Subcategory: Graphics Card. Price: 60,900৳61,900৳.
",271,144537,144808
616,recursive,"
Product: PNY GeForce RTX 5060 Ti 16GB Dual Fan GDDR7 Graphics Card. Category: PNY. Subcategory: Graphics Card. Price: 66,500৳.

Product: PNY GeForce RTX 5060 Ti 16GB OC Dual Fan GDDR7 Graphics Card. Category: PNY. Subcategory: Graphics Card. Price: 67,500৳.
",259,144808,145067
617,recursive,"
Product: PNY GeForce RTX 5070 OC Triple Fan 12GB GDDR7 Graphics Card. Category: PNY. Subcategory: Graphics Card. Price: 91,500৳99,500৳.
",137,145067,145204
618,recursive,"
Product: PNY GeForce RTX 4080 16GB XLR8 Gaming Verto EPIC-X RGB Triple Fan GDDR6X Graphics Card. Category: PNY. Subcategory: Graphics Card. Price: 170,000৳172,000৳.
",166,145204,145370
619,recursive,"
Product: PNY GeForce RTX 5080 16GB GDDR7 ARGB EPIC-X RGB Overclocked Triple Fan Graphics Card. Category: PNY. Subcategory: Graphics Card. Price: 170,000৳182,000৳.
",164,145370,145534
620,recursive,"
Product: PNY GeForce RTX 5080 16GB Triple Fan GDDR7 Graphics Card. Category: PNY. Subcategory: Graphics Card. Price: 178,000৳186,000৳.
",136,145534,145670
621,recursive,"
Product: PNY GeForce RTX 5090 32GB GDDR7 ARGB EPIC-X RGB Overclocked Triple Fan Graphics Card. Category: PNY. Subcategory: Graphics Card. Price: 427,000৳435,000৳.

Product: PNY GeForce RTX 3050 6GB VERTO Dual Fan GDDR6 Graphics Card. Category: PNY. Subcategory: Graphics Card. Price: Out Of Stock.
",299,145670,145969
622,recursive,"
Product: PNY GeForce RTX 3060 12GB VERTO Dual Fan GDDR6 Graphics Card (No Box, No Warranty). Category: PNY. Subcategory: Graphics Card. Price: Out Of Stock.
",158,145969,146127
623,recursive,"
Product: PNY GeForce RTX 4060 Ti 8GB XLR8 Gaming VERTO EPIC-X RGB Triple Fan GDDR6 Graphics Card (No Box, No Warranty). Category: PNY. Subcategory: Graphics Card. Price: Out Of Stock.
",185,146127,146312
624,recursive,"
Product: PNY GeForce RTX 4060 8GB VERTO Dual Fan GDDR6 Graphics Card. Category: PNY. Subcategory: Graphics Card. Price: Out Of Stock.

Product: PNY GeForce RTX 4060 8GB XLR8 Gaming VERTO EPIC-X RGB Triple Fan GDDR6 Graphics Card. Category: PNY. Subcategory: Graphics Card. Price: Out Of Stock.
",295,146312,146607
625,recursive,"
Product: PNY GeForce RTX 4060 Ti 8GB XLR8 Gaming VERTO EPIC-X RGB Triple Fan GDDR6 Graphics Card. Category: PNY. Subcategory: Graphics Card. Price: Out Of Stock.
",163,146607,146770
626,recursive,"
Product: PNY GeForce RTX 4070 SUPER 12GB XLR8 Gaming VERTO EPIC-X RGB Triple Fan GDDR6X Graphics Card. Category: PNY. Subcategory: Graphics Card. Price: Out Of Stock.

Product: PNY GeForce RTX 5070 Triple Fan 12GB GDDR7 Graphic Card. Category: PNY. Subcategory: Graphics Card. Price: Out Of Stock.
",299,146770,147069
627,recursive,"
Product: PNY GeForce RTX 5070 Ti OC Plus Triple Fan 16GB GDDR7 Graphic Card. Category: PNY. Subcategory: Graphics Card. Price: Out Of Stock.
",142,147069,147211
628,recursive,"
Product: PNY GeForce RTX 4070 Ti SUPER 16GB XLR8 Gaming VERTO EPIC-X RGB Overclocked Triple Fan GDDR6X Graphics Card. Category: PNY. Subcategory: Graphics Card. Price: Out Of Stock.
",183,147211,147394
629,recursive,"
Product: PNY GeForce RTX 5070 Ti Epic-X ARGB OC Triple Fan 16GB GDDR7 Graphic Card. Category: PNY. Subcategory: Graphics Card. Price: Out Of Stock.

Product: PNY XLR8 RGB 8GB DDR4 3600MHz Desktop RAM. Category: PNY. Subcategory: RAM (Desktop). Price: 3,999৳.
",260,147394,147654
630,recursive,"
Product: PNY XLR8 RGB 16GB DDR4 3200MHz Desktop RAM White. Category: PNY. Subcategory: RAM (Desktop). Price: 6,500৳.

Product: PNY XLR8 8GB DDR4 3200MHz Desktop Gaming RAM. Category: PNY. Subcategory: RAM (Desktop). Price: Out Of Stock.
",238,147654,147892
631,recursive,"
Product: PNY Performance 8GB DDR4 2666MHz Desktop RAM. Category: PNY. Subcategory: RAM (Desktop). Price: Out Of Stock.

Product: PNY XLR8 8GB RGB DDR4 3200MHz White Desktop RAM. Category: PNY. Subcategory: RAM (Desktop). Price: Out Of Stock.
",243,147892,148135
632,recursive,"
Product: PNY XLR8 Gaming EPIC-X RGB 8GB DDR4 3200MHz Desktop RAM. Category: PNY. Subcategory: RAM (Desktop). Price: Out Of Stock.

Product: PNY XLR8 RGB 8GB DDR4 3600MHz White Desktop RAM. Category: PNY. Subcategory: RAM (Desktop). Price: Out Of Stock.
",254,148135,148389
633,recursive,"
Product: PNY XLR8 16GB DDR4 3200MHz Desktop Gaming RAM. Category: PNY. Subcategory: RAM (Desktop). Price: Out Of Stock.

Product: PNY XLR8 Gaming MAKO 16GB DDR5 6000MHz Desktop RAM. Category: PNY. Subcategory: RAM (Desktop). Price: Out Of Stock.
",247,148389,148636
634,recursive,"
Product: PNY XLR8 Gaming MAKO 16GB DDR5 6000MHz Desktop RAM White. Category: PNY. Subcategory: RAM (Desktop). Price: Out Of Stock.

Product: PNY XLR8 RGB 16GB (8GBx2) DDR4 3600MHz Desktop RAM. Category: PNY. Subcategory: RAM (Desktop). Price: Out Of Stock.
",258,148636,148894
635,recursive,"
Product: Gigabyte 8GB DDR4 2666MHz Heatsink Desktop Ram. Category: Gigabyte. Subcategory: RAM (Desktop). Price: Out Of Stock.

Product: Gigabyte AORUS RGB 8GB DDR4 3200MHz Desktop RAM. Category: Gigabyte. Subcategory: RAM (Desktop). Price: Out Of Stock.
",255,148894,149149
636,recursive,"
Product: Gigabyte AORUS 8GB 3200MHz RGB RAM. Category: Gigabyte. Subcategory: RAM (Desktop). Price: Out Of Stock.

Product: Gigabyte AORUS RGB 8GB DDR4 3600MHz Desktop RAM. Category: Gigabyte. Subcategory: RAM (Desktop). Price: Out Of Stock.
",243,149149,149392
637,recursive,"
Product: Gigabyte AORUS RGB 16GB DDR5 6000MHz Desktop RAM. Category: Gigabyte. Subcategory: RAM (Desktop). Price: Out Of Stock.

Product: Colorful Battle-AX 8GB DDR4 3200MHz U-DIMM Desktop RAM White. Category: Colorful. Subcategory: RAM (Desktop). Price: 3,100৳.
",264,149392,149656
638,recursive,"
Product: Colorful CVN Guardian 8GB DDR4 3200MHz RGB Desktop RAM. Category: Colorful. Subcategory: RAM (Desktop). Price: Out Of Stock.

Product: Colorful Battle-AX 16GB DDR4 3200MHz U-DIMM Desktop RAM. Category: Colorful. Subcategory: RAM (Desktop). Price: Out Of Stock.
",271,149656,149927
639,recursive,"
Product: Colorful Battle-AX 16GB DDR4 3200MHz U-DIMM Desktop RAM White. Category: Colorful. Subcategory: RAM (Desktop). Price: Out Of Stock.

Product: Colorful Battle-AX Redline 16GB DDR5 6000MHz Desktop RAM. Category: Colorful. Subcategory: RAM (Desktop). Price: Out Of Stock.
",279,149927,150206
640,recursive,"
Product: Colorful CVN 16GB 6000MHz DDR5 Desktop RAM. Category: Colorful. Subcategory: RAM (Desktop). Price: Out Of Stock.

Product: Colorful CVN Icicle 16GB DDR5 6600MHz Desktop RAM. Category: Colorful. Subcategory: RAM (Desktop). Price: Out Of Stock.
",253,150206,150459
641,recursive,"
Product: Corsair Vengeance LPX 8GB 3200MHz DDR4 Desktop RAM. Category: Corsair. Subcategory: RAM (Desktop). Price: 3,800৳4,100৳.

Product: Corsair VENGEANCE RGB PRO 16GB DDR4 3000MHz Desktop RAM. Category: Corsair. Subcategory: RAM (Desktop). Price: 4,371৳4,700৳.
",265,150459,150724
642,recursive,"
Product: Corsair Vengeance LPX 16GB DDR4 DRAM 3200MHz RAM. Category: Corsair. Subcategory: RAM (Desktop). Price: 6,000৳6,200৳.

Product: Corsair VENGEANCE 16GB DDR5 5600MHz CL40 Desktop RAM. Category: Corsair. Subcategory: RAM (Desktop). Price: 6,600৳7,000৳.
",260,150724,150984
643,recursive,"
Product: Corsair VENGEANCE 16GB DDR5 6000MHz CL36 Desktop RAM. Category: Corsair. Subcategory: RAM (Desktop). Price: 7,050৳7,100৳.

Product: Corsair VENGEANCE 16GB DDR5 6000MHz RAM White. Category: Corsair. Subcategory: RAM (Desktop). Price: 7,500৳.
",251,150984,151235
644,recursive,"
Product: Corsair VENGEANCE 16GB DDR5 6200MHz Desktop RAM. Category: Corsair. Subcategory: RAM (Desktop). Price: 7,500৳.

Product: Corsair VENGEANCE RGB 16GB DDR5 6000MHz CL36 Desktop RAM. Category: Corsair. Subcategory: RAM (Desktop). Price: 7,200৳7,500৳.
",257,151235,151492
645,recursive,"
Product: Corsair VENGEANCE RGB 16GB DDR5 6000MHz CL30 Desktop RAM. Category: Corsair. Subcategory: RAM (Desktop). Price: 8,100৳8,300৳.

Product: Corsair VENGEANCE RGB 16GB DDR5 6600MHz RAM. Category: Corsair. Subcategory: RAM (Desktop). Price: 8,400৳8,700৳.
",259,151492,151751
646,recursive,"
Product: Corsair VENGEANCE RGB 24GB DDR5 7200MHz Desktop RAM. Category: Corsair. Subcategory: RAM (Desktop). Price: 13,999৳.

Product: Corsair DOMINATOR PLATINUM RGB 16GB (2x8GB) DDR4 3600MHz C18 RAM Kit. Category: Corsair. Subcategory: RAM (Desktop). Price: Up Coming.
",271,151751,152022
647,recursive,"
Product: Corsair VENGEANCE RGB 16GB DDR5 7200MHz Desktop RAM. Category: Corsair. Subcategory: RAM (Desktop). Price: Up Coming.

Product: Corsair Vengeance LPX 4GB (1x4GB) DDR4 DRAM 2400MHz. Category: Corsair. Subcategory: RAM (Desktop). Price: Out Of Stock.
",259,152022,152281
648,recursive,"
Product: CORSAIR VENGEANCE LPX 8GB DDR4 3600MHz RAM. Category: Corsair. Subcategory: RAM (Desktop). Price: Out Of Stock.

Product: Corsair Vengeance LPX 8GB DDR4 2400MHz RAM. Category: Corsair. Subcategory: RAM (Desktop). Price: Out Of Stock.
",244,152281,152525
649,recursive,"
Product: CORSAIR VENGEANCE RGB RS 8GB DDR4 3200MHz RAM. Category: Corsair. Subcategory: RAM (Desktop). Price: Out Of Stock.

Product: Corsair DOMINATOR PLATINUM RGB 8GB DDR4 3600MHz C18 RAM. Category: Corsair. Subcategory: RAM (Desktop). Price: Out Of Stock.
",260,152525,152785
650,recursive,"
Product: Corsair VENGEANCE RGB PRO 8GB DDR4 3200MHz Desktop RAM White. Category: Corsair. Subcategory: RAM (Desktop). Price: Out Of Stock.

Product: CORSAIR VENGEANCE RGB RS 8GB DDR4 3600MHz RAM. Category: Corsair. Subcategory: RAM (Desktop). Price: Out Of Stock.
",265,152785,153050
651,recursive,"
Product: TEAM VULCAN 8GB DDR5 6000MHz Desktop RAM. Category: TEAM. Subcategory: RAM (Desktop). Price: 3,700৳.

Product: Team T-Force VULCAN Z Red 8GB DDR4 3200MHz Desktop Gaming RAM. Category: TEAM. Subcategory: RAM (Desktop). Price: 3,850৳.
",243,153050,153293
652,recursive,"
Product: Team T-CREATE EXPERT 8GB DDR4 3200MHz Desktop RAM. Category: TEAM. Subcategory: RAM (Desktop). Price: 3,850৳.

Product: TEAM Delta RGB 8GB DDR5 5200MHz Gaming Desktop RAM. Category: TEAM. Subcategory: RAM (Desktop). Price: 3,950৳.
",241,153293,153534
653,recursive,"
Product: Team T-FORCE DELTA RGB 8GB DDR5 5600MHz Desktop RAM. Category: TEAM. Subcategory: RAM (Desktop). Price: 4,050৳.

Product: TEAM T-FORCE DELTA RGB 8GB 6000MHz DDR5 Gaming RAM. Category: TEAM. Subcategory: RAM (Desktop). Price: 4,150৳.
",243,153534,153777
654,recursive,"
Product: Team Delta RGB 8GB 3200MHz DDR4 CL16 Desktop RAM. Category: TEAM. Subcategory: RAM (Desktop). Price: 4,150৳.

Product: Team T-Force Delta 8GB 3200MHz DDR4 RGB White Desktop Gaming RAM. Category: TEAM. Subcategory: RAM (Desktop). Price: 4,250৳.
",254,153777,154031
655,recursive,"
Product: TEAM T-FORCE DELTA RGB White 8GB 6000MHz DDR5 Gaming RAM. Category: TEAM. Subcategory: RAM (Desktop). Price: 4,250৳.

Product: Team T-CREATE EXPERT 16GB DDR4 3200MHz Desktop RAM. Category: TEAM. Subcategory: RAM (Desktop). Price: 5,300৳.
",248,154031,154279
656,recursive,"
Product: Team T-Force VULCAN Z Red 16GB DDR4 3200MHz CL16 Gaming RAM. Category: TEAM. Subcategory: RAM (Desktop). Price: 6,199৳.

Product: Team T-Force Vulcan Z 16GB 3200MHz DDR4 Desktop RAM. Category: TEAM. Subcategory: RAM (Desktop). Price: 6,200৳.
",252,154279,154531
657,recursive,"
Product: TEAM VULCAN 16GB DDR5 5600MHz Gaming Desktop RAM. Category: TEAM. Subcategory: RAM (Desktop). Price: 6,500৳.

Product: Transcend 4GB DDR3 1333 MHz Desktop RAM. Category: Transcend. Subcategory: RAM (Desktop). Price: Out Of Stock.
",240,154531,154771
658,recursive,"
Product: Transcend 4GB DDR4 2400 Mhz Desktop Ram. Category: Transcend. Subcategory: RAM (Desktop). Price: Out Of Stock.

Product: Transcend 16GB DDR4 2666Mhz U-DIMM Desktop RAM. Category: Transcend. Subcategory: RAM (Desktop). Price: Out Of Stock.
",249,154771,155020
659,recursive,"
Product: Transcend JetRam 16GB DDR4 3200MHz U-DIMM Desktop RAM. Category: Transcend. Subcategory: RAM (Desktop). Price: Out Of Stock.

Product: Transcend JetRam 32GB DDR4 3200MHz U-DIMM Desktop RAM. Category: Transcend. Subcategory: RAM (Desktop). Price: Out Of Stock.
",270,155020,155290
660,recursive,"
Product: Transcend JetRam 4GB DDR4 3200MHz U-DIMM Desktop RAM. Category: Transcend. Subcategory: RAM (Desktop). Price: Out Of Stock.

Product: Transcend 4GB DDR4 2666Mhz Desktop RAM. Category: Transcend. Subcategory: RAM (Desktop). Price: Out Of Stock.
",254,155290,155544
661,recursive,"
Product: Transcend JetRam 8GB DDR4 3200MHz U-DIMM Desktop RAM. Category: Transcend. Subcategory: RAM (Desktop). Price: Out Of Stock.

Product: Transcend 8GB DDR4 2666MHz Desktop RAM. Category: Transcend. Subcategory: RAM (Desktop). Price: Out Of Stock.
",254,155544,155798
662,recursive,"
Product: Transcend JetRam 8GB DDR5 4800MHz U-DIMM Desktop RAM. Category: Transcend. Subcategory: RAM (Desktop). Price: Out Of Stock.

Product: Transcend 32GB DDR4 2666Mhz U-DIMM Desktop RAM. Category: Transcend. Subcategory: RAM (Desktop). Price: Out Of Stock.
",262,155798,156060
663,recursive,"
Product: Lexar 16GB DDR4 3200Mhz Desktop RAM. Category: Lexar. Subcategory: RAM (Desktop). Price: 5,300৳5,500৳.

Product: Lexar ARES 32GB (16x2) 6000Mhz DDR5 RGB Gaming Desktop RAM. Category: Lexar. Subcategory: RAM (Desktop). Price: 16,500৳.
",244,156060,156304
664,recursive,"
Product: Lexar 4GB DDR4 2666 Mhz UDIMM Desktop RAM. Category: Lexar. Subcategory: RAM (Desktop). Price: Out Of Stock.

Product: Lexar 8GB DDR4 3200 Mhz UDIMM Desktop RAM. Category: Lexar. Subcategory: RAM (Desktop). Price: Out Of Stock.
",238,156304,156542
665,recursive,"
Product: Lexar THOR 8GB DDR4 3200Mhz UDIMM Desktop RAM. Category: Lexar. Subcategory: RAM (Desktop). Price: Out Of Stock.

Product: Lexar THOR 8GB DDR4 3200Mhz Desktop RAM. Category: Lexar. Subcategory: RAM (Desktop). Price: Out Of Stock.
",240,156542,156782
666,recursive,"
Product: Lexar 8GB DDR4 2666 Mhz UDIMM Desktop RAM. Category: Lexar. Subcategory: RAM (Desktop). Price: Out Of Stock.

Product: Lexar THOR 16GB 3200Mhz DDR4 Desktop Ram. Category: Lexar. Subcategory: RAM (Desktop). Price: Out Of Stock.
",237,156782,157019
667,recursive,"
Product: Lexar THOR 16GB DDR4 3200Mhz Desktop RAM. Category: Lexar. Subcategory: RAM (Desktop). Price: Out Of Stock.

Product: Lexar ARES 16GB (8x2) 3600Mhz DDR4 RGB Gaming Desktop RAM. Category: Lexar. Subcategory: RAM (Desktop). Price: Out Of Stock.
",253,157019,157272
668,recursive,"
Product: Lexar ARES 16GB DDR5 4800Mhz Desktop RAM. Category: Lexar. Subcategory: RAM (Desktop). Price: Out Of Stock.

Product: Lexar ARES 16GB DDR5 5200Mhz OC Desktop Gaming RAM. Category: Lexar. Subcategory: RAM (Desktop). Price: Out Of Stock.
",246,157272,157518
669,recursive,"
Product: Lexar ARES 32GB (16x2) 5600Mhz DDR5 RGB Gaming Desktop Ram. Category: Lexar. Subcategory: RAM (Desktop). Price: Out Of Stock.

Product: Kingston FURY Beast 8GB DDR5 5600Mhz Desktop RAM. Category: Kingston. Subcategory: RAM (Desktop). Price: 3,750৳.
",259,157518,157777
670,recursive,"
Product: Kingston FURY Beast RGB 8GB 3200MHz DDR4 Desktop RAM. Category: Kingston. Subcategory: RAM (Desktop). Price: 3,850৳.

Product: Kingston FURY Beast RGB 8GB DDR5 5600Mhz Desktop RAM. Category: Kingston. Subcategory: RAM (Desktop). Price: 4,150৳.
",254,157777,158031
671,recursive,"
Product: Kingston FURY Beast 16GB 3200MHz DDR4 Desktop RAM. Category: Kingston. Subcategory: RAM (Desktop). Price: 5,900৳.

Product: Kingston FURY Beast RGB 16GB 3200MHz DDR4 Heatsink Desktop RAM. Category: Kingston. Subcategory: RAM (Desktop). Price: 6,000৳6,050৳.
",267,158031,158298
672,recursive,"
Product: Kingston FURY Beast 16GB 6000Mhz CL30 DDR5 Desktop RAM. Category: Kingston. Subcategory: RAM (Desktop). Price: 7,900৳.

Product: Kingston FURY Beast RGB 16GB 6000Mhz DDR5 EXPO Desktop RAM. Category: Kingston. Subcategory: RAM (Desktop). Price: 8,550৳.
",262,158298,158560
673,recursive,"
Product: Kingston FURY Renegade 16GB DDR5 6800MHz Desktop RAM. Category: Kingston. Subcategory: RAM (Desktop). Price: 9,700৳.

Product: Kingston FURY Renegade RGB 48GB DDR5 6000MHz CL32 Desktop RAM. Category: Kingston. Subcategory: RAM (Desktop). Price: 23,999৳25,000৳.
",271,158560,158831
674,recursive,"
Product: Kingston FURY Renegade RGB 48GB DDR5 6400MHz CL32 Desktop RAM. Category: Kingston. Subcategory: RAM (Desktop). Price: 24,999৳26,500৳.

Product: Kingston FURY Beast 8GB 3200MHz DDR4 Special Edition RGB Desktop RAM. Category: Kingston. Subcategory: RAM (Desktop). Price: Out Of Stock.
",293,158831,159124
675,recursive,"
Product: Kingston FURY Beast 8GB DDR5 5600Mhz CL36 Desktop RAM. Category: Kingston. Subcategory: RAM (Desktop). Price: 3,600৳3,750৳.

Product: Kingston FURY Beast RGB 16GB 3200MHz DDR4 Desktop RAM. Category: Kingston. Subcategory: RAM (Desktop). Price: Out Of Stock.
",268,159124,159392
676,recursive,"
Product: Kingston FURY Beast 16GB 3200MHz DDR4 CL16 Desktop RAM. Category: Kingston. Subcategory: RAM (Desktop). Price: Out Of Stock.

Product: Kingston FURY Beast 16GB 5200MHz DDR5 Desktop RAM. Category: Kingston. Subcategory: RAM (Desktop). Price: Out Of Stock.
",265,159392,159657
677,recursive,"
Product: Kingston FURY Beast 16GB 5600Mhz DDR5 Desktop RAM. Category: Kingston. Subcategory: RAM (Desktop). Price: Out Of Stock.

Product: Kingston FURY Beast 16GB 3600MHz DDR4 Desktop RAM. Category: Kingston. Subcategory: RAM (Desktop). Price: Out Of Stock.
",260,159657,159917
678,recursive,"
Product: Kingston FURY Beast 16GB 6000Mhz DDR5 Desktop RAM. Category: Kingston. Subcategory: RAM (Desktop). Price: Out Of Stock.

Product: Kingston FURY Beast 16GB 5600MHz DDR5 RGB Desktop RAM. Category: Kingston. Subcategory: RAM (Desktop). Price: 7,390৳7,399৳.
",264,159917,160181
679,recursive,"
Product: G.Skill Trident Z RGB 8GB DDR4 3200MHz Gaming Desktop RAM. Category: G.Skill. Subcategory: RAM (Desktop). Price: 4,000৳.

Product: G.Skill Ripjaws V 16GB DDR4 2666MHz C19 RAM. Category: G.Skill. Subcategory: RAM (Desktop). Price: 5,600৳.
",248,160181,160429
680,recursive,"
Product: G.SKILL Flare X 8GB DDR4 3200Mhz Desktop RAM. Category: G.Skill. Subcategory: RAM (Desktop). Price: 5,200৳.

Product: G.SKILL Aegis 16GB DDR4 3200Mhz Desktop RAM. Category: G.Skill. Subcategory: RAM (Desktop). Price: 5,100৳5,300৳.
",241,160429,160670
681,recursive,"
Product: G-Skill Flare X5 16GB DDR5 5600MHz Desktop RAM. Category: G.Skill. Subcategory: RAM (Desktop). Price: 5,900৳6,100৳.

Product: G-Skill Ripjaws S5 16GB DDR5 6000Mhz CL32 Desktop RAM. Category: G.Skill. Subcategory: RAM (Desktop). Price: 7,200৳.
",253,160670,160923
682,recursive,"
Product: G.SKILL Trident Z5 RGB 16GB DDR5 5600MHz CL30 1.25V Desktop RAM. Category: G.Skill. Subcategory: RAM (Desktop). Price: 7,300৳7,600৳.

Product: G.Skill Trident Z5 Neo RGB 16GB DDR5 5600Mhz Desktop RAM. Category: G.Skill. Subcategory: RAM (Desktop). Price: 7,300৳7,700৳.
",279,160923,161202
683,recursive,"
Product: G.Skill Trident Z5 RGB 16GB DDR5 6000MHz CL32 Desktop RAM Silver. Category: G.Skill. Subcategory: RAM (Desktop). Price: 8,200৳.

Product: G.Skill Trident Z5 RGB 16GB DDR5 6600MHz Desktop RAM. Category: G.Skill. Subcategory: RAM (Desktop). Price: 8,000৳8,100৳.
",270,161202,161472
684,recursive,"
Product: G.Skill Trident Z5 RGB 32GB DDR5 5600MHz Desktop RAM. Category: G.Skill. Subcategory: RAM (Desktop). Price: 11,000৳12,000৳.

Product: G.Skill Trident Z5 Neo RGB 32GB DDR5 6000Mhz Desktop RAM. Category: G.Skill. Subcategory: RAM (Desktop). Price: 14,200৳.
",265,161472,161737
685,recursive,"
Product: G.Skill Trident Z5 RGB 32GB DDR5 6000MHz Desktop RAM. Category: G.Skill. Subcategory: RAM (Desktop). Price: 14,000৳14,300৳.

Product: G.Skill Trident Z5 16GB DDR5 5600MHz CL36 Desktop RAM Black. Category: G.Skill. Subcategory: RAM (Desktop). Price: Up Coming.
",270,161737,162007
686,recursive,"
Product: G.Skill Trident Z5 16GB 5600MHz DDR5 CL40 Desktop RAM Silver. Category: G.Skill. Subcategory: RAM (Desktop). Price: Up Coming.

Product: G.Skill Trident Z5 16GB 5600MHz DDR5 CL40 Desktop RAM Black. Category: G.Skill. Subcategory: RAM (Desktop). Price: Up Coming.
",273,162007,162280
687,recursive,"
Product: G.Skill Trident Z5 RGB 16GB DDR5 5600MHz CL40 Desktop RAM Silver. Category: G.Skill. Subcategory: RAM (Desktop). Price: Up Coming.

Product: G.Skill Trident Z5 RGB 16GB DDR5 5600MHz CL36 Desktop RAM Silver. Category: G.Skill. Subcategory: RAM (Desktop). Price: Up Coming.
",282,162280,162562
688,recursive,"
Product: HP V6 8GB 3200MHz DDR4 Desktop RAM. Category: HP. Subcategory: RAM (Desktop). Price: Out Of Stock.

Product: Adata XPG GAMMIX D10 8GB DDR4 2666 MHz Desktop RAM. Category: Adata. Subcategory: RAM (Desktop). Price: Up Coming.
",234,162562,162796
689,recursive,"
Product: Adata 32GB DDR5 4800MHz U-DIMM Desktop RAM. Category: Adata. Subcategory: RAM (Desktop). Price: Up Coming.

Product: Adata 8GB DDR5 4800MHz U-DIMM Desktop RAM. Category: Adata. Subcategory: RAM (Desktop). Price: Up Coming.
",233,162796,163029
690,recursive,"
Product: Adata XPG 8GB D35 DDR4 3200MHz Desktop RAM. Category: Adata. Subcategory: RAM (Desktop). Price: Out Of Stock.

Product: Adata Premier 8GB DDR4 3200Mhz Desktop RAM. Category: Adata. Subcategory: RAM (Desktop). Price: Out Of Stock.
",240,163029,163269
691,recursive,"
Product: Adata XPG SPECTRIX D35G RGB 8GB DDR4 3200MHz Gaming Desktop RAM. Category: Adata. Subcategory: RAM (Desktop). Price: Out Of Stock.

Product: Netac Shadow Yellow 8GB DDR4 2666MHZ Desktop RAM. Category: Netac. Subcategory: RAM (Desktop). Price: Up Coming.
",264,163269,163533
692,recursive,"
Product: Netac Basic 16GB DDR4 2666MHz Desktop RAM. Category: Netac. Subcategory: RAM (Desktop). Price: Up Coming.

Product: Netac Basic 8GB DDR4 3200MHz Desktop RAM. Category: Netac. Subcategory: RAM (Desktop). Price: Up Coming.
",231,163533,163764
693,recursive,"
Product: Netac Basic 16GB DDR4 3200MHz Desktop RAM. Category: Netac. Subcategory: RAM (Desktop). Price: Up Coming.

Product: Netac Shadow Yellow 16GB DDR4 3200MHz Desktop RAM. Category: Netac. Subcategory: RAM (Desktop). Price: Up Coming.
",240,163764,164004
694,recursive,"
Product: Netac Z RGB 16GB DDR5 6200MHz Desktop RAM. Category: Netac. Subcategory: RAM (Desktop). Price: Up Coming.

Product: Netac Shadow RGB 16GB DDR5 5600MHz Desktop RAM. Category: Netac. Subcategory: RAM (Desktop). Price: Up Coming.
",237,164004,164241
695,recursive,"
Product: Netac Shadow 16GB DDR4 3600MHz Desktop RAM. Category: Netac. Subcategory: RAM (Desktop). Price: Up Coming.

Product: Netac Basic DDR3 8GB 1600MHZ Desktop RAM. Category: Netac. Subcategory: RAM (Desktop). Price: Up Coming.
",232,164241,164473
696,recursive,"
Product: OCPC X3 RGB DDR4 3200MHz 8GB Desktop RAM. Category: OCPC. Subcategory: RAM (Desktop). Price: 3,800৳.

Product: OCPC X3 RGB DDR4 3200MHz 8GB Desktop RAM White. Category: OCPC. Subcategory: RAM (Desktop). Price: 3,800৳.
",228,164473,164701
697,recursive,"
Product: OCPC X3 RGB DDR4 3200MHz 16GB Desktop RAM. Category: OCPC. Subcategory: RAM (Desktop). Price: 5,300৳5,500৳.

Product: OCPC X3 RGB DDR4 3200MHz 16GB Desktop RAM White. Category: OCPC. Subcategory: RAM (Desktop). Price: 5,200৳5,500৳.
",242,164701,164943
698,recursive,"
Product: OCPC XT II DDR4 3200MHz 16GB Desktop RAM. Category: OCPC. Subcategory: RAM (Desktop). Price: 5,100৳5,500৳.

Product: OCPC PISTA 16GB DDR5 6000MHz CL38 RGB Desktop RAM. Category: OCPC. Subcategory: RAM (Desktop). Price: 6,900৳7,200৳.
",243,164943,165186
699,recursive,"
Product: OCPC PISTA 16GB 5600MHz DDR5 RGB Desktop RAM. Category: OCPC. Subcategory: RAM (Desktop). Price: Out Of Stock.

Product: OCPC PISTA 16GB 6000MHz DDR5 RGB Desktop RAM. Category: OCPC. Subcategory: RAM (Desktop). Price: Out Of Stock.
",242,165186,165428
700,recursive,"
Product: OCPC PISTA DDR5 6200MHz 32GB (16GBx2) RGB RAM Kit. Category: OCPC. Subcategory: RAM (Desktop). Price: Out Of Stock.

Product: Kimtigo WOLFRINE 8GB 3200MHz DDR4 UDIMM Desktop RAM. Category: Kimtigo. Subcategory: RAM (Desktop). Price: Out Of Stock.
",257,165428,165685
701,recursive,"
Product: Adata 4GB DDR4 2400MHz Laptop Ram. Category: Adata. Subcategory: RAM (Laptop). Price: Up Coming.

Product: TEAM ELITE 8GB 3200MHz Laptop RAM. Category: TEAM. Subcategory: RAM (Laptop). Price: 3,450৳.
",210,165685,165895
702,recursive,"
Product: TEAM ELITE 16GB 5600MHz DDR5 Laptop RAM. Category: TEAM. Subcategory: RAM (Laptop). Price: 5,600৳.

Product: TEAM T-CREATE CLASSIC 16GB 5600MHz DDR5 Laptop RAM. Category: TEAM. Subcategory: RAM (Laptop). Price: 5,900৳.
",229,165895,166124
703,recursive,"
Product: TEAM ELITE 16GB 3200MHz Laptop RAM. Category: TEAM. Subcategory: RAM (Laptop). Price: 7,000৳.

Product: TEAM ELITE 16GB 4800MHz DDR5 Laptop RAM. Category: TEAM. Subcategory: RAM (Laptop). Price: Up Coming.
",216,166124,166340
704,recursive,"
Product: TEAM ELITE 4GB 2666MHz Laptop RAM. Category: TEAM. Subcategory: RAM (Laptop). Price: Out Of Stock.

Product: TEAM ELITE SO-DIMM DDR4 4GB 2400MHz Laptop RAM. Category: TEAM. Subcategory: RAM (Laptop). Price: Out Of Stock.
",231,166340,166571
705,recursive,"
Product: TEAM ELITE 8GB 2666MHz Laptop RAM. Category: TEAM. Subcategory: RAM (Laptop). Price: Out Of Stock.

Product: TEAM ELITE SO-DIMM DDR4 8GB 2400MHz Laptop RAM. Category: TEAM. Subcategory: RAM (Laptop). Price: Out Of Stock.
",231,166571,166802
706,recursive,"
Product: TEAM ELITE 8GB 4800MHz DDR5 Laptop RAM. Category: TEAM. Subcategory: RAM (Laptop). Price: Out Of Stock.

Product: TEAM ELITE 8GB 5600MHz DDR5 Laptop RAM. Category: TEAM. Subcategory: RAM (Laptop). Price: Out Of Stock.
",228,166802,167030
707,recursive,"
Product: TEAM ELITE 16GB 2666MHz Laptop RAM. Category: TEAM. Subcategory: RAM (Laptop). Price: Out Of Stock.

Product: TEAM ELITE SO-DIMM DDR4 16GB 2400MHz Laptop RAM. Category: TEAM. Subcategory: RAM (Laptop). Price: Out Of Stock.
",233,167030,167263
708,recursive,"
Product: TEAM ELITE 32GB 3200MHz DDR4 LAPTOP RAM. Category: TEAM. Subcategory: RAM (Laptop). Price: Out Of Stock.

Product: TEAM T-CREATE CLASSIC 32GB 5600MHz DDR5 Laptop RAM. Category: TEAM. Subcategory: RAM (Laptop). Price: Out Of Stock.
",241,167263,167504
709,recursive,"
Product: Crucial 8GB DDR4 2400MHz Laptop RAM. Category: Crucial. Subcategory: RAM (Laptop). Price: Out Of Stock.

Product: Crucial 4GB Single DDR4 2400MHz Laptop RAM. Category: Crucial. Subcategory: RAM (Laptop). Price: Out Of Stock.
",235,167504,167739
710,recursive,"
Product: Crucial 4GB Single DDR4 2666MHz Laptop RAM. Category: Crucial. Subcategory: RAM (Laptop). Price: Out Of Stock.

Product: Crucial 8GB Single DDR4 3200MHz Laptop RAM. Category: Crucial. Subcategory: RAM (Laptop). Price: Out Of Stock.
",242,167739,167981
711,recursive,"
Product: Crucial 8GB Single DDR4 2666MHz Laptop RAM. Category: Crucial. Subcategory: RAM (Laptop). Price: Out Of Stock.

Product: Crucial 16GB Single DDR4 3200MHz SODIMM Laptop RAM. Category: Crucial. Subcategory: RAM (Laptop). Price: Out Of Stock.
",250,167981,168231
712,recursive,"
Product: Crucial 16GB Single DDR4 2666MHz Laptop RAM. Category: Crucial. Subcategory: RAM (Laptop). Price: Out Of Stock.

Product: Colorful Notebook 16GB DDR4 3200MHz SO-DIMM Laptop RAM. Category: Colorful. Subcategory: RAM (Laptop). Price: 5,800৳.
",250,168231,168481
713,recursive,"
Product: Colorful Notebook 16GB DDR5 4800MHz Laptop RAM. Category: Colorful. Subcategory: RAM (Laptop). Price: 5,800৳.

Product: Colorful Notebook 8GB DDR4 2666MHz SO-DIMM Laptop RAM. Category: Colorful. Subcategory: RAM (Laptop). Price: Out Of Stock.
",253,168481,168734
714,recursive,"
Product: Colorful Notebook 8GB DDR4 3200MHz SO-DIMM Laptop RAM. Category: Colorful. Subcategory: RAM (Laptop). Price: Out Of Stock.

Product: Kingston 16GB 2400MHz Laptop ram. Category: Kingston. Subcategory: RAM (Laptop). Price: Out Of Stock.
",245,168734,168979
715,recursive,"
Product: Kingston Value RAM 4GB DDR4 2666MHz Laptop RAM. Category: Kingston. Subcategory: RAM (Laptop). Price: Out Of Stock.

Product: Kingston Value RAM 4GB DDR4 3200MHz Laptop RAM. Category: Kingston. Subcategory: RAM (Laptop). Price: Out Of Stock.
",252,168979,169231
716,recursive,"
Product: Kingston Value RAM 8GB DDR4 2666MHz Laptop RAM. Category: Kingston. Subcategory: RAM (Laptop). Price: Out Of Stock.

Product: Kingston Value RAM 8GB DDR4 3200MHz Laptop RAM. Category: Kingston. Subcategory: RAM (Laptop). Price: Out Of Stock.
",252,169231,169483
717,recursive,"
Product: Kingston Value RAM 16GB DDR4 3200MHz Laptop RAM. Category: Kingston. Subcategory: RAM (Laptop). Price: Out Of Stock.

Product: Kingston FURY Impact 16GB DDDR5 4800Mhz Laptop RAM. Category: Kingston. Subcategory: RAM (Laptop). Price: Out Of Stock.
",257,169483,169740
718,recursive,"
Product: Transcend JetRAM 8GB DDR5 5600Mhz SO-DIMM Laptop RAM. Category: Transcend. Subcategory: RAM (Laptop). Price: 3,800৳4,000৳.

Product: Transcend JetRAM 16GB DDR5 4800Mhz SO-DIMM Laptop RAM. Category: Transcend. Subcategory: RAM (Laptop). Price: 6,200৳.
",261,169740,170001
719,recursive,"
Product: Transcend JetRAM 16GB DDR5 5600Mhz SO-DIMM Laptop RAM. Category: Transcend. Subcategory: RAM (Laptop). Price: 6,500৳6,700৳.

Product: Transcend 16GB DDR4 2666MHz SO-DIMM Laptop RAM. Category: Transcend. Subcategory: RAM (Laptop). Price: Out Of Stock.
",261,170001,170262
720,recursive,"
Product: Transcend 4GB JM DDR4 3200Mhz SO-DIMM Laptop RAM. Category: Transcend. Subcategory: RAM (Laptop). Price: Out Of Stock.

Product: Transcend 4GB DDR4 2666MHz Bus SO-DIMM Laptop RAM. Category: Transcend. Subcategory: RAM (Laptop). Price: Out Of Stock.
",259,170262,170521
721,recursive,"
Product: Transcend 8GB DDR4 2666MHz Bus SO-DIMM Laptop RAM. Category: Transcend. Subcategory: RAM (Laptop). Price: Out Of Stock.

Product: Transcend JetRAM 8GB DDR4 3200Mhz SO-DIMM Laptop RAM. Category: Transcend. Subcategory: RAM (Laptop). Price: Out Of Stock.
",263,170521,170784
722,recursive,"
Product: Transcend JetRAM 8GB DDR5 4800Mhz SO-DIMM Laptop RAM. Category: Transcend. Subcategory: RAM (Laptop). Price: Out Of Stock.

Product: Transcend JetRAM 16GB DDR4 3200Mhz SO-DIMM Laptop RAM. Category: Transcend. Subcategory: RAM (Laptop). Price: Out Of Stock.
",267,170784,171051
723,recursive,"
Product: Transcend JetRAM 32GB DDR4 3200Mhz SO-DIMM Laptop RAM. Category: Transcend. Subcategory: RAM (Laptop). Price: Out Of Stock.

Product: Transcend JetRAM 32GB DDR5 4800Mhz SO-DIMM Laptop RAM. Category: Transcend. Subcategory: RAM (Laptop). Price: Out Of Stock.
",268,171051,171319
724,recursive,"
Product: Samsung 4GB 1600MHz DDR3 PC3L Laptop RAM. Category: RAM (Laptop). Subcategory: Component. Price: 1,500৳.

Product: G.Skill Ripjaws 4GB DDR3 1600MHz SO-DIMM Laptop RAM. Category: RAM (Laptop). Subcategory: Component. Price: 1,400৳1,500৳.
",247,171319,171566
725,recursive,"
Product: G.Skill Ripjaws 4GB DDR4-L 2400MHz SO-DIMM Laptop RAM. Category: RAM (Laptop). Subcategory: Component. Price: 1,900৳.

Product: Lexar 4GB DDR4 3200MHz SODIMM Laptop RAM. Category: RAM (Laptop). Subcategory: Component. Price: 1,500৳2,000৳.
",249,171566,171815
726,recursive,"
Product: G.Skill RipJaws 4GB 2666MHz Laptop RAM. Category: RAM (Laptop). Subcategory: Component. Price: 1,900৳2,200৳.

Product: Netac Basic SO DDR4 2666MHz 8GB Laptop RAM. Category: RAM (Laptop). Subcategory: Component. Price: 2,500৳.
",236,171815,172051
727,recursive,"
Product: Lexar 8GB DDR4 3200MHz SODIMM Laptop RAM. Category: RAM (Laptop). Subcategory: Component. Price: 3,000৳.

Product: G.Skill Ripjaws 8GB DDR4 3200MHz C22 Laptop RAM. Category: RAM (Laptop). Subcategory: Component. Price: 3,100৳.
",237,172051,172288
728,recursive,"
Product: G.Skill RipJaws 8GB 2666MHz Laptop RAM. Category: RAM (Laptop). Subcategory: Component. Price: 3,200৳.

Product: G.Skill Ripjaws 8GB DDR4-L 2400MHz SO-DIMM Laptop RAM. Category: RAM (Laptop). Subcategory: Component. Price: 3,100৳3,200৳.
",247,172288,172535
729,recursive,"
Product: CORSAIR VENGEANCE 8GB DDR4 3200MHz SODIMM Laptop RAM. Category: RAM (Laptop). Subcategory: Component. Price: 3,300৳.

Product: G.Skill Ripjaws 8GB DDR4 3200MHz SO-DIMM Laptop RAM. Category: RAM (Laptop). Subcategory: Component. Price: 3,600৳.
",253,172535,172788
730,recursive,"
Product: G.Skill Ripjaws 16GB DDR4 3200MHz C22 Laptop RAM. Category: RAM (Laptop). Subcategory: Component. Price: 5,300৳.

Product: G.Skill Ripjaws 16GB DDR4 2666MHz SO-DIMM Laptop RAM. Category: RAM (Laptop). Subcategory: Component. Price: 5,500৳.
",250,172788,173038
731,recursive,"
Product: OCPC SODIMM VS 16GB DDR5 5600MHz Laptop RAM. Category: OCPC. Subcategory: RAM (Laptop). Price: 6,200৳.

Product: OCPC SODIMM VS DDR4 3200MHz 8GB Laptop RAM. Category: OCPC. Subcategory: RAM (Laptop). Price: Out Of Stock.
",231,173038,173269
732,recursive,"
Product: OCPC SODIMM VS 16GB DDR5 4800MHz Laptop RAM. Category: OCPC. Subcategory: RAM (Laptop). Price: Out Of Stock.

Product: Lexar 4GB DDR4 2666Mhz SODIMM Laptop RAM. Category: Lexar. Subcategory: RAM (Laptop). Price: Out Of Stock.
",236,173269,173505
733,recursive,"
Product: Lexar 8GB DDR4 2666Mhz SODIMM Laptop RAM. Category: Lexar. Subcategory: RAM (Laptop). Price: Out Of Stock.

Product: Lexar 32GB DDR4 3200MHz SODIMM Laptop RAM. Category: Lexar. Subcategory: RAM (Laptop). Price: Out Of Stock.
",235,173505,173740
734,recursive,"
Product: Lexar 16GB DDR4 3200MHz SODIMM Laptop RAM. Category: Lexar. Subcategory: RAM (Laptop). Price: Out Of Stock.

Product: Corsair VENGEANCE 16GB DDR5 5200MHz SODIMM Laptop RAM. Category: Corsair. Subcategory: RAM (Laptop). Price: 6,500৳.
",244,173740,173984
735,recursive,"
Product: CORSAIR VENGEANCE 16GB DDR4 3200MHz SODIMM Laptop RAM. Category: Corsair. Subcategory: RAM (Laptop). Price: Out Of Stock.

Product: CORSAIR VENGEANCE 16GB DDR5 4800MHz SODIMM Laptop RAM. Category: Corsair. Subcategory: RAM (Laptop). Price: Out Of Stock.
",264,173984,174248
736,recursive,"
Product: CORSAIR VENGEANCE 16GB DDR5 5600MHz SODIMM Laptop RAM. Category: Corsair. Subcategory: RAM (Laptop). Price: Out Of Stock.

Product: G.Skill Ripjaws 16GB DDR4 3200MHz SO-DIMM Laptop RAM. Category: G.Skill. Subcategory: RAM (Laptop). Price: 8,000৳.
",257,174248,174505
737,recursive,"
Product: G.Skill Ripjaws 8GB DDR3 1600MHz SO-DIMM Laptop RAM. Category: G.Skill. Subcategory: RAM (Laptop). Price: Out Of Stock.

Product: G.Skill Ripjaws 16GB DDR4 2400MHz SO-DIMM Laptop RAM. Category: G.Skill. Subcategory: RAM (Laptop). Price: Out Of Stock.
",261,174505,174766
738,recursive,"
Product: G.Skill Ripjaws 16GB DDR5 4800MHz SO-DIMM Laptop RAM. Category: G.Skill. Subcategory: RAM (Laptop). Price: Out Of Stock.

Product: G.Skill Ripjaws 32GB DDR4 3200MHz C22 Laptop RAM. Category: G.Skill. Subcategory: RAM (Laptop). Price: Out Of Stock.
",258,174766,175024
739,recursive,"
Product: BORY 8GB DDR4 3200MHz SODIMM Laptop RAM. Category: Bory. Subcategory: RAM (Laptop). Price: Out Of Stock.

Product: BORY 16GB DDR4 3200MHz SODIMM Laptop RAM. Category: Bory. Subcategory: RAM (Laptop). Price: Out Of Stock.
",231,175024,175255
740,recursive,"
Product: Toshiba P300 2TB 3.5-Inch SATA 7200RPM Desktop HDD. Category: Toshiba. Subcategory: Hard Disk Drive. Price: 7,800৳.

Product: Toshiba S300 4TB 3.5 Inch Surveillance HDD. Category: Toshiba. Subcategory: Hard Disk Drive. Price: 12,500৳.
",245,175255,175500
741,recursive,"
Product: TOSHIBA X300 Performance 4TB 3.5"" 7200 RPM SATA Hard Disk Drive. Category: Toshiba. Subcategory: Hard Disk Drive. Price: 17,400৳17,500৳.

Product: Toshiba S300 6TB 5400rpm 3.5"" Surveillance Hard Drive. Category: Toshiba. Subcategory: Hard Disk Drive. Price: 19,200৳.
",277,175500,175777
742,recursive,"
Product: TOSHIBA Tomcat Nearline 4TB 3.5 Inch 7200RPM SATA NAS HDD. Category: Toshiba. Subcategory: Hard Disk Drive. Price: 20,500৳20,700৳.

Product: Toshiba S300 Pro 10TB 7200rpm 3.5"" Surveillance Hard Drive. Category: Toshiba. Subcategory: Hard Disk Drive. Price: 36,000৳36,500৳.
",283,175777,176060
743,recursive,"
Product: Toshiba MG07ACA Enterprise 12TB 3.5 Inch SATA 7200RPM HDD. Category: Toshiba. Subcategory: Hard Disk Drive. Price: 38,900৳.

Product: Toshiba 1TB Sata Laptop Hard Disk. Category: Toshiba. Subcategory: Hard Disk Drive. Price: Out Of Stock.
",249,176060,176309
744,recursive,"
Product: Toshiba S300 1TB 5700rpm 3.5"" Surveillance Hard Drive. Category: Toshiba. Subcategory: Hard Disk Drive. Price: Out Of Stock.

Product: Toshiba DT01ABA100V 1TB Surveillance Hard Drive. Category: Toshiba. Subcategory: Hard Disk Drive. Price: Out Of Stock.
",264,176309,176573
745,recursive,"
Product: Toshiba 3TB SATA Desktop Hard Disk. Category: Toshiba. Subcategory: Hard Disk Drive. Price: Out Of Stock.

Product: Toshiba P300 2TB 3.5-Inch SATA 5400RPM Desktop HDD. Category: Toshiba. Subcategory: Hard Disk Drive. Price: Out Of Stock.
",248,176573,176821
746,recursive,"
Product: Toshiba 2TB Sata Desktop Hard Disk. Category: Toshiba. Subcategory: Hard Disk Drive. Price: Out Of Stock.

Product: Toshiba P300 1TB Desktop PC Internal Hard Drive. Category: Toshiba. Subcategory: Hard Disk Drive. Price: Out Of Stock.
",245,176821,177066
747,recursive,"
Product: Toshiba S300 2TB 5400rpm 3.5"" Surveillance Hard Drive. Category: Toshiba. Subcategory: Hard Disk Drive. Price: Out Of Stock.

Product: Toshiba P300 4TB 3.5-Inch SATA 5400RPM Desktop HDD. Category: Toshiba. Subcategory: Hard Disk Drive. Price: Out Of Stock.
",267,177066,177333
748,recursive,"
Product: Toshiba 4TB Sata Desktop Hard Disk. Category: Toshiba. Subcategory: Hard Disk Drive. Price: Out Of Stock.

Product: Toshiba P300 6TB 3.5-Inch SATA 5400RPM Desktop HDD. Category: Toshiba. Subcategory: Hard Disk Drive. Price: Out Of Stock.
",248,177333,177581
749,recursive,"
Product: Toshiba S300 Pro 6TB 7200rpm 3.5"" Surveillance Hard Drive. Category: Toshiba. Subcategory: Hard Disk Drive. Price: Out Of Stock.

Product: TOSHIBA MG08-D Series 6TB 3.5"" 7200RPM Enterprise HDD. Category: Toshiba. Subcategory: Hard Disk Drive. Price: Out Of Stock.
",274,177581,177855
750,recursive,"
Product: Seagate SkyHawk 2TB 3.5"" Surveillance Hard Drive. Category: Seagate. Subcategory: Hard Disk Drive. Price: 8,700৳9,200৳.

Product: Seagate Barracuda 2TB 7200RPM SATA 3.5-inch HDD. Category: Seagate. Subcategory: Hard Disk Drive. Price: 8,800৳9,200৳.
",259,177855,178114
751,recursive,"
Product: Seagate SkyHawk 4TB Surveillance Hard Drive. Category: Seagate. Subcategory: Hard Disk Drive. Price: 12,500৳14,000৳.

Product: Seagate Barracuda 4TB SATA 3.5 inch HDD. Category: Seagate. Subcategory: Hard Disk Drive. Price: 14,400৳14,700৳.
",250,178114,178364
752,recursive,"
Product: Seagate Barracuda 6TB 3.5 Inch Desktop HDD. Category: Seagate. Subcategory: Hard Disk Drive. Price: 18,000৳.

Product: Seagate Skyhawk 6TB 3.5"" Surveillance Internal HDD. Category: Seagate. Subcategory: Hard Disk Drive. Price: 20,000৳.
",246,178364,178610
753,recursive,"
Product: Seagate Skyhawk 6TB 3.5"" Surveillance HDD. Category: Seagate. Subcategory: Hard Disk Drive. Price: 20,500৳.

Product: Seagate Barracuda 8TB 3.5 Inch Desktop HDD. Category: Seagate. Subcategory: Hard Disk Drive. Price: 24,500৳.
",237,178610,178847
754,recursive,"
Product: Seagate SkyHawk 8TB 3.5 inch SATA 7200RPM Surveillance HDD. Category: Seagate. Subcategory: Hard Disk Drive. Price: 25,000৳.

Product: Seagate Exos 7E10 4TB 3.5 Inch SATA 7200RPM Enterprise HDD #ST4000NM024B. Category: Seagate. Subcategory: Hard Disk Drive. Price: 24,500৳25,700৳.
",291,178847,179138
755,recursive,"
Product: Seagate Exos 7E10 4TB 3.5 Inch SAS 7200RPM Enterprise Internal HDD #ST4000NM025B. Category: Seagate. Subcategory: Hard Disk Drive. Price: 25,500৳26,400৳.

Product: Seagate IronWolf 6TB 3.5 Inch SATA 5400RPM NAS HDD. Category: Seagate. Subcategory: Hard Disk Drive. Price: 26,400৳.
",291,179138,179429
756,recursive,"
Product: Seagate IronWolf 10TB SATA 3.5"" 7200RPM NAS Hard Disk. Category: Seagate. Subcategory: Hard Disk Drive. Price: 38,400৳39,500৳.

Product: Seagate Exos 7E10 10TB 7200RPM 3.5"" SATA Enterprise HDD. Category: Seagate. Subcategory: Hard Disk Drive. Price: 42,000৳43,000৳.
",276,179429,179705
757,recursive,"
Product: Seagate SkyHawk AI 12TB 3.5"" Surveillance HDD. Category: Seagate. Subcategory: Hard Disk Drive. Price: 45,500৳.

Product: Seagate IronWolf Pro 10TB 3.5-inch SATA 7200RPM NAS HDD. Category: Seagate. Subcategory: Hard Disk Drive. Price: 45,000৳46,000৳.
",261,179705,179966
758,recursive,"
Product: Seagate IronWolf 12TB 3.5 Inch SATA 7200RPM NAS HDD. Category: Seagate. Subcategory: Hard Disk Drive. Price: 47,000৳47,800৳.

Product: Seagate Exos X18 12TB 7200rpm SATA III 3.5"" NAS HDD. Category: Seagate. Subcategory: Hard Disk Drive. Price: 58,000৳59,000৳.
",270,179966,180236
759,recursive,"
Product: Seagate IronWolf Pro 16TB 3.5 Inch SATA 7200RPM NAS HDD. Category: Seagate. Subcategory: Hard Disk Drive. Price: 62,500৳66,500৳.

Product: Seagate Exos X18 18TB 7200rpm SATA III 3.5"" NAS HDD. Category: Seagate. Subcategory: Hard Disk Drive. Price: 63,500৳72,500৳.
",274,180236,180510
760,recursive,"
Product: Netac Basic SO DDR3L 1600MHz 4GB Laptop RAM. Category: Netac. Subcategory: RAM (Laptop). Price: Up Coming.

Product: Netac Basic SO DDR3L 1600MHz 8GB Laptop RAM. Category: Netac. Subcategory: RAM (Laptop). Price: Up Coming.
",234,180510,180744
761,recursive,"
Product: Netac Basic SO DDR4 2666MHz 4GB Laptop RAM. Category: Netac. Subcategory: RAM (Laptop). Price: Up Coming.

Product: Netac Basic SO DDR4 3200MHz 8GB Laptop RAM. Category: Netac. Subcategory: RAM (Laptop). Price: 2,800৳.
",229,180744,180973
762,recursive,"
Product: Netac Basic SO DDR4 3200MHz 16GB Laptop RAM. Category: Netac. Subcategory: RAM (Laptop). Price: Up Coming.

Product: Xtreme XPS550N 200W ATX Power Supply. Category: Power Supply. Subcategory: Component. Price: 1,350৳1,700৳.
",234,180973,181207
763,recursive,"
Product: Xtreme XJOGOS JPS300G 300W ATX Power Supply. Category: Power Supply. Subcategory: Component. Price: 1,900৳2,000৳.

Product: Huntkey CP3000 300W Power Supply. Category: Power Supply. Subcategory: Component. Price: 2,300৳2,500৳.
",237,181207,181444
764,recursive,"
Product: Thermaltake W0422RE Litepower 350W Non Modular Power Supply. Category: Power Supply. Subcategory: Component. Price: 2,550৳2,750৳.

Product: MSI MAG A300N-H 300W 80 Plus Non Modular Power Supply. Category: Power Supply. Subcategory: Component. Price: 2,800৳.
",268,181444,181712
765,recursive,"
Product: Antec META V350 350W Power Supply. Category: Power Supply. Subcategory: Component. Price: 3,050৳.

Product: Gamdias AURA GP450 PRO 450W 80 Plus White Certified ATX Power Supply Black. Category: Power Supply. Subcategory: Component. Price: 3,099৳.
",257,181712,181969
766,recursive,"
Product: Thermaltake Litepower 450W Non Modular Power Supply. Category: Power Supply. Subcategory: Component. Price: 3,100৳3,300৳.

Product: Gamdias AURA GP550 550W Power Supply. Category: Power Supply. Subcategory: Component. Price: 3,300৳.
",243,181969,182212
767,recursive,"
Product: Antec META V450 450W Power Supply. Category: Power Supply. Subcategory: Component. Price: 3,350৳.

Product: 1STPLAYER FK 5.0 PS-500FK 500W Non-Modular ATX Power Supply. Category: Power Supply. Subcategory: Component. Price: 3,500৳.
",242,182212,182454
768,recursive,"
Product: Antec META V550 550W Power Supply. Category: Power Supply. Subcategory: Component. Price: 3,650৳.

Product: Gamdias HELIOS M1-450B 450W 80 Plus Bronze Power Supply. Category: Power Supply. Subcategory: Component. Price: 4,400৳.
",238,182454,182692
769,recursive,"
Product: Huntkey CP5000 500W Power Supply. Category: Power Supply. Subcategory: Component. Price: 4,300৳4,500৳.

Product: MSI MAG A500DN 500W 80 Plus Standard Power Supply. Category: Power Supply. Subcategory: Component. Price: 4,300৳4,580৳.
",243,182692,182935
770,recursive,"
Product: Xigmatek Odin 500W 80 Plus Power Supply. Category: Power Supply. Subcategory: Component. Price: 4,300৳4,500৳.

Product: Cougar STC550 550W 80+ White Non-Modular Power Supply. Category: Power Supply. Subcategory: Component. Price: 5,000৳.
",248,182935,183183
771,recursive,"
Product: Acer AC-550 550W 80 Plus Bronze Full Modular Power Supply. Category: Power Supply. Subcategory: Component. Price: 4,800৳5,100৳.

Product: Huntkey CP6000 600W Power Supply. Category: Power Supply. Subcategory: Component. Price: 4,800৳5,200৳.
",251,183183,183434
772,recursive,"
Product: ADATA HD330 2TB USB 3.1 Durable External Hard Drive. Category: ADATA. Subcategory: Portable Hard Disk Drive. Price: Out Of Stock.

Product: ADATA HD330 1TB USB 3.1 Durable External Hard Drive. Category: ADATA. Subcategory: Portable Hard Disk Drive. Price: Out Of Stock.
",280,183434,183714
773,recursive,"
Product: ADATA HD680 1TB USB 3.2 Durable External Hard Drive. Category: ADATA. Subcategory: Portable Hard Disk Drive. Price: Out Of Stock.

Product: Adata HD720 2TB USB 3.2 External Hard Drive. Category: ADATA. Subcategory: Portable Hard Disk Drive. Price: Out Of Stock.
",272,183714,183986
774,recursive,"
Product: ADATA HD680 2TB External Hard Drive. Category: ADATA. Subcategory: Portable Hard Disk Drive. Price: Out Of Stock.

Product: ADATA HV 620 2TB USB 3.0 External HDD. Category: ADATA. Subcategory: Portable Hard Disk Drive. Price: Out Of Stock.
",250,183986,184236
775,recursive,"
Product: Adata HD720 2TB USB 3.2 Blue External Hard Drive. Category: ADATA. Subcategory: Portable Hard Disk Drive. Price: Out Of Stock.

Product: Adata HD710 Pro 2TB USB 3.2 Blue External Hard Drive. Category: ADATA. Subcategory: Portable Hard Disk Drive. Price: Out Of Stock.
",278,184236,184514
776,recursive,"
Product: Adata HD710 Pro 2TB USB 3.2 Yellow External Hard Drive. Category: ADATA. Subcategory: Portable Hard Disk Drive. Price: Out Of Stock.

Product: Adata HD710M Pro 2TB USB 3.2 Camouflage External Hard Drive. Category: ADATA. Subcategory: Portable Hard Disk Drive. Price: Out Of Stock.
",291,184514,184805
777,recursive,"
Product: Adata HD770G 2TB USB 3.2 RGB Black External Hard Drive. Category: ADATA. Subcategory: Portable Hard Disk Drive. Price: Out Of Stock.

Product: ADATA HD330 4TB USB 3.1 Durable External Hard Drive. Category: ADATA. Subcategory: Portable Hard Disk Drive. Price: Out Of Stock.
",283,184805,185088
778,recursive,"
Product: ADATA HD330 5TB USB 3.1 Durable External Hard Drive. Category: ADATA. Subcategory: Portable Hard Disk Drive. Price: Out Of Stock.

Product: ADATA 6TB HM800 3.5 External Hard Drive. Category: ADATA. Subcategory: Portable Hard Disk Drive. Price: Out Of Stock.
",268,185088,185356
779,recursive,"
Product: ADATA 8TB HM800 3.5 External Hard Drive. Category: ADATA. Subcategory: Portable Hard Disk Drive. Price: Out Of Stock.

Product: Toshiba Canvio Basic 1TB External Hard Disk Drive. Category: Toshiba. Subcategory: Portable Hard Disk Drive. Price: Out Of Stock.
",268,185356,185624
780,recursive,"
Product: Toshiba Canvio Basic A5 1TB USB 3.2 External Hard Disk Drive. Category: Toshiba. Subcategory: Portable Hard Disk Drive. Price: Out Of Stock.
",151,185624,185775
781,recursive,"
Product: Toshiba Canvio Partner 1TB USB Type-C External Hard Disk Drive. Category: Toshiba. Subcategory: Portable Hard Disk Drive. Price: Out Of Stock.

Product: Toshiba Canvio Basic 2TB External Hard Disk Drive. Category: Toshiba. Subcategory: Portable Hard Disk Drive. Price: Out Of Stock.
",293,185775,186068
782,recursive,"
Product: Toshiba Canvio Basic A5 2TB USB 3.2 External Hard Disk Drive. Category: Toshiba. Subcategory: Portable Hard Disk Drive. Price: Out Of Stock.
",151,186068,186219
783,recursive,"
Product: Toshiba Canvio Partner 2TB USB Type-C External Hard Disk Drive. Category: Toshiba. Subcategory: Portable Hard Disk Drive. Price: Out Of Stock.
",153,186219,186372
784,recursive,"
Product: Toshiba Canvio Gaming 4TB USB 3.2 External Hard Disk Drive. Category: Toshiba. Subcategory: Portable Hard Disk Drive. Price: Out Of Stock.
",149,186372,186521
785,recursive,"
Product: Toshiba Canvio Flex 4TB USB 3.2 Type-C External Hard Disk Drive. Category: Toshiba. Subcategory: Portable Hard Disk Drive. Price: Out Of Stock.

Product: Transcend J25M3 1TB USB 3.1 Portable Hard Disk. Category: Portable Hard Disk Drive. Subcategory: Component. Price: 8,800৳.
",287,186521,186808
786,recursive,"
Product: Transcend 25H3 1TB USB 3.1 External HDD. Category: Portable Hard Disk Drive. Subcategory: Component. Price: 8,800৳.

Product: Western Digital 2TB My Passport Portable HDD. Category: Portable Hard Disk Drive. Subcategory: Component. Price: 8,800৳8,999৳.
",263,186808,187071
787,recursive,"
Product: Transcend J25H3 2TB USB 3.1 Portable Hard Disk. Category: Portable Hard Disk Drive. Subcategory: Component. Price: 11,500৳.

Product: Transcend J25M3 2TB USB 3.1 Portable Hard Disk. Category: Portable Hard Disk Drive. Subcategory: Component. Price: 11,500৳.
",268,187071,187339
788,recursive,"
Product: Western Digital External 4TB My Passport Hard Disk Drive. Category: Portable Hard Disk Drive. Subcategory: Component. Price: 13,800৳.

Product: Western Digital 5TB My Passport Portable HDD. Category: Portable Hard Disk Drive. Subcategory: Component. Price: 15,500৳.
",276,187339,187615
789,recursive,"
Product: Transcend StoreJet 25H3 4TB USB 3.1 External 2.5"" Portable Hard Disk. Category: Portable Hard Disk Drive. Subcategory: Component. Price: 17,400৳.

Product: Transcend StoreJet 25M3 4TB USB 3.1 Portable Hard Disk. Category: Portable Hard Disk Drive. Subcategory: Component. Price: 17,400৳.
",298,187615,187913
790,recursive,"
Product: Seagate One Touch Hub 6TB External HDD. Category: Portable Hard Disk Drive. Subcategory: Component. Price: 22,900৳23,500৳.

Product: Seagate One Touch Hub 8TB External Hard Disk Drive. Category: Portable Hard Disk Drive. Subcategory: Component. Price: 31,999৳33,000৳.
",278,187913,188191
791,recursive,"
Product: Seagate One Touch Hub 10TB External Hard Disk Drive. Category: Portable Hard Disk Drive. Subcategory: Component. Price: 36,000৳40,000৳.

Product: Seagate One Touch Hub 12TB External Hard Disk Drive. Category: Portable Hard Disk Drive. Subcategory: Component. Price: 37,720৳41,000৳.
",292,188191,188483
792,recursive,"
Product: Western Digital My Book 12TB External Hard Drive. Category: Portable Hard Disk Drive. Subcategory: Component. Price: 40,255৳41,500৳.

Product: Seagate One Touch Hub 16TB Type-C External HDD. Category: Portable Hard Disk Drive. Subcategory: Component. Price: 56,000৳57,500৳.
",284,188483,188767
793,recursive,"
Product: SanDisk Professional G-DRIVE PROJECT 6TB Thunderbolt 3 External Hard Drive. Category: Portable Hard Disk Drive. Subcategory: Component. Price: 56,000৳60,000৳.
",169,188767,188936
794,recursive,"
Product: Seagate One Touch Hub 20TB Type-C External HDD. Category: Portable Hard Disk Drive. Subcategory: Component. Price: 73,500৳75,000৳.
",141,188936,189077
795,recursive,"
Product: SanDisk Professional G-DRIVE Enterprise-Class 12TB USB 3.2 Gen 2 External HDD. Category: Portable Hard Disk Drive. Subcategory: Component. Price: 86,000৳.
",165,189077,189242
796,recursive,"
Product: Asus FX 2TB 2.5"" Aura Sync RGB USB 3.1 External HDD. Category: Portable Hard Disk Drive. Subcategory: Component. Price: Up Coming.

Product: Western Digital Black 2TB SATA Hard Disk. Category: Western Digital. Subcategory: Hard Disk Drive. Price: Out Of Stock.
",271,189242,189513
797,recursive,"
Product: Western Digital 1TB Purple Surveillance HDD. Category: Western Digital. Subcategory: Hard Disk Drive. Price: Out Of Stock.

Product: Western Digital 1TB Blue Desktop HDD. Category: Western Digital. Subcategory: Hard Disk Drive. Price: Out Of Stock.
",259,189513,189772
798,recursive,"
Product: Western Digital 2TB Purple Surveillance HDD. Category: Western Digital. Subcategory: Hard Disk Drive. Price: Out Of Stock.

Product: Western Digital 2TB Blue Desktop HDD. Category: Western Digital. Subcategory: Hard Disk Drive. Price: Out Of Stock.
",259,189772,190031
799,recursive,"
Product: Western Digital 2TB Blue 7200RPM Desktop HDD. Category: Western Digital. Subcategory: Hard Disk Drive. Price: Out Of Stock.

Product: Western Digital Red 2TB Nas Storage Hard Disk Drive.. Category: Western Digital. Subcategory: Hard Disk Drive. Price: Out Of Stock.
",276,190031,190307
800,recursive,"
Product: Western Digital 4TB Blue 5400RPM Desktop HDD. Category: Western Digital. Subcategory: Hard Disk Drive. Price: Out Of Stock.

Product: Western Digital 4TB Purple Surveillance HDD. Category: Western Digital. Subcategory: Hard Disk Drive. Price: Out Of Stock.
",267,190307,190574
801,recursive,"
Product: Western Digital 4TB Red Nas Hard Disk. Category: Western Digital. Subcategory: Hard Disk Drive. Price: Out Of Stock.

Product: Western Digital 6TB Blue 5400RPM Desktop HDD. Category: Western Digital. Subcategory: Hard Disk Drive. Price: Out Of Stock.
",261,190574,190835
802,recursive,"
Product: Western Digital 6TB 3.5"" RED NAS HDD WD60EFRX. Category: Western Digital. Subcategory: Hard Disk Drive. Price: Out Of Stock.

Product: Western Digital 6TB 3.5"" Purple Surveillance HDD. Category: Western Digital. Subcategory: Hard Disk Drive. Price: Out Of Stock.
",273,190835,191108
803,recursive,"
Product: Western Digital Purple 6TB 3.5"" 5400RPM Surveillance HDD. Category: Western Digital. Subcategory: Hard Disk Drive. Price: Out Of Stock.

Product: Western Digital 8TB 3.5"" PURPLE Surveillance HDD. Category: Western Digital. Subcategory: Hard Disk Drive. Price: Out Of Stock.
",284,191108,191392
804,recursive,"
Product: Western Digital Purple Pro 8TB Surveillance HDD. Category: Western Digital. Subcategory: Hard Disk Drive. Price: Out Of Stock.

Product: Western Digital 10TB Purple Surveillance HDD. Category: Western Digital. Subcategory: Hard Disk Drive. Price: Out Of Stock.
",271,191392,191663
805,recursive,"
Product: Western Digital Purple Pro 10TB Surveillance HDD. Category: Western Digital. Subcategory: Hard Disk Drive. Price: Out Of Stock.

Product: LaCie 2TB Rugged USB 3.0 Gen 1 USB-C External Hard Drive. Category: LaCie. Subcategory: Portable Hard Disk Drive. Price: Out Of Stock.
",283,191663,191946
806,recursive,"
Product: LaCie 4TB Rugged USB 3.0 Gen 1 USB-C External Hard Drive. Category: LaCie. Subcategory: Portable Hard Disk Drive. Price: Out Of Stock.
",145,191946,192091
807,recursive,"
Product: LaCie d2 Professional 8TB USB 3.2 Gen 2 Type-C External Hard Drive. Category: LaCie. Subcategory: Portable Hard Disk Drive. Price: Out Of Stock.
",155,192091,192246
808,recursive,"
Product: LaCie 10TB d2 Professional USB 3.2 Gen 2 Type-C External Hard Drive. Category: LaCie. Subcategory: Portable Hard Disk Drive. Price: Out Of Stock.

Product: Transcend 8TB 2-Bay Storejet Cloud 210. Category: Transcend. Subcategory: Portable Hard Disk Drive. Price: Out Of Stock.
",287,192246,192533
809,recursive,"
Product: Transcend TS2TSJM100 StoreJet 100 Portable Hard Drive For Mac 2TB. Category: Transcend. Subcategory: Portable Hard Disk Drive. Price: Out Of Stock.
",158,192533,192691
810,recursive,"
Product: Transcend Thunderbolt TS2TSJM300 StoreJet 100 Portable Hard Drive For Mac 2TB. Category: Transcend. Subcategory: Portable Hard Disk Drive. Price: Out Of Stock.
",170,192691,192861
811,recursive,"
Product: Transcend J25A3K 1TB USB 3.0 Black External HDD. Category: Transcend. Subcategory: Portable Hard Disk Drive. Price: Out Of Stock.

Product: Transcend StoreJet J25C3N 1TB External Hard Disk Drive (HDD). Category: Transcend. Subcategory: Portable Hard Disk Drive. Price: Out Of Stock.
",293,192861,193154
812,recursive,"
Product: Transcend StoreJet 25C3S 1TB USB 3.1 Gen 1 Type-C Silver External HDD. Category: Transcend. Subcategory: Portable Hard Disk Drive. Price: Out Of Stock.
",162,193154,193316
813,recursive,"
Product: Transcend J25A3K 2TB USB 3.0 Black External HDD. Category: Transcend. Subcategory: Portable Hard Disk Drive. Price: Out Of Stock.

Product: Transcend TS2TSJ25C3N 2TB USB 3.0 Ultra Slim External HDD. Category: Transcend. Subcategory: Portable Hard Disk Drive. Price: Out Of Stock.
",290,193316,193606
814,recursive,"
Product: Transcend StoreJet 25C3S 2TB USB 3.1 Gen 1 Type-C Silver External HDD. Category: Transcend. Subcategory: Portable Hard Disk Drive. Price: Out Of Stock.
",162,193606,193768
815,recursive,"
Product: Transcend StoreJet 25M3C 2TB USB 3.1 Type-C Portable Hard Disk. Category: Transcend. Subcategory: Portable Hard Disk Drive. Price: Out Of Stock.
",155,193768,193923
816,recursive,"
Product: Transcend StoreJet 25M3C 4TB USB 3.1 Type-C Portable Hard Disk. Category: Transcend. Subcategory: Portable Hard Disk Drive. Price: Out Of Stock.

Product: Transcend J35T3 8TB USB 3.1 External HDD. Category: Transcend. Subcategory: Portable Hard Disk Drive. Price: Out Of Stock.
",288,193923,194211
817,recursive,"
Product: SanDisk Professional G-DRIVE ArmorATD 2TB USB-C Portable External Hard Drive. Category: SanDisk. Subcategory: Portable Hard Disk Drive. Price: Out Of Stock.
",167,194211,194378
818,recursive,"
Product: SanDisk Professional G-DRIVE ArmorATD 4TB USB-C Portable External Hard Drive. Category: SanDisk. Subcategory: Portable Hard Disk Drive. Price: Out Of Stock.
",167,194378,194545
819,recursive,"
Product: SanDisk Professional G-DRIVE ArmorATD 5TB USB-C Portable External Hard Drive. Category: SanDisk. Subcategory: Portable Hard Disk Drive. Price: Out Of Stock.
",167,194545,194712
820,recursive,"
Product: SanDisk Professional G-DRIVE Enterprise-Class 4TB USB 3.2 Gen 2 External HDD. Category: SanDisk. Subcategory: Portable Hard Disk Drive. Price: Out Of Stock.
",167,194712,194879
821,recursive,"
Product: SanDisk Professional G-DRIVE Enterprise-Class 4TB External HDD. Category: SanDisk. Subcategory: Portable Hard Disk Drive. Price: Out Of Stock.
",153,194879,195032
822,recursive,"
Product: SanDisk Professional G-DRIVE Enterprise-Class 6TB USB 3.2 Gen 2 External HDD. Category: SanDisk. Subcategory: Portable Hard Disk Drive. Price: Out Of Stock.
",167,195032,195199
823,recursive,"
Product: SanDisk Professional G-DRIVE Enterprise-Class 6TB External HDD. Category: SanDisk. Subcategory: Portable Hard Disk Drive. Price: Out Of Stock.
",153,195199,195352
824,recursive,"
Product: SanDisk Professional G-DRIVE Pro 6TB Thunderbolt External HDD. Category: SanDisk. Subcategory: Portable Hard Disk Drive. Price: Out Of Stock.
",152,195352,195504
825,recursive,"
Product: SanDisk Professional G-DRIVE Enterprise-Class 12TB External HDD. Category: SanDisk. Subcategory: Portable Hard Disk Drive. Price: Out Of Stock.
",154,195504,195658
826,recursive,"
Product: SanDisk Professional G-RAID 2 12TB 2-Bay RAID Array External HDD. Category: SanDisk. Subcategory: Portable Hard Disk Drive. Price: Out Of Stock.

Product: Western Digital Elements 2TB Portable HDD. Category: Western Digital. Subcategory: Portable Hard Disk Drive. Price: Out Of Stock.
",295,195658,195953
827,recursive,"
Product: Western Digital 1TB My Passport Portable HDD Sky. Category: Western Digital. Subcategory: Portable Hard Disk Drive. Price: Out Of Stock.

Product: Western Digital 1TB My Passport Portable HDD Red. Category: Western Digital. Subcategory: Portable Hard Disk Drive. Price: Out Of Stock.
",294,195953,196247
828,recursive,"
Product: Western Digital 2TB My Passport Portable HDD Sky. Category: Western Digital. Subcategory: Portable Hard Disk Drive. Price: Out Of Stock.

Product: Western Digital 2TB My Passport Type-C Portable HDD. Category: Western Digital. Subcategory: Portable Hard Disk Drive. Price: Out Of Stock.
",297,196247,196544
829,recursive,"
Product: Western Digital 2TB My Passport Type-C Portable HDD Grey. Category: Western Digital. Subcategory: Portable Hard Disk Drive. Price: Out Of Stock.

Product: Western Digital Elements 4TB Portable HDD. Category: Western Digital. Subcategory: Portable Hard Disk Drive. Price: Out Of Stock.
",295,196544,196839
830,recursive,"
Product: Western Digital My Book 4TB External Hard Drive. Category: Western Digital. Subcategory: Portable Hard Disk Drive. Price: Out Of Stock.

Product: Western Digital 4TB My Passport Portable HDD Red. Category: Western Digital. Subcategory: Portable Hard Disk Drive. Price: Out Of Stock.
",293,196839,197132
831,recursive,"
Product: Western Digital 5TB My Passport Type-C Portable HDD. Category: Western Digital. Subcategory: Portable Hard Disk Drive. Price: Out Of Stock.

Product: Western Digital My Cloud Home 4TB HDD. Category: Western Digital. Subcategory: Portable Hard Disk Drive. Price: Out Of Stock.
",286,197132,197418
832,recursive,"
Product: Western Digital My Book 6TB External Hard Drive. Category: Western Digital. Subcategory: Portable Hard Disk Drive. Price: Out Of Stock.

Product: Western Digital My Book 8TB External Hard Drive. Category: Western Digital. Subcategory: Portable Hard Disk Drive. Price: Out Of Stock.
",292,197418,197710
833,recursive,"
Product: Western Digital My Cloud Home 8TB HDD. Category: Western Digital. Subcategory: Portable Hard Disk Drive. Price: Out Of Stock.

Product: Western Digital 2TB My Passport Portable HDD White. Category: Western Digital. Subcategory: Portable Hard Disk Drive. Price: 9,000৳.
",279,197710,197989
834,recursive,"
Product: Western Digital 1TB My Passport Portable HDD. Category: Western Digital. Subcategory: Portable Hard Disk Drive. Price: Out Of Stock.

Product: Netac K338 1TB USB 3.0 Portable External HDD. Category: Netac. Subcategory: Portable Hard Disk Drive. Price: Up Coming.
",273,197989,198262
835,recursive,"
Product: Netac K338 2TB USB 3.0 Portable External HDD. Category: Netac. Subcategory: Portable Hard Disk Drive. Price: Up Coming.

Product: Netac K338 4TB USB 3.0 Portable External HDD. Category: Netac. Subcategory: Portable Hard Disk Drive. Price: Up Coming.
",260,198262,198522
836,recursive,"
Product: Seagate Basic 1TB Portable USB 3.0 External HDD. Category: Seagate. Subcategory: Portable Hard Disk Drive. Price: Out Of Stock.

Product: Seagate Basic 2TB Portable USB 3.0 External HDD. Category: Seagate. Subcategory: Portable Hard Disk Drive. Price: Out Of Stock.
",276,198522,198798
837,recursive,"
Product: Seagate One Touch 4TB USB 3.0 Black External HDD. Category: Seagate. Subcategory: Portable Hard Disk Drive. Price: Out Of Stock.

Product: Seagate STKZ5000400 One Touch 5TB External Hard Disk Drive. Category: Seagate. Subcategory: Portable Hard Disk Drive. Price: Out Of Stock.
",288,198798,199086
838,recursive,"
Product: Samsung T7 Shield 2TB USB 3.2 Type-C Portable SSD. Category: Samsung. Subcategory: Portable SSD. Price: 21,500৳22,700৳.

Product: SAMSUNG T7 2TB USB 3.2 Gen Type-C Portable SSD. Category: Samsung. Subcategory: Portable SSD. Price: 20,500৳23,500৳.
",257,199086,199343
839,recursive,"
Product: Samsung T7 1TB USB 3.2 Type-C Portable SSD. Category: Samsung. Subcategory: Portable SSD. Price: Out Of Stock.

Product: Samsung T7 Shield 1TB USB 3.2 Type-C Portable SSD. Category: Samsung. Subcategory: Portable SSD. Price: Out Of Stock.
",249,199343,199592
840,recursive,"
Product: SanDisk Extreme V2 1TB USB-C USB 3.2 Gen 2 Portable SSD. Category: SanDisk. Subcategory: Portable SSD. Price: 13,400৳.

Product: SanDisk Extreme V2 2TB USB-C USB 3.2 Gen 2 Portable SSD. Category: SanDisk. Subcategory: Portable SSD. Price: 18,999৳20,500৳.
",265,199592,199857
841,recursive,"
Product: Sandisk Extreme PRO V2 2TB USB 3.2 Gen 2 Type-C Portable SSD. Category: SanDisk. Subcategory: Portable SSD. Price: 25,999৳27,000৳.

Product: Sandisk Extreme PRO V2 1TB USB 3.2 Gen 2 Type-C Portable SSD. Category: SanDisk. Subcategory: Portable SSD. Price: 16,530৳19,000৳.
",282,199857,200139
842,recursive,"
Product: Sandisk 4TB USB 3.2 Gen 2 Type-C Portable SSD. Category: SanDisk. Subcategory: Portable SSD. Price: Up Coming.

Product: Sandisk 1TB USB 3.2 Gen 2 Type-C Portable SSD (Updated Firmware). Category: SanDisk. Subcategory: Portable SSD. Price: Out Of Stock.
",264,200139,200403
843,recursive,"
Product: Sandisk 1TB USB 3.2 Gen 2 Type-C Portable SSD. Category: SanDisk. Subcategory: Portable SSD. Price: Out Of Stock.

Product: SanDisk Extreme 1TB Type-C Portable SSD. Category: SanDisk. Subcategory: Portable SSD. Price: Out Of Stock.
",242,200403,200645
844,recursive,"
Product: Sandisk 2TB USB 3.2 Gen 2 Type-C Portable SSD (Updated Firmware). Category: SanDisk. Subcategory: Portable SSD. Price: Out Of Stock.

Product: Sandisk 2TB USB 3.2 Gen 2 Type-C Portable SSD. Category: SanDisk. Subcategory: Portable SSD. Price: Out Of Stock.
",267,200645,200912
845,recursive,"
Product: Sandisk Extreme 2TB Portable SSD. Category: SanDisk. Subcategory: Portable SSD. Price: Out Of Stock.

Product: Sandisk Extreme PRO V2 4TB USB 3.2 Gen 2 Type-C Portable SSD. Category: SanDisk. Subcategory: Portable SSD. Price: Out Of Stock.
",250,200912,201162
846,recursive,"
Product: SanDisk Extreme V2 4TB USB-C USB 3.2 Gen 2 Portable SSD. Category: SanDisk. Subcategory: Portable SSD. Price: Out Of Stock.

Product: Transcend ESD330C 512GB Type-C Portable SSD. Category: Transcend. Subcategory: Portable SSD. Price: 6,050৳6,300৳.
",258,201162,201420
847,recursive,"
Product: Transcend ESD300S 512GB Type-C Portable SSD. Category: Transcend. Subcategory: Portable SSD. Price: 5,900৳6,500৳.

Product: Transcend ESD300C 512GB USB Type-C Portable SSD. Category: Transcend. Subcategory: Portable SSD. Price: 5,950৳6,800৳.
",252,201420,201672
848,recursive,"
Product: Transcend ESD300C 1TB USB Type-C Portable SSD. Category: Transcend. Subcategory: Portable SSD. Price: 10,500৳10,700৳.

Product: Transcend ESD320A 1TB Type-A Portable SSD. Category: Transcend. Subcategory: Portable SSD. Price: 10,500৳10,900৳.
",252,201672,201924
849,recursive,"
Product: Transcend ESD300P 1TB Type-C Portable SSD. Category: Transcend. Subcategory: Portable SSD. Price: 10,100৳11,000৳.

Product: Transcend ESD265C 2TB Type-C Portable SSD. Category: Transcend. Subcategory: Portable SSD. Price: 21,800৳22,000৳.
",248,201924,202172
850,recursive,"
Product: Transcend ESD320A 2TB Type-A Portable SSD. Category: Transcend. Subcategory: Portable SSD. Price: 21,300৳22,000৳.

Product: Transcend ESD330C 2TB Type-C Portable SSD. Category: Transcend. Subcategory: Portable SSD. Price: 21,300৳22,400৳.
",248,202172,202420
851,recursive,"
Product: Transcend ESD370C 250GB USB 3.1 Gen 2 Type-C Portable External SSD. Category: Transcend. Subcategory: Portable SSD. Price: Out Of Stock.

Product: Transcend ESD270C 250GB USB 3.1 Gen 2 Type-C External SSD. Category: Transcend. Subcategory: Portable SSD. Price: Out Of Stock.
",285,202420,202705
852,recursive,"
Product: Transcend ESD260C 250GB Type-C Portable External SSD. Category: Transcend. Subcategory: Portable SSD. Price: Out Of Stock.

Product: Transcend ESD310C 256GB USB Type-C Portable SSD. Category: Transcend. Subcategory: Portable SSD. Price: Out Of Stock.
",261,202705,202966
853,recursive,"
Product: Transcend ESD240C 240GB USB 3.1 Gen 2 Type-C Portable SSD. Category: Transcend. Subcategory: Portable SSD. Price: Out Of Stock.

Product: Transcend ESD270C 500GB USB 3.1 Gen 2 Type-C External SSD. Category: Transcend. Subcategory: Portable SSD. Price: Out Of Stock.
",276,202966,203242
854,recursive,"
Product: Transcend ESD310S 512GB USB Type-C Portable SSD. Category: Transcend. Subcategory: Portable SSD. Price: Out Of Stock.

Product: Transcend ESD310P 512GB USB Type-A & Type-C Dual Port Portable SSD. Category: Transcend. Subcategory: Portable SSD. Price: Out Of Stock.
",275,203242,203517
855,recursive,"
Product: Transcend ESD260C 500GB Type-C Portable External SSD. Category: Transcend. Subcategory: Portable SSD. Price: Out Of Stock.

Product: Transcend ESD370C 500GB USB 3.1 Portable External SSD. Category: Transcend. Subcategory: Portable SSD. Price: Out Of Stock.
",267,203517,203784
856,recursive,"
Product: Transcend ESD310C 512GB USB Type-C Portable SSD. Category: Transcend. Subcategory: Portable SSD. Price: Out Of Stock.

Product: Crucial X8 2TB USB 3.2 Type-C Portable SSD. Category: Crucial. Subcategory: Portable SSD. Price: 36,000৳.
",244,203784,204028
857,recursive,"
Product: Crucial X8 1TB USB 3.2 Type-C Portable SSD. Category: Crucial. Subcategory: Portable SSD. Price: Out Of Stock.

Product: Netac Z Slim 128GB USB 3.2 Gen 2 Type-C Portable SSD. Category: Netac. Subcategory: Portable SSD. Price: Up Coming.
",247,204028,204275
858,recursive,"
Product: Netac Z Slim 250GB USB 3.2 Gen 2 Type-C Portable SSD. Category: Netac. Subcategory: Portable SSD. Price: Up Coming.

Product: Netac Z Slim 500GB USB 3.2 Gen 2 Type-C Portable SSD. Category: Netac. Subcategory: Portable SSD. Price: Up Coming.
",252,204275,204527
859,recursive,"
Product: Netac Z Slim 1TB USB 3.2 Gen 2 Type-C Portable SSD. Category: Netac. Subcategory: Portable SSD. Price: Up Coming.

Product: Netac Z Slim 2TB USB 3.2 Gen 2 Type-C Portable SSD. Category: Netac. Subcategory: Portable SSD. Price: Up Coming.
",248,204527,204775
860,recursive,"
Product: Netac ZX 250GB USB 3.2 Gen 2 Type-C Portable SSD. Category: Netac. Subcategory: Portable SSD. Price: Up Coming.

Product: Netac ZX 500GB USB 3.2 Gen 2 Type-C Portable SSD. Category: Netac. Subcategory: Portable SSD. Price: Up Coming.
",244,204775,205019
861,recursive,"
Product: Netac ZX 1TB USB 3.2 Gen 2 Type-C Portable SSD. Category: Netac. Subcategory: Portable SSD. Price: Up Coming.

Product: Netac Z11 250GB USB 3.2 Gen 2 Type-C Portable SSD. Category: Netac. Subcategory: Portable SSD. Price: Up Coming.
",243,205019,205262
862,recursive,"
Product: Netac Z11 500GB USB 3.2 Gen 2 Type-C Portable SSD. Category: Netac. Subcategory: Portable SSD. Price: Up Coming.

Product: Netac Z11 1TB USB 3.2 Gen 2 Type-C Portable SSD. Category: Netac. Subcategory: Portable SSD. Price: Up Coming.
",244,205262,205506
863,recursive,"
Product: Netac Z9 250GB USB 3.2 Gen 2 Type-C Portable SSD. Category: Netac. Subcategory: Portable SSD. Price: Up Coming.

Product: Netac Z9 500GB USB 3.2 Gen 2 Type-C Portable SSD. Category: Netac. Subcategory: Portable SSD. Price: Up Coming.
",244,205506,205750
864,recursive,"
Product: Netac Z9 1TB USB 3.2 Gen 2 Type-C Portable SSD. Category: Netac. Subcategory: Portable SSD. Price: Up Coming.

Product: Netac Z9 2TB USB 3.2 Gen 2 Type-C Portable SSD. Category: Netac. Subcategory: Portable SSD. Price: Up Coming.
",240,205750,205990
865,recursive,"
Product: Netac Z7S 120GB USB 3.2 Type-C Portable SSD. Category: Netac. Subcategory: Portable SSD. Price: Up Coming.

Product: Netac Z7S 240GB USB 3.2 Type-C Portable SSD. Category: Netac. Subcategory: Portable SSD. Price: Up Coming.
",234,205990,206224
866,recursive,"
Product: Netac Z7S 480GB USB 3.2 Type-C Portable SSD. Category: Netac. Subcategory: Portable SSD. Price: Up Coming.

Product: Netac Z7S 960GB USB 3.2 Type-C Portable SSD. Category: Netac. Subcategory: Portable SSD. Price: Up Coming.
",234,206224,206458
867,recursive,"
Product: Netac Z7S 2TB USB 3.2 Type-C Portable SSD. Category: Netac. Subcategory: Portable SSD. Price: Up Coming.

Product: TEAM PD1000 512GB USB3.2 Type-C Portable SSD. Category: TEAM. Subcategory: Portable SSD. Price: 8,599৳8,900৳.
",235,206458,206693
868,recursive,"
Product: TEAM PD1000 1TB USB3.2 Type-C Portable SSD. Category: TEAM. Subcategory: Portable SSD. Price: 11,500৳12,999৳.

Product: TEAM PD20 ECO Mini 1TB Type-C Portable SSD. Category: TEAM. Subcategory: Portable SSD. Price: 13,050৳.
",233,206693,206926
869,recursive,"
Product: TEAM CinemaPr P31 1TB USB 3.2 Type-C External SSD. Category: TEAM. Subcategory: Portable SSD. Price: 19,999৳20,899৳.

Product: TEAM PD20 ECO Mini 2TB Type-C Portable SSD. Category: TEAM. Subcategory: Portable SSD. Price: 22,500৳.
",240,206926,207166
870,recursive,"
Product: TEAM PD20 Mini 2TB Type-C Portable SSD. Category: TEAM. Subcategory: Portable SSD. Price: 24,100৳.

Product: Team PD20M 2TB MagSafe Type-C Portable SSD. Category: TEAM. Subcategory: Portable SSD. Price: 24,100৳24,999৳.
",229,207166,207395
871,recursive,"
Product: TEAM T-Force M200 250GB USB3.2 Type-C Portable SSD. Category: TEAM. Subcategory: Portable SSD. Price: Out Of Stock.

Product: TEAM T-Force Treasure Touch 1TB Type-C USB 3.2 RGB Portable External SSD. Category: TEAM. Subcategory: Portable SSD. Price: Out Of Stock.
",274,207395,207669
872,recursive,"
Product: TEAM T-Force M200 500GB Portable SSD. Category: TEAM. Subcategory: Portable SSD. Price: Out Of Stock.

Product: Team PD20M 1TB MagSafe Type-C Portable SSD. Category: TEAM. Subcategory: Portable SSD. Price: Out Of Stock.
",230,207669,207899
873,recursive,"
Product: TEAM T-Force M200 1TB Portable SSD. Category: TEAM. Subcategory: Portable SSD. Price: Out Of Stock.

Product: TEAM T-Force M200 2TB Portable SSD. Category: TEAM. Subcategory: Portable SSD. Price: Out Of Stock.
",220,207899,208119
874,recursive,"
Product: TEAM PD20 Mini 1TB Type-C Portable SSD. Category: TEAM. Subcategory: Portable SSD. Price: Out Of Stock.

Product: Netac SA500 120GB 2.5-inch SATAIII SSD. Category: SSD. Subcategory: Component. Price: 1,350৳1,400৳.
",224,208119,208343
875,recursive,"
Product: Netac N535S 120GB 2.5-inch SATAIII SSD. Category: SSD. Subcategory: Component. Price: 1,300৳.

Product: Netac SA500 128GB 2.5-inch SATAIII SSD. Category: SSD. Subcategory: Component. Price: 1,380৳1,490৳.
",214,208343,208557
876,recursive,"
Product: Netac N535N 128GB M.2 2280 SSD. Category: SSD. Subcategory: Component. Price: 1,500৳1,600৳.

Product: ORICO Y20 128GB 2.5 Inch SATA III SSD. Category: SSD. Subcategory: Component. Price: 1,500৳1,600৳.
",211,208557,208768
877,recursive,"
Product: OCPC XTL-200 128GB SATA III SSD. Category: SSD. Subcategory: Component. Price: 1,650৳1,700৳.

Product: Patriot P210 128GB 2.5 inch SATA III SSD. Category: SSD. Subcategory: Component. Price: 1,800৳.
",209,208768,208977
878,recursive,"
Product: Hikvision E1000 128GB M.2 2280 NVMe PCIe Gen 3 x 4 SSD. Category: SSD. Subcategory: Component. Price: 1,850৳1,890৳.

Product: Netac N930E Pro 128GB NVMe M.2 2280 SSD. Category: SSD. Subcategory: Component. Price: 1,600৳1,650৳.
",237,208977,209214
879,recursive,"
Product: Colorful CN600 128gb M.2 Nvme SSD. Category: SSD. Subcategory: Component. Price: 1,900৳.

Product: Patriot P300 M.2 PCIe Gen 3 x4 128GB SSD. Category: SSD. Subcategory: Component. Price: 2,000৳.
",205,209214,209419
880,recursive,"
Product: OCPC MFL-300 128GB M.2 NVMe SSD. Category: SSD. Subcategory: Component. Price: 2,000৳2,050৳.

Product: Netac SA500 240GB 2.5-inch SATAIII SSD. Category: SSD. Subcategory: Component. Price: 2,000৳2,075৳.
",213,209419,209632
881,recursive,"
Product: Netac N535N 256GB M.2 2280 SSD. Category: SSD. Subcategory: Component. Price: 2,150৳2,190৳.

Product: OCPC XTL-200 256GB SATA III SSD. Category: SSD. Subcategory: Component. Price: 2,250৳.
",199,209632,209831
882,recursive,"
Product: OSCOO OS002 256GB 2.5'' SATA III SSD. Category: SSD. Subcategory: Component. Price: 2,200৳2,300৳.

Product: MiPhi MP100 256GB 2.5'' SATA III SSD. Category: SSD. Subcategory: Component. Price: 2,250৳2,350৳.
",216,209831,210047
883,recursive,"
Product: ORICO Y20 256GB 2.5 Inch SATA III SSD. Category: SSD. Subcategory: Component. Price: 2,399৳.

Product: COLORFUL SL500 256GB 2.5'' SATA III SSD. Category: SSD. Subcategory: Component. Price: 2,040৳2,400৳.
",214,210047,210261
884,recursive,"
Product: AITC KINGSMAN SK350 256GB 2.5"" SATA III SSD. Category: SSD. Subcategory: Component. Price: 2,450৳.

Product: Lexar SL600 512GB Blazing-fast USB 3.2 Gen2x2 Portable SSD. Category: Lexar. Subcategory: Portable SSD. Price: Out Of Stock.
",244,210261,210505
885,recursive,"
Product: Lexar SL660 512GB Blazing-fast Portable SSD. Category: Lexar. Subcategory: Portable SSD. Price: Out Of Stock.

Product: Lexar SL600 1TB Blazing-fast USB 3.2 Gen2x2 Portable SSD. Category: Lexar. Subcategory: Portable SSD. Price: Out Of Stock.
",253,210505,210758
886,recursive,"
Product: Seagate One Touch 1TB Portable USB Type-C Black External SSD. Category: Seagate. Subcategory: Portable SSD. Price: 17,300৳.

Product: Seagate One Touch 1TB External Portable SSD. Category: Seagate. Subcategory: Portable SSD. Price: 17,000৳17,500৳.
",258,210758,211016
887,recursive,"
Product: Seagate Ultra Compact 1TB Type-C Portable SSD. Category: Seagate. Subcategory: Portable SSD. Price: 20,000৳.

Product: Seagate One Touch 2TB USB Type-C External SSD. Category: Seagate. Subcategory: Portable SSD. Price: 20,400৳20,800৳.
",245,211016,211261
888,recursive,"
Product: Seagate Ultra Compact 2TB Type-C Portable SSD. Category: Seagate. Subcategory: Portable SSD. Price: 32,000৳.

Product: Seagate Expansion 1TB Portable USB 3.0 External SSD. Category: Seagate. Subcategory: Portable SSD. Price: Out Of Stock.
",249,211261,211510
889,recursive,"
Product: OSCOO MD008 512GB Magnetic Type-C Portable SSD. Category: Portable SSD. Subcategory: Component. Price: 6,000৳.

Product: OSCOO T10 512GB Type-C Portable SSD. Category: Portable SSD. Subcategory: Component. Price: 6,700৳.
",231,211510,211741
890,recursive,"
Product: OSCOO MD003 512GB Type-C Portable SSD. Category: Portable SSD. Subcategory: Component. Price: 4,600৳.

Product: OSCOO MD003 256GB Type-C Portable SSD. Category: Portable SSD. Subcategory: Component. Price: 3,000৳.
",224,211741,211965
891,recursive,"
Product: OSCOO MD005M 1TB Type-C Portable SSD. Category: Portable SSD. Subcategory: Component. Price: 7,600৳.

Product: OSCOO MD005M 512GB Type-C Portable SSD. Category: Portable SSD. Subcategory: Component. Price: 4,700৳.
",224,211965,212189
892,recursive,"
Product: OSCOO MD005M 256GB Type-C Portable SSD. Category: Portable SSD. Subcategory: Component. Price: 3,150৳.

Product: OSCOO T10 1TB Type-C Portable SSD. Category: Portable SSD. Subcategory: Component. Price: 10,300৳.
",222,212189,212411
893,recursive,"
Product: Patriot Transporter 1TB Type C Portable SSD. Category: Portable SSD. Subcategory: Component. Price: 10,500৳.

Product: Patriot VIPER Gaming PVP30 1TB USB Type-A & Type-C Portable SSD. Category: Portable SSD. Subcategory: Component. Price: 10,000৳.
",258,212411,212669
894,recursive,"
Product: Patriot Transporter 2TB Type C Portable SSD. Category: Portable SSD. Subcategory: Component. Price: 18,000৳.

Product: Patriot VIPER Gaming PVP30 512GB USB Type-A & Type-C Portable SSD. Category: Portable SSD. Subcategory: Component. Price: 6,000৳.
",259,212669,212928
895,recursive,"
Product: Corsair EX100U 1TB Type-C Portable SSD. Category: Corsair. Subcategory: Portable SSD. Price: 11,700৳12,000৳.

Product: Kingston SXS2000 500GB USB 3.2 Portable SSD. Category: Kingston. Subcategory: Portable SSD. Price: 7,800৳.
",236,212928,213164
896,recursive,"
Product: Kingston XS2000 1TB USB Type C 3.2 Gen 2 Portable SSD. Category: Kingston. Subcategory: Portable SSD. Price: 11,650৳11,800৳.

Product: Kingston XS1000 2TB USB 3.2 Gen 2 Portable SSD. Category: Kingston. Subcategory: Portable SSD. Price: 17,250৳.
",256,213164,213420
897,recursive,"
Product: Kingston XS2000 2TB USB 3.2 Gen 2 Portable SSD. Category: Kingston. Subcategory: Portable SSD. Price: 19,600৳.

Product: Adata SD600Q 240GB External SSD. Category: Adata. Subcategory: Portable SSD. Price: Out Of Stock.
",229,213420,213649
898,recursive,"
Product: Adata SE880 500GB USB 3.2 Type-C Portable External SSD. Category: Adata. Subcategory: Portable SSD. Price: Out Of Stock.

Product: Adata SE760 512GB USB 3.2 Type-C Portable External SSD. Category: Adata. Subcategory: Portable SSD. Price: Out Of Stock.
",262,213649,213911
899,recursive,"
Product: ADATA SC685 500GB External SSD. Category: Adata. Subcategory: Portable SSD. Price: Out Of Stock.

Product: Adata SD600Q 480GB External SSD. Category: Adata. Subcategory: Portable SSD. Price: Out Of Stock.
",215,213911,214126
900,recursive,"
Product: Adata SE880 1TB USB 3.2 Type-C Portable External SSD. Category: Adata. Subcategory: Portable SSD. Price: Out Of Stock.

Product: Adata SE760 1TB USB 3.2 Type-C Portable External SSD. Category: Adata. Subcategory: Portable SSD. Price: Out Of Stock.
",258,214126,214384
901,recursive,"
Product: Adata SD810 1TB USB 3.2 Type-C Portable External SSD. Category: Adata. Subcategory: Portable SSD. Price: Out Of Stock.

Product: ADATA SC685 1TB Type-C Portable External SSD. Category: Adata. Subcategory: Portable SSD. Price: Out Of Stock.
",250,214384,214634
902,recursive,"
Product: Adata SE760 2TB USB 3.2 Type-C Portable External SSD. Category: Adata. Subcategory: Portable SSD. Price: Out Of Stock.

Product: Adata SD810 4TB USB 3.2 Type-C Portable External SSD. Category: Adata. Subcategory: Portable SSD. Price: Out Of Stock.
",258,214634,214892
903,recursive,"
Product: Antec VX10M Micro-ATX Mini Tower Casing. Category: Casing. Subcategory: Component. Price: 1,450৳.

Product: Xtreme 950 Mid Tower ATX Casing. Category: Casing. Subcategory: Component. Price: 1,450৳1,500৳.
",214,214892,215106
904,recursive,"
Product: Xtreme 951 Mid Tower ATX Casing. Category: Casing. Subcategory: Component. Price: 1,550৳.

Product: Xtreme F01 RGB Mini Tower Casing. Category: Casing. Subcategory: Component. Price: 1,400৳1,599৳.
",207,215106,215313
905,recursive,"
Product: Xtreme F03 Mini Tower Casing. Category: Casing. Subcategory: Component. Price: 1,450৳1,599৳.

Product: MaxGreen H2 M-ATX Case With 200W Power Supply. Category: Casing. Subcategory: Component. Price: 2,500৳.
",217,215313,215530
906,recursive,"
Product: Xtreme M111 RGB Mid Tower Casing With 2 RGB Fan. Category: Casing. Subcategory: Component. Price: 2,500৳.

Product: MaxGreen H6 M-ATX Case with 200W Standard PSU. Category: Casing. Subcategory: Component. Price: 2,550৳.
",230,215530,215760
907,recursive,"
Product: PC Power 180B Mid-Tower ATX Desktop Casing. Category: Casing. Subcategory: Component. Price: 2,500৳2,600৳.

Product: Value-Top V200H Micro ATX Casing With PSU. Category: Casing. Subcategory: Component. Price: 2,400৳2,600৳.
",233,215760,215993
908,recursive,"
Product: MaxGreen 17303 Mid-Tower M-ATX Casing With 200W PSU. Category: Casing. Subcategory: Component. Price: 2,600৳.

Product: PC Power 180D-1U Mid Tower ATX Case. Category: Casing. Subcategory: Component. Price: 2,550৳2,750৳.
",230,215993,216223
909,recursive,"
Product: PC Power 180O Mid-Tower ATX Desktop Casing. Category: Casing. Subcategory: Component. Price: 2,600৳2,800৳.

Product: PC Power 180J Mid-Tower ATX Desktop Casing. Category: Casing. Subcategory: Component. Price: 2,450৳2,800৳.
",234,216223,216457
910,recursive,"
Product: PC Power PC404 Mid Tower ATX Casing With Power Supply. Category: Casing. Subcategory: Component. Price: 2,500৳2,800৳.

Product: PC Power 180D-2U Mid Tower ATX Case. Category: Casing. Subcategory: Component. Price: 2,600৳2,800৳.
",238,216457,216695
911,recursive,"
Product: 1STPLAYER MC1 mATX Gaming Casing With 200W PSU. Category: Casing. Subcategory: Component. Price: 2,500৳2,800৳.

Product: PC Power Pulse Fire X2 m-ATX Mid Tower Casing with 200W PSU. Category: Casing. Subcategory: Component. Price: 2,700৳2,800৳.
",255,216695,216950
912,recursive,"
Product: PC Power 180I Mid-Tower ATX Desktop Casing. Category: Casing. Subcategory: Component. Price: 2,850৳.

Product: Gamdias MARS E4M mATX Micro Tower Casing With PSU. Category: Casing. Subcategory: Component. Price: 2,900৳.
",229,216950,217179
913,recursive,"
Product: Arctic P12 Silent 120 mm Low Noise Casing Fan. Category: Casing Cooler. Subcategory: Component. Price: 1,000৳1,100৳.

Product: Arctic F12 PWM PST 120 mm Casing Fan. Category: Casing Cooler. Subcategory: Component. Price: 1,300৳1,350৳.
",245,217179,217424
914,recursive,"
Product: Xtreme XJOGOS CF31R 3 In 1 ARGB Casing Fan With Remote Controller. Category: Casing Cooler. Subcategory: Component. Price: 1,399৳1,500৳.

Product: MaxGreen M59 ARGB 3 in 1 120mm Casing Fan. Category: Casing Cooler. Subcategory: Component. Price: 1,500৳.
",264,217424,217688
915,recursive,"
Product: LITE-ON 8x Slim Internal Laptop DVD Burner. Category: Internal Optical Disk Drive. Subcategory: Optical Disk Drive. Price: Up Coming.

Product: LITE-ON 24X SATA Internal DVD Burner. Category: Internal Optical Disk Drive. Subcategory: Optical Disk Drive. Price: Out Of Stock.
",285,217688,217973
916,recursive,"
Product: ASUS BW-16D1HT Ultra-fast 16X Blu-ray DVD Writer. Category: Internal Optical Disk Drive. Subcategory: Optical Disk Drive. Price: Out Of Stock.

Product: Samsung Internal DVD RW. Category: Internal Optical Disk Drive. Subcategory: Optical Disk Drive. Price: Out Of Stock.
",281,217973,218254
917,recursive,"
Product: Asus DRW-24D5MT 24x DVDRW SATA. Category: Internal Optical Disk Drive. Subcategory: Optical Disk Drive. Price: Out Of Stock.

Product: Asus DRW-24B1ST Internal SATA DVD Writer. Category: Internal Optical Disk Drive. Subcategory: Optical Disk Drive. Price: Out Of Stock.
",280,218254,218534
918,recursive,"
Product: Transcend TS8XDVDS-K Slim External Black DVD Writer. Category: External Optical Disk Drive. Subcategory: Optical Disk Drive. Price: 4,200৳4,400৳.
",156,218534,218690
919,recursive,"
Product: ASUS ZenDrive SDRW-08U8M-U External DVD Drive. Category: External Optical Disk Drive. Subcategory: Optical Disk Drive. Price: 4,900৳.

Product: ASUS ZenDrive V1M External DVD Writer. Category: External Optical Disk Drive. Subcategory: Optical Disk Drive. Price: 5,600৳.
",280,218690,218970
920,recursive,"
Product: Orico XD007-BK-BP External CD Driver. Category: External Optical Disk Drive. Subcategory: Optical Disk Drive. Price: Out Of Stock.

Product: ORICO XD008 External DVD Writer with Hub. Category: External Optical Disk Drive. Subcategory: Optical Disk Drive. Price: Out Of Stock.
",286,218970,219256
921,recursive,"
Product: ORICO XD010 External DVD Writer with Hub. Category: External Optical Disk Drive. Subcategory: Optical Disk Drive. Price: Out Of Stock.

Product: ASUS SDRW-08D2S-U LITE External Slim DVD Writer. Category: External Optical Disk Drive. Subcategory: Optical Disk Drive. Price: Out Of Stock.
",297,219256,219553
922,recursive,"
Product: ASUS ZenDrive SDRW-08U9M-U External DVD Drive. Category: External Optical Disk Drive. Subcategory: Optical Disk Drive. Price: Out Of Stock.
",150,219553,219703
923,recursive,"
Product: ASUS ZenDrive U7M Ultra-Slim Portable External DVD Writer. Category: External Optical Disk Drive. Subcategory: Optical Disk Drive. Price: Out Of Stock.
",162,219703,219865
924,recursive,"
Product: ASUS ZenDrive SDRW-08U9M-U External DVD Drive Gold. Category: External Optical Disk Drive. Subcategory: Optical Disk Drive. Price: Out Of Stock.
",155,219865,220020
925,recursive,"
Product: ASUS SBW-06D2X-U External Slim Blu-ray DVD Writer. Category: External Optical Disk Drive. Subcategory: Optical Disk Drive. Price: Out Of Stock.

Product: Antec AT-HGPUH-ARGB DAGGER ARGB GPU Holder. Category: Vertical Graphics Card Holder. Subcategory: Component. Price: 2,500৳.
",288,220020,220308
926,recursive,"
Product: Antec AT-GPUH-ARGB-TG-BK Tempered Glass ARGB GPU Holder. Category: Vertical Graphics Card Holder. Subcategory: Component. Price: 2,600৳.

Product: Antec AT-GPUH-ARGB Aluminum ARGB GPU Holder. Category: Vertical Graphics Card Holder. Subcategory: Component. Price: 2,800৳.
",282,220308,220590
927,recursive,"
Product: DeepCool PCIe 4.0 Vertical GPU Bracket. Category: Vertical Graphics Card Holder. Subcategory: Component. Price: 6,700৳.

Product: NZXT Vertical GPU Mounting Kit. Category: Vertical Graphics Card Holder. Subcategory: Component. Price: 10,000৳.
",253,220590,220843
928,recursive,"
Product: Cooler Master PCIe 4.0 x16 300mm Riser Cable. Category: Vertical Graphics Card Holder. Subcategory: Component. Price: Up Coming.

Product: Antec SHIFT White Vertical GPU Bracket With PCI-E 4.0 Riser Cable. Category: Vertical Graphics Card Holder. Subcategory: Component. Price: Up Coming.
",299,220843,221142
929,recursive,"
Product: Antec AT-IGPUH-BK I Shape GPU Holder. Category: Vertical Graphics Card Holder. Subcategory: Component. Price: Out Of Stock.

Product: DeepCool ST500 ARGB GPU Support Bracket. Category: Vertical Graphics Card Holder. Subcategory: Component. Price: Out Of Stock.
",271,221142,221413
930,recursive,"
Product: Cooler Master ARGB GPU Support Bracket. Category: Vertical Graphics Card Holder. Subcategory: Component. Price: Out Of Stock.

Product: Antec RTX40 PCIe4.0 Riser Cable Vertical Bracket Kit. Category: Vertical Graphics Card Holder. Subcategory: Component. Price: Out Of Stock.
",286,221413,221699
931,recursive,"
Product: Antec RTX40 PCIe4.0 Riser Cable Vertical Bracket Kit White. Category: Vertical Graphics Card Holder. Subcategory: Component. Price: Out Of Stock.
",156,221699,221855
932,recursive,"
Product: CORSAIR PREMIUM PCIE 3.0 X16 EXTENSION 300MM CABLE. Category: Vertical Graphics Card Holder. Subcategory: Component. Price: Out Of Stock.

Product: Asus RS200 ROG Strix Riser Cable. Category: Vertical Graphics Card Holder. Subcategory: Component. Price: Out Of Stock.
",278,221855,222133
933,recursive,"
Product: Antec SHIFT Vertical GPU Bracket With PCI-E 4.0 Riser Cable. Category: Vertical Graphics Card Holder. Subcategory: Component. Price: Out Of Stock.

Product: ASUS XH01 ROG Herculx Graphics Card Holder. Category: Vertical Graphics Card Holder. Subcategory: Component. Price: Out Of Stock.
",297,222133,222430
934,recursive,"
Product: Cooler Master Universal Vertical Graphics Card Holder Kit V2 (PCIe 4.0). Category: Vertical Graphics Card Holder. Subcategory: Component. Price: Out Of Stock.
",169,222430,222599
935,recursive,"
Product: Cooler Master Vertical Graphics Card Holder Kit V3 (PCIe 4.0). Category: Vertical Graphics Card Holder. Subcategory: Component. Price: Out Of Stock.
",159,222599,222758
936,recursive,"
Product: Cooler Master White Vertical Graphics Card Holder Kit V3 (PCIe 4.0). Category: Vertical Graphics Card Holder. Subcategory: Component. Price: Out Of Stock.

Product: SANTAK Robust R650 650VA Offline UPS. Category: SANTAK. Subcategory: UPS. Price: 4,500৳4,850৳.
",270,222758,223028
937,recursive,"
Product: SANTAK Robust R1200 1200VA Offline UPS. Category: SANTAK. Subcategory: UPS. Price: Out Of Stock.

Product: PC Power PCMU1018P 8800mAh Mini UPS For Router. Category: Power. Price: 1,584৳1,800৳.
",203,223028,223231
938,recursive,"
Product: PC Power PCMU1018 8800mAh Multifunction Mini UPS For Router. Category: Power. Price: 1,760৳2,000৳.

Product: Marsriva KP1 EC 18W 8000mAh Mini DC UPS. Category: Power. Price: 1,892৳2,150৳.

Product: PC Power PCMU1018LCD 8800mAh Mini UPS For Router. Category: Power. Price: 2,300৳.
",290,223231,223521
939,recursive,"
Product: PC Power PCMU1018LED 10400mAh Mini UPS For Router. Category: Power. Price: 2,075৳2,300৳.

Product: MARSRIVA KP3 10000mAh Smart Mini DC UPS for Router. Category: Power. Price: 2,050৳2,500৳.

Product: PC Power PCMU1018LCD 10400mAh Mini UPS For Router. Category: Power. Price: 2,600৳.
",292,223521,223813
940,recursive,"
Product: PC Power PCMU1018LED 13200mAh Mini UPS For Router. Category: Power. Price: 2,288৳2,600৳.

Product: PC Power PCMU1018LCD 13200mAh Mini UPS For Router. Category: Power. Price: 2,800৳2,950৳.

Product: PC Power PCMU1018LL 20000mAh Mini UPS For Router. Category: Power. Price: 3,200৳.
",290,223813,224103
941,recursive,"
Product: Digital X 650VA Offline UPS. Category: Power. Price: 3,250৳3,300৳.

Product: APOLLO 650VA 300W UPS. Category: Power. Price: 3,196৳3,499৳.

Product: Prolink 650VA Offline UPS. Category: Power. Price: 3,060৳3,600৳.

Product: Dahua 650VA Offline UPS. Category: Power. Price: 3,250৳3,600৳.
",296,224103,224399
942,recursive,"
Product: Vertiv ITON CX 650VA Offline UPS. Category: Power. Price: 3,600৳.

Product: Marsriva MR-UF650 650VA Offline UPS. Category: Power. Price: 3,600৳.

Product: MaxGreen MG-LI-EAP-650VA 650VA Offline UPS. Category: Power. Price: 3,700৳.
",241,224399,224640
943,recursive,"
Product: Marsriva MR-UF750 750VA Smart Line-Interactive UPS. Category: Power. Price: 3,300৳3,800৳.

Product: Digital X 850VA Offline UPS. Category: Power. Price: 3,999৳4,300৳.

Product: Marsriva KP1 Ultra 30W 16000mAh Mini DC UPS. Category: Power. Price: 3,780৳4,500৳.
",270,224640,224910
944,recursive,"
Product: MaxGreen MG-LI-EAP-1200VA 1200VA Offline UPS. Category: MaxGreen. Subcategory: UPS. Price: 6,900৳.

Product: MaxGreen MG-LI-EAP 1500VA Offline UPS. Category: MaxGreen. Subcategory: UPS. Price: 10,900৳.
",212,224910,225122
945,recursive,"
Product: MaxGreen MG-LI-EAP-2000VA 2000VA UPS. Category: MaxGreen. Subcategory: UPS. Price: 13,500৳.

Product: MaxGreen MG-LI-KSP 850VA Offline UPS. Category: MaxGreen. Subcategory: UPS. Price: Out Of Stock.
",209,225122,225331
946,recursive,"
Product: MaxGreen 850VA Offline UPS. Category: MaxGreen. Subcategory: UPS. Price: Out Of Stock.

Product: MaxGreen MG-LI-KSP 1200VA Offline UPS. Category: MaxGreen. Subcategory: UPS. Price: Out Of Stock.
",205,225331,225536
947,recursive,"
Product: MaxGreen MG-LI-KSP 1500VA Offline UPS. Category: MaxGreen. Subcategory: UPS. Price: Out Of Stock.

Product: MaxGreen MG-LI-KSP 2000VA Offline UPS. Category: MaxGreen. Subcategory: UPS. Price: Out Of Stock.
",216,225536,225752
948,recursive,"
Product: Prolink 1200VA Offline UPS. Category: Prolink. Subcategory: UPS. Price: 6,800৳.

Product: Prolink 1500VA Offline UPS. Category: Prolink. Subcategory: UPS. Price: 10,200৳11,000৳.

Product: Prolink 2000VA Offline UPS. Category: Prolink. Subcategory: UPS. Price: Out Of Stock.
",284,225752,226036
949,recursive,"
Product: Prolink 3000VA Offline UPS. Category: Prolink. Subcategory: UPS. Price: Out Of Stock.

Product: Gigasonic RDA-1705M 17 Inch HDMI LED Square Monitor. Category: Monitor. Price: 4,500৳4,800৳.

Product: Gigasonic RB-G19S-300C 19"" HD LED Monitor. Category: Monitor. Price: 5,800৳.
",286,226036,226322
950,recursive,"
Product: Gigasonic RB-G195S-300C 19.5"" HD LED Monitor. Category: Monitor. Price: 5,900৳.

Product: Acer K202Q BI 19.5 Inch HD+ Monitor. Category: Monitor. Price: 8,200৳.

Product: Walton WDF13C22I 21.45"" 100Hz FHD IPS Monitor. Category: Monitor. Price: Up Coming.
",265,226322,226587
951,recursive,"
Product: Gigasonic GS-21.5FHD500S8 21.5"" 100Hz FHD IPS Gaming Monitor. Category: Monitor. Price: 8,600৳.

Product: Dahua DHI-LM19-A202Y 18.5"" HD Monitor. Category: Monitor. Price: 8,800৳8,900৳.

Product: Viewsonic VA2025-H 20” WSXGA 60Hz LED Monitor. Category: Monitor. Price: 9,500৳.
",286,226587,226873
952,recursive,"
Product: Hikvision DS-D5022F2-2P2/CBD 21.5"" 100Hz Full HD IPS Monitor. Category: Monitor. Price: 8,900৳10,300৳.

Product: Dahua DHI-LM22-A201YFS 21.45"" IPS Full HD 100Hz Monitor. Category: Monitor. Price: 9,000৳10,900৳.
",221,226873,227094
953,recursive,"
Product: Walton WD215I10 21.45"" 100Hz FHD IPS Monitor. Category: Monitor. Price: 8,450৳9,750৳.

Product: PC Power PCGM-King22 21.45"" IPS FHD 100Hz Monitor. Category: Monitor. Price: 9,800৳.

Product: Lenovo D19-10 18.5 Inch HD HDMI VGA Monitor. Category: Monitor. Price: 9,500৳9,700৳.
",286,227094,227380
954,recursive,"
Product: Xiaomi Redmi V22FAB-RA 21.45"" FHD Monitor. Category: Monitor. Price: 9,500৳.

Product: Aiwa MF2219-V 21.45"" IPS FHD 100Hz Monitor. Category: Monitor. Price: 9,000৳9,900৳.

Product: Samsung LS19A330NHW 19"" LED Monitor. Category: Monitor. Price: 9,100৳9,950৳.
",268,227380,227648
955,recursive,"
Product: Dell 20 E2020H 19.5-inch 60Hz HD+ Monitor. Category: Monitor. Price: 10,900৳.

Product: PC Power PCGM22 21.45"" IPS FHD 100Hz Borderless Monitor. Category: Monitor. Price: 10,200৳.

Product: Lenovo D20-30 19.5 Inch HD+ HDMI VGA Monitor. Category: Monitor. Price: 9,900৳10,200৳.
",287,227648,227935
956,recursive,"
Product: PC Power PCGM22U 21.5"" IPS FHD 100Hz Borderless Gaming Monitor. Category: Monitor. Price: 10,600৳.

Product: Marsriva MR-UF800 800VA Smart Line-Interactive UPS. Category: UPS. Subcategory: Power. Price: 4,000৳4,500৳.
",227,227935,228162
957,recursive,"
Product: Digital X 1200VA Offline UPS. Category: UPS. Subcategory: Power. Price: 6,080৳6,400৳.

Product: KSTAR 1200VA Offline UPS. Category: UPS. Subcategory: Power. Price: 6,600৳.

Product: APOLLO 1120F/1120 1200VA Offline UPS. Category: UPS. Subcategory: Power. Price: 6,432৳6,700৳.
",286,228162,228448
958,recursive,"
Product: Marsriva MR-UF1200 1200VA Offline UPS. Category: UPS. Subcategory: Power. Price: 6,900৳.

Product: Marsriva MR-UF1250 1250VA Smart Line-Interactive UPS. Category: UPS. Subcategory: Power. Price: 6,800৳7,000৳.
",219,228448,228667
959,recursive,"
Product: Vertiv ITON CX 1000VA Offline UPS. Category: UPS. Subcategory: Power. Price: 7,600৳7,900৳.

Product: Marsriva MR-UF2000 2000VA Smart Line-Interactive UPS. Category: MARSRIVA. Subcategory: UPS. Price: 12,999৳14,000৳.
",226,228667,228893
960,recursive,"
Product: Marsriva MR-UF3000 3000VA Smart Line-Interactive UPS. Category: MARSRIVA. Subcategory: UPS. Price: 21,800৳24,000৳.

Product: Apollo 1240 2000VA Offline UPS with Metal Body. Category: Apollo. Subcategory: UPS. Price: Out Of Stock.
",240,228893,229133
961,recursive,"
Product: Apollo 2000VA Offline UPS. Category: Apollo. Subcategory: UPS. Price: Out Of Stock.

Product: KSTAR 650VA Offline UPS. Category: KSTAR. Subcategory: UPS. Price: Out Of Stock.

Product: KSTAR 850VA Offline UPS. Category: KSTAR. Subcategory: UPS. Price: Out Of Stock.
",276,229133,229409
962,recursive,"
Product: KSTAR UA120 1200VA Offline UPS. Category: KSTAR. Subcategory: UPS. Price: Out Of Stock.

Product: KSTAR UA100 1000VA Offline UPS. Category: KSTAR. Subcategory: UPS. Price: Out Of Stock.

Product: KSTAR 2000VA Offline UPS. Category: KSTAR. Subcategory: UPS. Price: Out Of Stock.
",288,229409,229697
963,recursive,"
Product: KSTAR 3000VA Line Interactive Offline UPS. Category: KSTAR. Subcategory: UPS. Price: Out Of Stock.

Product: KSTAR 1500VA Offline UPS. Category: KSTAR. Subcategory: UPS. Price: Out Of Stock.
",201,229697,229898
964,recursive,"
Product: Apollo 2300HS 3KVA Standard Backup Online UPS. Category: APOLLO. Subcategory: Online UPS. Price: 38,500৳.

Product: Apollo 2B6K-L 6KVA Long Backup Online UPS. Category: APOLLO. Subcategory: Online UPS. Price: 112,000৳.
",229,229898,230127
965,recursive,"
Product: Apollo 2600HS 6KVA Standard Backup Online UPS. Category: APOLLO. Subcategory: Online UPS. Price: 120,000৳.

Product: Apollo 2B10K-L 10KVA Long Backup Online UPS. Category: APOLLO. Subcategory: Online UPS. Price: 135,500৳.
",232,230127,230359
966,recursive,"
Product: Apollo 2B10K 10KVA Standard Backup Online UPS. Category: APOLLO. Subcategory: Online UPS. Price: 158,000৳.

Product: Apollo 2B15K-L 15KVA Long Backup Online UPS. Category: APOLLO. Subcategory: Online UPS. Price: 212,000৳220,000৳.
",240,230359,230599
967,recursive,"
Product: Apollo 3P10K 10KVA Long Backup Online UPS. Category: APOLLO. Subcategory: Online UPS. Price: 300,000৳.

Product: Apollo 3P20K-L 20KVA Long Backup Online UPS. Category: APOLLO. Subcategory: Online UPS. Price: 380,000৳.
",228,230599,230827
968,recursive,"
Product: Apollo 2100HS 1KVA Standard Backup Online UPS. Category: APOLLO. Subcategory: Online UPS. Price: Up Coming.

Product: Apollo 2B6K 6KVA Standard Backup Online UPS. Category: APOLLO. Subcategory: Online UPS. Price: Up Coming.
",234,230827,231061
969,recursive,"
Product: KSTAR HP930CH 3KVA Long Backup Online UPS (Without Battery). Category: KSTAR. Subcategory: Online UPS. Price: 29,500৳.

Product: KSTAR HP930CS 3KVA Standard Backup Online UPS. Category: KSTAR. Subcategory: Online UPS. Price: 35,500৳.
",244,231061,231305
970,recursive,"
Product: KSTAR MEMO III 6K S 6KVA Standard Backup Online UPS. Category: KSTAR. Subcategory: Online UPS. Price: 87,000৳.

Product: KSTAR HP960C 6KVA Online UPS. Category: KSTAR. Subcategory: Online UPS. Price: Up Coming.
",221,231305,231526
971,recursive,"
Product: Kstar Memo Series 6KVA Online Ups. Category: KSTAR. Subcategory: Online UPS. Price: Up Coming.

Product: KSTAR HP910CS 1KVA Standard Backup Online UPS. Category: KSTAR. Subcategory: Online UPS. Price: Up Coming.
",222,231526,231748
972,recursive,"
Product: KSTAR HP Series 1000VA Online UPS. Category: KSTAR. Subcategory: Online UPS. Price: Out Of Stock.

Product: KSTAR MEMO S 2000VA Online UPS with Metal Body. Category: KSTAR. Subcategory: Online UPS. Price: Out Of Stock.
",229,231748,231977
973,recursive,"
Product: KSTAR HP920CS 2KVA Standard Backup Online UPS. Category: KSTAR. Subcategory: Online UPS. Price: Out Of Stock.

Product: KSTAR HP Series 2000VA Online UPS. Category: KSTAR. Subcategory: Online UPS. Price: Out Of Stock.
",228,231977,232205
974,recursive,"
Product: Marsriva MR-US1K Energy Efficient 1kVA Online UPS. Category: MARSRIVA. Subcategory: Online UPS. Price: 18,700৳.

Product: Marsriva MR-US1KRT Energy Efficient 1kVA Online UPS. Category: MARSRIVA. Subcategory: Online UPS. Price: 26,000৳.
",246,232205,232451
975,recursive,"
Product: Marsriva MR-US3K Energy Efficient 3kVA Online UPS. Category: MARSRIVA. Subcategory: Online UPS. Price: 35,500৳.

Product: Marsriva MR-US3KRT-H 3kVA Online UPS Long Backup. Category: MARSRIVA. Subcategory: Online UPS. Price: 38,000৳.
",243,232451,232694
976,recursive,"
Product: Marsriva MR-US3KRT Energy Efficient 3kVA Online UPS. Category: MARSRIVA. Subcategory: Online UPS. Price: 45,000৳.

Product: Marsriva MR-US10KRT-H Energy Efficient 10kVA Online UPS. Category: MARSRIVA. Subcategory: Online UPS. Price: 67,000৳.
",252,232694,232946
977,recursive,"
Product: Marsriva MR-US6K Energy Efficient 6kVA Online UPS. Category: MARSRIVA. Subcategory: Online UPS. Price: 88,000৳.

Product: Marsriva MR-US3320K-H Energy Efficient 20kVA Online UPS. Category: MARSRIVA. Subcategory: Online UPS. Price: 215,000৳220,000৳.
",259,232946,233205
978,recursive,"
Product: Marsriva MR-US6KRT-H Energy Efficient 6kVA Online UPS. Category: MARSRIVA. Subcategory: Online UPS. Price: Out Of Stock.

Product: Marsriva MR-US10K-H Energy Efficient 10kVA Online UPS. Category: MARSRIVA. Subcategory: Online UPS. Price: Out Of Stock.
",262,233205,233467
979,recursive,"
Product: Marsriva MR-US10K Energy Efficient 10kVA Online UPS. Category: MARSRIVA. Subcategory: Online UPS. Price: Out Of Stock.

Product: MaxGreen MGOE-W1KS 1KVA Standard Backup Online UPS. Category: MaxGreen. Subcategory: Online UPS. Price: 21,000৳.
",252,233467,233719
980,recursive,"
Product: MaxGreen MGOE-W2KS 2KVA Standard Backup Online UPS. Category: MaxGreen. Subcategory: Online UPS. Price: 35,000৳.

Product: MaxGreen MGOE-W3KS 3KVA Standard Backup Online UPS. Category: MaxGreen. Subcategory: Online UPS. Price: 39,000৳.
",246,233719,233965
981,recursive,"
Product: MaxGreen MGO-W6KS 6KVA Standard Backup High-Frequency Online UPS. Category: MaxGreen. Subcategory: Online UPS. Price: 93,000৳.

Product: MaxGreen B6KS/L 6kVA Low-Frequency Online UPS. Category: MaxGreen. Subcategory: Online UPS. Price: 120,000৳.
",256,233965,234221
982,recursive,"
Product: MaxGreen MGO-W10KS 10 KVA Standard Backup High-Frequency Online UPS. Category: MaxGreen. Subcategory: Online UPS. Price: 120,500৳.

Product: MaxGreen B10KS/L 10kVA Low-Frequency Online UPS. Category: MaxGreen. Subcategory: Online UPS. Price: 165,000৳.
",262,234221,234483
983,recursive,"
Product: MaxGreen 3KVA Online UPS Long Backup (96V). Category: MaxGreen. Subcategory: Online UPS. Price: Call for Price.

Product: MaxGreen MGO-S1KS(PX1KL) Online UPS. Category: MaxGreen. Subcategory: Online UPS. Price: Call for Price.
",237,234483,234720
984,recursive,"
Product: MaxGreen 3B10K 20KVA Low frequency Transformer Base Online UPS. Category: MaxGreen. Subcategory: Online UPS. Price: Call for Price.

Product: MaxGreen 3W20KL 20KVA Standard Backup Online UPS. Category: MaxGreen. Subcategory: Online UPS. Price: Call for Price.
",270,234720,234990
985,recursive,"
Product: MaxGreen 3W3RX10KL 10kVA Online UPS. Category: MaxGreen. Subcategory: Online UPS. Price: Call for Price.

Product: MaxGreen 3B310-60KVA Low-frequency Transformer Base Online UPS. Category: MaxGreen. Subcategory: Online UPS. Price: Call for Price.
",257,234990,235247
986,recursive,"
Product: MaxGreen MGO-W1KL 1KVA Long Backup Online UPS. Category: MaxGreen. Subcategory: Online UPS. Price: Call for Price.

Product: MaxGreen MGO-G2031-HF 20KVA High-Frequency Long Back-Up Online UPS. Category: MaxGreen. Subcategory: Online UPS. Price: Call for Price.
",271,235247,235518
987,recursive,"
Product: MaxGreen MGO-BG6033-LF 60KVA Long Backup Low-Frequency Transformer Base Online UPS. Category: MaxGreen. Subcategory: Online UPS. Price: Call for Price.
",162,235518,235680
988,recursive,"
Product: MaxGreen B2033-LF 20KVA Low-Frequency Transformer Base Online UPS. Category: MaxGreen. Subcategory: Online UPS. Price: Call for Price.

Product: MaxGreen MGO-W3033-LF 30000VA Online UPS. Category: MaxGreen. Subcategory: Online UPS. Price: Call for Price.
",265,235680,235945
989,recursive,"
Product: MaxGreen W4033-LF 40KVA Online UPS. Category: MaxGreen. Subcategory: Online UPS. Price: Call for Price.

Product: MaxGreen MGOE-W3KL 3KVA Long Backup Online UPS. Category: MaxGreen. Subcategory: Online UPS. Price: Call for Price.
",240,235945,236185
990,recursive,"
Product: Power Pac 650VA Offline UPS. Category: Power Pac. Subcategory: UPS. Price: Out Of Stock.

Product: Power Pac 1200VA Offline UPS (Plastic Body). Category: Power Pac. Subcategory: UPS. Price: Out Of Stock.
",214,236185,236399
991,recursive,"
Product: Power Pac 2000VA Offline UPS. Category: Power Pac. Subcategory: UPS. Price: Out Of Stock.

Product: Power Pac 1500VA Offline UPS. Category: Power Pac. Subcategory: UPS. Price: Out Of Stock.
",200,236399,236599
992,recursive,"
Product: Vertiv Liebert GXT MT+CX 1KVA Standard Backup Online UPS. Category: Vertiv. Subcategory: Online UPS. Price: 31,500৳34,000৳.

Product: Vertiv Liebert GXT MT+EX 3KVA Online UPS. Category: Vertiv. Subcategory: Online UPS. Price: 52,000৳.
",245,236599,236844
993,recursive,"
Product: Vertiv Liebert GXT MT+EX 6KVA Online UPS. Category: Vertiv. Subcategory: Online UPS. Price: 190,000৳.

Product: Vertiv Liebert GXT MT+ 6KVA Online UPS. Category: Vertiv. Subcategory: Online UPS. Price: Call for Price.
",228,236844,237072
994,recursive,"
Product: Vertiv Liebert GXT MT+ 10KVA Online UPS. Category: Vertiv. Subcategory: Online UPS. Price: Call for Price.

Product: Power Pac 1KVA Online UPS. Category: Online UPS. Subcategory: Power. Price: 24,500৳.
",212,237072,237284
995,recursive,"
Product: Power Pac 3KVA Online UPS. Category: Online UPS. Subcategory: Power. Price: 40,500৳.

Product: Zigor Volga NG+3 3KVA Online UPS. Category: Online UPS. Subcategory: Power. Price: 51,000৳.
",197,237284,237481
996,recursive,"
Product: SANTAK Castle Rack 6K 6000VA Standard Backup Online UPS. Category: SANTAK. Subcategory: Online UPS. Price: 195,000৳.

Product: SANTAK Castle C2KS 2000VA Long Backup Online UPS. Category: SANTAK. Subcategory: Online UPS. Price: Call for Price.
",253,237481,237734
997,recursive,"
Product: SANTAK Castle C10KS 10000VA Long Backup Online UPS. Category: SANTAK. Subcategory: Online UPS. Price: Call for Price.

Product: SANTAK Castle C2K 2000VA Standard Backup Online UPS. Category: SANTAK. Subcategory: Online UPS. Price: Out Of Stock.
",255,237734,237989
998,recursive,"
Product: SANTAK Castle C1K 1000VA Standard Backup Online UPS. Category: SANTAK. Subcategory: Online UPS. Price: 34,000৳.

Product: SANTAK Castle C3KS 3000VA Long Backup Online UPS. Category: SANTAK. Subcategory: Online UPS. Price: Call for Price.
",248,237989,238237
999,recursive,"
Product: SANTAK Castle C3K 3000VA Standard Backup Online UPS. Category: SANTAK. Subcategory: Online UPS. Price: 61,000৳.

Product: SANTAK Castle Rack 3K 3000VA Standard Backup Online UPS. Category: SANTAK. Subcategory: Online UPS. Price: 73,000৳.
",248,238237,238485
1000,recursive,"
Product: SANTAK Castle C6KS 6000VA Long Backup Online UPS. Category: SANTAK. Subcategory: Online UPS. Price: Call for Price.

Product: SANTAK Castle C6K 6000VA Standard Backup Online UPS. Category: SANTAK. Subcategory: Online UPS. Price: 135,000৳.
",249,238485,238734
1001,recursive,"
Product: ZIGOR Ottawa Pro Online UPS. Category: ZIGOR. Subcategory: Online UPS. Price: Call for Price.

Product: Zigor Volga Ng 1KVA Online UPS. Category: ZIGOR. Subcategory: Online UPS. Price: Out Of Stock.
",209,238734,238943
1002,recursive,"
Product: Zigor Volga NG+2 2KVA Online UPS. Category: ZIGOR. Subcategory: Online UPS. Price: Out Of Stock.

Product: APC E3SUPS20KH Easy UPS 3S 20kVA 400V 3:3 Online UPS. Category: APC. Subcategory: Online UPS. Price: Call for Price.
",234,238943,239177
1003,recursive,"
Product: APC SRV3KUXI-IN Easy UPS 2U 3KVA 230V Online UPS. Category: APC. Subcategory: Online UPS. Price: Call for Price.

Product: APC SRV10KUXI-IN 10KVA Online UPS. Category: APC. Subcategory: Online UPS. Price: Call for Price.
",231,239177,239408
1004,recursive,"
Product: APC SRV6KUXI-IN 6kVA 2U Rackmount Online UPS. Category: APC. Subcategory: Online UPS. Price: Call for Price.

Product: Kehua KR1000+ 1KVA Online UPS. Category: Kehua. Subcategory: Online UPS. Price: 22,500৳.
",218,239408,239626
1005,recursive,"
Product: Power Guard 1KVA PS Standard Backup Online UPS. Category: Power Guard. Subcategory: Online UPS. Price: Up Coming.

Product: Power Guard 6KVA 6000VA 6000W Online UPS. Category: Power Guard. Subcategory: Online UPS. Price: Up Coming.
",242,239626,239868
1006,recursive,"
Product: Power Guard 3KVA PS Standard Backup Online UPS. Category: Power Guard. Subcategory: Online UPS. Price: Out Of Stock.

Product: Power Guard 10KVA 10000VA 10000W Online UPS. Category: Power Guard. Subcategory: Online UPS. Price: Out Of Stock.
",251,239868,240119
1007,recursive,"
Product: EnSmart Smart BX 3:3 30kVA long-Run Backup Online UPS. Category: EnSmart. Subcategory: Online UPS. Price: Call for Price.

Product: EnSmart Smart Pack RT 3KVA 2700W Standard Backup Online UPS. Category: EnSmart. Subcategory: Online UPS. Price: Call for Price.
",270,240119,240389
1008,recursive,"
Product: EnSmart Smart Pack RT 1KVA 900W Standard Backup Online UPS. Category: EnSmart. Subcategory: Online UPS. Price: 30,000৳.

Product: MARSRIVA KP7 17600mAh Smart Mini DC UPS for Router. Category: Mini UPS. Subcategory: Power. Price: 6,750৳7,500৳.
",253,240389,240642
1009,recursive,"
Product: Solitine SOL-702Max 20000mAh Mini DC UPS. Category: Mini UPS. Subcategory: Power. Price: 2,500৳.

Product: Solitine SOL-702 12000mAh Mini DC UPS. Category: Mini UPS. Subcategory: Power. Price: 2,100৳.
",211,240642,240853
1010,recursive,"
Product: Solitine SOL-700BS 20000mAh Mini DC UPS. Category: Mini UPS. Subcategory: Power. Price: 3,600৳.

Product: Solitine SOL-604 10000mAh Mini DC UPS. Category: Mini UPS. Subcategory: Power. Price: 1,600৳.
",210,240853,241063
1011,recursive,"
Product: MARSRIVA KP7 Pro 24000mAh Smart Mini DC UPS. Category: Mini UPS. Subcategory: Power. Price: Out Of Stock.

Product: MARSRIVA KP7 Pro 84000mAh Smart Mini DC UPS. Category: Mini UPS. Subcategory: Power. Price: 7,458৳7,900৳.
",232,241063,241295
1012,recursive,"
Product: MARSRIVA KP9 20000mAh Smart Mini DC UPS for Router. Category: Mini UPS. Subcategory: Power. Price: Up Coming.

Product: MARSRIVA KP3 EC 8400mAh Smart Mini DC UPS for Router. Category: Mini UPS. Subcategory: Power. Price: Out Of Stock.
",245,241295,241540
1013,recursive,"
Product: Power Guard ECO-1825 10000mAh Mini DC UPS for Router. Category: Power Guard. Subcategory: Mini UPS. Price: Out Of Stock.

Product: Power Guard ECO-430-PRO 8000mAh Mini DC UPS for Router. Category: Power Guard. Subcategory: Mini UPS. Price: Out Of Stock.
",264,241540,241804
1014,recursive,"
Product: MARSRIVA KP4 10000mAh Smart Mini DC UPS for Router. Category: MARSRIVA. Subcategory: Mini UPS. Price: Out Of Stock.

Product: MARSRIVA KP2 10000mAh Smart Mini DC UPS for Router. Category: MARSRIVA. Subcategory: Mini UPS. Price: Out Of Stock.
",252,241804,242056
1015,recursive,"
Product: Marsriva KP1 Plus 18W 16000mAh Mini DC UPS. Category: MARSRIVA. Subcategory: Mini UPS. Price: Out Of Stock.

Product: MARSRIVA KP6 Max 20000mAh Smart Mini DC UPS for Router. Category: MARSRIVA. Subcategory: Mini UPS. Price: Out Of Stock.
",248,242056,242304
1016,recursive,"
Product: MARSRIVA KP3 Pro 8400mAh Smart Mini DC UPS for Router. Category: MARSRIVA. Subcategory: Mini UPS. Price: Out Of Stock.

Product: MARSRIVA KP5 8800mAh Smart Mini DC UPS for Router. Category: MARSRIVA. Subcategory: Mini UPS. Price: Out Of Stock.
",254,242304,242558
1017,recursive,"
Product: Marsriva KP2 Ultra 30W 16000mAh Mini DC UPS. Category: MARSRIVA. Subcategory: Mini UPS. Price: Out Of Stock.

Product: MARSRIVA KP9 Pro 24000mAh Smart Mini DC UPS for Router. Category: MARSRIVA. Subcategory: Mini UPS. Price: Out Of Stock.
",249,242558,242807
1018,recursive,"
Product: MARSRIVA KP6 EC 8400mAh Smart Mini DC UPS for Router. Category: MARSRIVA. Subcategory: Mini UPS. Price: Out Of Stock.

Product: EcoFlow RIVER 2 Portable Power Station. Category: Portable Power Station. Subcategory: Power. Price: 25,450৳26,500৳.
",255,242807,243062
1019,recursive,"
Product: EcoFlow River 3 UPS & Portable Power Station. Category: Portable Power Station. Subcategory: Power. Price: 28,450৳29,500৳.

Product: Ecoflow River 2 Max Portable Power Station. Category: Portable Power Station. Subcategory: Power. Price: 45,900৳.
",257,243062,243319
1020,recursive,"
Product: EcoFlow RIVER 2 Pro Portable Power Station. Category: Portable Power Station. Subcategory: Power. Price: 53,900৳.

Product: EcoFlow E980 Portable Power Station. Category: Portable Power Station. Subcategory: Power. Price: 54,500৳57,900৳.
",248,243319,243567
1021,recursive,"
Product: Ecoflow Delta 3 Portable Power Station. Category: Portable Power Station. Subcategory: Power. Price: 77,900৳.

Product: EcoFlow E2000 Portable Power Station. Category: Portable Power Station. Subcategory: Power. Price: 114,900৳.
",239,243567,243806
1022,recursive,"
Product: Ecoflow Delta 2 Max Portable Power Station. Category: Portable Power Station. Subcategory: Power. Price: 125,900৳.

Product: EcoFlow DELTA Pro Portable Power Station. Category: Portable Power Station. Subcategory: Power. Price: 224,900৳.
",248,243806,244054
1023,recursive,"
Product: Ecoflow Delta Pro 3 Portable Power Station. Category: Portable Power Station. Subcategory: Power. Price: 459,900৳.

Product: Ecoflow Delta 2 Portable Power Station. Category: Portable Power Station. Subcategory: Power. Price: Out Of Stock.
",250,244054,244304
1024,recursive,"
Product: LONG WP12-12 12V 12Ah Rechargeable Sealed Lead Acid Battery. Category: UPS Battery. Subcategory: Power. Price: 4,500৳.

Product: LONG WPS26-12N 12V 26Ah Rechargeable Sealed Lead Acid Battery. Category: UPS Battery. Subcategory: Power. Price: 9,500৳.
",260,244304,244564
1025,recursive,"
Product: KENSON KS4 4V 4.5AH Rechargeable Sealed Lead Acid Battery. Category: UPS Battery. Subcategory: Power. Price: 400৳.

Product: MaxGreen MG12-7.5 12V 7.5A UPS Battery. Category: UPS Battery. Subcategory: Power. Price: 1,300৳1,600৳.
",239,244564,244803
1026,recursive,"
Product: MaxGreen MG12-9 12V 9A UPS Battery. Category: UPS Battery. Subcategory: Power. Price: 1,500৳1,800৳.

Product: KENSON KS12-9AH 12V 9AH UPS Battery. Category: UPS Battery. Subcategory: Power. Price: 1,800৳.
",215,244803,245018
1027,recursive,"
Product: LONG LG7-12 12V 7Ah Rechargeable Sealed Lead Acid Battery. Category: UPS Battery. Subcategory: Power. Price: 2,250৳.

Product: KENSON KS12 12V 12AH UPS Battery. Category: UPS Battery. Subcategory: Power. Price: 2,400৳.
",229,245018,245247
1028,recursive,"
Product: KENSON KS12 12V 18AH UPS Battery. Category: UPS Battery. Subcategory: Power. Price: 4,000৳.

Product: MaxGreen MG12-18 12V 18A UPS Battery. Category: UPS Battery. Subcategory: Power. Price: 4,800৳.
",208,245247,245455
1029,recursive,"
Product: Power Guard SS18-12 12V 18Ah UPS Battery. Category: UPS Battery. Subcategory: Power. Price: 4,000৳.

Product: KENSON KS12-26AH 12V 26AH UPS Battery. Category: UPS Battery. Subcategory: Power. Price: 5,500৳.
",217,245455,245672
1030,recursive,"
Product: MaxGreen MG12-26 12V 26A UPS Battery. Category: UPS Battery. Subcategory: Power. Price: 5,500৳.

Product: Leoch LP12-18 (12V 18Ah) Sealed Lead Acid Battery. Category: UPS Battery. Subcategory: Power. Price: 6,000৳.
",225,245672,245897
1031,recursive,"
Product: LONG WP18-12SHR 12V 18Ah Rechargeable Sealed Lead Acid Battery. Category: UPS Battery. Subcategory: Power. Price: 6,700৳7,000৳.

Product: KENSON KS12 12V 40AH UPS Battery. Category: UPS Battery. Subcategory: Power. Price: 7,100৳.
",240,245897,246137
1032,recursive,"
Product: KENSON KS12 12V 65AH UPS Battery. Category: UPS Battery. Subcategory: Power. Price: 12,000৳.

Product: Leoch LP12-40 (12V 40Ah) Sealed Lead Acid Battery. Category: UPS Battery. Subcategory: Power. Price: 14,000৳.
",223,246137,246360
1033,recursive,"
Product: MaxGreen MG12-65 12V 65Ah UPS Battery. Category: UPS Battery. Subcategory: Power. Price: 14,500৳.

Product: KENSON KS12 12V 70AH UPS Battery. Category: UPS Battery. Subcategory: Power. Price: 15,000৳.
",211,246360,246571
1034,recursive,"
Product: Tecnoware 18KVA Electronic Single Phase Stabilizer. Category: Voltage Stabilizer. Subcategory: Power. Price: 78,000৳.

Product: Tecnoware 25KVA Electronic Three Phase Stabilizer (Origin Italy). Category: Voltage Stabilizer. Subcategory: Power. Price: 95,000৳.
",270,246571,246841
1035,recursive,"
Product: Tecnoware FSTEL75KT 75KVA Electronic Three Phase Stabilizer (Origin Italy). Category: Voltage Stabilizer. Subcategory: Power. Price: Call for Price.

Product: Star 600VA Stabilizer. Category: Voltage Stabilizer. Subcategory: Power. Price: Out Of Stock.
",263,246841,247104
1036,recursive,"
Product: Star 600VA LED Display Stabilizer. Category: Voltage Stabilizer. Subcategory: Power. Price: Out Of Stock.

Product: Star 1000VA Meter Display Stabilizer. Category: Voltage Stabilizer. Subcategory: Power. Price: Out Of Stock.
",235,247104,247339
1037,recursive,"
Product: Star 2000VA Meter Display Stabilizer. Category: Voltage Stabilizer. Subcategory: Power. Price: Out Of Stock.

Product: Tecnoware 3000VA Power Reg Stabilizer. Category: Voltage Stabilizer. Subcategory: Power. Price: Out Of Stock.
",239,247339,247578
1038,recursive,"
Product: Tecnoware 9KVA Electronic Single Phase Stabilizer. Category: Voltage Stabilizer. Subcategory: Power. Price: Out Of Stock.

Product: Tecnoware 12KVA Electronic Single Phase Stabilizer. Category: Voltage Stabilizer. Subcategory: Power. Price: Out Of Stock.
",265,247578,247843
1039,recursive,"
Product: Tecnoware 35KVA Electronic Three Phase Stabilizer (Origin Italy). Category: Voltage Stabilizer. Subcategory: Power. Price: Out Of Stock.

Product: Exide GQP 1125VA Pure Sine Wave IPS Without Battery. Category: IPS. Subcategory: Power. Price: 16,000৳.
",261,247843,248104
1040,recursive,"
Product: NPTE 200VA Pure Sine Wave IPS With Battery. Category: IPS. Subcategory: Power. Price: 18,300৳.

Product: Exide 700VA Pure Sine Wave IPS With Battery. Category: IPS. Subcategory: Power. Price: 27,800৳.
",211,248104,248315
1041,recursive,"
Product: Exide Star 700VA Pure Sine Wave IPS With Battery. Category: IPS. Subcategory: Power. Price: 32,900৳.

Product: Hithium HeroEE 1 1kWh Portable IPS. Category: IPS. Subcategory: Power. Price: 32,500৳37,800৳.
",215,248315,248530
1042,recursive,"
Product: Exide Star 900VA Pure Sine Wave IPS With Battery. Category: IPS. Subcategory: Power. Price: 37,950৳.

Product: Exide GQP 1125VA Pure Sine Wave IPS With Battery. Category: IPS. Subcategory: Power. Price: 46,800৳.
",222,248530,248752
1043,recursive,"
Product: Luminous Eco Volt Neo 1150VA Non Sine Wave IPS With Battery. Category: IPS. Subcategory: Power. Price: 46,800৳.

Product: Exide Star 1225VA Pure Sine Wave IPS With Battery. Category: IPS. Subcategory: Power. Price: 48,000৳.
",234,248752,248986
1044,recursive,"
Product: Exide Star 1625VA Pure Sine Wave IPS With Battery. Category: IPS. Subcategory: Power. Price: 63,250৳.

Product: Exide Star 2550VA Pure Sine Wave IPS With Battery. Category: IPS. Subcategory: Power. Price: 78,400৳.
",224,248986,249210
1045,recursive,"
Product: Hithium HeroEE 2 2kWh Portable IPS. Category: IPS. Subcategory: Power. Price: 76,500৳85,000৳.

Product: Luminous Eco Watt Neo 2300VA Pure Sine Wave IPS With Battery. Category: IPS. Subcategory: Power. Price: 87,400৳.
",227,249210,249437
1046,recursive,"
Product: Luminous Eco Volt Neo 2800VA Pure Sine Wave IPS With Battery. Category: IPS. Subcategory: Power. Price: 139,000৳.

Product: EcoFlow 45W Portable Solar Panel. Category: Solar Panel. Subcategory: Power. Price: 6,500৳.
",226,249437,249663
1047,recursive,"
Product: EcoFlow 60W Portable Solar Panel. Category: Solar Panel. Subcategory: Power. Price: 9,500৳.

Product: EcoFlow 110W Portable Solar Panel. Category: Solar Panel. Subcategory: Power. Price: 15,500৳.
",206,249663,249869
1048,recursive,"
Product: EcoFlow 125W Portable Solar Panel. Category: Solar Panel. Subcategory: Power. Price: 17,100৳.

Product: EcoFlow 160W Portable Solar Panel. Category: Solar Panel. Subcategory: Power. Price: 24,300৳.
",208,249869,250077
1049,recursive,"
Product: EcoFlow 220W Portable Solar Panel. Category: Solar Panel. Subcategory: Power. Price: 33,100৳.

Product: EcoFlow 400W Portable Solar Panel. Category: Solar Panel. Subcategory: Power. Price: Out Of Stock.

Product: Symphony B80. Category: Phone. Price: 990৳.
",267,250077,250344
1050,recursive,"
Product: Symphony A30. Category: Phone. Price: 999৳.

Product: Symphony D89. Category: Phone. Price: 1,290৳.

Product: Symphony L34. Category: Phone. Price: 1,350৳.

Product: Walton Olvio E100. Category: Phone. Price: 1,450৳.

Product: Symphony D54 Pro. Category: Phone. Price: 1,499৳.
",287,250344,250631
1051,recursive,"
Product: Symphony T94. Category: Phone. Price: 1,550৳.

Product: Symphony L280. Category: Phone. Price: 1,599৳.

Product: TCL Onetouch 4021. Category: Phone. Price: 1,600৳.

Product: Symphony FiRE30. Category: Phone. Price: 1,699৳.

Product: Symphony S75. Category: Phone. Price: 1,799৳.
",289,250631,250920
1052,recursive,"
Product: Symphony S72. Category: Phone. Price: 1,899৳.

Product: XTRA X10. Category: Phone. Price: 1,990৳2,199৳.

Product: Symphony S80. Category: Phone. Price: 2,199৳.

Product: Symphony EVO 10. Category: Phone. Price: 2,250৳.

Product: Nokia 105 DS (2023). Category: Phone. Price: 2,350৳.
",292,250920,251212
1053,recursive,"
Product: Nokia 106 DS (2023). Category: Phone. Price: 2,440৳.

Product: XTRA R24. Category: Phone. Price: 2,499৳.

Product: Symphony G26 (2/32GB). Category: Phone. Price: 6,550৳6,699৳.

Product: Symphony Max 10. Category: Phone. Price: 6,650৳6,999৳.
",251,251212,251463
1054,recursive,"
Product: iPhone 16. Category: iPhone. Subcategory: Phone. Price: 142,000৳169,999৳.

Product: iPhone 15 Plus. Category: iPhone. Subcategory: Phone. Price: 151,000৳199,999৳.

Product: iPhone 16 Pro. Category: iPhone. Subcategory: Phone. Price: 183,000৳209,999৳.
",261,251463,251724
1055,recursive,"
Product: iPhone 15 Pro. Category: iPhone. Subcategory: Phone. Price: 182,000৳219,999৳.

Product: iPhone 16 Pro Max. Category: iPhone. Subcategory: Phone. Price: 194,500৳249,999৳.

Product: iPhone 15 Pro Max. Category: iPhone. Subcategory: Phone. Price: 178,000৳239,999৳.
",272,251724,251996
1056,recursive,"
Product: iPhone 15. Category: iPhone. Subcategory: Phone. Price: Out Of Stock.

Product: iPhone 16 Plus. Category: iPhone. Subcategory: Phone. Price: Out Of Stock.

Product: iPhone 14 Pro Max. Category: iPhone. Subcategory: Phone. Price: Out Of Stock.
",253,251996,252249
1057,recursive,"
Product: iPhone 16e. Category: iPhone. Subcategory: Phone. Price: Out Of Stock.

Product: OPPO A5x. Category: OPPO. Subcategory: Phone. Price: 13,990৳.

Product: OPPO A3. Category: OPPO. Subcategory: Phone. Price: 18,990৳.

Product: OPPO A5. Category: OPPO. Subcategory: Phone. Price: 19,990৳.
",295,252249,252544
1058,recursive,"
Product: Oppo Reno 12 F 4G (8/256GB). Category: OPPO. Subcategory: Phone. Price: 24,990৳.

Product: OPPO Reno13 F. Category: OPPO. Subcategory: Phone. Price: 30,990৳.

Product: OPPO Reno12 F 5G. Category: OPPO. Subcategory: Phone. Price: 32,990৳.
",248,252544,252792
1059,recursive,"
Product: OPPO Reno14 F 5G. Category: OPPO. Subcategory: Phone. Price: 42,990৳.

Product: OPPO Reno13. Category: OPPO. Subcategory: Phone. Price: Up Coming.

Product: OPPO A18 (4/128GB). Category: OPPO. Subcategory: Phone. Price: Out Of Stock.
",244,252792,253036
1060,recursive,"
Product: OPPO A3x. Category: OPPO. Subcategory: Phone. Price: Out Of Stock.

Product: OPPO A38 (4/128GB). Category: OPPO. Subcategory: Phone. Price: Out Of Stock.

Product: OPPO A58. Category: OPPO. Subcategory: Phone. Price: Out Of Stock.
",241,253036,253277
1061,recursive,"
Product: OPPO A60 (8/256GB). Category: OPPO. Subcategory: Phone. Price: Out Of Stock.

Product: OPPO A60 (8/128GB). Category: OPPO. Subcategory: Phone. Price: Out Of Stock.

Product: OPPO A5 Pro. Category: OPPO. Subcategory: Phone. Price: Out Of Stock.
",254,253277,253531
1062,recursive,"
Product: OPPO Reno14 5G. Category: OPPO. Subcategory: Phone. Price: Out Of Stock.

Product: OPPO Reno12 5G (12/512GB). Category: OPPO. Subcategory: Phone. Price: Out Of Stock.

Product: OnePlus Nord CE4 Lite 5G. Category: OnePlus. Subcategory: Phone. Price: 22,990৳23,999৳.
",275,253531,253806
1063,recursive,"
Product: OnePlus Nord CE5 5G. Category: OnePlus. Subcategory: Phone. Price: 34,500৳35,999৳.

Product: OnePlus Nord 5 5G. Category: OnePlus. Subcategory: Phone. Price: 52,000৳53,999৳.

Product: OnePlus 13R. Category: OnePlus. Subcategory: Phone. Price: Up Coming.
",264,253806,254070
1064,recursive,"
Product: OnePlus 12. Category: OnePlus. Subcategory: Phone. Price: Up Coming.

Product: OnePlus 12R. Category: OnePlus. Subcategory: Phone. Price: Up Coming.

Product: OnePlus Nord N30 SE 5G. Category: OnePlus. Subcategory: Phone. Price: Out Of Stock.
",253,254070,254323
1065,recursive,"
Product: OnePlus Nord 4. Category: OnePlus. Subcategory: Phone. Price: Out Of Stock.

Product: Google Pixel 7 Pro. Category: Google. Subcategory: Phone. Price: 57,390৳59,999৳.

Product: Google Pixel 8 Pro. Category: Google. Subcategory: Phone. Price: 76,200৳79,999৳.
",268,254323,254591
1066,recursive,"
Product: Google Pixel 10. Category: Google. Subcategory: Phone. Price: Up Coming.

Product: Google Pixel 10 Pro Fold. Category: Google. Subcategory: Phone. Price: Up Coming.

Product: Google Pixel 10 Pro. Category: Google. Subcategory: Phone. Price: Up Coming.
",262,254591,254853
1067,recursive,"
Product: Google Pixel 10 Pro XL. Category: Google. Subcategory: Phone. Price: Up Coming.

Product: Google Pixel 9a. Category: Google. Subcategory: Phone. Price: Out Of Stock.

Product: Google Pixel 9. Category: Google. Subcategory: Phone. Price: Out Of Stock.
",261,254853,255114
1068,recursive,"
Product: HONOR X5b Plus. Category: HONOR. Subcategory: Phone. Price: 12,999৳.

Product: HONOR X6c. Category: HONOR. Subcategory: Phone. Price: 14,999৳.

Product: HONOR 400. Category: HONOR. Subcategory: Phone. Price: 59,999৳.
",227,255114,255341
1069,recursive,"
Product: Honor X7c. Category: HONOR. Subcategory: Phone. Price: Up Coming.

Product: HONOR X9c. Category: HONOR. Subcategory: Phone. Price: Up Coming.

Product: HONOR 200 Pro 5G. Category: HONOR. Subcategory: Phone. Price: Up Coming.
",235,255341,255576
1070,recursive,"
Product: HONOR 400 Pro. Category: HONOR. Subcategory: Phone. Price: Up Coming.

Product: Honor X5 Plus (4/64GB). Category: HONOR. Subcategory: Phone. Price: Out Of Stock.

Product: Honor X6b (6/128GB). Category: HONOR. Subcategory: Phone. Price: Out Of Stock.
",261,255576,255837
1071,recursive,"
Product: Honor X8a (8/128GB). Category: HONOR. Subcategory: Phone. Price: Out Of Stock.

Product: Honor X8b (8/512GB). Category: HONOR. Subcategory: Phone. Price: Out Of Stock.

Product: Honor X8c. Category: HONOR. Subcategory: Phone. Price: 29,999৳.
",252,255837,256089
1072,recursive,"
Product: Honor X9a 5G (8/256GB). Category: HONOR. Subcategory: Phone. Price: Out Of Stock.

Product: Honor X9b 5G. Category: HONOR. Subcategory: Phone. Price: Out Of Stock.

Product: Honor 200 5G. Category: HONOR. Subcategory: Phone. Price: Out Of Stock.
",256,256089,256345
1073,recursive,"
Product: Honor Magic V3. Category: HONOR. Subcategory: Phone. Price: Out Of Stock.

Product: HONOR 400 Lite. Category: HONOR. Subcategory: Phone. Price: Up Coming.

Product: Honor Magic V5. Category: HONOR. Subcategory: Phone. Price: Up Coming.
",246,256345,256591
1074,recursive,"
Product: Xiaomi Redmi A5. Category: Xiaomi. Subcategory: Phone. Price: 10,850৳10,999৳.

Product: Xiaomi Redmi 15C. Category: Xiaomi. Subcategory: Phone. Price: 14,650৳14,999৳.

Product: Xiaomi Redmi 13 (6/128GB). Category: Xiaomi. Subcategory: Phone. Price: 16,490৳16,999৳.
",275,256591,256866
1075,recursive,"
Product: Xiaomi Redmi Note 14. Category: Xiaomi. Subcategory: Phone. Price: 20,550৳20,999৳.

Product: Xiaomi Redmi Note 14 Pro. Category: Xiaomi. Subcategory: Phone. Price: 29,399৳29,999৳.

Product: Xiaomi Redmi 14C. Category: Xiaomi. Subcategory: Phone. Price: Out Of Stock.
",277,256866,257143
1076,recursive,"
Product: Xiaomi Redmi 13 (8/128GB). Category: Xiaomi. Subcategory: Phone. Price: Out Of Stock.

Product: Xiaomi Redmi Note 13 (6/128GB). Category: Xiaomi. Subcategory: Phone. Price: Out Of Stock.

Product: Xiaomi Redmi Note 13 (8/256GB). Category: Xiaomi. Subcategory: Phone. Price: Out Of Stock.
",298,257143,257441
1077,recursive,"
Product: Samsung Galaxy A06. Category: Samsung. Subcategory: Phone. Price: 13,650৳14,399৳.

Product: Samsung Galaxy A05 (6/128GB). Category: Samsung. Subcategory: Phone. Price: 19,250৳20,299৳.

Product: Samsung Galaxy A16 5G. Category: Samsung. Subcategory: Phone. Price: 22,900৳23,999৳.
",289,257441,257730
1078,recursive,"
Product: Samsung Galaxy A26 5G. Category: Samsung. Subcategory: Phone. Price: 35,450৳37,499৳.

Product: Samsung Galaxy A36 5G. Category: Samsung. Subcategory: Phone. Price: 41,650৳43,999৳.

Product: Samsung Galaxy A56 5G. Category: Samsung. Subcategory: Phone. Price: 56,250৳59,499৳.
",285,257730,258015
1079,recursive,"
Product: Samsung Galaxy A35 5G. Category: Samsung. Subcategory: Phone. Price: 59,650৳62,199৳.

Product: Samsung Galaxy Z Flip7. Category: Samsung. Subcategory: Phone. Price: Up Coming.

Product: Samsung Galaxy Z Fold7. Category: Samsung. Subcategory: Phone. Price: Up Coming.
",277,258015,258292
1080,recursive,"
Product: Samsung Galaxy S24 Ultra (12/512GB). Category: Samsung. Subcategory: Phone. Price: Out Of Stock.

Product: Samsung Galaxy S24 Ultra (12/1TB). Category: Samsung. Subcategory: Phone. Price: Out Of Stock.
",212,258292,258504
1081,recursive,"
Product: Samsung Galaxy S25. Category: Samsung. Subcategory: Phone. Price: Out Of Stock.

Product: Samsung Galaxy S25 Ultra. Category: Samsung. Subcategory: Phone. Price: Out Of Stock.

Product: Samsung Galaxy A03 Core (2/32GB). Category: Samsung. Subcategory: Phone. Price: Out Of Stock.
",290,258504,258794
1082,recursive,"
Product: Samsung Galaxy A03 (3/32GB). Category: Samsung. Subcategory: Phone. Price: Out Of Stock.

Product: Samsung Galaxy A04 (4/64GB). Category: Samsung. Subcategory: Phone. Price: Out Of Stock.

Product: Samsung Galaxy A05 (4/64GB). Category: Samsung. Subcategory: Phone. Price: Out Of Stock.
",297,258794,259091
1083,recursive,"
Product: Samsung Galaxy A04e (3/32GB). Category: Samsung. Subcategory: Phone. Price: Out Of Stock.

Product: Samsung Galaxy A04 (3/32GB). Category: Samsung. Subcategory: Phone. Price: Out Of Stock.

Product: Samsung Galaxy F13 (4/64GB). Category: Samsung. Subcategory: Phone. Price: Out Of Stock.
",298,259091,259389
1084,recursive,"
Product: Vivo Y04. Category: Vivo. Subcategory: Phone. Price: 11,999৳.

Product: Vivo Y19s. Category: Vivo. Subcategory: Phone. Price: 14,999৳.

Product: Vivo Y19s Pro. Category: Vivo. Subcategory: Phone. Price: 16,999৳.

Product: Vivo Y29. Category: Vivo. Subcategory: Phone. Price: 19,999৳.
",294,259389,259683
1085,recursive,"
Product: Vivo Y400. Category: Vivo. Subcategory: Phone. Price: 27,999৳.

Product: Vivo V50 Lite. Category: Vivo. Subcategory: Phone. Price: 31,900৳32,999৳.

Product: Vivo V50 5G. Category: Vivo. Subcategory: Phone. Price: 62,999৳.
",232,259683,259915
1086,recursive,"
Product: Vivo V60 5G. Category: Vivo. Subcategory: Phone. Price: Up Coming.

Product: Vivo Y03t. Category: Vivo. Subcategory: Phone. Price: Out Of Stock.

Product: Vivo Y03. Category: Vivo. Subcategory: Phone. Price: Out Of Stock.
",232,259915,260147
1087,recursive,"
Product: Vivo Y17s. Category: Vivo. Subcategory: Phone. Price: Out Of Stock.

Product: Vivo Y18. Category: Vivo. Subcategory: Phone. Price: Out Of Stock.

Product: Vivo Y28. Category: Vivo. Subcategory: Phone. Price: Out Of Stock.
",232,260147,260379
1088,recursive,"
Product: Vivo Y27s (8/128GB). Category: Vivo. Subcategory: Phone. Price: Out Of Stock.

Product: Vivo Y36. Category: Vivo. Subcategory: Phone. Price: Out Of Stock.

Product: Vivo V30 Lite (8/128GB). Category: Vivo. Subcategory: Phone. Price: Out Of Stock.
",257,260379,260636
1089,recursive,"
Product: Vivo V40 Lite. Category: Vivo. Subcategory: Phone. Price: Out Of Stock.

Product: Vivo V30 Lite (8/256GB). Category: Vivo. Subcategory: Phone. Price: Out Of Stock.

Product: Vivo V30 5G (12/256GB). Category: Vivo. Subcategory: Phone. Price: Out Of Stock.
",265,260636,260901
1090,recursive,"
Product: Vivo V40 5G (12/256GB). Category: Vivo. Subcategory: Phone. Price: Out Of Stock.

Product: Realme Note 60x. Category: Realme. Subcategory: Phone. Price: 10,999৳.

Product: Realme Note 60. Category: Realme. Subcategory: Phone. Price: 11,499৳.
",252,260901,261153
1091,recursive,"
Product: Realme Note 70. Category: Realme. Subcategory: Phone. Price: 11,999৳.

Product: Realme C71. Category: Realme. Subcategory: Phone. Price: 14,999৳.

Product: Realme C75x. Category: Realme. Subcategory: Phone. Price: 17,999৳.
",233,261153,261386
1092,recursive,"
Product: Realme 12. Category: Realme. Subcategory: Phone. Price: 24,999৳.

Product: Realme 14T 5G. Category: Realme. Subcategory: Phone. Price: 31,999৳.

Product: Realme 14. Category: Realme. Subcategory: Phone. Price: 41,999৳.
",229,261386,261615
1093,recursive,"
Product: Realme C75. Category: Realme. Subcategory: Phone. Price: Out Of Stock.

Product: Infinix SMART 10 Plus. Category: Infinix. Subcategory: Phone. Price: 11,499৳.

Product: Infinix Hot 60i. Category: Infinix. Subcategory: Phone. Price: 13,750৳13,999৳.
",258,261615,261873
1094,recursive,"
Product: Infinix Hot 60 Pro. Category: Infinix. Subcategory: Phone. Price: 18,750৳18,999৳.

Product: Infinix Hot 60 Pro+. Category: Infinix. Subcategory: Phone. Price: 21,750৳21,999৳.

Product: Infinix Note 50. Category: Infinix. Subcategory: Phone. Price: 25,650৳25,999৳.
",274,261873,262147
1095,recursive,"
Product: Infinix GT 30 Pro. Category: Infinix. Subcategory: Phone. Price: 39,250৳39,999৳.

Product: Infinix Zero Ultra. Category: Infinix. Subcategory: Phone. Price: Up Coming.

Product: Infinix Smart 9 HD. Category: Infinix. Subcategory: Phone. Price: Out Of Stock.
",268,262147,262415
1096,recursive,"
Product: Infinix SMART 10. Category: Infinix. Subcategory: Phone. Price: Out Of Stock.

Product: Infinix Smart 9. Category: Infinix. Subcategory: Phone. Price: Out Of Stock.

Product: Infinix Hot 50i. Category: Infinix. Subcategory: Phone. Price: Out Of Stock.
",262,262415,262677
1097,recursive,"
Product: Infinix Hot 50. Category: Infinix. Subcategory: Phone. Price: Out Of Stock.

Product: Infinix Hot 50 Pro. Category: Infinix. Subcategory: Phone. Price: Out Of Stock.

Product: Infinix Hot 50 Pro Plus. Category: Infinix. Subcategory: Phone. Price: Out Of Stock.
",271,262677,262948
1098,recursive,"
Product: Infinix Note 50 Pro+. Category: Infinix. Subcategory: Phone. Price: 54,400৳54,999৳.

Product: Infinix Note 50 Pro. Category: Infinix. Subcategory: Phone. Price: Out Of Stock.

Product: Nokia C32. Category: Nokia. Subcategory: Phone. Price: 13,100৳13,499৳.
",266,262948,263214
1099,recursive,"
Product: Nokia 150 DS (2023). Category: Nokia. Subcategory: Phone. Price: Out Of Stock.

Product: Nokia 3210 DS. Category: Nokia. Subcategory: Phone. Price: Out Of Stock.

Product: Nokia C12 Pro (4/64GB). Category: Nokia. Subcategory: Phone. Price: Out Of Stock.
",264,263214,263478
1100,recursive,"
Product: Nokia 110 DS (2023). Category: Nokia. Subcategory: Phone. Price: Out Of Stock.

Product: Nokia C22 (3/64GB). Category: Nokia. Subcategory: Phone. Price: Out Of Stock.

Product: Walton Primo GH11 (4/32GB). Category: Walton. Subcategory: Phone. Price: 8,990৳9,523৳.
",274,263478,263752
1101,recursive,"
Product: Walton NEXG N73 (8/128GB). Category: Walton. Subcategory: Phone. Price: 13,299৳13,999৳.

Product: Walton NEXG N74 (8/128GB). Category: Walton. Subcategory: Phone. Price: Up Coming.

Product: Walton XANON X21. Category: Walton. Subcategory: Phone. Price: Up Coming.
",275,263752,264027
1102,recursive,"
Product: Walton NEXG N10 Ultra. Category: Walton. Subcategory: Phone. Price: Up Coming.

Product: Walton ZENX 1. Category: Walton. Subcategory: Phone. Price: Up Coming.

Product: Walton NEXG N27. Category: Walton. Subcategory: Phone. Price: Up Coming.
",253,264027,264280
1103,recursive,"
Product: Walton Orbit Y71. Category: Walton. Subcategory: Phone. Price: Up Coming.

Product: Walton XANON X91. Category: Walton. Subcategory: Phone. Price: Up Coming.

Product: Walton ZENX 1T. Category: Walton. Subcategory: Phone. Price: Up Coming.
",250,264280,264530
1104,recursive,"
Product: Walton ZENX 2. Category: Walton. Subcategory: Phone. Price: Up Coming.

Product: Walton NEXG N26 (8/128GB). Category: Walton. Subcategory: Phone. Price: Up Coming.

Product: Walton Olvio M100. Category: Walton. Subcategory: Phone. Price: Out Of Stock.
",262,264530,264792
1105,recursive,"
Product: Walton Olvio M200. Category: Walton. Subcategory: Phone. Price: Out Of Stock.

Product: Walton Orbit Y11 (2/16GB). Category: Walton. Subcategory: Phone. Price: Out Of Stock.

Product: Walton Orbit Y70C (6/64GB). Category: Walton. Subcategory: Phone. Price: Out Of Stock.
",281,264792,265073
1106,recursive,"
Product: Walton Orbit Y50 (4/64GB). Category: Walton. Subcategory: Phone. Price: Out Of Stock.

Product: Walton Primo S8 mini (4/64GB). Category: Walton. Subcategory: Phone. Price: Out Of Stock.

Product: Walton NEXG N25 (8/128GB). Category: Walton. Subcategory: Phone. Price: Out Of Stock.
",292,265073,265365
1107,recursive,"
Product: Tecno Spark Go 2. Category: TECNO. Subcategory: Phone. Price: 10,700৳10,990৳.

Product: Tecno SPARK 40C. Category: TECNO. Subcategory: Phone. Price: 12,100৳12,499৳.

Product: Tecno SPARK 30C. Category: TECNO. Subcategory: Phone. Price: 13,450৳13,999৳.
",262,265365,265627
1108,recursive,"
Product: Tecno SPARK 40. Category: TECNO. Subcategory: Phone. Price: 13,650৳13,999৳.

Product: Tecno SPARK 40 Pro. Category: TECNO. Subcategory: Phone. Price: 19,690৳19,999৳.

Product: Tecno SPARK 40 Pro Plus. Category: TECNO. Subcategory: Phone. Price: 24,150৳24,999৳.
",271,265627,265898
1109,recursive,"
Product: Tecno Camon 40 Pro. Category: TECNO. Subcategory: Phone. Price: 27,250৳27,999৳.

Product: Tecno PHANTOM V Fold2 5G. Category: TECNO. Subcategory: Phone. Price: Up Coming.

Product: Tecno Spark Go 1. Category: TECNO. Subcategory: Phone. Price: Out Of Stock.
",267,265898,266165
1110,recursive,"
Product: Tecno SPARK 30. Category: TECNO. Subcategory: Phone. Price: Out Of Stock.

Product: Tecno SPARK 30 Pro. Category: TECNO. Subcategory: Phone. Price: Out Of Stock.

Product: Tecno Camon 30. Category: TECNO. Subcategory: Phone. Price: Out Of Stock.
",256,266165,266421
1111,recursive,"
Product: Tecno Camon 40. Category: TECNO. Subcategory: Phone. Price: Out Of Stock.

Product: Tecno Camon 30S. Category: TECNO. Subcategory: Phone. Price: Out Of Stock.

Product: Tecno Camon 40 Pro 5G. Category: TECNO. Subcategory: Phone. Price: Out Of Stock.
",260,266421,266681
1112,recursive,"
Product: Benco V90 Plus. Category: benco. Subcategory: Phone. Price: 8,590৳8,999৳.

Product: Benco V90i. Category: benco. Subcategory: Phone. Price: 9,150৳9,499৳.

Product: Benco V91 Plus. Category: benco. Subcategory: Phone. Price: 12,100৳12,499৳.
",250,266681,266931
1113,recursive,"
Product: Benco C1. Category: benco. Subcategory: Phone. Price: Out Of Stock.

Product: Benco E20. Category: benco. Subcategory: Phone. Price: Out Of Stock.

Product: Benco P26. Category: benco. Subcategory: Phone. Price: Out Of Stock.
",236,266931,267167
1114,recursive,"
Product: Benco C27. Category: benco. Subcategory: Phone. Price: Out Of Stock.

Product: Benco E21. Category: benco. Subcategory: Phone. Price: Out Of Stock.

Product: Benco P32. Category: benco. Subcategory: Phone. Price: Out Of Stock.
",237,267167,267404
1115,recursive,"
Product: Benco V82 (3/64GB). Category: benco. Subcategory: Phone. Price: Out Of Stock.

Product: Benco V90 (4/64GB). Category: benco. Subcategory: Phone. Price: Out Of Stock.

Product: Benco V90 (4/128GB). Category: benco. Subcategory: Phone. Price: Out Of Stock.
",265,267404,267669
1116,recursive,"
Product: Benco V80 (4/64GB). Category: benco. Subcategory: Phone. Price: Out Of Stock.

Product: Benco V91 (4/128GB). Category: benco. Subcategory: Phone. Price: Out Of Stock.

Product: Benco V91c. Category: benco. Subcategory: Phone. Price: 10,100৳10,499৳.
",259,267669,267928
1117,recursive,"
Product: Benco V91 (8/128GB). Category: benco. Subcategory: Phone. Price: Out Of Stock.

Product: Benco S1 (6/128GB). Category: benco. Subcategory: Phone. Price: Out Of Stock.

Product: Benco S1 Plus. Category: benco. Subcategory: Phone. Price: 17,100৳17,499৳.
",262,267928,268190
1118,recursive,"
Product: Benco S1 (8/128GB). Category: benco. Subcategory: Phone. Price: Out Of Stock.

Product: Benco S1 Pro (6/128GB). Category: benco. Subcategory: Phone. Price: Out Of Stock.

Product: TCL 408 (4/128GB). Category: TCL. Subcategory: Phone. Price: Out Of Stock.
",265,268190,268455
1119,recursive,"
Product: TCL 40 SE (6/256GB). Category: TCL. Subcategory: Phone. Price: Out Of Stock.

Product: Symphony S100. Category: Feature Phone. Subcategory: Phone. Price: Up Coming.

Product: Symphony B70. Category: Feature Phone. Subcategory: Phone. Price: Out Of Stock.
",265,268455,268720
1120,recursive,"
Product: ZTE Blade A35 (4/64GB). Category: ZTE. Subcategory: Phone. Price: 7,690৳7,999৳.

Product: ZTE Blade A36. Category: ZTE. Subcategory: Phone. Price: 8,150৳8,499৳.

Product: ZTE nubia A56. Category: ZTE. Subcategory: Phone. Price: 9,250৳9,499৳.
",252,268720,268972
1121,recursive,"
Product: ZTE nubia V70 Design. Category: ZTE. Subcategory: Phone. Price: 11,650৳11,999৳.

Product: ZTE nubia Neo 5G (8/256GB). Category: ZTE. Subcategory: Phone. Price: 18,200৳19,999৳.

Product: ZTE Blade A35e. Category: ZTE. Subcategory: Phone. Price: Up Coming.
",265,268972,269237
1122,recursive,"
Product: ZTE Blade A55 (4/128GB). Category: ZTE. Subcategory: Phone. Price: Out Of Stock.

Product: ZTE Blade A54 (4/128GB). Category: ZTE. Subcategory: Phone. Price: Out Of Stock.

Product: ZTE Blade V40 Smartphone (6/128GB). Category: ZTE. Subcategory: Phone. Price: Out Of Stock.
",284,269237,269521
1123,recursive,"
Product: ZTE Blade V50 Design (8/128GB). Category: ZTE. Subcategory: Phone. Price: Out Of Stock.

Product: ZTE Blade V50 Design (8/256GB). Category: ZTE. Subcategory: Phone. Price: Out Of Stock.
",196,269521,269717
1124,recursive,"
Product: ZTE nubia REDMAGIC 8S Pro (12/256GB). Category: ZTE. Subcategory: Phone. Price: Out Of Stock.

Product: ZTE nubia Z60 Ultra (12/256GB). Category: ZTE. Subcategory: Phone. Price: Out Of Stock.
",202,269717,269919
1125,recursive,"
Product: ZTE nubia REDMAGIC 9 Pro (12/256GB). Category: ZTE. Subcategory: Phone. Price: Out Of Stock.

Product: ZTE nubia REDMAGIC 9 Pro (16/512GB). Category: ZTE. Subcategory: Phone. Price: Out Of Stock.
",206,269919,270125
1126,recursive,"
Product: Symphony ATOM 5 (4/64GB). Category: Symphony. Subcategory: Phone. Price: 7,850৳7,999৳.

Product: Symphony Z72. Category: Symphony. Subcategory: Phone. Price: 8,790৳8,999৳.

Product: Symphony Innova 30 (8/128GB). Category: Symphony. Subcategory: Phone. Price: 12,290৳12,699৳.
",285,270125,270410
1127,recursive,"
Product: Symphony Helio 40 (8/128GB). Category: Symphony. Subcategory: Phone. Price: 12,850৳13,199৳.

Product: Symphony Helio 100. Category: Symphony. Subcategory: Phone. Price: 19,400৳19,999৳.
",195,270410,270605
1128,recursive,"
Product: Micropack WCP-315 15W 3 in 1 Magnetic Wireless Charger. Category: Charger & Adapter. Subcategory: Mobile Accessories. Price: 9,999৳.

Product: Micropack MTA-5100 100W 5 Port Universal Travel Adapter. Category: Charger & Adapter. Subcategory: Mobile Accessories. Price: 7,500৳.
",287,270605,270892
1129,recursive,"
Product: Micropack MTA-535 35W 5 Port Universal Travel Adapter. Category: Charger & Adapter. Subcategory: Mobile Accessories. Price: 3,299৳.

Product: Micropack MWC-4100 100W 4 Port Universal Travel Adapter. Category: Charger & Adapter. Subcategory: Mobile Accessories. Price: 7,500৳.
",286,270892,271178
1130,recursive,"
Product: Micropack MWC-265H 65W Type C Fast GaN Charger. Category: Charger & Adapter. Subcategory: Mobile Accessories. Price: 6,500৳.

Product: Micropack MWC-233PD 33W Type C Charger Adapter. Category: Charger & Adapter. Subcategory: Mobile Accessories. Price: 2,250৳.
",270,271178,271448
1131,recursive,"
Product: Anker Zolo 20W IQ & PD Type-C Charger Adapter. Category: Charger & Adapter. Subcategory: Mobile Accessories. Price: 1,050৳1,150৳.

Product: Anker 312 30W Type-C Charger Adapter. Category: Charger & Adapter. Subcategory: Mobile Accessories. Price: 1,150৳1,250৳.
",271,271448,271719
1132,recursive,"
Product: Micropack WCP-10PD AIR WAVE LITE Wireless Charger. Category: Charger & Adapter. Subcategory: Mobile Accessories. Price: 1,890৳.

Product: Oraimo Firefly 3 10W USB Charger Adapter with Type C Cable (OCW-E66S+C53). Category: Charger & Adapter. Subcategory: Mobile Accessories. Price: 230৳.
",298,271719,272017
1133,recursive,"
Product: Oraimo Firefly 3 10W USB Charger Adapter with Micro USB Cable (OCW-E66S+M53). Category: Charger & Adapter. Subcategory: Mobile Accessories. Price: 215৳.
",163,272017,272180
1134,recursive,"
Product: Xiaomi MI 3A 1 Port USB 2 Pin Charging Adapter White. Category: Charger & Adapter. Subcategory: Mobile Accessories. Price: 340৳390৳.

Product: Oraimo Cannon 18S 18W Charger Adapter with Micro USB Cable. Category: Charger & Adapter. Subcategory: Mobile Accessories. Price: 380৳415৳.
",292,272180,272472
1135,recursive,"
Product: Oraimo Cannon 18S 18W Charger Adapter with Type-C Cable. Category: Charger & Adapter. Subcategory: Mobile Accessories. Price: 380৳415৳.

Product: Oraimo Cannon 2 Pro 18W Charger Adapter with Lighting Cable. Category: Charger & Adapter. Subcategory: Mobile Accessories. Price: 390৳420৳.
",296,272472,272768
1136,recursive,"
Product: Oraimo Cannon 18S USB 18W Charger Adapter with USB to Lightning Cable. Category: Charger & Adapter. Subcategory: Mobile Accessories. Price: 390৳420৳.
",160,272768,272928
1137,recursive,"
Product: FONENG EU39 20W PD Charger Adapter With Type-C Cable. Category: Charger & Adapter. Subcategory: Mobile Accessories. Price: 440৳480৳.

Product: FONENG EU46 QC3 18W Fast Charger with Type - C Cable. Category: Charger & Adapter. Subcategory: Mobile Accessories. Price: 450৳.
",282,272928,273210
1138,recursive,"
Product: Oraimo Cannon 18D Dual Port 18W Charger Adapter with Micro USB Cable. Category: Charger & Adapter. Subcategory: Mobile Accessories. Price: 450৳490৳.
",159,273210,273369
1139,recursive,"
Product: Oraimo Cannon Dual Port 18W Charger Adapter with Type-C Cable. Category: Charger & Adapter. Subcategory: Mobile Accessories. Price: 460৳490৳.

Product: Baseus Folding Bracket Antiskid Pad. Category: Holder & Stand. Subcategory: Mobile Accessories. Price: 528৳.
",271,273369,273640
1140,recursive,"
Product: WiWU ZM-014 360 Degree Rotating Desktop Phone Stand. Category: Holder & Stand. Subcategory: Mobile Accessories. Price: 600৳.

Product: Baseus SUWY-A01 Desktop Phone Holder. Category: Holder & Stand. Subcategory: Mobile Accessories. Price: 1,050৳1,134৳.
",263,273640,273903
1141,recursive,"
Product: UGREEN LP373 Desk Mount Foldable Phone Stand #20434. Category: Holder & Stand. Subcategory: Mobile Accessories. Price: 800৳.

Product: Vention KCZH0 Portable Cell Phone Stand. Category: Holder & Stand. Subcategory: Mobile Accessories. Price: 690৳825৳.
",262,273903,274165
1142,recursive,"
Product: Ugreen LP189 Car Mount Snap Clip Dashboard Phone Holder #60796. Category: Holder & Stand. Subcategory: Mobile Accessories. Price: 900৳.

Product: Micropack MMW-01 Magnetic Card Wallet. Category: Holder & Stand. Subcategory: Mobile Accessories. Price: 4,500৳.
",269,274165,274434
1143,recursive,"
Product: Vention FGHIF Wireless Charger Stand. Category: Holder & Stand. Subcategory: Mobile Accessories. Price: 2,750৳2,850৳.

Product: Vention FGEI0 3-in-1 Wireless Charger Stand. Category: Holder & Stand. Subcategory: Mobile Accessories. Price: 5,650৳6,199৳.
",263,274434,274697
1144,recursive,"
Product: Vention KSDH0 Articulating 360° Rotatable Desk Phone Stand. Category: Holder & Stand. Subcategory: Mobile Accessories. Price: 1,050৳1,150৳.

Product: WiWU ZM100 Foldable Desktop Stand for Mobile & Tablet. Category: Holder & Stand. Subcategory: Mobile Accessories. Price: 1,250৳.
",289,274697,274986
1145,recursive,"
Product: Vyvylabs VFBRS-01 Knight Smartphone Holder for Bicycle and Motorcycle. Category: Holder & Stand. Subcategory: Mobile Accessories. Price: 1,490৳1,599৳.
",161,274986,275147
1146,recursive,"
Product: Baseus Energy Storage Backseat Holder Qi 15W Wireless Charger. Category: Holder & Stand. Subcategory: Mobile Accessories. Price: 2,300৳2,600৳.

Product: Takstar ST-201 Cell Phone Stand. Category: Holder & Stand. Subcategory: Mobile Accessories. Price: 2,300৳3,000৳.
",276,275147,275423
1147,recursive,"
Product: Baseus Wisdom Auto Alignment Car Mount Qi 15W Wireless Charger. Category: Holder & Stand. Subcategory: Mobile Accessories. Price: 2,490৳2,699৳.
",154,275423,275577
1148,recursive,"
Product: Ugreen Adjustable Portable Multi-Angle Tablet Stand (White) #30485. Category: Holder & Stand. Subcategory: Mobile Accessories. Price: Up Coming.

Product: Vyvylabs VFMFS-01 Wood OX Mini Smartphone Holder. Category: Holder & Stand. Subcategory: Mobile Accessories. Price: Up Coming.
",292,275577,275869
1149,recursive,"
Product: Ugreen Ring Phone Holder Silver. Category: Holder & Stand. Subcategory: Mobile Accessories. Price: Out Of Stock.

Product: Ugreen LP106 Adjustable Portable Multi-Angle Mobile Holder Stand #50747. Category: Holder & Stand. Subcategory: Mobile Accessories. Price: Out Of Stock.
",286,275869,276155
1150,recursive,"
Product: UGreen 30283 Air Vent Mount Phone Holder. Category: Holder & Stand. Subcategory: Mobile Accessories. Price: Out Of Stock.

Product: WIWU Waltz Rotative Folio Protective Tablet Case For iPad 12.9 Inch. Category: Case & Cover. Subcategory: Mobile Accessories. Price: 1,700৳.
",283,276155,276438
1151,recursive,"
Product: Ugreen Transparent Soft Phone Case for iPhone 7/8 #50796. Category: Case & Cover. Subcategory: Mobile Accessories. Price: Out Of Stock.

Product: WIWU Smart Folio Protective Case for iPad. Category: Case & Cover. Subcategory: Mobile Accessories. Price: Out Of Stock.
",277,276438,276715
1152,recursive,"
Product: UGreen 50580 iPhone X Battery Case with wireless charging treasure. Category: Case & Cover. Subcategory: Mobile Accessories. Price: Out Of Stock.

Product: Anker iPhone 15 Pro Clear Magnetic Phone Case. Category: Case & Cover. Subcategory: Mobile Accessories. Price: Out Of Stock.
",291,276715,277006
1153,recursive,"
Product: Fantech Gletser PC-10 Phone Cooler. Category: Mobile Phone Cooler. Subcategory: Mobile Accessories. Price: 1,090৳1,199৳.

Product: Plextone UF1 RGB Magnetic Radiator Phone Cooler. Category: Mobile Phone Cooler. Subcategory: Mobile Accessories. Price: 1,250৳1,350৳.
",275,277006,277281
1154,recursive,"
Product: Plextone EX2 Pro RGB Magnetic Radiator Phone Cooler. Category: Mobile Phone Cooler. Subcategory: Mobile Accessories. Price: 1,250৳1,350৳.

Product: Plextone EX2 Ultra RGB Magnetic Radiator Phone Cooler. Category: Mobile Phone Cooler. Subcategory: Mobile Accessories. Price: 1,350৳1,450৳.
",298,277281,277579
1155,recursive,"
Product: Plextone EX3 Pro RGB Magnetic Radiator Phone Cooler. Category: Mobile Phone Cooler. Subcategory: Mobile Accessories. Price: 2,450৳2,650৳.

Product: Plextone EX2 GO RGB Magnetic Radiator Phone Cooler. Category: Mobile Phone Cooler. Subcategory: Mobile Accessories. Price: Up Coming.
",292,277579,277871
1156,recursive,"
Product: Plextone EX2 RGB Magnetic Radiator Phone Cooler. Category: Mobile Phone Cooler. Subcategory: Mobile Accessories. Price: Up Coming.

Product: Plextone EX2 Plus RGB Magnetic Radiator Phone Cooler. Category: Mobile Phone Cooler. Subcategory: Mobile Accessories. Price: Up Coming.
",287,277871,278158
1157,recursive,"
Product: OnePlus Gaming Triggers. Category: Mobile Phone Cooler. Subcategory: Mobile Accessories. Price: Out Of Stock.

Product: Realme Cooling Back Clip Neo Mobile Cooler. Category: Mobile Phone Cooler. Subcategory: Mobile Accessories. Price: Out Of Stock.
",259,278158,278417
1158,recursive,"
Product: OnePlus PCV02 18W Freezing Point Phone Cooler. Category: Mobile Phone Cooler. Subcategory: Mobile Accessories. Price: Out Of Stock.

Product: Hoco GM26 Ambitious Mobile Phone Cooler. Category: Mobile Phone Cooler. Subcategory: Mobile Accessories. Price: Out Of Stock.
",278,278417,278695
1159,recursive,"
Product: Black Shark FunCooler Pro BR20 Mobile Cooler. Category: Mobile Phone Cooler. Subcategory: Mobile Accessories. Price: Out Of Stock.

Product: XP-Pen Star-G430S Ultra-Thin Digital Drawing Graphics Tablet. Category: XP-PEN. Subcategory: Graphics Tablet. Price: 2,300৳2,800৳.
",282,278695,278977
1160,recursive,"
Product: XP-Pen Deco Mini 7 V2 4.37"" Drawing Graphics Tablet. Category: XP-PEN. Subcategory: Graphics Tablet. Price: 5,200৳5,400৳.

Product: XP-Pen Star-G960S Digital Drawing Graphics Tablet. Category: XP-PEN. Subcategory: Graphics Tablet. Price: 4,800৳5,000৳.
",262,278977,279239
1161,recursive,"
Product: XP-Pen Star 03 V2 Drawing Graphics Tablet. Category: XP-PEN. Subcategory: Graphics Tablet. Price: 6,600৳6,700৳.

Product: XP-Pen Deco 01 V3 Digital Drawing Graphics Tablet. Category: XP-PEN. Subcategory: Graphics Tablet. Price: 6,200৳6,700৳.
",252,279239,279491
1162,recursive,"
Product: XP-Pen Deco M (Medium) IT850 8 Inch Drawing Graphic Tablet. Category: XP-PEN. Subcategory: Graphics Tablet. Price: 7,500৳7,900৳.

Product: XP-Pen Star 06 Wireless Digital Painting Graphics Drawing Tablet. Category: XP-PEN. Subcategory: Graphics Tablet. Price: 7,000৳8,350৳.
",284,279491,279775
1163,recursive,"
Product: XP-Pen Deco 02 Pen Digital Drawing Graphics Tablet. Category: XP-PEN. Subcategory: Graphics Tablet. Price: 8,200৳8,500৳.

Product: XP-Pen Deco L Drawing Graphics Tablet. Category: XP-PEN. Subcategory: Graphics Tablet. Price: 8,900৳10,000৳.
",250,279775,280025
1164,recursive,"
Product: XP-Pen Deco Pro Small Drawing Graphics Tablet. Category: XP-PEN. Subcategory: Graphics Tablet. Price: 11,200৳11,800৳.

Product: XP-Pen Deco Pro Medium Digital Drawing Graphics Tablet. Category: XP-PEN. Subcategory: Graphics Tablet. Price: 11,200৳11,800৳.
",265,280025,280290
1165,recursive,"
Product: XP-PEN Deco Fun LW Wireless Digital 10 inch Drawing Graphics Tablet. Category: XP-PEN. Subcategory: Graphics Tablet. Price: 9,500৳10,000৳.

Product: XP-Pen Deco Pro SW Bluetooth Drawing Graphics Tablet. Category: XP-PEN. Subcategory: Graphics Tablet. Price: 12,000৳.
",277,280290,280567
1166,recursive,"
Product: XP-Pen Deco Pro XLW Gen 2 Wireless Graphics Drawing Tablet. Category: XP-PEN. Subcategory: Graphics Tablet. Price: 22,800৳23,300৳.

Product: XP-Pen Artist 10 (2nd Gen) Digital Graphics Drawing Tablet. Category: XP-PEN. Subcategory: Graphics Tablet. Price: 24,000৳.
",275,280567,280842
1167,recursive,"
Product: XP-Pen Artist 13 2nd Gen 13.3"" IPS Drawing Tablet. Category: XP-PEN. Subcategory: Graphics Tablet. Price: 30,500৳.

Product: XP-Pen Artist 15.6 Pro V2 Graphics Tablet. Category: XP-PEN. Subcategory: Graphics Tablet. Price: 48,000৳.
",242,280842,281084
1168,recursive,"
Product: XP-Pen Artist 13.3 Pro V2 Graphics Tablet. Category: XP-PEN. Subcategory: Graphics Tablet. Price: 36,500৳.

Product: XP-Pen Artist 15.6 Pro IPS Drawing Monitor Pen Display Digital Graphics Tablet. Category: XP-PEN. Subcategory: Graphics Tablet. Price: 45,000৳48,000৳.
",278,281084,281362
1169,recursive,"
Product: XP-Pen Artist 24 2K QHD 23.8"" Digital Graphics Drawing Tablet. Category: XP-PEN. Subcategory: Graphics Tablet. Price: 94,500৳.

Product: TECLAST P85T 4GB 64GB Storage 8 inch Android Kids Tablet. Category: Tablet. Price: 11,000৳.
",239,281362,281601
1170,recursive,"
Product: Teclast P30 4GB 64GB 10.1"" Tablet Wi-Fi Only. Category: Tablet. Price: 12,000৳.

Product: TECLAST P30T 4GB 64GB Storage 10.1 inch Android Kids Tablet. Category: Tablet. Price: 13,000৳.

Product: Walton Walpad 8G 4GB RAM 64GB Storage 8"" Tablet. Category: Tablet. Price: 8,999৳14,500৳.
",294,281601,281895
1171,recursive,"
Product: Teclast P30T 10.1 Inch Unisoc T606 Tablet with All-in-one KIT. Category: Tablet. Price: 16,000৳.

Product: Teclast P50 2025 11"" Tablet. Category: Tablet. Price: 16,500৳.

Product: Walton Walpad 9G 4GB RAM 128GB Storage 8.68"" Tablet. Category: Tablet. Price: 16,500৳18,000৳.
",284,281895,282179
1172,recursive,"
Product: HONOR Pad X8a 4GB RAM 128GB Storage 11"" Tablet. Category: Tablet. Price: 18,000৳19,900৳.

Product: Amazon Fire HD 8 12th Gen 8"" FHD Tablet. Category: Tablet. Price: 20,000৳.

Product: Teclast T60AI 12"" Tablet. Category: Tablet. Price: 20,600৳.
",254,282179,282433
1173,recursive,"
Product: Amazon Fire 7 Kids 12th Gen 7"" Display Tablet. Category: Tablet. Price: 21,000৳.

Product: Amazon Fire HD 10 11th Gen Octa-Core 10.1"" FHD Tablet with Alexa. Category: Tablet. Price: 22,000৳.
",201,282433,282634
1174,recursive,"
Product: Amazon Fire HD 8 Plus 10th Gen Quad Core 8"" Display Tablet. Category: Tablet. Price: 22,000৳.

Product: Lenovo Tab M8 3GB RAM 32GB Storage 8"" FHD Tablet (Sim Supported). Category: Tablet. Price: 19,500৳22,500৳.

Product: Honor Pad 10. Category: Tablet. Price: 37,000৳38,990৳.
",286,282634,282920
1175,recursive,"
Product: HONOR Pad X9a 6GB RAM 128GB Storage 11.5-inch Tablet. Category: Tablet. Price: 21,500৳22,500৳.

Product: Lenovo Tab M9 4GB RAM 64GB Storage 9"" Android Tablet  (Sim Supported). Category: Tablet. Price: 23,999৳.
",220,282920,283140
1176,recursive,"
Product: Amazon Fire HD 8 Kids Pro 12th Gen 8"" Display Tablet. Category: Tablet. Price: 24,000৳.

Product: Walton Walpad 10H Pro Max 8GB RAM 128GB Storage 10.36"" Tablet. Category: Tablet. Price: 23,000৳24,000৳.
",212,283140,283352
1177,recursive,"
Product: Teclast T60 8GB RAM 256GB ROM 11.97"" 2K IPS Tablet (Sim Supported). Category: Tablet. Price: 24,300৳25,500৳.

Product: Wacom One by CTL-472 Small 6-inch x 3.5-inch Graphic Tablet. Category: Wacom. Subcategory: Graphics Tablet. Price: 6,800৳7,400৳.
",258,283352,283610
1178,recursive,"
Product: Wacom CTL-4100/K0-CX Intuos Small Dimensions 20 x 16 x 0.9 Cm Pen Tablet. Category: Wacom. Subcategory: Graphics Tablet. Price: 9,000৳.
",146,283610,283756
1179,recursive,"
Product: Wacom One By CTL-672/K2/K0-F Medium Dimensions 18.9 x 27.7 x 0.9 Cm Pen Graphics Tablet. Category: Wacom. Subcategory: Graphics Tablet. Price: 8,500৳9,500৳.
",167,283756,283923
1180,recursive,"
Product: Wacom One S 6"" Small Bluetooth Graphics Drawing Tablet. Category: Wacom. Subcategory: Graphics Tablet. Price: 12,800৳13,500৳.
",136,283923,284059
1181,recursive,"
Product: Wacom CTL-6100WL/K0-CX Intuos Medium Dimensions 26.4 x 20 x 0.9 Cm Bluetooth Pen Graphics Tablet. Category: Wacom. Subcategory: Graphics Tablet. Price: 18,000৳.
",171,284059,284230
1182,recursive,"
Product: Wacom PTH-460/K0-CX Intuos Pro S 10.6 x 6.7 x 0.3 inch Graphics Tablet. Category: Wacom. Subcategory: Graphics Tablet. Price: 25,500৳32,000৳.

Product: Wacom Cintiq DTK-1660 16 Inch FHD Pen Graphics Tablet. Category: Wacom. Subcategory: Graphics Tablet. Price: 87,000৳.
",280,284230,284510
1183,recursive,"
Product: Wacom DTK 2260 K0-CA Cintiq 22 Inch FHD 22ms HDMI Pen Graphics Tablet. Category: Wacom. Subcategory: Graphics Tablet. Price: 155,000৳.

Product: Wacom Cintiq Pro 16 Inch UHD 22ms Creative Pen & Touch Graphics Tablet. Category: Wacom. Subcategory: Graphics Tablet. Price: 165,000৳.
",291,284510,284801
1184,recursive,"
Product: Wacom DTK-2420 CINTIQ PRO 24 PEN Graphic Tablet. Category: Wacom. Subcategory: Graphics Tablet. Price: Pre Order.

Product: Wacom Cintiq Pro 32 Inch 4K UHD 14ms Pen and Touch Graphics Tablet. Category: Wacom. Subcategory: Graphics Tablet. Price: Pre Order.
",267,284801,285068
1185,recursive,"
Product: Wacom CTL-4100WL/K0-CX Intuos Small Bluetooth Dimensions 20 x 16 x 0.9 cm Pen Graphics Tablet. Category: Wacom. Subcategory: Graphics Tablet. Price: Out Of Stock.
",173,285068,285241
1186,recursive,"
Product: Wacom CTL-6100/K0-CX Intuos Medium Dimensions 26.4 x 20 x 0.9 cm Pen Graphics Tablet. Category: Wacom. Subcategory: Graphics Tablet. Price: Out Of Stock.
",164,285241,285405
1187,recursive,"
Product: Wacom PTH-660/K1-CX Intuos Pro Medium Paper Edition Dimensions 33.4 x 21.7 x 0.8 cm Pen Graphics Tablet. Category: Wacom. Subcategory: Graphics Tablet. Price: Out Of Stock.

Product: Huion H430P Graphics Tablet. Category: Graphics Tablet. Subcategory: Tablet. Price: 2,800৳2,900৳.
",291,285405,285696
1188,recursive,"
Product: Huion Inspiroy RTE-100 Graphics Drawing Tablet. Category: Graphics Tablet. Subcategory: Tablet. Price: 3,200৳3,550৳.

Product: Huion H640P Graphics Tablet. Category: Graphics Tablet. Subcategory: Tablet. Price: 3,700৳4,000৳.
",235,285696,285931
1189,recursive,"
Product: VEIKK S640 Small Dimensions 8.6 x 5.2 x 0.8 inches Drawing Graphic Tablet. Category: Graphics Tablet. Subcategory: Tablet. Price: 4,200৳5,000৳.

Product: Huion Inspiroy RTS-300 Graphics Drawing Tablet. Category: Graphics Tablet. Subcategory: Tablet. Price: 5,000৳5,500৳.
",281,285931,286212
1190,recursive,"
Product: Huion H950P Graphics Tablet. Category: Graphics Tablet. Subcategory: Tablet. Price: 5,500৳5,700৳.

Product: Huion Inspiroy H580X Graphics Tablet. Category: Graphics Tablet. Subcategory: Tablet. Price: 5,200৳5,900৳.
",225,286212,286437
1191,recursive,"
Product: Huion Inspiroy H610X Graphics Tablet. Category: Graphics Tablet. Subcategory: Tablet. Price: 6,700৳7,000৳.

Product: Huion Inspiroy RTM-500 Graphics Drawing Tablet. Category: Graphics Tablet. Subcategory: Tablet. Price: 7,000৳7,500৳.
",244,286437,286681
1192,recursive,"
Product: Huion Inspiroy H1060P Graphics Tablet. Category: Graphics Tablet. Subcategory: Tablet. Price: 8,200৳8,200৳.

Product: VEIKK A50 Medium Dimensions 38.1 x 21.8 x 4.3 cm Drawing Graphic Tablet. Category: Graphics Tablet. Subcategory: Tablet. Price: 7,500৳8,300৳.
",270,286681,286951
1193,recursive,"
Product: Huion Inspiroy H1161 Graphics Tablet. Category: Graphics Tablet. Subcategory: Tablet. Price: 7,800৳8,400৳.

Product: Huion HS611 Graphics Drawing Tablet. Category: Graphics Tablet. Subcategory: Tablet. Price: 8,000৳8,450৳.
",233,286951,287184
1194,recursive,"
Product: Veikk A30 Digital Drawing Graphic Tablet. Category: Graphics Tablet. Subcategory: Tablet. Price: 7,000৳8,500৳.

Product: Huion Inspiroy RTP-700 Graphics Drawing Tablet. Category: Huion. Subcategory: Graphics Tablet. Price: 8,500৳9,000৳.
",247,287184,287431
1195,recursive,"
Product: Huion Inspiroy Dial Q620M Graphic Drawing Tablet. Category: Huion. Subcategory: Graphics Tablet. Price: 8,500৳9,200৳.

Product: Huion A3 LED Light Pad. Category: Huion. Subcategory: Graphics Tablet. Price: 10,200৳.
",225,287431,287656
1196,recursive,"
Product: Huion Inspiroy Q11K V2 Wireless Graphic Tablet. Category: Huion. Subcategory: Graphics Tablet. Price: 9,500৳10,299৳.

Product: Huion Inspiroy Keydial KD200 Graphics Drawing Tablet. Category: Huion. Subcategory: Graphics Tablet. Price: 13,300৳.
",254,287656,287910
1197,recursive,"
Product: Huion Inspiroy WH1409 V2 13.8 Inch Wireless Graphic Tablet. Category: Huion. Subcategory: Graphics Tablet. Price: 13,500৳13,700৳.

Product: Huion Kamvas 12 Graphics Drawing Tablet. Category: Huion. Subcategory: Graphics Tablet. Price: 24,000৳25,000৳.
",261,287910,288171
1198,recursive,"
Product: Huion Kamvas Pro 12 Pen Display. Category: Huion. Subcategory: Graphics Tablet. Price: 29,000৳31,000৳.

Product: Huion KAMVAS Pro 13 13.3-Inch FHD Graphics Drawing Tablet. Category: Huion. Subcategory: Graphics Tablet. Price: 34,000৳35,000৳.
",252,288171,288423
1199,recursive,"
Product: Black Shark Pad 6 8GB RAM 256GB Storage 11"" FHD+ Tablet With Flip Cover (Dual Sim Supported). Category: Black Shark. Subcategory: Tablet. Price: 23,990৳26,000৳.

Product: HONOR Pad X8a LTE 4GB RAM 128GB Storage 11"" Tablet. Category: HONOR. Subcategory: Tablet. Price: 25,990৳.
",287,288423,288710
1200,recursive,"
Product: HONOR Pad X9 LTE 4GB RAM 128GB Storage 11.5-inch Tablet (Sim Supported). Category: HONOR. Subcategory: Tablet. Price: 27,350৳27,850৳.

Product: HONOR Pad X8 4GB RAM 64GB Storage 10.1"" Tablet (SIM Supported). Category: HONOR. Subcategory: Tablet. Price: 21,500৳.
",272,288710,288982
1201,recursive,"
Product: HONOR Pad X7 4GB RAM 64GB Storage 8.7"" Tablet With Case. Category: HONOR. Subcategory: Tablet. Price: 12,100৳13,500৳.

Product: HONOR Pad 9 Wi-Fi 8GB RAM 256GB Storage 12.1"" WQXGA Tablet. Category: HONOR. Subcategory: Tablet. Price: Out Of Stock.
",257,288982,289239
1202,recursive,"
Product: Lenovo Tab M10 Plus (3rd Gen) Snapdragon 4GB RAM 128GB ROM 10.61"" 2K Android Tablet. Category: Lenovo. Subcategory: Tablet. Price: 27,500৳29,000৳.
",157,289239,289396
1203,recursive,"
Product: Lenovo K10 Pro Snapdragon 680 6GB RAM 128GB ROM LTE (Nano-SIM) 10.6"" Android Tablet. Category: Lenovo. Subcategory: Tablet. Price: 28,500৳29,000৳.

Product: Lenovo Xiaoxin Pad 2024 Snapdragon 685 11"" Tablet (WiFi Only). Category: Lenovo. Subcategory: Tablet. Price: 30,000৳.
",285,289396,289681
1204,recursive,"
Product: Lenovo Xiaoxin Pad 2024 Snapdragon 685 8GB RAM 128GB ROM 11"" Tablet (WiFi Only). Category: Lenovo. Subcategory: Tablet. Price: 31,000৳32,500৳.
",153,289681,289834
1205,recursive,"
Product: Lenovo Tab M10 Plus (3rd Gen) Snapdragon 6GB RAM 128GB ROM 10.61"" 2K Android Tablet. Category: Lenovo. Subcategory: Tablet. Price: 33,000৳.
",150,289834,289984
1206,recursive,"
Product: Lenovo Xiaoxin Pad 2024 Snapdragon 685 8GB RAM 256GB ROM 11"" Tablet (WiFi Only). Category: Lenovo. Subcategory: Tablet. Price: 32,500৳33,500৳.
",153,289984,290137
1207,recursive,"
Product: Lenovo Xiaoxin Pad Pro Snapdragon 870 8GB RAM 256GB Storage 12.7"" Tablet (WiFi Only). Category: Lenovo. Subcategory: Tablet. Price: 45,000৳48,500৳.
",158,290137,290295
1208,recursive,"
Product: Lenovo Xiaoxin Pad Pro (2025) Dimensity 8300 12GB RAM 256GB Storage 12.7"" Tablet (Wi-Fi). Category: Lenovo. Subcategory: Tablet. Price: 57,500৳.
",155,290295,290450
1209,recursive,"
Product: Lenovo Tab P11 Gen 2 4GB RAM 128GB Storage 11.5-Inch 2K Android Tablet with keyboard & Pen. Category: Lenovo. Subcategory: Tablet. Price: Up Coming.
",159,290450,290609
1210,recursive,"
Product: Lenovo Tab K11 4GB RAM 64GB Storage 11"" 2K Android Tablet (Sim Supported). Category: Lenovo. Subcategory: Tablet. Price: Up Coming.

Product: Lenovo Tab K11 / P11 J6C6F Plus Helio G90T 6GB RAM 128GB Storage 11"" 2K Android Tablet. Category: Lenovo. Subcategory: Tablet. Price: Up Coming.
",297,290609,290906
1211,recursive,"
Product: Veikk Creator A15 Pro Drawing Graphic Tablet. Category: VEIKK. Subcategory: Graphics Tablet. Price: 8,000৳9,500৳.

Product: Apple iPad 11th Gen (2025). Category: iPad. Subcategory: Tablet. Price: 43,000৳45,500৳.
",222,290906,291128
1212,recursive,"
Product: Apple iPad Air 5 (WiFi). Category: iPad. Subcategory: Tablet. Price: 54,900৳61,000৳.

Product: Apple iPad Mini 7 (WiFi). Category: iPad. Subcategory: Tablet. Price: 55,000৳62,500৳.

Product: Apple iPad Air M3 11-inch (WiFi). Category: iPad. Subcategory: Tablet. Price: 68,000৳75,000৳.
",295,291128,291423
1213,recursive,"
Product: Apple iPad Air M2 11-inch (WiFi). Category: iPad. Subcategory: Tablet. Price: 71,000৳84,900৳.

Product: Apple iPad Air M3 11-inch (WiFI+Cellular). Category: iPad. Subcategory: Tablet. Price: 96,500৳95,000৳.
",217,291423,291640
1214,recursive,"
Product: Apple iPad Air M2 13-inch (WiFi). Category: iPad. Subcategory: Tablet. Price: 96,500৳99,800৳.

Product: Apple iPad Air 5 (WiFi+Cellular). Category: iPad. Subcategory: Tablet. Price: 102,000৳.
",202,291640,291842
1215,recursive,"
Product: Apple iPad Air M2 11-inch (WiFi+Cellular). Category: iPad. Subcategory: Tablet. Price: 100,000৳104,900৳.

Product: Apple iPad Mini 7 (WiFi+Cellular). Category: iPad. Subcategory: Tablet. Price: 110,000৳114,500৳.
",222,291842,292064
1216,recursive,"
Product: Apple iPad Pro M4 11-inch (WiFi). Category: iPad. Subcategory: Tablet. Price: 113,800৳121,000৳.

Product: Apple iPad Pro M4 11-inch (WiFi+Cellular). Category: iPad. Subcategory: Tablet. Price: 155,000৳157,000৳.
",221,292064,292285
1217,recursive,"
Product: Apple iPad Pro M4 13-inch (WiFi). Category: iPad. Subcategory: Tablet. Price: 143,000৳157,000৳.

Product: Apple iPad Pro M4 13 inch (WiFi+Cellular). Category: iPad. Subcategory: Tablet. Price: 164,000৳173,000৳.
",221,292285,292506
1218,recursive,"
Product: Apple iPad 9th Gen. Category: iPad. Subcategory: Tablet. Price: Out Of Stock.

Product: Apple iPad 10th Gen. Category: iPad. Subcategory: Tablet. Price: Out Of Stock.

Product: Xiaomi Redmi Pad 2. Category: Xiaomi. Subcategory: Tablet. Price: 27,400৳.
",262,292506,292768
1219,recursive,"
Product: Xiaomi Redmi Pad SE Snapdragon 680 4GB RAM 128GB ROM 11"" FHD Tablet. Category: Xiaomi. Subcategory: Tablet. Price: 26,500৳27,500৳.

Product: Xiaomi Redmi Pad SE Snapdragon 680 6GB RAM 128GB ROM 11"" FHD Tablet. Category: Xiaomi. Subcategory: Tablet. Price: 28,000৳.
",275,292768,293043
1220,recursive,"
Product: Xiaomi Redmi Pad SE Snapdragon 680 8GB RAM 256GB ROM 11"" FHD Tablet. Category: Xiaomi. Subcategory: Tablet. Price: 30,700৳33,000৳.
",141,293043,293184
1221,recursive,"
Product: Xiaomi Redmi Pad Pro Snapdragon 7s gen 2 8GB RAM 256GB Storage 12.1 Inch Tablet Only Wi-Fi. Category: Xiaomi. Subcategory: Tablet. Price: 29,000৳34,500৳.
",164,293184,293348
1222,recursive,"
Product: Xiaomi Pad 6 Snapdragon 870 8GB RAM 256GB Storage 11"" WQHD+ Tablet. Category: Xiaomi. Subcategory: Tablet. Price: 35,500৳36,500৳.

Product: Xiaomi POCO Pad 12.1"" 2.5K Tablet. Category: Xiaomi. Subcategory: Tablet. Price: 41,000৳.
",240,293348,293588
1223,recursive,"
Product: Xiaomi Pad 7 11.2"" Tablet Snapdragon 7+ Gen 3, 256GB. Category: Xiaomi. Subcategory: Tablet. Price: 39,500৳44,000৳.

Product: Xiaomi Pad 7 Pro Snapdragon 8s Gen 3 12GB RAM 512GB Storage 11.2"" 3.2K Tablet. Category: Xiaomi. Subcategory: Tablet. Price: 60,500৳65,000৳.
",277,293588,293865
1224,recursive,"
Product: Xiaomi Pad 7 Ultra. Category: Xiaomi. Subcategory: Tablet. Price: 110,000৳.

Product: Xiaomi Pad 6S Pro Snapdragon 8 Gen 2 8GB RAM 256GB Storage 12.4"" 3K Tablet. Category: Xiaomi. Subcategory: Tablet. Price: 69,000৳75,000৳.
",234,293865,294099
1225,recursive,"
Product: Xiaomi Redmi Pad SE Snapdragon 680 8GB RAM 128GB ROM 11"" FHD Tablet. Category: Xiaomi. Subcategory: Tablet. Price: Out Of Stock.
",139,294099,294238
1226,recursive,"
Product: Xiaomi Redmi Pad Pro Snapdragon 7s gen 2 8GB RAM 256GB Storage 12.1 Inch Tablet With 5G Sim Supported. Category: Xiaomi. Subcategory: Tablet. Price: Out Of Stock.

Product: Samsung Galaxy Tab A9 LTE (Wi-Fi + SIM). Category: Samsung. Subcategory: Tablet. Price: 13,990৳14,500৳.
",287,294238,294525
1227,recursive,"
Product: Samsung Galaxy Tab A9+ (Wi-Fi + SIM). Category: Samsung. Subcategory: Tablet. Price: 24,990৳32,500৳.

Product: Samsung Galaxy Tab S6 Lite 2024 (Wi-Fi + SIM). Category: Samsung. Subcategory: Tablet. Price: 35,000৳36,000৳.
",231,294525,294756
1228,recursive,"
Product: Samsung Galaxy Tab S9 FE (Wi-Fi Only). Category: Samsung. Subcategory: Tablet. Price: 37,000৳40,000৳.

Product: Samsung Galaxy Tab S9 FE+ (Wi-Fi Only). Category: Samsung. Subcategory: Tablet. Price: 43,500৳51,000৳.
",225,294756,294981
1229,recursive,"
Product: Samsung Galaxy Tab S10 FE. Category: Samsung. Subcategory: Tablet. Price: 45,000৳52,000৳.

Product: Samsung Galaxy Tab S10 FE 12GB RAM 256GB Storage. Category: Samsung. Subcategory: Tablet. Price: 53,500৳56,500৳.
",223,294981,295204
1230,recursive,"
Product: Samsung Galaxy Tab S9 (Wi-Fi Only). Category: Samsung. Subcategory: Tablet. Price: 58,000৳60,000৳.

Product: Samsung Galaxy Tab S10 FE+. Category: Samsung. Subcategory: Tablet. Price: 73,500৳.
",203,295204,295407
1231,recursive,"
Product: Samsung Galaxy Tab S9 5G (Wi-Fi + SIM). Category: Samsung. Subcategory: Tablet. Price: 75,000৳82,000৳.

Product: Samsung Galaxy Tab S10+ With Keyboard. Category: Samsung. Subcategory: Tablet. Price: 92,500৳98,500৳.
",225,295407,295632
1232,recursive,"
Product: Samsung Galaxy Tab S10 Ultra Wi-Fi Tablet With Keyboard. Category: Samsung. Subcategory: Tablet. Price: 111,500৳115,000৳.

Product: Samsung Galaxy Tab S9+ (Wi-Fi Only). Category: Samsung. Subcategory: Tablet. Price: 120,000৳138,000৳.
",244,295632,295876
1233,recursive,"
Product: Samsung Galaxy Tab S9+ (Wi-Fi + SIM). Category: Samsung. Subcategory: Tablet. Price: 129,900৳145,000৳.

Product: Samsung Galaxy Tab S10 Ultra 5G (Wi-Fi + SIM). Category: Samsung. Subcategory: Tablet. Price: 137,000৳145,000৳.
",235,295876,296111
1234,recursive,"
Product: Samsung Galaxy Tab S10 Ultra 5G 512GB (Wi-Fi + SIM). Category: Samsung. Subcategory: Tablet. Price: 155,000৳.

Product: Samsung Galaxy Tab S9 FE 5G (Wi-Fi + SIM). Category: Samsung. Subcategory: Tablet. Price: Out Of Stock.
",234,296111,296345
1235,recursive,"
Product: Samsung Galaxy Tab S9 FE+ (Wi-Fi + SIM). Category: Samsung. Subcategory: Tablet. Price: Out Of Stock.

Product: Samsung Galaxy Tab A9+ (Wi-Fi Only). Category: Samsung. Subcategory: Tablet. Price: Out Of Stock.
",220,296345,296565
1236,recursive,"
Product: Huawei MatePad 11 Wi-Fi 6GB RAM 128GB ROM IPS LCD Tablet. Category: HUAWEI. Subcategory: Tablet. Price: 52,500৳.

Product: Huawei MatePad 12 X. Category: HUAWEI. Subcategory: Tablet. Price: Up Coming.
",211,296565,296776
1237,recursive,"
Product: Huion Kamvas Slate 10 10.1-Inch FHD+ Android Drawing Tablet. Category: Huion. Subcategory: Tablet. Price: 21,000৳27,500৳.

Product: Chuwi Hi10 Max 12GB RAM 512GB ROM 12.96"" 3K Display Tablet. Category: Chuwi. Subcategory: Tablet. Price: 42,500৳44,900৳.
",263,296776,297039
1238,recursive,"
Product: Chuwi Hi10 XPro 4GB RAM 128GB Storage 10.1"" Android Tablet. Category: Chuwi. Subcategory: Tablet. Price: Up Coming.

Product: Amazon Fire MAX 11 13th Gen Octa-Core 11"" 2K Tablet with Alexa. Category: Amazon. Subcategory: Tablet. Price: 30,000৳.
",255,297039,297294
1239,recursive,"
Product: Amazon Kindle Paperwhite 12th Gen 16GB 7"" Display with Built-in Light, WiFi. Category: Amazon. Subcategory: Tablet. Price: 26,500৳33,000৳.

Product: Amazon Kindle Scribe 16GB 10.2” Tablet. Category: Amazon. Subcategory: Tablet. Price: 60,000৳.
",254,297294,297548
1240,recursive,"
Product: Amazon Fire 7 Quad Core 7"" Display Kids Tablet. Category: Amazon. Subcategory: Tablet. Price: Up Coming.

Product: Amazon Fire HD 8 Quad Core 8"" Display Kids Tablet. Category: Amazon. Subcategory: Tablet. Price: Up Coming.
",233,297548,297781
1241,recursive,"
Product: Amazon Fire HD 10 Kids 13th Gen 10.1"" FHD Tablet. Category: Amazon. Subcategory: Tablet. Price: Up Coming.

Product: Amazon Kindle Colorsoft Signature Edition 32GB 7"" E-Book Reader. Category: Amazon. Subcategory: Tablet. Price: 50,000৳.
",247,297781,298028
1242,recursive,"
Product: Amazon Kindle Kids 11th Gen 16GB 6"" E-Book Reader. Category: Amazon. Subcategory: Tablet. Price: Up Coming.

Product: Amazon Fire HD 10 13th Gen Octa-Core 10.1"" FHD Tablet with Alexa. Category: Amazon. Subcategory: Tablet. Price: Out Of Stock.
",254,298028,298282
1243,recursive,"
Product: Infinix Xpad 20. Category: Infinix. Subcategory: Tablet. Price: 19,900৳.

Product: Motorola Moto Pad 60 Pro. Category: Motorola. Subcategory: Tablet. Price: Out Of Stock.
",181,298282,298463
1244,recursive,"
Product: OnePlus Pad 2 Snapdragon 8 Gen 3 12GB RAM 256GB Storage 12.1"" 3K Tablet. Category: OnePlus. Subcategory: Tablet. Price: 55,200৳57,500৳.

Product: OnePlus Pad Lite 6GB RAM 128GB Storage 11"" Tablet. Category: OnePlus. Subcategory: Tablet. Price: Up Coming.
",265,298463,298728
1245,recursive,"
Product: OnePlus Pad 3 Snapdragon 8 Elite 12GB RAM 256GB Storage 13.2"" 3.4K Tablet. Category: OnePlus. Subcategory: Tablet. Price: Up Coming.

Product: ZTE Nubia Pad 3D Snapdragon 888 12GB RAM 256GB Storage 12.4"" 2.5K Tablet. Category: ZTE. Subcategory: Tablet. Price: 95,000৳102,000৳.
",287,298728,299015
1246,recursive,"
Product: Teclast T65 Max 13"" Android Tablet 8GB 256GB (Sim Supported). Category: Teclast. Subcategory: Tablet. Price: 29,500৳.

Product: Teclast T70 14"" Android Tablet. Category: Teclast. Subcategory: Tablet. Price: 32,000৳.
",226,299015,299241
1247,recursive,"
Product: Teclast M50 Plus 10.1"" Tablet. Category: Teclast. Subcategory: Tablet. Price: Out Of Stock.

Product: TECLAST T50 Plus 6GB 256GB Storage 11 inch Android Tablet. Category: Teclast. Subcategory: Tablet. Price: 20,000৳.
",227,299241,299468
1248,recursive,"
Product: Teclast T60 Plus 12 inch Android Tablet With Sim Supported. Category: Teclast. Subcategory: Tablet. Price: Out Of Stock.

Product: Teclast T50 Mini 8GB RAM 128GB ROM 8.7"" WXGA+ IPS Tablet (Sim Supported). Category: Teclast. Subcategory: Tablet. Price: 20,000৳.
",271,299468,299739
1249,recursive,"
Product: Google Pixel Tablet 8GB RAM 128GB Storage 10.95-inch Android Tablet. Category: Google. Subcategory: Tablet. Price: Up Coming.

Product: Google Pixel Tablet 8GB RAM 256GB Storage 10.95-inch Android Tablet. Category: Google. Subcategory: Tablet. Price: Up Coming.
",272,299739,300011
1250,recursive,"
Product: Hoco GM111 Cool Dynamic Series 3 in 1 Passive Universal Capacitive Stylus Pen. Category: Stylus. Subcategory: Tablet. Price: 500৳800৳.

Product: Wiwu Pencil One 2 in 1 Passive Style Stylus Pen (Universal). Category: Stylus. Subcategory: Tablet. Price: 950৳1,000৳.
",274,300011,300285
1251,recursive,"
Product: ESR Geo Digital Pencil for iPad. Category: Stylus. Subcategory: Tablet. Price: 5,278৳.

Product: ESR Digital Pencil for iPad. Category: Stylus. Subcategory: Tablet. Price: 3,958৳.
",190,300285,300475
1252,recursive,"
Product: Baseus Golden Cudgel Capacitive Stylus Pen Universal Android and Windows. Category: Stylus. Subcategory: Tablet. Price: 1,100৳1,200৳.

Product: Baseus Smooth Writing III 3-in-1 Multi-functional Passive Stylus Pen. Category: Stylus. Subcategory: Tablet. Price: 950৳1,100৳.
",282,300475,300757
1253,recursive,"
Product: Hoco GM109 Smart Stylus Pen. Category: Stylus. Subcategory: Tablet. Price: 1,850৳2,000৳.

Product: WiWU Pencil D Stylus Universal pencil for iPad, iPhone, & Android. Category: Stylus. Subcategory: Tablet. Price: 2,050৳2,100৳.
",236,300757,300993
1254,recursive,"
Product: WiWU Pencil W Stylus Pen For iPad. Category: Stylus. Subcategory: Tablet. Price: 2,950৳3,250৳.

Product: WiWU Pencil W Pro Stylus Pen. Category: Stylus. Subcategory: Tablet. Price: 2,250৳2,300৳.

Product: Xiaomi Focus Pen. Category: Stylus. Subcategory: Tablet. Price: 8,000৳8,300৳.
",293,300993,301286
1255,recursive,"
Product: WiWU Pencil L Stylus Pen (Palm Rejection). Category: Stylus. Subcategory: Tablet. Price: 2,300৳2,450৳.

Product: WIWU Picasso P339 Active Stylus Universal Capacities Touch Screen Stylus Pen for iOS & Android. Category: Stylus. Subcategory: Tablet. Price: 2,200৳2,900৳.
",279,301286,301565
1256,recursive,"
Product: WiWU Pencil Pro For iPad (Palm Rejection). Category: Stylus. Subcategory: Tablet. Price: Out Of Stock.

Product: WiWU Touch Screen Stylus S Pen for Samsung Galaxy Z Fold 3 Rechargeable Mobile Phone Stylus Pencil. Category: Stylus. Subcategory: Tablet. Price: 1,800৳3,200৳.
",283,301565,301848
1257,recursive,"
Product: Microsoft Surface Pen (Ice Blue). Category: Stylus. Subcategory: Tablet. Price: 11,000৳12,000৳.

Product: Apple Pencil USB Type-C. Category: Stylus. Subcategory: Tablet. Price: 11,000৳12,500৳.
",203,301848,302051
1258,recursive,"
Product: Apple Pencil (2nd generation). Category: Stylus. Subcategory: Tablet. Price: 14,500৳15,500৳.

Product: Apple Pencil (2nd generation). Category: Stylus. Subcategory: Tablet. Price: 14,500৳16,500৳.

Product: Apple Pencil Pro. Category: Stylus. Subcategory: Tablet. Price: 14,500৳18,000৳.
",296,302051,302347
1259,recursive,"
Product: Epson S015639/S015634 Ribbon For LQ-310 Printer. Category: Office Equipment. Price: 420৳.

Product: Power Print TN-85 HP 85A /36A/35A/78A Toner. Category: Office Equipment. Price: 700৳.

Product: Epson 003 Black Ink Bottle. Category: Office Equipment. Price: 600৳.
",275,302347,302622
1260,recursive,"
Product: Starink 83A Black LaserJet Toner. Category: Office Equipment. Price: 700৳.

Product: Epson C13T6641 Black Ink Bottle. Category: Office Equipment. Price: 700৳.

Product: Epson C13T6642 Cyan Ink Bottle. Category: Office Equipment. Price: 700৳750৳.
",256,302622,302878
1261,recursive,"
Product: Epson C13T6643 Magenta Ink Bottle. Category: Office Equipment. Price: 720৳.

Product: Epson C13T6644 Yellow Ink Bottle. Category: Office Equipment. Price: 700৳750৳.

Product: DELI E15130 Barcode Scanner Stand. Category: Office Equipment. Price: 750৳.
",261,302878,303139
1262,recursive,"
Product: Epson 001 T03Y2 70ml Cyan Ink Bottle (Bundle With Full Set). Category: Office Equipment. Price: 750৳.

Product: Epson 001 T03Y4 70ml Yellow Ink Bottle (Bundle With Full Set). Category: Office Equipment. Price: 750৳.
",226,303139,303365
1263,recursive,"
Product: Epson 001 T03Y3 70ml Magenta Ink Bottle (Bundle With Full Set). Category: Office Equipment. Price: 720৳.

Product: Epson 003 Cyan Ink Bottle. Category: Office Equipment. Price: 720৳.

Product: Epson 003 Magenta Ink Bottle. Category: Office Equipment. Price: 720৳.
",274,303365,303639
1264,recursive,"
Product: Epson 003 Yellow Ink Bottle. Category: Office Equipment. Price: 720৳.

Product: Power Print TN-79A Toner. Category: Office Equipment. Price: 750৳.

Product: Starink 79A Black LaserJet Toner. Category: Office Equipment. Price: 750৳.
",242,303639,303881
1265,recursive,"
Product: Starink 35A Black LaserJet Toner. Category: Office Equipment. Price: 800৳.

Product: MaxGreen 48A Black LaserJet Toner. Category: Office Equipment. Price: 700৳800৳.

Product: True Trust 85A Black Laser Toner. Category: Office Equipment. Price: 800৳.
",260,303881,304141
1266,recursive,"
Product: BenQ MX560C XGA 4000 ANSI Lumens Business Projector. Category: BenQ. Subcategory: Office Equipment. Price: 42,000৳.

Product: Benq MX550 3600 Lumens XGA Multimedia Projector. Category: BenQ. Subcategory: Office Equipment. Price: 41,000৳44,000৳.
",255,304141,304396
1267,recursive,"
Product: BenQ MS560 4000 ANSI Lumens SVGA Business Projector. Category: BenQ. Subcategory: Office Equipment. Price: 40,800৳44,000৳.

Product: BenQ MX560 4000 ANSI Lumens XGA Business Projector. Category: BenQ. Subcategory: Office Equipment. Price: 41,500৳45,000৳.
",265,304396,304661
1268,recursive,"
Product: BenQ MW560C WXGA 4000 ANSI Lumens Business Projector. Category: BenQ. Subcategory: Office Equipment. Price: 55,000৳.

Product: BenQ MW560 4000 ANSI Lumens WXGA Business Projector. Category: BenQ. Subcategory: Office Equipment. Price: 55,000৳60,000৳.
",260,304661,304921
1269,recursive,"
Product: BenQ MX808STH 3600 Lumens XGA Short Throw Projector. Category: BenQ. Subcategory: Office Equipment. Price: Out Of Stock.

Product: BENQ EX600 3600 Lumens XGA Wireless Smart Projector for Business. Category: BenQ. Subcategory: Office Equipment. Price: 74,000৳75,000৳.
",277,304921,305198
1270,recursive,"
Product: BenQ EX605 4000lms Android Smart Projector. Category: BenQ. Subcategory: Office Equipment. Price: 74,000৳80,000৳.

Product: BenQ EW600 3600 Lumens WXGA Wireless Android Smart Projector. Category: BenQ. Subcategory: Office Equipment. Price: 81,000৳83,000৳.
",266,305198,305464
1271,recursive,"
Product: BenQ MH560 3800 Lumen DLP Full Hd Business Projector. Category: BenQ. Subcategory: Office Equipment. Price: 85,000৳88,000৳.

Product: BenQ EW805ST 3600lms Short Throw Smart Projector. Category: BenQ. Subcategory: Office Equipment. Price: 100,000৳.
",258,305464,305722
1272,recursive,"
Product: BenQ LW650 4000 Lumens WXGA Laser Projector. Category: BenQ. Subcategory: Office Equipment. Price: 110,000৳.

Product: BenQ LH750 5000 ANSI Lumens 1080p Conference Room Projector. Category: BenQ. Subcategory: Office Equipment. Price: 160,000৳.
",254,305722,305976
1273,recursive,"
Product: BenQ LU9245 7000 Lumens BlueCore Large-Venue Laser Projector. Category: BenQ. Subcategory: Office Equipment. Price: Pre Order.

Product: BenQ LU9715 8000 ANSI Lumens WUXGA Large-Venue BlueCore Laser Projector. Category: BenQ. Subcategory: Office Equipment. Price: Pre Order.
",285,305976,306261
1274,recursive,"
Product: BenQ GP520 2600 ANSI Lumens 4K UHD DLP Projector. Category: BenQ. Subcategory: Office Equipment. Price: Up Coming.

Product: BenQ GV50 500 ANSI Lumens 1080p DLP Projector. Category: BenQ. Subcategory: Office Equipment. Price: Up Coming.
",247,306261,306508
1275,recursive,"
Product: BenQ TK710STi 3200 ANSI Lumens 4K UHD DLP Projector. Category: BenQ. Subcategory: Office Equipment. Price: Up Coming.

Product: BenQ MH550 3500 Lumens DLP Full Hd Business Projector. Category: BenQ. Subcategory: Office Equipment. Price: Up Coming.
",258,306508,306766
1276,recursive,"
Product: Boxlight ALX320 3200 Lumens XGA Standard Throw Projector. Category: Boxlight. Subcategory: Office Equipment. Price: Up Coming.

Product: Boxlight ALX330 3300 Lumens XGA Standard Throw Projector. Category: Boxlight. Subcategory: Office Equipment. Price: Up Coming.
",274,306766,307040
1277,recursive,"
Product: Boxlight ALX352 3500 Lumens XGA LCD Standard Throw Projector. Category: Boxlight. Subcategory: Office Equipment. Price: Up Coming.

Product: Boxlight ALX462 4600 Lumes XGA Standard Throw Projector. Category: Boxlight. Subcategory: Office Equipment. Price: Up Coming.
",277,307040,307317
1278,recursive,"
Product: Boxlight ALX502 5000 Lumens XGA Standard Throw Projector. Category: Boxlight. Subcategory: Office Equipment. Price: Up Coming.

Product: Boxlight ALX402 4000 Lumes XGA Standard Throw Projector. Category: Boxlight. Subcategory: Office Equipment. Price: Out Of Stock.
",276,307317,307593
1279,recursive,"
Product: Optoma SA520 4000 Lumens SVGA DLP Projector. Category: Optoma. Subcategory: Office Equipment. Price: 37,000৳.

Product: Optoma X400LVe XGA 4000 Lumens Professional Projector. Category: Optoma. Subcategory: Office Equipment. Price: 39,500৳.
",250,307593,307843
1280,recursive,"
Product: Optoma W400LVe 4000 Lumens WXGA DLP Projector. Category: Optoma. Subcategory: Office Equipment. Price: 46,000৳50,000৳.

Product: Optoma X309ST 3700 Lumens Short Throw XGA DLP Projector. Category: Optoma. Subcategory: Office Equipment. Price: 56,500৳61,000৳.
",268,307843,308111
1281,recursive,"
Product: Optoma HD30HDR 3800 Full HD DLP Home Cinema Projector. Category: Optoma. Subcategory: Office Equipment. Price: 72,300৳76,000৳.

Product: Optoma ZX350e 3700 Lumens XGA DLP Laser Projector. Category: Optoma. Subcategory: Office Equipment. Price: 72,500৳78,000৳.
",270,308111,308381
1282,recursive,"
Product: Optoma ZW350e 4000 Lumens WXGA DLP Laser Projector. Category: Optoma. Subcategory: Office Equipment. Price: 80,000৳.

Product: Optoma AZW500 5200 Lumens WXGA DLP Laser Projector. Category: Optoma. Subcategory: Office Equipment. Price: 106,000৳115,000৳.
",263,308381,308644
1283,recursive,"
Product: Optoma UHD55 3600 Lumens 4K UHD Gaming Projector. Category: Optoma. Subcategory: Office Equipment. Price: 162,000৳159,000৳.

Product: Optoma L1 Plus 2500 lumens Ultra Short Throw 4K LED Home Projector. Category: Optoma. Subcategory: Office Equipment. Price: 187,000৳190,000৳.
",286,308644,308930
1284,recursive,"
Product: Optoma CinemaX D2 3000 Lumens 4K Ultra Short Throw DLP Laser Projector. Category: Optoma. Subcategory: Office Equipment. Price: 267,000৳270,000৳.
",156,308930,309086
1285,recursive,"
Product: Optoma ZU606T-W 6000 Lumens WUXGA 4K UHD HRD DLP Laser Projector. Category: Optoma. Subcategory: Office Equipment. Price: 440,000৳450,000৳.

Product: Optoma S400LVe 4000 Lumens SVGA DLP Projector. Category: Optoma. Subcategory: Office Equipment. Price: Up Coming.
",274,309086,309360
1286,recursive,"
Product: Optoma UHD35+ 4000 Lumens 4K UHD Gaming And Home Entertainment Projector. Category: Optoma. Subcategory: Office Equipment. Price: Up Coming.

Product: Optoma ZH507 5500 Lumens DLP Full HD Laser Projector. Category: Optoma. Subcategory: Office Equipment. Price: Up Coming.
",282,309360,309642
1287,recursive,"
Product: Optoma ZU500USTe 5000 lumens Ultra Short Throw WUXGA Laser Projector. Category: Optoma. Subcategory: Office Equipment. Price: 340,000৳.

Product: Optoma X412 4200 Lumens XGA DLP Projector. Category: Optoma. Subcategory: Office Equipment. Price: Out Of Stock.
",269,309642,309911
1288,recursive,"
Product: Optoma AZH500 5200 Lumens FHD DLP Laser Projector. Category: Optoma. Subcategory: Office Equipment. Price: Out Of Stock.

Product: Optoma AZH430UST 4000 lumens Ultra Short Throw Laser Projector. Category: Optoma. Subcategory: Office Equipment. Price: 180,000৳.
",271,309911,310182
1289,recursive,"
Product: Acer V60S 4000 lumens Projector. Category: Acer. Subcategory: Office Equipment. Price: 45,000৳.

Product: AUN AKEY6 6800 Lumens Full HD Portable Projector. Category: AUN. Subcategory: Office Equipment. Price: 22,500৳23,000৳.
",235,310182,310417
1290,recursive,"
Product: AUN AKEY8 6000 Lumens Full HD Portable Projector. Category: AUN. Subcategory: Office Equipment. Price: Out Of Stock.

Product: AUN AKEY9 8200 Lumens Full HD Smart Android Portable Projector. Category: AUN. Subcategory: Office Equipment. Price: Out Of Stock.
",268,310417,310685
1291,recursive,"
Product: Philips NeoPix Easy 2600 Lumen WVGA LCD Projector. Category: Philips. Subcategory: Office Equipment. Price: 18,000৳19,000৳.

Product: Philips NeoPix Prime 2 HD LCD Projector. Category: Philips. Subcategory: Office Equipment. Price: Up Coming.
",253,310685,310938
1292,recursive,"
Product: Vivitek BS570 4200 Lumens SVGA Projector. Category: VIVItek. Subcategory: Office Equipment. Price: 45,500৳50,000৳.

Product: Vivitek DX330 4000 Lumens XGA DLP Projector. Category: VIVItek. Subcategory: Office Equipment. Price: 45,000৳50,000৳.
",253,310938,311191
1293,recursive,"
Product: Vivitek DW350 4000 Lumens WXGA DLP Projector. Category: VIVItek. Subcategory: Office Equipment. Price: 56,000৳57,000৳.

Product: Vivitek DW350BD 4200 Lumens WXGA DLP Projector. Category: VIVItek. Subcategory: Office Equipment. Price: 53,500৳60,000৳.
",260,311191,311451
1294,recursive,"
Product: Vivitek DX331 4500 Lumens XGA DLP Projector. Category: VIVItek. Subcategory: Office Equipment. Price: 62,000৳67,000৳.

Product: Vivitek DW351 4500 Lumens WXGA DLP Projector. Category: VIVItek. Subcategory: Office Equipment. Price: 73,500৳75,000৳.
",257,311451,311708
1295,recursive,"
Product: Vivitek DW2650Z 4200 Lumens WXGA DLP Projector With Built-In Speaker. Category: VIVItek. Subcategory: Office Equipment. Price: Up Coming.

Product: ViewSonic LS500WHE 3000 Lumens WXGA LED Classroom Projector. Category: ViewSonic. Subcategory: Office Equipment. Price: 45,500৳48,000৳.
",294,311708,312002
1296,recursive,"
Product: Viewsonic M1X Smart LED Portable Projector. Category: ViewSonic. Subcategory: Office Equipment. Price: 46,500৳50,000৳.

Product: ViewSonic PA503XE 4000 Lumens XGA Business Projector. Category: ViewSonic. Subcategory: Office Equipment. Price: Up Coming.
",263,312002,312265
1297,recursive,"
Product: ViewSonic PA503SE 4000 Lumens SVGA Business Projector. Category: ViewSonic. Subcategory: Office Equipment. Price: 49,000৳53,000৳.

Product: Viewsonic SP6 4800 Lumens Business Projector. Category: ViewSonic. Subcategory: Office Equipment. Price: 55,000৳.
",264,312265,312529
1298,recursive,"
Product: Viewsonic SP7 4800 Lumens Business Projector. Category: ViewSonic. Subcategory: Office Equipment. Price: 58,000৳.

Product: ViewSonic PS502X 4000 ANSI Lumens XGA Short Throw Projector. Category: ViewSonic. Subcategory: Office Equipment. Price: 68,000৳69,000৳.
",270,312529,312799
1299,recursive,"
Product: ViewSonic LX60HD 630 Lumen Smart LED Projector. Category: ViewSonic. Subcategory: Office Equipment. Price: 75,000৳.

Product: ViewSonic M2e 1000 Lumens Smart Built-in Wi-Fi 1080p Portable Android Mini Projector. Category: ViewSonic. Subcategory: Office Equipment. Price: 77,000৳78,000৳.
",297,312799,313096
1300,recursive,"
Product: ViewSonic LS740W 5000 Lumens WXGA Laser Projector. Category: ViewSonic. Subcategory: Office Equipment. Price: 115,000৳120,000৳.

Product: ViewSonic LS740HD 5000 Lumens Full HD Laser Projector. Category: ViewSonic. Subcategory: Office Equipment. Price: 124,000৳125,000৳.
",280,313096,313376
1301,recursive,"
Product: ViewSonic LS700HD 3500 Lumens FHD Laser Projector. Category: ViewSonic. Subcategory: Office Equipment. Price: Pre Order.
",131,313376,313507
1302,recursive,"
Product: ViewSonic M1 Mini Plus 120 LED Lumens Built-in Wi-Fi Ultra-portable LED Android Projector. Category: ViewSonic. Subcategory: Office Equipment. Price: Up Coming.
",171,313507,313678
1303,recursive,"
Product: ViewSonic PA503X Bright 3800 Lumens XGA Multimedia Projector. Category: ViewSonic. Subcategory: Office Equipment. Price: Up Coming.

Product: ViewSonic PG603W 3,600 Lumens WXGA Business DLP Projector. Category: ViewSonic. Subcategory: Office Equipment. Price: Up Coming.
",281,313678,313959
1304,recursive,"
Product: ViewSonic PX747-4K ULTRA HD 3500 Lumens 4K DLP Projector. Category: ViewSonic. Subcategory: Office Equipment. Price: Out Of Stock.

Product: ViewSonic PA503S 3800 Lumens SVGA Multimedia Projector. Category: ViewSonic. Subcategory: Office Equipment. Price: Out Of Stock.
",280,313959,314239
1305,recursive,"
Product: ViewSonic M1+_G2 300 Lumens Smart LED Built-in Wi-Fi Portable Android Projector. Category: ViewSonic. Subcategory: Office Equipment. Price: Out Of Stock.
",164,314239,314403
1306,recursive,"
Product: ViewSonic PG603X 3,800 Lumens XGA Business DLP Projector. Category: ViewSonic. Subcategory: Office Equipment. Price: Out Of Stock.

Product: ViewSonic PG707W 4000 Lumens WXGA Business DLP Projector. Category: ViewSonic. Subcategory: Office Equipment. Price: Out Of Stock.
",282,314403,314685
1307,recursive,"
Product: Epson EB-E01 3LCD XGA 3300 Lumens Projector. Category: Epson. Subcategory: Office Equipment. Price: 41,000৳42,000৳.

Product: Epson CO-W01 3000 Lumens 3LCD WXGA Projector. Category: Epson. Subcategory: Office Equipment. Price: 46,000৳47,000৳.
",253,314685,314938
1308,recursive,"
Product: Epson CB-X49 3600 Lumens XGA 3LCD Multimedia Projector. Category: Epson. Subcategory: Office Equipment. Price: 63,000৳64,000৳.

Product: Epson EB-X06 XGA 3600 Lumens 3LCD Business Classroom Projector. Category: Epson. Subcategory: Office Equipment. Price: 64,000৳.
",275,314938,315213
1309,recursive,"
Product: Epson EB-X49 3600 Lumens XGA 3LCD Multimedia Projector. Category: Epson. Subcategory: Office Equipment. Price: 66,000৳72,000৳.

Product: Epson CO-FH02 3000 Lumens 3LCD Full HD Android Projector. Category: Epson. Subcategory: Office Equipment. Price: 66,000৳72,000৳.
",276,315213,315489
1310,recursive,"
Product: Epson EB-W06 3700 Lumens WXGA 3LCD Office Projector. Category: Epson. Subcategory: Office Equipment. Price: 73,000৳76,000৳.

Product: Epson EB-W49 3800 Lumens WXGA 3LCD Multimedia Projector. Category: Epson. Subcategory: Office Equipment. Price: 77,000৳.
",265,315489,315754
1311,recursive,"
Product: Epson EB-972 4100 Lumens XGA 3LCD Projector. Category: Epson. Subcategory: Office Equipment. Price: 86,000৳.

Product: Epson EB-982W PowerLite 4200-Lumen WXGA 3LCD Projector. Category: Epson. Subcategory: Office Equipment. Price: 93,000৳96,500৳.
",256,315754,316010
1312,recursive,"
Product: Epson EB-992F 4000 Lumens Full HD 3LCD Projector. Category: Epson. Subcategory: Office Equipment. Price: 145,000৳152,000৳.

Product: Epson EB-L210SW 4000 Lumens WXGA Wireless Short Throw Laser Projector. Category: Epson. Subcategory: Office Equipment. Price: 172,000৳.
",279,316010,316289
1313,recursive,"
Product: Epson EB-2065 5500 Lumens 3LCD XGA Projector. Category: Epson. Subcategory: Office Equipment. Price: 191,000৳200,000৳.

Product: Epson EB-2250U 5000 Lumens 3LCD WUXGA Projector. Category: Epson. Subcategory: Office Equipment. Price: 206,000৳210,000৳.
",261,316289,316550
1314,recursive,"
Product: Epson EB-2155W 5000 Lumens LCD Projector. Category: Epson. Subcategory: Office Equipment. Price: 223,500৳225,000৳.

Product: Epson EB-L530U 5200 Lumens FHD WUXGA Long-throw Laser Projector. Category: Epson. Subcategory: Office Equipment. Price: 280,000৳.
",265,316550,316815
1315,recursive,"
Product: Epson EB-W52 4000 Lumens 3LCD WXGA Projector. Category: Epson. Subcategory: Office Equipment. Price: 83,000৳.

Product: EPSON EB-L630U 6200 Lumens 3LCD WUXGA LASER Multimedia Projector. Category: Epson. Subcategory: Office Equipment. Price: 420,000৳.
",261,316815,317076
1316,recursive,"
Product: Epson EB-770Fi 4100 Lumens FHD Business Wireless Laser Projector. Category: Epson. Subcategory: Office Equipment. Price: 445,000৳.

Product: Epson EB-E10 3600 Lumens XGA 3LCD Projector. Category: Epson. Subcategory: Office Equipment. Price: Up Coming.
",262,317076,317338
1317,recursive,"
Product: Xiaomi Wanbo X2 Max 450 ANSI Lumens Smart Portable Projector. Category: Xiaomi. Subcategory: Office Equipment. Price: 20,000৳.

Product: Xiaomi Wanbo T2 Max 450 ANSI Lumens Smart Android Portable LED Projector. Category: Xiaomi. Subcategory: Office Equipment. Price: 19,500৳21,000৳.
",293,317338,317631
1318,recursive,"
Product: Xiaomi Wanbo T6 Max 650 Lumens Smart Android Portable LED Projector. Category: Xiaomi. Subcategory: Office Equipment. Price: 27,400৳28,000৳.

Product: Xiaomi Wanbo T2 Ultra 500 ANSI Lumens Android Portable Projector. Category: Xiaomi. Subcategory: Office Equipment. Price: 25,500৳.
",292,317631,317923
1319,recursive,"
Product: Xiaomi Wanbo DaVinci 1 Pro 1100 ANSI Lumens Projector. Category: Xiaomi. Subcategory: Office Equipment. Price: 30,000৳.

Product: Xiaomi Wanbo TT 650 Lumens Netflix Certified Projector. Category: Xiaomi. Subcategory: Office Equipment. Price: 28,800৳31,500৳.
",268,317923,318191
1320,recursive,"
Product: Xiaomi Wanbo X5 1100 Lumens Smart Android Portable LED Projector. Category: Xiaomi. Subcategory: Office Equipment. Price: 31,000৳33,800৳.

Product: Xiaomi Wanbo X5 Pro 1100 Lumens FHD LCD Projector. Category: Xiaomi. Subcategory: Office Equipment. Price: 36,500৳.
",274,318191,318465
1321,recursive,"
Product: Xiaomi Wanbo Mozart 1 900 Lumens Smart Android Portable LED Projector. Category: Xiaomi. Subcategory: Office Equipment. Price: 38,000৳40,000৳.
",153,318465,318618
1322,recursive,"
Product: Xiaomi Wanbo Mozart 1 Pro 1200 Lumens Smart Android Portable LED Projector. Category: Xiaomi. Subcategory: Office Equipment. Price: 47,000৳49,000৳.
",158,318618,318776
1323,recursive,"
Product: Xiaomi Mi Smart Projector 2 Portable Android Smart Laser Projector (Global version). Category: Xiaomi. Subcategory: Office Equipment. Price: 54,500৳.
",160,318776,318936
1324,recursive,"
Product: Xiaomi Fengmi Cinema 2 Formovie 4K Ultra 2200 Lumens Smart Android Laser Projector (China Version). Category: Xiaomi. Subcategory: Office Equipment. Price: 199,000৳205,000৳.
",184,318936,319120
1325,recursive,"
Product: Xiaomi Wanbo T2 Free 150 Lumens Smart Portable LED Projector. Category: Xiaomi. Subcategory: Office Equipment. Price: Up Coming.

Product: Xiaomi Wanbo X1 Pro 300 Lumens Smart Android Portable LED Projector. Category: Xiaomi. Subcategory: Office Equipment. Price: Up Coming.
",285,319120,319405
1326,recursive,"
Product: Xiaomi Wanbo T2R Max 250 Lumens Portable LCD Projector. Category: Xiaomi. Subcategory: Office Equipment. Price: Up Coming.

Product: Xiaomi Wanbo T2 Max 150 Lumens Smart Android Portable LED Projector. Category: Xiaomi. Subcategory: Office Equipment. Price: Out Of Stock.
",282,319405,319687
1327,recursive,"
Product: Xiaomi Wanbo T4 450 ANSI Lumens Auto Focus Android Portable Projector. Category: Xiaomi. Subcategory: Office Equipment. Price: Out Of Stock.
",151,319687,319838
1328,recursive,"
Product: Xiaomi Wanbo T6R Max 650 ANSI Lumens Android Smart Portable Projector. Category: Xiaomi. Subcategory: Office Equipment. Price: Out Of Stock.
",151,319838,319989
1329,recursive,"
Product: Xiaomi Mi Smart Projector 2 Pro 1300 Lumens Smart Android Portable DLP Laser Projector (Global Version). Category: Xiaomi. Subcategory: Office Equipment. Price: Out Of Stock.
",185,319989,320174
1330,recursive,"
Product: Xiaomi Fengmi 4K Ultra 5000 Lumens Smart Android Laser Projector (Global Version). Category: Xiaomi. Subcategory: Office Equipment. Price: Out Of Stock.

Product: Cheerlux C8 1800 Lumens Mini LCD Projector. Category: Cheerlux. Subcategory: Office Equipment. Price: 8,500৳9,000৳.
",289,320174,320463
1331,recursive,"
Product: Cheerlux C9 2800 Lumens Mini Projector with Built-in TV Card. Category: Cheerlux. Subcategory: Office Equipment. Price: 9,200৳9,500৳.

Product: Cheerlux C10 2600 Lumens FHD LED WiFi Projector. Category: Cheerlux. Subcategory: Office Equipment. Price: 9,200৳9,500৳.
",275,320463,320738
1332,recursive,"
Product: Cheerlux C9 2800 Lumens Wi-Fi Mini LED Projector. Category: Cheerlux. Subcategory: Office Equipment. Price: 10,500৳11,000৳.

Product: Cheerlux C9 Android Wifi Full HD 3600 Lumens LED Projector With TV Port. Category: Cheerlux. Subcategory: Office Equipment. Price: 13,500৳.
",284,320738,321022
1333,recursive,"
Product: Cheerlux C9 Full HD 3600 Lumens LED Projector (New Edition). Category: Cheerlux. Subcategory: Office Equipment. Price: 13,500৳.

Product: Cheerlux C12 3600 Lumens Full HD WiFi LED Projector. Category: Cheerlux. Subcategory: Office Equipment. Price: 16,000৳16,500৳.
",275,321022,321297
1334,recursive,"
Product: Cheerlux CL770 4000 Lumens Android Full HD Multimedia Projector. Category: Cheerlux. Subcategory: Office Equipment. Price: 21,500৳22,500৳.

Product: Cheerlux C16 4000 Lumens Full HD Android Multimedia Projector. Category: Cheerlux. Subcategory: Office Equipment. Price: Out Of Stock.
",294,321297,321591
1335,recursive,"
Product: Cheerlux C7 1500 Lumens Mini LCD Projector. Category: Cheerlux. Subcategory: Office Equipment. Price: Up Coming.

Product: Cheerlux CL760 3200 Lumens Projector with Built-In TV Card. Category: Cheerlux. Subcategory: Office Equipment. Price: Up Coming.
",262,321591,321853
1336,recursive,"
Product: Cheerlux C8 2200 Lumens Wi-Fi Mini LED Projector. Category: Cheerlux. Subcategory: Office Equipment. Price: Out Of Stock.

Product: Cheerlux C8 1800 Lumens Wi-Fi Mini LED Projector. Category: Cheerlux. Subcategory: Office Equipment. Price: Out Of Stock.
",264,321853,322117
1337,recursive,"
Product: Cheerlux C9 2800 Lumens Android Wi-Fi Mini LED Projector. Category: Cheerlux. Subcategory: Office Equipment. Price: Out Of Stock.

Product: Cheerlux C50 3800 Lumens Wi-Fi Mini LED Projector. Category: Cheerlux. Subcategory: Office Equipment. Price: Out Of Stock.
",273,322117,322390
1338,recursive,"
Product: Cheerlux CL770 4000 Lumens Full HD With Built-In TV Card Multimedia Projector. Category: Cheerlux. Subcategory: Office Equipment. Price: Out Of Stock.

Product: InFocus IN1004 3100 Lumens 3LCD XGA Projector. Category: InFocus. Subcategory: Office Equipment. Price: 40,500৳41,500৳.
",291,322390,322681
1339,recursive,"
Product: InFocus IN114BB 3800 Lumens DLP Projector. Category: InFocus. Subcategory: Office Equipment. Price: Up Coming.

Product: InFocus IN1014 3400 Lumens 3LCD XGA Projector. Category: InFocus. Subcategory: Office Equipment. Price: Up Coming.
",246,322681,322927
1340,recursive,"
Product: InFocus IN2134 4500-Lumen XGA DLP Projector. Category: InFocus. Subcategory: Office Equipment. Price: Up Coming.

Product: InFocus IN1034 5000 Lumens XGA 3LCD Multimedia Projector. Category: InFocus. Subcategory: Office Equipment. Price: Up Coming.
",259,322927,323186
1341,recursive,"
Product: InFocus IN1036 5000 Lumens 3LCD WXGA Projector. Category: InFocus. Subcategory: Office Equipment. Price: Up Coming.

Product: InFocus INL2156 4500 WXGA Lumens Laser Projector. Category: InFocus. Subcategory: Office Equipment. Price: Up Coming.
",254,323186,323440
1342,recursive,"
Product: InFocus IN116xv WXGA 3800 LUMENS 16:10 Projector. Category: InFocus. Subcategory: Office Equipment. Price: Out Of Stock.

Product: InFocus IN119HDG 3800 LUMENS Full HD Projector. Category: InFocus. Subcategory: Office Equipment. Price: Out Of Stock.
",260,323440,323700
1343,recursive,"
Product: InFocus IN118BB 3400 Lumens Full HD Projector. Category: InFocus. Subcategory: Office Equipment. Price: Out Of Stock.

Product: InFocus IN1024 4000 Lumens 3LCD XGA Projector. Category: InFocus. Subcategory: Office Equipment. Price: Out Of Stock.
",256,323700,323956
1344,recursive,"
Product: XINJI PX1 100 ANSI Lumens LCD Portable Projector With Android OS. Category: XINJI. Subcategory: Office Equipment. Price: 16,000৳20,000৳.
",147,323956,324103
1345,recursive,"
Product: Havit PJ207 110 Lumens HD 720p Wi-Fi Screen Mirroring Portable Projector. Category: Havit. Subcategory: Office Equipment. Price: 12,000৳13,500৳.
",155,324103,324258
1346,recursive,"
Product: Havit PJ202 300 ANSI Lumens Full HD Wi-Fi Screen Mirroring Portable Projector. Category: Havit. Subcategory: Office Equipment. Price: 18,000৳.
",153,324258,324411
1347,recursive,"
Product: Havit PJ215 Pro Prime Jasper Smart Portable Projector With Android TV 9.0. Category: Havit. Subcategory: Office Equipment. Price: 19,000৳.

Product: Havit PJ300 Plus Google Licensed Projector. Category: Havit. Subcategory: Office Equipment. Price: 45,000৳.
",267,324411,324678
1348,recursive,"
Product: Havit PJ201 120 Lumens HD 720p Portable Projector. Category: Havit. Subcategory: Office Equipment. Price: Up Coming.

Product: Havit PJ206 Pro 350 Lumens Full HD Android Wi-Fi Screen Mirroring Portable Projector. Category: Havit. Subcategory: Office Equipment. Price: Up Coming.
",289,324678,324967
1349,recursive,"
Product: Havit PJ205 Pro 200 Lumens Full HD 1080p Portable Projector. Category: Havit. Subcategory: Office Equipment. Price: Out Of Stock.

Product: Havit PJ209 Pro 350 ANSI Lumens Android Portable Projector. Category: Havit. Subcategory: Office Equipment. Price: Out Of Stock.
",279,324967,325246
1350,recursive,"
Product: Havit PJ219 PRO Smart Projector with Android TV 9.0. Category: Havit. Subcategory: Office Equipment. Price: Out Of Stock.

Product: Blisbond Mirror 4K Gimbal Projector. Category: Blisbond. Subcategory: Office Equipment. Price: 22,690৳24,500৳.
",253,325246,325499
1351,recursive,"
Product: Apollo 60""x60"" Tripod Projection Screen. Category: Projection Screen. Subcategory: Office Equipment. Price: Out Of Stock.

Product: Apollo 70""x70"" Tripod Projection Screen. Category: Projection Screen. Subcategory: Office Equipment. Price: 3,600৳.
",258,325499,325757
1352,recursive,"
Product: Super View 70 x 70 Inch Wall Projector Screen. Category: Projection Screen. Subcategory: Office Equipment. Price: 3,450৳3,700৳.

Product: Apollo 70""x70"" Wall Projection Screen. Category: Projection Screen. Subcategory: Office Equipment. Price: 3,500৳3,900৳.
",268,325757,326025
1353,recursive,"
Product: Apollo 84""x84"" Wall Projection Screen. Category: Projection Screen. Subcategory: Office Equipment. Price: 6,200৳.

Product: Dopah 84 x 84 Inch Wall Projection Screen. Category: Projection Screen. Subcategory: Office Equipment. Price: 6,200৳.
",252,326025,326277
1354,recursive,"
Product: Dopah 70""x70"" Tripod Projection Screen. Category: Projection Screen. Subcategory: Office Equipment. Price: 3,600৳.

Product: Dopah 84""x 84"" Tripod Projection Screen. Category: Projection Screen. Subcategory: Office Equipment. Price: 7,200৳.
",251,326277,326528
1355,recursive,"
Product: Apollo 60""x60"" Electric Projection Screen. Category: Projection Screen. Subcategory: Office Equipment. Price: 7,200৳.

Product: Dopah 60""x60"" Electric Projection Screen. Category: Projection Screen. Subcategory: Office Equipment. Price: 7,300৳.
",255,326528,326783
1356,recursive,"
Product: Magpie 70""x70"" Electric Projection System Screen. Category: Projection Screen. Subcategory: Office Equipment. Price: 7,800৳8,000৳.

Product: Super View 96 x 96 Inch Wall Projector Screen. Category: Projection Screen. Subcategory: Office Equipment. Price: 7,500৳8,000৳.
",279,326783,327062
1357,recursive,"
Product: Super View 70 x 70 Inch Electric Projector Screen. Category: Projection Screen. Subcategory: Office Equipment. Price: 8,000৳8,300৳.

Product: Super View 96 x 96 Inch Tripod Projector Screen. Category: Projection Screen. Subcategory: Office Equipment. Price: 8,000৳8,300৳.
",282,327062,327344
1358,recursive,"
Product: Apollo 96""x96"" Wall Projection Screen. Category: Projection Screen. Subcategory: Office Equipment. Price: 7,600৳8,600৳.

Product: Apollo 70""x70"" Electric Projection Screen. Category: Projection Screen. Subcategory: Office Equipment. Price: 8,300৳.
",258,327344,327602
1359,recursive,"
Product: Super View 96 Inch x 96 Inch Electric Wall Projector Screen. Category: Projection Screen. Subcategory: Office Equipment. Price: 9,900৳.

Product: Apollo 84""x84"" Electric Projection Screen. Category: Projection Screen. Subcategory: Office Equipment. Price: 10,300৳.
",275,327602,327877
1360,recursive,"
Product: Dopah 84""x84"" Electric Projection Screen. Category: Projection Screen. Subcategory: Office Equipment. Price: 10,500৳.

Product: Apollo 96""x 96"" Electric Projection Screen. Category: Projection Screen. Subcategory: Office Equipment. Price: 11,500৳12,000৳.
",265,327877,328142
1361,recursive,"
Product: Projector Ceiling Mount Kit 2 Feet. Category: Projector Mount. Subcategory: Office Equipment. Price: 1,500৳1,600৳.

Product: Projector Ceiling Mount Kit 3 Feet. Category: Projector Mount. Subcategory: Office Equipment. Price: 2,000৳2,300৳.
",250,328142,328392
1362,recursive,"
Product: Lexin PM02 Projector Ceiling Mount Kit 3 Feet. Category: Projector Mount. Subcategory: Office Equipment. Price: 2,500৳3,000৳.

Product: Abtus AV815 Projector Ceiling Mount Kit 3 Feet. Category: Projector Mount. Subcategory: Office Equipment. Price: 3,800৳4,000৳.
",273,328392,328665
1363,recursive,"
Product: Dopah DTT-04 Portable Multimedia Projector Tripod Trolley. Category: Projector Mount. Subcategory: Office Equipment. Price: 4,700৳5,200৳.

Product: Dopah DTT-05 Multimedia Projector Trolley. Category: Projector Mount. Subcategory: Office Equipment. Price: 8,500৳.
",274,328665,328939
1364,recursive,"
Product: Jabra Speak 510 Speakerphone Audio Conference Up to 5 People & Bluetooth Speaker. Category: Jabra. Subcategory: Conference System. Price: 14,200৳.

Product: Jabra Speak2 55 Duplex Noise Reduction Speakerphone. Category: Jabra. Subcategory: Conference System. Price: 17,500৳.
",285,328939,329224
1365,recursive,"
Product: Jabra Speak 710 Speakerphone HD Audio Conference Up to 6 People and Bluetooth Speaker. Category: Jabra. Subcategory: Conference System. Price: 23,900৳.

Product: Jabra Panacast 20 4K Ultra HD Video Conference Camera. Category: Jabra. Subcategory: Conference System. Price: 26,900৳.
",292,329224,329516
1366,recursive,"
Product: Jabra Speak 750 Speakerphone Audio Conference. Category: Jabra. Subcategory: Conference System. Price: 28,700৳.

Product: Jabra Speak2 75 Full-Duplex Speakerphone With Type A Wireless Receiver. Category: Jabra. Subcategory: Conference System. Price: 34,900৳.
",269,329516,329785
1367,recursive,"
Product: Jabra Speak 810 Conference Speakerphone. Category: Jabra. Subcategory: Conference System. Price: 54,900৳.

Product: Jabra Panacast 20 Conference Camera & Speak 750 Bundle with Table Stand. Category: Jabra. Subcategory: Conference System. Price: 69,900৳.
",264,329785,330049
1368,recursive,"
Product: Jabra PanaCast 50 Panoramic 4K USB Conference Videobar. Category: Jabra. Subcategory: Conference System. Price: 165,000৳.

Product: Jabra PanaCast Table Stand. Category: Jabra. Subcategory: Conference System. Price: Out Of Stock.
",240,330049,330289
1369,recursive,"
Product: Jabra Speak2 75 Full-Duplex Speakerphone With Type-C Wireless Receiver. Category: Jabra. Subcategory: Conference System. Price: Out Of Stock.

Product: Jabra PanaCast 50 Room System MTR. Category: Jabra. Subcategory: Conference System. Price: Out Of Stock.
",267,330289,330556
1370,recursive,"
Product: HTDZ HT-E2 Gooseneck Microphone. Category: Conference System. Price: 3,308৳.

Product: HTDZ HT-E4 Gooseneck Microphone. Category: Conference System. Price: 3,308৳.

Product: HTDZ HT-XLRM3 Microphone Base. Category: Conference System. Price: 3,780৳.
",259,330556,330815
1371,recursive,"
Product: HTDZ HT-E1 Gooseneck Microphone. Category: Conference System. Price: 4,410৳.

Product: HTDZ HT-XLRM2 Microphone Base. Category: Conference System. Price: 4,410৳.

Product: CMX DU-50 PA 100V Driver Unit (15W-30W-50W). Category: Conference System. Price: 4,680৳.
",271,330815,331086
1372,recursive,"
Product: HTDZ HT-801 Professional Conference Gooseneck Microphone. Category: Conference System. Price: 5,640৳.

Product: HTDZ HT-710A High Quality Professional Boundary Microphone. Category: Conference System. Price: 6,840৳.
",226,331086,331312
1373,recursive,"
Product: HTDZ HT-808 Professional Gooseneck Conference Microphone. Category: Conference System. Price: 7,560৳.

Product: CMX CS-702 Conference System Delegate Unit. Category: Conference System. Price: 8,160৳.
",210,331312,331522
1374,recursive,"
Product: CMX CS-701 Conference System Chairman Unit. Category: Conference System. Price: 8,760৳.

Product: HTDZ HB-350D Delegate Unit Audio Conference System (Single Unit). Category: Conference System. Price: 9,840৳.
",218,331522,331740
1375,recursive,"
Product: HTDZ HT-D38 Gooseneck Microphone. Category: Conference System. Price: 9,840৳.

Product: HTDZ HT-D48 Wired Cardioid Gooseneck Meeting Microphone. Category: Conference System. Price: 10,200৳.
",200,331740,331940
1376,recursive,"
Product: Logitech TV Mount for Meet Up Video Conference Cam. Category: Conference System. Price: 10,990৳.

Product: TEV TCS-3510 15W Column Speaker. Category: Conference System. Price: 11,015৳.
",195,331940,332135
1377,recursive,"
Product: HTDZ HB-350C Chairman Unit Audio Conference System (Single Unit). Category: Conference System. Price: 12,600৳.

Product: HTDZ HT-7500D Table Top Delegate Unit Conference System. Category: Conference System. Price: 12,840৳.
",233,332135,332368
1378,recursive,"
Product: Logitech Wall Mount for Video Bar. Category: Conference System. Price: 20,000৳.

Product: AVerMedia BO317 Camera & Headphone Video Conference Kit. Category: AVerMedia. Subcategory: Conference System. Price: 6,099৳6,190৳.
",231,332368,332599
1379,recursive,"
Product: AVerMedia PW313 2MP Fixed Focus USB Webcam. Category: AVerMedia. Subcategory: Conference System. Price: Out Of Stock.

Product: HTDZ HT-7500C Table Top Chairman Unit Conference System. Category: HTDZ. Subcategory: Conference System. Price: 15,600৳.
",259,332599,332858
1380,recursive,"
Product: HTDZ HT-580 UHF Wireless Microphone System (1 Hand + 1 Tie or 2 Hand). Category: HTDZ. Subcategory: Conference System. Price: 15,600৳.

Product: HTDZ HT-F12/2 12 Channel Professional Mixing Console. Category: HTDZ. Subcategory: Conference System. Price: 29,400৳.
",273,332858,333131
1381,recursive,"
Product: HTDZ HT-7000 Main Amplifier Unit Conference System. Category: HTDZ. Subcategory: Conference System. Price: 51,600৳.

Product: HTDZ HT-F16/2 12 Channel Professional Mixing Console. Category: HTDZ. Subcategory: Conference System. Price: Up Coming.
",256,333131,333387
1382,recursive,"
Product: HTDZ HT-F8/2 8 Channel Professional Mixing Console. Category: HTDZ. Subcategory: Conference System. Price: Out Of Stock.

Product: HTDZ HT-3000 Central Amplifier Conference System. Category: HTDZ. Subcategory: Conference System. Price: Out Of Stock.
",260,333387,333647
1383,recursive,"
Product: Rapoo CM600 Omnidirectional Conference Microphone. Category: Rapoo. Subcategory: Conference System. Price: 35,000৳.

Product: Rapoo C1612 FHD Video Conference Camera. Category: Rapoo. Subcategory: Conference System. Price: 65,000৳.
",242,333647,333889
1384,recursive,"
Product: Rapoo C5305 4K UHD ALL-IN-ONE USB Video Conference Webcam. Category: Rapoo. Subcategory: Conference System. Price: 98,500৳.

Product: TEV TPA-6060U 60W PA Amplifier. Category: TEV. Subcategory: Conference System. Price: 21,410৳.
",239,333889,334128
1385,recursive,"
Product: TEV PRO-II Handheld Wired Microphone. Category: TEV. Subcategory: Conference System. Price: 6,300৳.

Product: Tev Tm-621 Handheld Wired Microphone. Category: TEV. Subcategory: Conference System. Price: Out Of Stock.
",226,334128,334354
1386,recursive,"
Product: TEV TM-700 Handheld Wired Microphone. Category: TEV. Subcategory: Conference System. Price: Out Of Stock.

Product: TEV TR-8100TD 1H+1Tie Wireless Microphone. Category: TEV. Subcategory: Conference System. Price: Out Of Stock.
",237,334354,334591
1387,recursive,"
Product: Poly Studio P15 Video Conference Bar for Small Conferencing Room. Category: Poly. Subcategory: Conference System. Price: 70,000৳.

Product: Poly Studio USB Video Bar. Category: Poly. Subcategory: Conference System. Price: Out Of Stock.
",246,334591,334837
1388,recursive,"
Product: CMX EA-30 30W PA Amplifier with USB/SD & FM & Bluetooth. Category: CMX. Subcategory: Conference System. Price: 16,920৳.

Product: CMX EA-60 60W PA Amplifier with USB/SD & FM & Bluetooth. Category: CMX. Subcategory: Conference System. Price: 21,960৳.
",260,334837,335097
1389,recursive,"
Product: CMX EA-120 120W PA Amplifier with USB/SD & FM & Bluetooth. Category: CMX. Subcategory: Conference System. Price: 23,880৳.

Product: CMX CS-700 Conference System Amplifier Controller. Category: CMX. Subcategory: Conference System. Price: 27,600৳.
",256,335097,335353
1390,recursive,"
Product: CMX EA-240A 240W PA Amplifier with USB/SD & FM & Bluetooth. Category: CMX. Subcategory: Conference System. Price: 36,600৳.

Product: CMX TS-12 180W Portable PA System (1 Hand + 1 Head Mic). Category: CMX. Subcategory: Conference System. Price: 40,800৳.
",263,335353,335616
1391,recursive,"
Product: CMX EA-350A 350W PA Amplifier with USB/SD & FM & Bluetooth. Category: CMX. Subcategory: Conference System. Price: 43,920৳.

Product: CMX EA-500A USB/SD & FM & Bluetooth Mixer Amplifier. Category: CMX. Subcategory: Conference System. Price: 46,080৳.
",259,335616,335875
1392,recursive,"
Product: CMX UHF-300BC Battery Charger. Category: CMX. Subcategory: Conference System. Price: 82,500৳.

Product: CMX CLSK-10C 10W Outdoor Column Speaker. Category: CMX. Subcategory: Conference System. Price: Up Coming.
",220,335875,336095
1393,recursive,"
Product: CMX CSK-610Q 6"" Coaxial Ceiling Speaker (3W-6W-10W). Category: CMX. Subcategory: Conference System. Price: Out Of Stock.

Product: CMX TS-12 180W Portable PA System (2 Hand Mic). Category: CMX. Subcategory: Conference System. Price: Out Of Stock.
",257,336095,336352
1394,recursive,"
Product: CMX UHF-300DU UHF Wireless Delegate Unit. Category: CMX. Subcategory: Conference System. Price: Out Of Stock.

Product: CMX UHF-300CU UHF Wireless Chairman Unit. Category: CMX. Subcategory: Conference System. Price: Out Of Stock.
",240,336352,336592
1395,recursive,"
Product: CMX UHF-300MC UHF Wireless Conference System Master Controller. Category: CMX. Subcategory: Conference System. Price: Out Of Stock.

Product: Benq DVY23 Full HD 1080P PTZ Video Conference Camera Balck. Category: BenQ. Subcategory: Conference System. Price: 120,500৳.
",277,336592,336869
1396,recursive,"
Product: Benq DVY32 4K UHD AI Auto Framing Video Conference Webcam. Category: BenQ. Subcategory: Conference System. Price: Out Of Stock.

Product: AVer VC520 Pro Expansion Speakerphone and Microphone. Category: AVer. Subcategory: Conference System. Price: 53,500৳.
",266,336869,337135
1397,recursive,"
Product: AVer FONE540 Conference Speakerphone. Category: AVer. Subcategory: Conference System. Price: 58,000৳.

Product: AVer VC520 Pro2 USB Full HD Video Conference Camera with Speaker Microphone Set. Category: AVer. Subcategory: Conference System. Price: 134,990৳.
",268,337135,337403
1398,recursive,"
Product: AVer VC520 Pro3 USB Full HD Video Conference Camera with Speaker Microphone Set. Category: AVer. Subcategory: Conference System. Price: Up Coming.

Product: Logitech BCC950 HD 1080p Camera Video Conference Webcam. Category: Logitech. Subcategory: Conference System. Price: 25,000৳.
",292,337403,337695
1399,recursive,"
Product: Logitech Rally Mounting Kit. Category: Logitech. Subcategory: Conference System. Price: 25,000৳.

Product: Logitech Rally Mic Pod HUB. Category: Logitech. Subcategory: Conference System. Price: 30,000৳.
",213,337695,337908
1400,recursive,"
Product: Logitech Expantion Mic for Meetup Cam (989-000405). Category: Logitech. Subcategory: Conference System. Price: 35,000৳.

Product: Logitech SmartDock (Used with Microsoft Surface Pro). Category: Logitech. Subcategory: Conference System. Price: 85,000৳.
",262,337908,338170
1401,recursive,"
Product: Logitech SmartDock Flex Expansion Kit (960-001213). Category: Logitech. Subcategory: Conference System. Price: 95,000৳.

Product: Logitech Meetup Video Conference Camera (960-001101). Category: Logitech. Subcategory: Conference System. Price: Out Of Stock.
",267,338170,338437
1402,recursive,"
Product: Logitech Tap for one Touch Video Conference Controlling. Category: Logitech. Subcategory: Conference System. Price: 125,000৳.

Product: Logitech Video Conference Group (960-001054). Category: Logitech. Subcategory: Conference System. Price: 135,000৳.
",261,338437,338698
1403,recursive,"
Product: Logitech Meetup 2 Video Conference Camera (960-001681). Category: Logitech. Subcategory: Conference System. Price: 155,000৳.

Product: Logitech Rally System Video Conferencing Cam Set (6 Pcs Set/Audio Coverage 10 Feet). Category: Logitech. Subcategory: Conference System. Price: 300,000৳.
",299,338698,338997
1404,recursive,"
Product: Logitech Tap IP Meeting Room Touch Controller (952-000085). Category: Logitech. Subcategory: Conference System. Price: 140,000৳.

Product: Logitech Sight Video Conference Camera (960-001510). Category: Logitech. Subcategory: Conference System. Price: 350,000৳.
",271,338997,339268
1405,recursive,"
Product: Logitech Rally Plus Video Conferencing Set (8 Pcs Set/Audio Coverage 24 Feet). Category: Logitech. Subcategory: Conference System. Price: 390,000৳.
",158,339268,339426
1406,recursive,"
Product: Logitech Rally Bar Mini 4K All-In-One Video Conferencing System. Category: Logitech. Subcategory: Conference System. Price: 390,000৳.

Product: Logitech Rally Bar 4K All-In-One Video Conferencing System. Category: Logitech. Subcategory: Conference System. Price: 520,000৳.
",283,339426,339709
1407,recursive,"
Product: Logitech Brio 505 Full HD Business Conferencing Webcam. Category: Logitech. Subcategory: Conference System. Price: Up Coming.

Product: Logitech C920E Pro Full HD Video Conferencing Webcam. Category: Logitech. Subcategory: Conference System. Price: Out Of Stock.
",273,339709,339982
1408,recursive,"
Product: Grandstream GAC2500 Networks Android Enterprise Conference Phone. Category: Grandstream. Subcategory: Conference System. Price: 44,990৳.

Product: Grandstream GVC3210 Video Conferencing Endpoint. Category: Grandstream. Subcategory: Conference System. Price: 68,000৳.
",277,339982,340259
1409,recursive,"
Product: Grandstream GAC2570 Enterprise Conference Phone. Category: Grandstream. Subcategory: Conference System. Price: Up Coming.

Product: Grandstream GMD1208 Wireless Desktop Microphone. Category: Grandstream. Subcategory: Conference System. Price: Up Coming.
",264,340259,340523
1410,recursive,"
Product: Grandstream GVC3202 Video Conference System. Category: Grandstream. Subcategory: Conference System. Price: Up Coming.

Product: Grandstream GVC3200 Video Conference System. Category: Grandstream. Subcategory: Conference System. Price: Up Coming.
",256,340523,340779
1411,recursive,"
Product: Grandstream GVC3220 Video Conference System. Category: Grandstream. Subcategory: Conference System. Price: Up Coming.

Product: Maxhub UC P25 4K UHD Video Conference Camera. Category: MAXHUB. Subcategory: Conference System. Price: 85,000৳.
",250,340779,341029
1412,recursive,"
Product: Maxhub SL22MC Smart Lectern. Category: MAXHUB. Subcategory: Conference System. Price: 495,000৳.

Product: Maxhub WT13M 4K Wireless Sharing Dongle. Category: MAXHUB. Subcategory: Conference System. Price: Up Coming.
",225,341029,341254
1413,recursive,"
Product: Maxhub WB05 4K Professional Screen Sharing Box. Category: MAXHUB. Subcategory: Conference System. Price: Up Coming.

Product: Maxhub UC BM35 Bluetooth Teleconference Speakerphone. Category: MAXHUB. Subcategory: Conference System. Price: Out Of Stock.
",261,341254,341515
1414,recursive,"
Product: TEV TCS-610 10W Ceiling Speaker. Category: TEV. Subcategory: PA System. Price: 5,870৳.

Product: TEV TA-120II 35W Portable PA System. Category: TEV. Subcategory: PA System. Price: 11,800৳.

Product: TEV TCS-3520 30W Column Speaker. Category: TEV. Subcategory: PA System. Price: 16,000৳.
",297,341515,341812
1415,recursive,"
Product: TEV TA-380 80W Portable PA System (1 Hand + 1 Head Mic). Category: TEV. Subcategory: PA System. Price: 63,960৳.

Product: TEV TA-780D 300W Portable PA System (1 Hand Mic). Category: TEV. Subcategory: PA System. Price: Up Coming.
",239,341812,342051
1416,recursive,"
Product: TEV TB-700II Wireless Microphone Bodypack Transmitter. Category: TEV. Subcategory: PA System. Price: Out Of Stock.

Product: TEV TA-680D 220W Portable PA System (1 Hand Mic). Category: TEV. Subcategory: PA System. Price: Out Of Stock.
",245,342051,342296
1417,recursive,"
Product: ScreenBeam SBUSBSW4 USB Pro Switch for Content Sharing. Category: ScreenBeam. Subcategory: Conference System. Price: 15,900৳.

Product: ScreenBeam 1100 Plus Wireless Display Receiver. Category: ScreenBeam. Subcategory: Conference System. Price: 145,000৳.
",265,342296,342561
1418,recursive,"
Product: CMX CSK-66E 6"" Ceiling Speaker (1.5-3-6W). Category: CMX. Subcategory: PA System. Price: 4,080৳.

Product: CMX WSK-610P 10W Wall Mount Speaker. Category: CMX. Subcategory: PA System. Price: 4,440৳.
",208,342561,342769
1419,recursive,"
Product: CMX HSK-15T 15W Outdoor Horn Speaker. Category: CMX. Subcategory: PA System. Price: 5,520৳.

Product: CMX CLSK-20C 20W Outdoor Column Speaker. Category: CMX. Subcategory: PA System. Price: 6,300৳.
",207,342769,342976
1420,recursive,"
Product: CMX WSK-640C 40W Wall Mount Speaker. Category: CMX. Subcategory: PA System. Price: 9,000৳.

Product: CMX WM-U200C UHF Wireless Microphone System. Category: CMX. Subcategory: PA System. Price: 28,800৳.
",211,342976,343187
1421,recursive,"
Product: JBL IRX108BT 8"" Powered Portable Bluetooth PA Speaker. Category: PA System. Price: 52,000৳.

Product: JBL EON710 10"" Powered Portable Bluetooth PA Speaker. Category: PA System. Price: 68,000৳.
",203,343187,343390
1422,recursive,"
Product: JBL IRX112BT 12"" Powered Portable Bluetooth PA Speaker. Category: PA System. Price: 72,000৳.

Product: JBL EON712 12"" Powered Portable PA Speaker with Bluetooth. Category: PA System. Price: 80,000৳.
",209,343390,343599
1423,recursive,"
Product: JBL EON715 15"" Powered Portable Bluetooth PA Speaker. Category: PA System. Price: 85,000৳.

Product: JBL IRX115S 15"" Powered Portable PA Speaker. Category: PA System. Price: 95,000৳.

Product: JBL EON208P Portable All-In-One 2-Way PA System. Category: PA System. Price: 98,500৳102,000৳.
",297,343599,343896
1424,recursive,"
Product: JBL EON ONE MK2 Battery-powered Column PA System. Category: PA System. Price: 125,000৳130,000৳.

Product: JBL PRX ONE All-In-One Powered Column PA System. Category: PA System. Price: 160,000৳170,000৳.
",211,343896,344107
1425,recursive,"
Product: Grandstream GSC3505 1-Way Public Address SIP Speaker. Category: Grandstream. Subcategory: PA System. Price: Up Coming.

Product: Grandstream GSC3510 2-Way SIP Intercom Speaker. Category: Grandstream. Subcategory: PA System. Price: Up Coming.
",252,344107,344359
1426,recursive,"
Product: Grandstream GSC3516 2-Way SIP Multicast Speaker. Category: Grandstream. Subcategory: PA System. Price: Up Coming.

Product: Grandstream GSC3506 1-Way Public Address SIP Speaker. Category: Grandstream. Subcategory: PA System. Price: Up Coming.
",253,344359,344612
1427,recursive,"
Product: Optoma 3653RK 65"" 4K Creative Touch 3 Series Interactive Flat Panel Display. Category: Optoma. Subcategory: Interactive Flat Panel. Price: 240,000৳.
",159,344612,344771
1428,recursive,"
Product: Optoma 5653RK 65"" 4K UHD Premium Interactive Flat Panel Display. Category: Optoma. Subcategory: Interactive Flat Panel. Price: 280,000৳.

Product: Optoma 5752RK+ 75 Inch 4K UHD Touch Interactive Flat Panel Display. Category: Optoma. Subcategory: Interactive Flat Panel. Price: 305,000৳.
",297,344771,345068
1429,recursive,"
Product: Optoma 5753RK 75"" 4K UHD Premium Interactive Flat Panel Display. Category: Optoma. Subcategory: Interactive Flat Panel. Price: 330,000৳.
",147,345068,345215
1430,recursive,"
Product: Optoma 3863RK 86"" 4K Creative Touch 3 Series Interactive Flat Panel Display. Category: Optoma. Subcategory: Interactive Flat Panel. Price: 360,000৳.
",159,345215,345374
1431,recursive,"
Product: Optoma 5863RK 86"" 4K UHD Premium Interactive Flat Panel Display. Category: Optoma. Subcategory: Interactive Flat Panel. Price: 380,000৳.
",147,345374,345521
1432,recursive,"
Product: Optoma 3753RK 75"" 4K Creative Touch 3 Series Interactive Flat Panel Display. Category: Optoma. Subcategory: Interactive Flat Panel. Price: Up Coming.

Product: Trolley for Interactive Flat Panel Display. Category: Interactive Flat Panel. Price: 25,000৳.
",264,345521,345785
1433,recursive,"
Product: Maxhub ST41B Stand For Interactive Flat Panel. Category: Interactive Flat Panel. Price: 41,000৳.

Product: OPS Core i5 PC Module for Interactive Flat Panel Display. Category: Interactive Flat Panel. Price: 50,000৳.
",225,345785,346010
1434,recursive,"
Product: METZ S084 Core i5 12th Gen OPS PC Module for Interactive Flat Panel. Category: Interactive Flat Panel. Price: 65,000৳.

Product: OPS PC Module for interactive Flat Panel. Category: Interactive Flat Panel. Price: 65,000৳.
",231,346010,346241
1435,recursive,"
Product: BenQ Core i5 12th Gen OPS PC Module For Interactive Flat Panel. Category: Interactive Flat Panel. Price: 60,000৳65,000৳.

Product: METZ S084 Core i7 12th Gen OPS PC Module for Interactive Flat Panel. Category: Interactive Flat Panel. Price: 80,000৳.
",260,346241,346501
1436,recursive,"
Product: Maxhub OPS62A Core i5 11th Gen OPS PC Module For Interactive Flat Panel. Category: Interactive Flat Panel. Price: 83,000৳.

Product: Hikvision DS-D5AC12T5-8S2 Core i5 12th Gen OPS Module for Interactive Flat Panel. Category: Interactive Flat Panel. Price: 85,000৳.
",275,346501,346776
1437,recursive,"
Product: Maxhub OPS62A Core i7 11th Gen OPS PC Module For Interactive Flat Panel. Category: Interactive Flat Panel. Price: 88,000৳.

Product: Hikvision DS-D5B65RB/EL 65"" 4K UHD Interactive Flat Panel Display. Category: Interactive Flat Panel. Price: 210,000৳.
",261,346776,347037
1438,recursive,"
Product: Hikvision DS-D5B65RB/EL 65"" 4K UHD 128GB Storage Interactive Flat Panel. Category: Interactive Flat Panel. Price: 220,000৳.

Product: Boxlight ProColor 654U 65"" 4K Interactive Flat Panel Display. Category: Interactive Flat Panel. Price: 225,000৳.
",257,347037,347294
1439,recursive,"
Product: Armor ARM6505 65"" 4K Android Interactive Flat Panel. Category: Interactive Flat Panel. Price: 230,000৳.

Product: Dahua LPH65-ST420 65'' 4K Smart Interactive Flat Panel Display. Category: Interactive Flat Panel. Price: 235,000৳.
",239,347294,347533
1440,recursive,"
Product: iBoard TE-QS-65 65-inch 4K Interactive Flat Panel Display. Category: Interactive Flat Panel. Price: 240,000৳.

Product: Maxhub E6520 65"" 4K UHD Interactive Flat Panel Display. Category: Interactive Flat Panel. Price: 245,000৳.
",237,347533,347770
1441,recursive,"
Product: METZ 65KD1 65"" K Series Interactive Flat Panel Display. Category: Interactive Flat Panel. Price: 240,000৳250,000৳.

Product: InFocus INF6513 65"" 4K Interactive Touch Display Inbuilt Camera. Category: Interactive Flat Panel. Price: 250,000৳.
",251,347770,348021
1442,recursive,"
Product: Viewsonic ViewBoard IFP6533-G 65"" 4K UHD Interactive Flat Panel Display. Category: ViewSonic. Subcategory: Interactive Flat Panel. Price: 280,000৳.
",158,348021,348179
1443,recursive,"
Product: Viewsonic ViewBoard IFP8633-G 86"" 4K UHD Interactive Flat Panel Display. Category: ViewSonic. Subcategory: Interactive Flat Panel. Price: 500,000৳.
",158,348179,348337
1444,recursive,"
Product: Viewsonic ViewBoard IFP7533-G 75"" 4K UHD Interactive Flat Panel Display. Category: ViewSonic. Subcategory: Interactive Flat Panel. Price: Up Coming.
",159,348337,348496
1445,recursive,"
Product: ViewSonic VPC16-WP-3 Windows Slot-in PC for interactive displays. Category: ViewSonic. Subcategory: Interactive Flat Panel. Price: Out Of Stock.
",155,348496,348651
1446,recursive,"
Product: ViewSonic VPC25-W33-O1-1B Slot-in PC Module for Interactive Displays. Category: ViewSonic. Subcategory: Interactive Flat Panel. Price: Out Of Stock.
",159,348651,348810
1447,recursive,"
Product: Viewsonic ViewBoard 7550-5 75 Inch 4K UHD Interactive Flat Panel Display. Category: ViewSonic. Subcategory: Interactive Flat Panel. Price: Out Of Stock.
",163,348810,348973
1448,recursive,"
Product: InFocus INF7513 75"" 4K Interactive Touch Display Inbuilt Camera. Category: InFocus. Subcategory: Interactive Flat Panel. Price: 295,000৳.

Product: InFocus INF9855 98"" 4K Interactive Touch Display Inbuilt Camera. Category: InFocus. Subcategory: Interactive Flat Panel. Price: Pre Order.
",297,348973,349270
1449,recursive,"
Product: InFocus INF6540e 65"" 4K Interactive Touch Display. Category: InFocus. Subcategory: Interactive Flat Panel. Price: Up Coming.

Product: InFocus INF6510 65"" 4K Interactive Touch Display. Category: InFocus. Subcategory: Interactive Flat Panel. Price: Up Coming.
",269,349270,349539
1450,recursive,"
Product: InFocus INF7510 75"" 4K Interactive Touch Display. Category: InFocus. Subcategory: Interactive Flat Panel. Price: Up Coming.

Product: InFocus INF7550 75"" 4K Interactive Touch Display. Category: InFocus. Subcategory: Interactive Flat Panel. Price: Up Coming.
",268,349539,349807
1451,recursive,"
Product: InFocus INF8613 86"" 4K Interactive Touch Display Inbuilt Camera. Category: InFocus. Subcategory: Interactive Flat Panel. Price: Up Coming.

Product: InFocus INF8650 86"" 4K Interactive Touch Display. Category: InFocus. Subcategory: Interactive Flat Panel. Price: Up Coming.
",283,349807,350090
1452,recursive,"
Product: InFocus JTouch 50 Series INF9850 98"" 4K UHD Interactive Touch Display. Category: InFocus. Subcategory: Interactive Flat Panel. Price: Out Of Stock.

Product: InFocus INF5510 55"" 4K Interactive Touch Display. Category: InFocus. Subcategory: Interactive Flat Panel. Price: Out Of Stock.
",295,350090,350385
1453,recursive,"
Product: InFocus INF6550 65"" 4K Interactive Touch Display. Category: InFocus. Subcategory: Interactive Flat Panel. Price: Out Of Stock.

Product: InFocus INF7540e 75"" 4K Interactive Touch Display. Category: InFocus. Subcategory: Interactive Flat Panel. Price: Out Of Stock.
",275,350385,350660
1454,recursive,"
Product: InFocus INF8610 86"" 4K Interactive Touch Display. Category: InFocus. Subcategory: Interactive Flat Panel. Price: Out Of Stock.

Product: InFocus INF8640e 86"" 4K Interactive Touch Display. Category: InFocus. Subcategory: Interactive Flat Panel. Price: Out Of Stock.
",275,350660,350935
1455,recursive,"
Product: InFocus JTouch INF9800 98"" 4K Interactive Touch Display. Category: InFocus. Subcategory: Interactive Flat Panel. Price: Out Of Stock.

Product: Dahua DHI-LPH75-ST420-L 75'' 4K Smart Interactive Flat Panel Display. Category: Dahua. Subcategory: Interactive Flat Panel. Price: 300,000৳.
",295,350935,351230
1456,recursive,"
Product: Dahua LPH86-MC470-P 86'' 4K Smart Interactive Flat Panel Display with 48MP Camera. Category: Dahua. Subcategory: Interactive Flat Panel. Price: 350,000৳430,000৳.
",172,351230,351402
1457,recursive,"
Product: Dahua LPH98-MC470-P 98'' 4K Smart Interactive Flat Panel Display with 48MP Camera. Category: Dahua. Subcategory: Interactive Flat Panel. Price: 975,000৳.
",164,351402,351566
1458,recursive,"
Product: Dahua LPH75-MC470-P 75'' 4K Smart Interactive Flat Panel Display with 48MP Camera. Category: Dahua. Subcategory: Interactive Flat Panel. Price: Up Coming.
",165,351566,351731
1459,recursive,"
Product: Dahua LPH65-MC470-P 65'' 4K Smart Interactive Flat Panel Display with 48MP Camera. Category: Dahua. Subcategory: Interactive Flat Panel. Price: Out Of Stock.
",168,351731,351899
1460,recursive,"
Product: BenQ RE6504 65 Inch 4K UHD Education Interactive Flat Panel Display With Camera & Microphone. Category: BenQ. Subcategory: Interactive Flat Panel. Price: 260,000৳270,000৳.
",182,351899,352081
1461,recursive,"
Product: BenQ RM7504 75 Inch 4K UHD Education Interactive Flat Panel Display. Category: BenQ. Subcategory: Interactive Flat Panel. Price: 395,000৳400,000৳.
",157,352081,352238
1462,recursive,"
Product: BenQ RE8604 86 Inch 4K UHD Education Interactive Flat Panel Display With Camera & Microphone. Category: BenQ. Subcategory: Interactive Flat Panel. Price: 460,000৳470,000৳.
",182,352238,352420
1463,recursive,"
Product: BenQ RM6504 65 Inch 4K UHD Education Interactive Flat Panel Display. Category: BenQ. Subcategory: Interactive Flat Panel. Price: Up Coming.
",150,352420,352570
1464,recursive,"
Product: BenQ RE7504 75 Inch 4K UHD Education Interactive Flat Panel Display With Camera & Microphone. Category: BenQ. Subcategory: Interactive Flat Panel. Price: 360,000৳370,000৳.
",182,352570,352752
1465,recursive,"
Product: BenQ RM8604 86 Inch 4K UHD Education Interactive Flat Panel Display. Category: BenQ. Subcategory: Interactive Flat Panel. Price: Up Coming.

Product: Armor ARM7505 75"" 4K Android Interactive Flat Panel. Category: ARMOR. Subcategory: Interactive Flat Panel. Price: 300,000৳.
",284,352752,353036
1466,recursive,"
Product: Armor ARM8605 86"" 4K Android Interactive Flat Panel. Category: ARMOR. Subcategory: Interactive Flat Panel. Price: 390,000৳.

Product: LG 75TR3DK-BM 75 Inch 4K UHD Touch Interactive Flat Panel Display. Category: LG. Subcategory: Interactive Flat Panel. Price: 370,000৳.
",279,353036,353315
1467,recursive,"
Product: LG 86TR3DK-BM 86 Inch 4K UHD Touch Interactive Flat Panel Display. Category: LG. Subcategory: Interactive Flat Panel. Price: 515,000৳.

Product: LG 86TR3DQ 86 Inch 4K UHD Interactive Flat Panel Display. Category: LG. Subcategory: Interactive Flat Panel. Price: 440,000৳.
",281,353315,353596
1468,recursive,"
Product: LG 98TR3PJ 98 inch 4K UHD Education Interactive Flat Panel Display. Category: LG. Subcategory: Interactive Flat Panel. Price: 1,500,000৳.

Product: LG 65TR3DK-BG 65 inch 4K UHD Interactive Flat Panel Display. Category: LG. Subcategory: Interactive Flat Panel. Price: 300,000৳.
",287,353596,353883
1469,recursive,"
Product: LG 65TR3DJ 65 inch 4K UHD Education Interactive Flat Panel Display. Category: LG. Subcategory: Interactive Flat Panel. Price: Out Of Stock.
",150,353883,354033
1470,recursive,"
Product: LG One:Quick Flex 43HT3WJ 43"" 4K UHD All-in-One Commercial Touch Display. Category: LG. Subcategory: Interactive Flat Panel. Price: Out Of Stock.
",156,354033,354189
1471,recursive,"
Product: Hikvision DS-D5B65RB/FL 65"" 4K UHD Interactive Flat Panel Display. Category: Hikvision. Subcategory: Interactive Flat Panel. Price: 250,000৳.
",152,354189,354341
1472,recursive,"
Product: Hikvision DS-D5B75RB/EL 75"" 4K UHD Interactive Flat Panel Display. Category: Hikvision. Subcategory: Interactive Flat Panel. Price: 270,000৳.
",152,354341,354493
1473,recursive,"
Product: Hikvision DS-D5C65RB-B 65 Inch 4K UHD Interactive Flat Panel Display with 8MP AI Camera & 8 Array Mic (For Android). Category: Hikvision. Subcategory: Interactive Flat Panel. Price: 280,000৳.
",202,354493,354695
1474,recursive,"
Product: Hikvision DS-D5B75RB/D 75"" 4K UHD Interactive Flat Panel Display With 8MP WebCam. Category: Hikvision. Subcategory: Interactive Flat Panel. Price: 290,000৳.
",167,354695,354862
1475,recursive,"
Product: Hikvision DS-D5C75RB/A 75 Inch 4K UHD Interactive Flat Panel Display (For Android). Category: Hikvision. Subcategory: Interactive Flat Panel. Price: Up Coming.
",170,354862,355032
1476,recursive,"
Product: Hikvision DS-D5B86RB/EL 86"" 4K UHD Interactive Flat Panel Display. Category: Hikvision. Subcategory: Interactive Flat Panel. Price: 330,000৳.
",152,355032,355184
1477,recursive,"
Product: Hikvision DS-D5B86RB/EL 86"" 4K UHD 128GB Storage Interactive Flat Panel. Category: Hikvision. Subcategory: Interactive Flat Panel. Price: 350,000৳.
",158,355184,355342
1478,recursive,"
Product: Hikvision DS-D5B75RB/FL 75"" 4K UHD Interactive Flat Panel Display. Category: Hikvision. Subcategory: Interactive Flat Panel. Price: 350,000৳.
",152,355342,355494
1479,recursive,"
Product: Hikvision DS-D5C75RB/B 75 Inch 4K UHD Interactive Flat Panel Display with 8MP AI Camera & 8 Array Mic (For Android). Category: Hikvision. Subcategory: Interactive Flat Panel. Price: 360,000৳.
",202,355494,355696
1480,recursive,"
Product: Hikvision DS-D5B86RB/D 86"" 4K UHD Interactive Flat Panel Display With 8MP WebCam. Category: Hikvision. Subcategory: Interactive Flat Panel. Price: 370,000৳.
",167,355696,355863
1481,recursive,"
Product: Hikvision DS-D5B86RB/FL 86"" 4K UHD Interactive Flat Panel Display. Category: Hikvision. Subcategory: Interactive Flat Panel. Price: 400,000৳.
",152,355863,356015
1482,recursive,"
Product: Hikvision DS-D5C86RB-B 86 Inch 4K UHD Interactive Flat Panel Display with 8MP AI Camera & 8 Array Mic (For Android). Category: Hikvision. Subcategory: Interactive Flat Panel. Price: 420,000৳.
",202,356015,356217
1483,recursive,"
Product: Hikvision DS-D5C86RB/A 86 Inch 4K UHD Interactive Flat Panel Display (For Android). Category: Hikvision. Subcategory: Interactive Flat Panel. Price: 430,000৳.
",169,356217,356386
1484,recursive,"
Product: Hikvision DS-D5B75RB/EL 75"" 4K UHD 128GB Storage Interactive Flat Panel. Category: Hikvision. Subcategory: Interactive Flat Panel. Price: Up Coming.
",159,356386,356545
1485,recursive,"
Product: Hikvision DS-D5C65RB/A 65 Inch 4K UHD Interactive Flat Panel Display (For Android). Category: Hikvision. Subcategory: Interactive Flat Panel. Price: Out Of Stock.
",173,356545,356718
1486,recursive,"
Product: Hitachi HILS65205 65"" UHD Interactive Flat Panel Display. Category: Hitachi. Subcategory: Interactive Flat Panel. Price: Out Of Stock.

Product: Hitachi HILS75205 75"" UHD Interactive Flat Panel Display. Category: Hitachi. Subcategory: Interactive Flat Panel. Price: Out Of Stock.
",290,356718,357008
1487,recursive,"
Product: Hitachi HILS86205 86"" UHD Interactive Flat Panel Display. Category: Hitachi. Subcategory: Interactive Flat Panel. Price: Out Of Stock.

Product: METZ 65SG1 65"" S Series 4K Interactive Flat Panel Display AI Camera. Category: METZ. Subcategory: Interactive Flat Panel. Price: 270,000৳.
",294,357008,357302
1488,recursive,"
Product: METZ 75KD1 75"" K Series Interactive Flat Panel Display. Category: METZ. Subcategory: Interactive Flat Panel. Price: 320,000৳.

Product: METZ 75SG1 75"" S Series 4K Interactive Flat Panel Display AI Camera. Category: METZ. Subcategory: Interactive Flat Panel. Price: 360,000৳.
",285,357302,357587
1489,recursive,"
Product: METZ 86HD1 86"" H Series Interactive Flat Panel Display. Category: METZ. Subcategory: Interactive Flat Panel. Price: 370,000৳.

Product: METZ 86KD1 86"" K Series Interactive Flat Panel Display. Category: METZ. Subcategory: Interactive Flat Panel. Price: 410,000৳.
",272,357587,357859
1490,recursive,"
Product: METZ 86SG1 86"" S Series 4K Interactive Flat Panel Display AI Camera. Category: METZ. Subcategory: Interactive Flat Panel. Price: 420,000৳.

Product: METZ 65HD1 65"" H Series Interactive Flat Panel Display. Category: METZ. Subcategory: Interactive Flat Panel. Price: Up Coming.
",286,357859,358145
1491,recursive,"
Product: METZ 75HD1 75"" H Series Interactive Flat Panel Display. Category: METZ. Subcategory: Interactive Flat Panel. Price: Up Coming.

Product: Boxlight ProColor P565UC 65"" 4K Interactive Flat Panel Display. Category: BoxLight. Subcategory: Interactive Flat Panel. Price: Up Coming.
",286,358145,358431
1492,recursive,"
Product: Boxlight ProColor P575UC 75"" 4K Interactive Flat Panel Display. Category: BoxLight. Subcategory: Interactive Flat Panel. Price: Up Coming.

Product: Boxlight ProColor P586UC 86"" 4K Interactive Flat Panel Display. Category: BoxLight. Subcategory: Interactive Flat Panel. Price: Up Coming.
",298,358431,358729
1493,recursive,"
Product: Boxlight ProColor 984UC 98"" 4K Interactive Flat Panel Display. Category: BoxLight. Subcategory: Interactive Flat Panel. Price: Up Coming.

Product: Boxlight ProColor 754U 75"" 4K Interactive Flat Panel Display. Category: BoxLight. Subcategory: Interactive Flat Panel. Price: Up Coming.
",295,358729,359024
1494,recursive,"
Product: Panasonic LH-65TD3VS 65-inch Touch Commercial Display. Category: Panasonic. Subcategory: Interactive Flat Panel. Price: 290,000৳.

Product: Panasonic LH-75TD3VS 75-inch Touch Commercial Display. Category: Panasonic. Subcategory: Interactive Flat Panel. Price: 420,000৳.
",280,359024,359304
1495,recursive,"
Product: Panasonic LH-86TD3VS 86-inch Touch Commercial Display. Category: Panasonic. Subcategory: Interactive Flat Panel. Price: 520,000৳.

Product: Panasonic LH-55TD3VS 55-inch Touch Commercial Display. Category: Panasonic. Subcategory: Interactive Flat Panel. Price: Out Of Stock.
",284,359304,359588
1496,recursive,"
Product: Maxhub E7520 75"" 4K UHD Interactive Flat Panel Display. Category: MAXHUB. Subcategory: Interactive Flat Panel. Price: 305,000৳.

Product: Maxhub E7521 75"" 4K UHD Interactive Flat Panel Display. Category: MAXHUB. Subcategory: Interactive Flat Panel. Price: 340,000৳.
",276,359588,359864
1497,recursive,"
Product: Maxhub C5530 55"" 4K UHD Interactive Flat Panel With Camera, Microphone & OPS. Category: MAXHUB. Subcategory: Interactive Flat Panel. Price: 340,000৳.
",160,359864,360024
1498,recursive,"
Product: Maxhub C6530 65"" 4K UHD Interactive Flat Panel With Camera, Microphone & OPS. Category: MAXHUB. Subcategory: Interactive Flat Panel. Price: 390,000৳.

Product: Maxhub E8621 86"" 4K UHD Interactive Flat Panel Display. Category: MAXHUB. Subcategory: Interactive Flat Panel. Price: 405,000৳.
",298,360024,360322
1499,recursive,"
Product: Maxhub C7530 75"" 4K UHD Interactive Flat Panel With Camera, Microphone & OPS. Category: MAXHUB. Subcategory: Interactive Flat Panel. Price: Up Coming.
",161,360322,360483
1500,recursive,"
Product: Maxhub C8630 86"" 4K UHD Interactive Flat Panel With Camera, Microphone & OPS. Category: MAXHUB. Subcategory: Interactive Flat Panel. Price: 615,000৳.
",160,360483,360643
1501,recursive,"
Product: ZKTeco SC02-I365A 65 Inch 4K UHD Interactive Flat Panel Display. Category: ZKTeco. Subcategory: Interactive Flat Panel. Price: 260,000৳.

Product: ZKTeco SC02-I386A 86 Inch 4K UHD Interactive Flat Panel Display. Category: ZKTeco. Subcategory: Interactive Flat Panel. Price: 380,000৳.
",294,360643,360937
1502,recursive,"
Product: ZKTeco ZK-IWB65BM 65 Inch 4K UHD Interactive Flat Panel Display. Category: ZKTeco. Subcategory: Interactive Flat Panel. Price: Up Coming.

Product: ZKTeco ZK-IWB86BP 86 Inch 4K UHD Interactive Flat Panel Display. Category: ZKTeco. Subcategory: Interactive Flat Panel. Price: Out Of Stock.
",299,360937,361236
1503,recursive,"
Product: ZKTeco SC02-I375A 75 Inch 4K UHD Interactive Flat Panel Display. Category: ZKTeco. Subcategory: Interactive Flat Panel. Price: Up Coming.

Product: Newline S Series 86-inch 4K Interactive Flat Panel Display. Category: Newline. Subcategory: Interactive Flat Panel. Price: 440,000৳.
",291,361236,361527
1504,recursive,"
Product: Horion 65M6APro 65"" 4K UHD Interactive Flat Panel With 48MP WebCam & Microphone. Category: Horion. Subcategory: Interactive Flat Panel. Price: 286,000৳.
",163,361527,361690
1505,recursive,"
Product: Horion 75M6APro 75"" 4K UHD Interactive Flat Panel With 48MP WebCam & Microphone. Category: Horion. Subcategory: Interactive Flat Panel. Price: 366,000৳.
",163,361690,361853
1506,recursive,"
Product: Horion 86M6APro 86"" 4K UHD Interactive Flat Panel With 48MP WebCam & Microphone. Category: Horion. Subcategory: Interactive Flat Panel. Price: 435,000৳.
",163,361853,362016
1507,recursive,"
Product: Horion 98M6APro 98"" 4K UHD Interactive Flat Panel With 48MP WebCam & Microphone. Category: Horion. Subcategory: Interactive Flat Panel. Price: Call for Price.
",169,362016,362185
1508,recursive,"
Product: ViewSonic CDE5520 55"" 4K UHD Wireless Commercial Display. Category: ViewSonic. Subcategory: Signage. Price: 140,000৳149,000৳.

Product: ViewSonic CDE6520 65 inch 4K UHD Wireless Commercial Display. Category: ViewSonic. Subcategory: Signage. Price: 165,000৳190,000৳.
",276,362185,362461
1509,recursive,"
Product: ViewSonic CDE7520 75"" 4K UHD Wireless Commercial Display. Category: ViewSonic. Subcategory: Signage. Price: Up Coming.

Product: BenQ ST5502 55 Inch Android 4K Professional Smart Signage. Category: BenQ. Subcategory: Signage. Price: Up Coming.
",254,362461,362715
1510,recursive,"
Product: BenQ ST6502 65"" Android 4K Professional Smart Signage. Category: BenQ. Subcategory: Signage. Price: Up Coming.

Product: BenQ ST7502 75"" Android 4K Professional Smart Signage. Category: BenQ. Subcategory: Signage. Price: Out Of Stock.
",245,362715,362960
1511,recursive,"
Product: Panasonic LH-55QM3VS 55-inch Pro Commercial Display. Category: Signage. Price: 110,000৳120,000৳.

Product: Panasonic LH-55AN3ND 55-inch Android Commercial Display. Category: Signage. Price: 127,700৳.
",210,362960,363170
1512,recursive,"
Product: Hikvision DS-D6055UH 55"" 4K UHD Android Signage Display. Category: Signage. Price: 170,000৳.

Product: Maxhub ND75CMA 75"" 4K UHD Android Signage Display. Category: Signage. Price: 245,000৳.

Product: Panasonic LH-75QM3VS 75-inch Pro Commercial Display. Category: Signage. Price: 445,000৳.
",299,363170,363469
1513,recursive,"
Product: Maxhub ND98CMA  98"" 4K UHD Android Signage Display. Category: Signage. Price: 550,000৳.

Product: LG 98UM5K 98 Inch 4K UHD Signage Display. Category: Signage. Price: 1,000,000৳.

Product: Panasonic LH-98QM3HVS 98-inch Pro Commercial Display. Category: Signage. Price: 1,731,400৳.
",290,363469,363759
1514,recursive,"
Product: Panasonic LH-43AN 43-inch Android Commercial Display. Category: Signage. Price: Out Of Stock.

Product: Panasonic LH-65AN3ND 65-inch Android Commercial Display. Category: Signage. Price: Out Of Stock.
",211,363759,363970
1515,recursive,"
Product: Panasonic LH-65QM3VS 65-inch Pro Commercial Display. Category: Signage. Price: Out Of Stock.

Product: Panasonic LH-86QM3VS 86-inch Pro Commercial Display. Category: Signage. Price: Out Of Stock.
",206,363970,364176
1516,recursive,"
Product: ViewSonic EP5542T 55"" 4K Multi-Touch Digital ePoster Kiosk. Category: ViewSonic. Subcategory: Kiosk. Price: 310,000৳.

Product: Canon Pixma IP 2770 Inkjet Printer with Original PG 810 & PG 811 Ink. Category: Printer. Price: 8,500৳8,700৳.
",248,364176,364424
1517,recursive,"
Product: HP DeskJet Ink Advantage 2336 All-in-One Color Printer. Category: Printer. Price: 9,500৳10,000৳.

Product: Pantum P2500 Single Function Mono Laser Printer. Category: Printer. Price: 9,900৳10,500৳.
",207,364424,364631
1518,recursive,"
Product: Pantum P2506 Single Function Mono Laser Printer (22 PPM). Category: Printer. Price: 10,000৳.

Product: Pantum P2506W Single Function Mono Laser Printer With Wi-Fi (22 PPM). Category: Printer. Price: 10,800৳11,000৳.
",225,364631,364856
1519,recursive,"
Product: HP DeskJet Ink Advantage 2875 All-in-One Wi-Fi Color Printer. Category: Printer. Price: 10,500৳11,000৳.

Product: Pantum P2500W Single Function Mono Laser Printer. Category: Printer. Price: 10,300৳12,000৳.
",216,364856,365072
1520,recursive,"
Product: HP Laser 1008a Single Function Mono Laser Printer. Category: Printer. Price: 12,300৳13,500৳.

Product: Pantum BP2310W Single Function Mono Laser Printer. Category: Printer. Price: 13,500৳.

Product: Pantum BP2310NW Single Function Mono Laser Printer. Category: Printer. Price: 15,500৳.
",296,365072,365368
1521,recursive,"
Product: Epson EcoTank L130 Single Function InkTank Printer (Unofficial). Category: Printer. Price: 13,800৳14,000৳.

Product: Canon Pixma G1010 Refillable Ink Tank Printer. Category: Printer. Price: 14,500৳14,700৳.
",216,365368,365584
1522,recursive,"
Product: Brother HL-L2320D Auto Duplex Laser Printer (30 PPM). Category: Printer. Price: 15,300৳.

Product: Epson EcoTank L130 Single Function InkTank Printer (Official). Category: Printer. Price: 14,000৳15,500৳.
",214,365584,365798
1523,recursive,"
Product: HP Laser 1008w Single Function Mono Laser Printer. Category: Printer. Price: 15,500৳.

Product: HP Smart Tank 210 Single Function Color Ink Printer. Category: Printer. Price: 15,300৳15,500৳.
",201,365798,365999
1524,recursive,"
Product: Pantum P3010DW Single Function Mono Laser Printer (30 PPM). Category: Printer. Price: 15,500৳16,000৳.

Product: Canon Pixma G1020 Ink Tank Color Printer. Category: Printer. Price: 15,000৳16,000৳.
",206,365999,366205
1525,recursive,"
Product: Pantum M6500NW Multifunction Mono Laser Printer. Category: Printer. Price: 16,000৳.

Product: Canon imageCLASS LBP6030B Mono Laser Printer. Category: Printer. Price: 15,800৳.

Product: Innovtech 43 inch E-Poster Non-Touch Floor Standing Kiosk. Category: Kiosk. Price: 125,000৳150,000৳.
",296,366205,366501
1526,recursive,"
Product: Armor ATFSD-A430 43"" Android Floor Standing Touch Kiosk. Category: Kiosk. Price: 150,000৳155,000৳.

Product: Innovtech 55-inch E-Poster Non-Touch Floor Standing Kiosk. Category: Kiosk. Price: 145,000৳170,000৳.
",220,366501,366721
1527,recursive,"
Product: Hikvision DS-D6055UL-B/S 55"" 4K UHD Floor Standing Digital Signage Kiosk (Non-Touch). Category: Kiosk. Price: 170,000৳185,000৳.

Product: Armor ATFSD-A550 55"" Android Floor Standing Touch Kiosk. Category: Kiosk. Price: 195,000৳200,000৳.
",247,366721,366968
1528,recursive,"
Product: Armor ANTSD-A430 43"" Android Floor Standing Kiosk. Category: Kiosk. Price: Up Coming.

Product: Armor ATFSD-A650 65"" Android Floor Standing Touch Kiosk. Category: Kiosk. Price: Out Of Stock.
",201,366968,367169
1529,recursive,"
Product: Armor ATFSD-W550 55"" Windows Floor Standing Touch Kiosk. Category: Kiosk. Price: Out Of Stock.

Product: Brother DCP-T220 Multi-Function Color Inktank Printer (Black/Color: 28/11 PPM). Category: Brother. Subcategory: Printer. Price: 16,000৳17,000৳.
",259,367169,367428
1530,recursive,"
Product: Brother HL-B2100D Single Function Laser Printer. Category: Brother. Subcategory: Printer. Price: 17,200৳17,500৳.

Product: Brother HL-L2365DW Auto Duplex Mono Laser Printer with Wifi (30 PPM). Category: Brother. Subcategory: Printer. Price: 18,300৳18,700৳.
",267,367428,367695
1531,recursive,"
Product: Brother DCP-T420W Multi-Function Color Inktank Printer with Wifi(Black/Color: 28/11 PPM). Category: Brother. Subcategory: Printer. Price: 18,000৳19,500৳.

Product: Brother HL-B2150W Single Function Laser Printer. Category: Brother. Subcategory: Printer. Price: 20,500৳.
",280,367695,367975
1532,recursive,"
Product: Brother DCP-T530DW Multifunction Color Inkjet Printer. Category: Brother. Subcategory: Printer. Price: 22,300৳23,000৳.

Product: Brother HL-B2180DW Mono Laser Duplex Printer. Category: Brother. Subcategory: Printer. Price: 22,000৳.
",242,367975,368217
1533,recursive,"
Product: Brother DCP-L2540DW Laser Multi-Function Wireless Duplex Printer (30 PPM). Category: Brother. Subcategory: Printer. Price: 26,400৳.

Product: Brother DCP-B7620DW Multifunctional Duplex Mono Laser Printer. Category: Brother. Subcategory: Printer. Price: 25,500৳.
",272,368217,368489
1534,recursive,"
Product: Brother HL-L5210DN Mono Laser Printer. Category: Brother. Subcategory: Printer. Price: 27,000৳.

Product: Brother DCP-B7640DW Multifunctional Duplex Laser Printer. Category: Brother. Subcategory: Printer. Price: 29,500৳30,000৳.
",238,368489,368727
1535,recursive,"
Product: Brother DCP-T720DW Multi-Function Color Inktank Printer with Wifi (Black/Color: 17/16.5 PPM). Category: Brother. Subcategory: Printer. Price: 30,500৳31,000৳.

Product: Brother DCP-T730DW Multifunction Color Inkjet Printer. Category: Brother. Subcategory: Printer. Price: 30,500৳31,500৳.
",297,368727,369024
1536,recursive,"
Product: Brother MFC-L2700DW Multifunction Laser Printer with Wifi (30 PPM). Category: Brother. Subcategory: Printer. Price: 29,200৳30,000৳.

Product: Brother MFC-J2340DW A3 Inkjet Printer. Category: Brother. Subcategory: Printer. Price: 32,000৳33,000৳.
",255,369024,369279
1537,recursive,"
Product: Brother DCP-T820DW Multi Function Inkjet Printer. Category: Brother. Subcategory: Printer. Price: Out Of Stock.

Product: Brother HL-L5210DW Professional Mono Laser Printer. Category: Brother. Subcategory: Printer. Price: 32,000৳33,500৳.
",248,369279,369527
1538,recursive,"
Product: Brother MFP MFC-B7810DW Multifunctional Mono Laser Printer. Category: Brother. Subcategory: Printer. Price: 34,500৳.

Product: Brother DCP-T830DW Multifunction Color Inkjet Printer. Category: Brother. Subcategory: Printer. Price: 33,500৳35,000৳.
",256,369527,369783
1539,recursive,"
Product: Fujifilm Apeos C325dw Color Laser Printer. Category: Fujifilm. Subcategory: Printer. Price: 56,000৳55,000৳.

Product: Fujifilm Apeos C325dw 3-in-1 Multifunction Color Laser Printer. Category: Fujifilm. Subcategory: Printer. Price: 67,400৳68,000৳.
",257,369783,370040
1540,recursive,"
Product: Fujifilm Apeos C325z 4-in-1 Multifunction Color Laser Printer. Category: Fujifilm. Subcategory: Printer. Price: 72,000৳73,000৳.

Product: Canon LBP 6030 Single Function Mono Laser Printer. Category: Canon. Subcategory: Printer. Price: 15,800৳16,500৳.
",261,370040,370301
1541,recursive,"
Product: Canon Pixma G2010 Ink Tank All-In-One Printer. Category: Canon. Subcategory: Printer. Price: 17,000৳17,500৳.

Product: Canon Pixma G2020 Ink Tank Color Printer. Category: Canon. Subcategory: Printer. Price: 17,700৳.
",226,370301,370527
1542,recursive,"
Product: Canon imageCLASS LBP6030W Wi-Fi Mono Laser Printer. Category: Canon. Subcategory: Printer. Price: 17,200৳17,500৳.

Product: Canon Pixma G3010 Refillable Ink Tank Wireless All-In-One Printer. Category: Canon. Subcategory: Printer. Price: 20,000৳21,000৳.
",263,370527,370790
1543,recursive,"
Product: Canon Pixma G3020 Wi-Fi Multifunction Color InkTank Printer. Category: Canon. Subcategory: Printer. Price: 22,500৳23,500৳.

Product: Canon imageCLASS LBP121dn Single Function Mono Laser Printer. Category: Canon. Subcategory: Printer. Price: 23,500৳.
",260,370790,371050
1544,recursive,"
Product: Canon imageCLASS LBP122dw Single Function Duplex Mono Laser Printer. Category: Canon. Subcategory: Printer. Price: 24,500৳25,000৳.

Product: Canon Pixma G4010 All in One Wireless Ink Tank Printer. Category: Canon. Subcategory: Printer. Price: 29,000৳29,500৳.
",269,371050,371319
1545,recursive,"
Product: Canon i-SENSYS LBP631Cw Color Laser Printer. Category: Canon. Subcategory: Printer. Price: Out Of Stock.

Product: Canon i-SENSYS LBP246dw Single Function Laser Printer. Category: Canon. Subcategory: Printer. Price: Up Coming.
",237,371319,371556
1546,recursive,"
Product: Canon Color imageCLASS LBP633Cdw Laser Printer. Category: Canon. Subcategory: Printer. Price: 39,000৳.

Product: Canon LBP-623Cdw Wireless Color Laser Printer. Category: Canon. Subcategory: Printer. Price: 82,000৳.
",225,371556,371781
1547,recursive,"
Product: Canon imageCLASS MF275dw Wi-Fi Multifunction Mono Laser Printer. Category: Canon. Subcategory: Printer. Price: 44,000৳45,000৳.

Product: Canon i-SENSYS MF651Cw All-In-One Multifunction Color Laser Printer. Category: Canon. Subcategory: Printer. Price: 50,000৳51,000৳.
",278,371781,372059
1548,recursive,"
Product: Canon LBP-325X Single-Function Mono Laser Printer. Category: Canon. Subcategory: Printer. Price: 97,000৳.

Product: HID FARGO DTC1250E FD AP Dual Side Plastic Card Printer. Category: HID. Subcategory: ID Card Printer. Price: 220,000৳.
",245,372059,372304
1549,recursive,"
Product: Pantum M6550NW Mono Lase Multifunction Printer with WiFi & ADF. Category: Pantum. Subcategory: Printer. Price: 16,300৳18,000৳.

Product: Pantum M6556NW Mono Laser Printer With ADF, LAN & Wi-fi (22 PPM). Category: Pantum. Subcategory: Printer. Price: Out Of Stock.
",274,372304,372578
1550,recursive,"
Product: Pantum M6700DW Mono Laser Multifunction Printer. Category: Pantum. Subcategory: Printer. Price: 19,300৳20,000৳.

Product: Pantum P3305DW Mono Laser Single Function Printer (33 PPM). Category: Pantum. Subcategory: Printer. Price: 21,500৳22,000৳.
",255,372578,372833
1551,recursive,"
Product: Pantum BP5100DN Single Function Mono Laser Printer With Duplex & Network (40 PPM). Category: Pantum. Subcategory: Printer. Price: 21,700৳24,000৳.

Product: Pantum BP5130DN Single Function Mono Laser Printer. Category: Pantum. Subcategory: Printer. Price: 23,500৳24,500৳.
",281,372833,373114
1552,recursive,"
Product: Pantum M7100DW Multifunction Mono Laser Printer. Category: Pantum. Subcategory: Printer. Price: 26,500৳.

Product: Pantum BP5100DW Mono Laser Printer with Duplex & Wi-Fi (40 PPM). Category: Pantum. Subcategory: Printer. Price: 26,500৳27,500৳.
",253,373114,373367
1553,recursive,"
Product: Pantum M7105DW Mono Laser Multifunction Printer. Category: Pantum. Subcategory: Printer. Price: 28,000৳.

Product: Pantum CP1100DW Color Laser Printer (18 ppm). Category: Pantum. Subcategory: Printer. Price: 38,500৳39,200৳.
",234,373367,373601
1554,recursive,"
Product: Pantum CP2100DW Color Laser Printer. Category: Pantum. Subcategory: Printer. Price: 45,000৳.

Product: Pantum CM1100ADW Multifunction Color Laser Printer. Category: Pantum. Subcategory: Printer. Price: 64,000৳.
",221,373601,373822
1555,recursive,"
Product: EVOLIS Badgy200 card printer. Category: Evolis. Subcategory: ID Card Printer. Price: 85,000৳.

Product: Evolis Zenius Classic Card Printer. Category: Evolis. Subcategory: ID Card Printer. Price: 115,000৳.
",215,373822,374037
1556,recursive,"
Product: Evolis Primacy 2 Simplex Expert ID Card Printer. Category: Evolis. Subcategory: ID Card Printer. Price: 145,000৳150,000৳.

Product: Evolis Primacy 2 Duplex Expert ID Card Printer. Category: Evolis. Subcategory: ID Card Printer. Price: 175,000৳.
",255,374037,374292
1557,recursive,"
Product: Evolis Avansia Dual-Sided ID Card Printer. Category: Evolis. Subcategory: ID Card Printer. Price: 600,000৳.

Product: Evolis Primacy Simplex Expert Card Printer. Category: Evolis. Subcategory: ID Card Printer. Price: Out Of Stock.
",241,374292,374533
1558,recursive,"
Product: Zebra ZC300 Single-Sided ID Card Printer (Without Ribbon & Card). Category: Zebra. Subcategory: ID Card Printer. Price: Up Coming.

Product: Zebra ZC300 Dual-Sided ID Card Printer (Without Ribbon & Card). Category: Zebra. Subcategory: ID Card Printer. Price: 97,000৳98,000৳.
",285,374533,374818
1559,recursive,"
Product: Zebra ZC100 Single-Sided Card Printer (Without Ribbon & Card). Category: Zebra. Subcategory: ID Card Printer. Price: Up Coming.

Product: Zebra ZXP Series 3 Single Sided ID Card Printer Without Ribbon & Card. Category: Zebra. Subcategory: ID Card Printer. Price: Out Of Stock.
",287,374818,375105
1560,recursive,"
Product: Zebra ZXP Series 7 Card Printer (Single -Sided Printing, without Ribbon & Card). Category: Zebra. Subcategory: ID Card Printer. Price: Out Of Stock.

Product: Epson EcoTank L3210 Multifunction InkTank Printer (Unofficial). Category: Epson. Subcategory: Printer. Price: 16,800৳17,000৳.
",295,375105,375400
1561,recursive,"
Product: Epson EcoTank L3210 Multifunction InkTank Printer (Official). Category: Epson. Subcategory: Printer. Price: 17,000৳18,000৳.

Product: Epson EcoTank M1120 Monochrome Wi-Fi Ink Tank Printer. Category: Epson. Subcategory: Printer. Price: 18,300৳19,500৳.
",261,375400,375661
1562,recursive,"
Product: Epson EcoTank M1050 Monochrome Wi-Fi Ink Tank Printer. Category: Epson. Subcategory: Printer. Price: 19,500৳20,000৳.

Product: Epson EcoTank L3250 A4 Wi-Fi Multifunction InkTank Printer (Unofficial). Category: Epson. Subcategory: Printer. Price: 19,800৳20,000৳.
",272,375661,375933
1563,recursive,"
Product: Epson EcoTank L1250 A4 Wi-Fi Ink Tank Printer. Category: Epson. Subcategory: Printer. Price: 20,700৳21,000৳.

Product: Epson EcoTank L3250 A4 Wi-Fi Multifunction InkTank Printer (Official). Category: Epson. Subcategory: Printer. Price: 21,000৳22,500৳.
",262,375933,376195
1564,recursive,"
Product: Epson EcoTank M2050 Multifunction Monochrome Ink Tank Printer. Category: Epson. Subcategory: Printer. Price: 24,500৳27,500৳.

Product: Epson EcoTank Monochrome M1170 Wi-Fi Inkjet Printer. Category: Epson. Subcategory: Printer. Price: 32,500৳33,000৳.
",260,376195,376455
1565,recursive,"
Product: EPSON EcoTank Monochrome M2170 All-in-One Wi-Fi Duplex InkTank Printer. Category: Epson. Subcategory: Printer. Price: 32,500৳34,000৳.

Product: Epson EcoTank L4260 A4 Wi-Fi Duplex All-in-One Ink Tank Printer. Category: Epson. Subcategory: Printer. Price: 39,500৳41,000৳.
",281,376455,376736
1566,recursive,"
Product: Epson EcoTank L5290 A4 Wi-Fi All-in-One Ink Tank Printer with ADF. Category: Epson. Subcategory: Printer. Price: 44,000৳.

Product: Epson EcoTank L8050 WiFi Color Ink Tank Printer. Category: Epson. Subcategory: Printer. Price: 44,000৳.
",246,376736,376982
1567,recursive,"
Product: Epson EcoTank L6460 A4 All-in-One Ink Tank Printer. Category: Epson. Subcategory: Printer. Price: 45,000৳.

Product: Epson EcoTank L6490 A4 All-in-One Ink Tank Printer. Category: Epson. Subcategory: Printer. Price: Out Of Stock.
",239,376982,377221
1568,recursive,"
Product: Epson EcoTank L6270 A4 Wi-Fi All-in-One Ink Tank Printer with ADF. Category: Epson. Subcategory: Printer. Price: 50,000৳52,000৳.

Product: Epson EcoTank L11050 A3 Wi-Fi Ink Tank Printer. Category: Epson. Subcategory: Printer. Price: 59,000৳62,000৳.
",259,377221,377480
1569,recursive,"
Product: Epson EcoTank L14150 (A3) Multifunction Ink Tank Printer with Duplex & Wi-Fi. Category: Epson. Subcategory: Printer. Price: 67,000৳71,000৳.

Product: Deli ES421 Thermal POS Receipt Printer. Category: Deli. Subcategory: POS Printer. Price: 3,000৳.
",257,377480,377737
1570,recursive,"
Product: Deli ES420 Thermal POS Receipt Printer. Category: Deli. Subcategory: POS Printer. Price: 3,100৳.

Product: Deli ES302 Thermal Receipt POS Printer. Category: Deli. Subcategory: POS Printer. Price: 9,500৳.
",214,377737,377951
1571,recursive,"
Product: Deli E801PN Direct Thermal Receipt Printer. Category: Deli. Subcategory: POS Printer. Price: 9,000৳12,000৳.

Product: Deli DL-801PS Thermal Receipt Printer. Category: Deli. Subcategory: POS Printer. Price: Up Coming.
",227,377951,378178
1572,recursive,"
Product: Deli DL-581PS Thermal Receipt Printer. Category: Deli. Subcategory: POS Printer. Price: Out Of Stock.

Product: Deli DL-581WPS Receipt Printer. Category: Deli. Subcategory: POS Printer. Price: Out Of Stock.
",217,378178,378395
1573,recursive,"
Product: Epson TM-U220IIB Dot Matrix Receipt Printer. Category: Epson. Subcategory: POS Printer. Price: 30,500৳.

Product: Epson TM-T81III POS Printer With USB Port. Category: Epson. Subcategory: POS Printer. Price: 14,500৳15,000৳.
",233,378395,378628
1574,recursive,"
Product: Epson TM-T81III POS Printer with Ethernet Port. Category: Epson. Subcategory: POS Printer. Price: 14,800৳15,000৳.

Product: EPSON TM-U220A IMPACT POS PRINTER. Category: Epson. Subcategory: POS Printer. Price: Up Coming.
",230,378628,378858
1575,recursive,"
Product: Epson TM U220B USB POS Printer. Category: Epson. Subcategory: POS Printer. Price: 27,000৳27,500৳.

Product: Epson TM-T82 Thermal POS Receipt Printer. Category: Epson. Subcategory: POS Printer. Price: Out Of Stock.
",224,378858,379082
1576,recursive,"
Product: Rongta RPP02C 58mm Mobile POS Printer. Category: RONGTA. Subcategory: POS Printer. Price: 3,500৳4,000৳.

Product: Rongta RP582 58mm Thermal Receipt Printer. Category: RONGTA. Subcategory: POS Printer. Price: 3,500৳4,000৳.
",232,379082,379314
1577,recursive,"
Product: Rongta RP58E-U POS Thermal Receipt Printer. Category: RONGTA. Subcategory: POS Printer. Price: 4,000৳4,200৳.

Product: Rongta RP335 Thermal POS Printer. Category: RONGTA. Subcategory: POS Printer. Price: 5,800৳6,500৳.
",228,379314,379542
1578,recursive,"
Product: Rongta RP336-U Thermal POS Receipt Printer. Category: RONGTA. Subcategory: POS Printer. Price: 6,200৳7,000৳.

Product: Rongta RPP300BU 80mm Thermal POS Printer. Category: RONGTA. Subcategory: POS Printer. Price: 7,000৳7,200৳.
",236,379542,379778
1579,recursive,"
Product: Rongta RP328-USE Thermal Receipt Printer. Category: RONGTA. Subcategory: POS Printer. Price: 7,000৳7,500৳.

Product: Rongta RP336-UE Thermal POS Receipt Printer. Category: RONGTA. Subcategory: POS Printer. Price: 6,700৳7,500৳.
",237,379778,380015
1580,recursive,"
Product: Rongta RP328-BU Thermal Receipt Printer (Bluetooth + USB). Category: RONGTA. Subcategory: POS Printer. Price: 8,500৳.

Product: Rongta RP330-USE Thermal Pos Printer. Category: RONGTA. Subcategory: POS Printer. Price: 9,000৳9,500৳.
",241,380015,380256
1581,recursive,"
Product: Rongta RP80 IV-USE-G / RP804-USE POS Printer. Category: RONGTA. Subcategory: POS Printer. Price: 10,000৳10,500৳.

Product: Rongta RP850-USE 300mm/s Thermal Receipt Printer. Category: RONGTA. Subcategory: POS Printer. Price: 9,800৳11,500৳.
",249,380256,380505
1582,recursive,"
Product: Rongta RP327-UP Thermal Receipt Printer. Category: RONGTA. Subcategory: POS Printer. Price: 8,000৳8,200৳.

Product: Rongta RP327-USE Thermal Receipt Printer. Category: RONGTA. Subcategory: POS Printer. Price: Up Coming.
",230,380505,380735
1583,recursive,"
Product: Rongta RPP200BU 56mm Thermal POS Printer. Category: RONGTA. Subcategory: POS Printer. Price: Up Coming.

Product: Rongta RP80 (USEB-Version) Thermal Pos Printer Black (USB/Serial/Ethernet/Bluetooth). Category: RONGTA. Subcategory: POS Printer. Price: Out Of Stock.
",275,380735,381010
1584,recursive,"
Product: Rongta RP80IV Thermal POS Printer. Category: RONGTA. Subcategory: POS Printer. Price: Out Of Stock.

Product: HP Smart Tank 520 All-in-One Color Ink Printer. Category: HP. Subcategory: Printer. Price: 17,000৳18,300৳.
",227,381010,381237
1585,recursive,"
Product: HP Laserjet MFP 1188a Multifunction Mono Laser Printer. Category: HP. Subcategory: Printer. Price: 18,700৳19,500৳.

Product: HP Smart Tank 580 Multifunction Wi-Fi All-in-One Color Ink Printer. Category: HP. Subcategory: Printer. Price: 18,700৳20,000৳.
",262,381237,381499
1586,recursive,"
Product: HP LaserJet M211d Single Function Mono Laser Printer. Category: HP. Subcategory: Printer. Price: 22,500৳23,500৳.

Product: HP Laserjet MFP 1188w Multifunction Mono Laser Printer. Category: HP. Subcategory: Printer. Price: 22,500৳.
",241,381499,381740
1587,recursive,"
Product: HP Laser MFP 135w Multifunction Mono Laser Printer. Category: HP. Subcategory: Printer. Price: 28,300৳28,500৳.

Product: HP LaserJet Pro 4003dn Single Function Mono Laser Printer. Category: HP. Subcategory: Printer. Price: 26,800৳27,000৳.
",249,381740,381989
1588,recursive,"
Product: HP Smart Tank 670 Wi-Fi Duplexer All-in-One Color Printer. Category: HP. Subcategory: Printer. Price: 29,000৳30,500৳.

Product: HP Laser MFP 137fnw Multifunction Mono Laser Printer. Category: HP. Subcategory: Printer. Price: 29,000৳.
",244,381989,382233
1589,recursive,"
Product: HP LaserJet Pro 4003dw Single Function Mono Laser Printer. Category: HP. Subcategory: Printer. Price: 34,000৳35,000৳.

Product: HP Smart Tank 750 Wi-Fi Duplexer All-in-One Color Printer. Category: HP. Subcategory: Printer. Price: 35,000৳36,000৳.
",256,382233,382489
1590,recursive,"
Product: HP Color Laser 150a Single Function Color Laser Printer. Category: HP. Subcategory: Printer. Price: 36,800৳38,000৳.

Product: HP Color LaserJet Pro M255nw Single Function A4 Color Laser Printer. Category: HP. Subcategory: Printer. Price: 37,000৳40,000৳.
",264,382489,382753
1591,recursive,"
Product: HP Color LaserJet Pro M255DW Single Function A4 Color Laser Printer. Category: HP. Subcategory: Printer. Price: 47,000৳48,000৳.

Product: HP LaserJet Pro MFP M227fdw Multifunction Mono Laser Printer. Category: HP. Subcategory: Printer. Price: 48,000৳49,000৳.
",269,382753,383022
1592,recursive,"
Product: BM58E Portable Bluetooth Thermal POS Printer. Category: POS Printer. Price: 4,500৳.

Product: Xprinter XP-Q890K Thermal Receipt Printer. Category: POS Printer. Price: Up Coming.

Product: Xprinter XP-E260L Thermal POS Printer. Category: POS Printer. Price: Up Coming.
",278,383022,383300
1593,recursive,"
Product: Xprinter XP-P502A Wireless Thermal Receipt Printer. Category: POS Printer. Price: Up Coming.

Product: Xprinter XP-58IIL Mini Thermal Direct Receipt POS Printer. Category: POS Printer. Price: 4,500৳.

Product: Xprinter XP80T Thermal Receipt Printer. Category: POS Printer. Price: 6,500৳.
",298,383300,383598
1594,recursive,"
Product: Xprinter XP-P210 Mobile Receipt Direct Thermal Label & POS Printer. Category: POS Printer. Price: 7,000৳.

Product: Xprinter XP-K200L Thermal POS Printer. Category: POS Printer. Price: 7,500৳.

Product: Xprinter XP-A160H 80mm Thermal POS Printer. Category: POS Printer. Price: 7,000৳.
",295,383598,383893
1595,recursive,"
Product: G-Printer GP-C80180II 80mm Thermal Receipt Printer. Category: POS Printer. Price: 7,500৳.

Product: Sewoo SLK-TS400 POS Thermal Receipt Printer (With Lan). Category: Sewoo. Subcategory: POS Printer. Price: 17,500৳.
",225,383893,384118
1596,recursive,"
Product: Sewoo SLK-TE213 3-inch Direct Thermal POS Printer. Category: Sewoo. Subcategory: POS Printer. Price: 22,000৳.

Product: Sewoo LKP21 Wireless POS Printer. Category: Sewoo. Subcategory: POS Printer. Price: 27,000৳.
",223,384118,384341
1597,recursive,"
Product: Sewoo LK-Tl200 Thermal POS Printer. Category: Sewoo. Subcategory: POS Printer. Price: Up Coming.

Product: Sewoo SLK-TL210 POS Printer. Category: Sewoo. Subcategory: POS Printer. Price: Up Coming.
",207,384341,384548
1598,recursive,"
Product: Sewoo SLK-TE212 3-inch Direct Thermal POS Printer. Category: Sewoo. Subcategory: POS Printer. Price: Out Of Stock.

Product: SEWOO SLK-TS100 Direct Thermal POS Printer. Category: Sewoo. Subcategory: POS Printer. Price: Out Of Stock.
",243,384548,384791
1599,recursive,"
Product: Sewoo SLK-TS400 POS Thermal Receipt Printer (With out Lan). Category: Sewoo. Subcategory: POS Printer. Price: Out Of Stock.

Product: Xprinter XP-P810 Direct Thermal Portable POS Printer. Category: Xprinter. Subcategory: POS Printer. Price: 8,350৳8,500৳.
",265,384791,385056
1600,recursive,"
Product: Xprinter XP-365B Thermal Label & POS Printer. Category: Xprinter. Subcategory: POS Printer. Price: 7,800৳8,500৳.

Product: Xprinter XP-E260M Thermal POS Printer. Category: Xprinter. Subcategory: POS Printer. Price: 8,500৳8,800৳.
",239,385056,385295
1601,recursive,"
Product: Xprinter XP-P3301B Direct Thermal Portable Mobile POS & Label Printer. Category: Xprinter. Subcategory: POS Printer. Price: 8,850৳.

Product: Xprinter XP-E300M Thermal POS Printer. Category: Xprinter. Subcategory: POS Printer. Price: 10,000৳.
",253,385295,385548
1602,recursive,"
Product: Xprinter XP-350BM Direct Thermal Barcode Label & POS Printer. Category: Xprinter. Subcategory: POS Printer. Price: 11,000৳11,300৳.

Product: Xprinter XP-V330N Thermal Receipt Printer. Category: Xprinter. Subcategory: POS Printer. Price: Out Of Stock.
",261,385548,385809
1603,recursive,"
Product: Xprinter XP-E200M Thermal POS Printer. Category: Xprinter. Subcategory: POS Printer. Price: Out Of Stock.

Product: SPRT SP-POS891 POS Printer. Category: SPRT. Subcategory: POS Printer. Price: 12,000৳.
",212,385809,386021
1604,recursive,"
Product: SPRT SP-POS890W Thermal POS Printer. Category: SPRT. Subcategory: POS Printer. Price: 14,500৳.

Product: SPRT SP-TL51 Low Cost Label Printer. Category: SPRT. Subcategory: POS Printer. Price: Out Of Stock.
",215,386021,386236
1605,recursive,"
Product: Sunmi V2s POS Terminal (2GB+16GB+NFC+Label). Category: Sunmi. Subcategory: POS Printer. Price: 28,000৳.

Product: Sunmi V3 MIX Smart Android POS Terminal. Category: Sunmi. Subcategory: POS Printer. Price: 45,000৳.
",224,386236,386460
1606,recursive,"
Product: Sunmi V2s POS Terminal WIth NFC (2GB +16GB). Category: Sunmi. Subcategory: POS Printer. Price: 30,000৳.

Product: Sunmi V3 Family Smart Android POS Terminal. Category: Sunmi. Subcategory: POS Printer. Price: 30,000৳.
",227,386460,386687
1607,recursive,"
Product: Sunmi L2s Pro T8920 5.5"" HD+ Smart Mobile POS Terminal. Category: Sunmi. Subcategory: POS Printer. Price: 34,500৳.

Product: Sunmi V2s Plus T5F01 GMS (NFC + Label) Handheld POS Terminal. Category: Sunmi. Subcategory: POS Printer. Price: 38,000৳.
",256,386687,386943
1608,recursive,"
Product: Sunmi V2s Plus NFC Android POS Terminal with Scanner. Category: Sunmi. Subcategory: POS Printer. Price: 39,500৳.

Product: Sunmi D2s 15.6"" FHD Display POS Terminal. Category: Sunmi. Subcategory: POS Printer. Price: 45,000৳.
",234,386943,387177
1609,recursive,"
Product: Sunmi L2H T8911 5.5"" HD Touch Smart Mobile POS Terminal. Category: Sunmi. Subcategory: POS Printer. Price: 50,500৳.

Product: Sunmi T2s Lite 15.6"" FHD and 10.1"" HD Touch POS Terminal. Category: Sunmi. Subcategory: POS Printer. Price: 62,000৳.
",253,387177,387430
1610,recursive,"
Product: Sunmi T2 15.6""+10.1"" FHD Touch POS terminal with Printer. Category: Sunmi. Subcategory: POS Printer. Price: 67,000৳.

Product: Sunmi T2 15.6""+15.6"" FHD Touch POS terminal with Printer. Category: Sunmi. Subcategory: POS Printer. Price: 77,000৳.
",254,387430,387684
1611,recursive,"
Product: Sunmi D2s Plus Combo 15.6"" FHD and 10.1 Inch HD Touch Display POS Terminal. Category: Sunmi. Subcategory: POS Printer. Price: 82,000৳.

Product: SUNMI L2Ks T8A10 4 Inch Smart Mobile POS Terminal (4+32+Scanner). Category: Sunmi. Subcategory: POS Printer. Price: Call for Price.
",287,387684,387971
1612,recursive,"
Product: Sunmi V2 Pro Android Handheld POS Terminal with Printer 2GB+16GB. Category: Sunmi. Subcategory: POS Printer. Price: Up Coming.

Product: Sunmi V2 T5930 Android Handheld POS Terminal. Category: Sunmi. Subcategory: POS Printer. Price: Up Coming.
",254,387971,388225
1613,recursive,"
Product: Sunmi V2s T5940 Label & Scanner 5.5 Inch HD+ Touch Handheld POS Terminal. Category: Sunmi. Subcategory: POS Printer. Price: Up Coming.

Product: Sunmi V2s T5940 Label & NFC 3GB RAM 16GB ROM POS Terminal. Category: Sunmi. Subcategory: POS Printer. Price: Up Coming.
",275,388225,388500
1614,recursive,"
Product: Sunmi T2 L1523 EPOS 15.6 Inch FHD Touch Display Dual POS Terminal. Category: Sunmi. Subcategory: POS Printer. Price: Up Coming.

Product: Sunmi V2 Pro Android Handheld POS Terminal with Printer 1GB+8GB. Category: Sunmi. Subcategory: POS Printer. Price: Out Of Stock.
",277,388500,388777
1615,recursive,"
Product: G-Printer GP-3120TU Barcode Thermal Label & POS Printer. Category: G-Printer. Subcategory: Label Printer. Price: 7,800৳.

Product: G-Printer GP-1324D Direct Barcode Thermal Label Printer. Category: G-Printer. Subcategory: Label Printer. Price: 14,000৳15,000৳.
",270,388777,389047
1616,recursive,"
Product: G-printer GP-1224T Barcode Label Printer. Category: G-Printer. Subcategory: Label Printer. Price: 18,500৳20,000৳.

Product: Citizen CT-D150 Thermal Receipt POS Printer. Category: Citizen. Subcategory: POS Printer. Price: 15,000৳.
",240,389047,389287
1617,recursive,"
Product: Citizen CL-E321XUBNNA Barcode Label Printer. Category: Citizen. Subcategory: POS Printer. Price: 37,000৳.

Product: Zebra ZD230TA Desktop Label Printer With 4 Inch, 203dpi. Category: Zebra. Subcategory: Label Printer. Price: Up Coming.
",246,389287,389533
1618,recursive,"
Product: Zebra GK888T Desktop Label Printer. Category: Zebra. Subcategory: Label Printer. Price: 21,000৳.

Product: Zebra GT820 Barcode Label Printer. Category: Zebra. Subcategory: Label Printer. Price: Out Of Stock.
",218,389533,389751
1619,recursive,"
Product: Zebra ZT230 Barcode Label Printer. Category: Zebra. Subcategory: Label Printer. Price: 75,000৳80,000৳.

Product: Zebra ZT231 300 dpi Industrial Barcode Label Printer. Category: Zebra. Subcategory: Label Printer. Price: 103,000৳.
",239,389751,389990
1620,recursive,"
Product: Zebra ZT411 Industrial Barcode Label Printer. Category: Zebra. Subcategory: Label Printer. Price: 155,000৳.

Product: Zebra ZT421 203 dpi Industrial Barcode Label Printer. Category: Zebra. Subcategory: Label Printer. Price: Up Coming.
",245,389990,390235
1621,recursive,"
Product: Zebra ZT421 300 dpi Industrial Barcode Label Printer. Category: Zebra. Subcategory: Label Printer. Price: Up Coming.

Product: Zebra ZT231 203 dpi Industrial Barcode Label Printer. Category: Zebra. Subcategory: Label Printer. Price: Up Coming.
",254,390235,390489
1622,recursive,"
Product: Zebra ZT230 Barcode Label Printer (300 DPI). Category: Zebra. Subcategory: Label Printer. Price: Out Of Stock.

Product: Zebra ZT411 Industrial Barcode Label Printer(203 DPI). Category: Zebra. Subcategory: Label Printer. Price: Out Of Stock.
",252,390489,390741
1623,recursive,"
Product: Zebra ZT510 300 dpi Industrial Label Printer. Category: Zebra. Subcategory: Label Printer. Price: 195,000৳.

Product: Zebra ZT420 Industrial Label Printer. Category: Zebra. Subcategory: Label Printer. Price: Out Of Stock.
",232,390741,390973
1624,recursive,"
Product: TSC TTP-384MT A4 Barcode Label Printer. Category: TSC. Subcategory: Label Printer. Price: 375,000৳.

Product: Sewoo LK-B24 Label Printer. Category: Sewoo. Subcategory: Label Printer. Price: 32,500৳.
",209,390973,391182
1625,recursive,"
Product: Sewoo LK-B20 Label Printer. Category: Sewoo. Subcategory: Label Printer. Price: 38,000৳.

Product: G-Printer GP-D802 80mm Thermal Receipt Printer. Category: G-Printer. Subcategory: POS Printer. Price: 12,000৳.
",220,391182,391402
1626,recursive,"
Product: Deli E581PW Thermal Receipt Printer. Category: Deli. Subcategory: Label Printer. Price: 4,300৳.

Product: Deli E886BW Receipt & Label Printer. Category: Deli. Subcategory: Label Printer. Price: 9,500৳.
",212,391402,391614
1627,recursive,"
Product: Deli ES351 Direct Thermal Transfer Label Printer. Category: Deli. Subcategory: Label Printer. Price: 17,500৳.

Product: Deli E720C Thermal Transfer Label Printer. Category: Deli. Subcategory: Label Printer. Price: Out Of Stock.
",238,391614,391852
1628,recursive,"
Product: Deli E740C Thermal Label Printer. Category: Deli. Subcategory: Label Printer. Price: Out Of Stock.

Product: Rongta RP80VI/RP80VI-USE 6 inch/sec High Printing Speed Label Barcode Printer. Category: Rongta. Subcategory: Label Printer. Price: 10,900৳11,200৳.
",267,391852,392119
1629,recursive,"
Product: Rongta RP400H 4-inch Thermal Transfer Barcode Label Printer. Category: Rongta. Subcategory: Label Printer. Price: 12,300৳13,000৳.

Product: Rongta RPW215 Commercial Label Wristband Printer. Category: Rongta. Subcategory: Label Printer. Price: 29,000৳.
",262,392119,392381
1630,recursive,"
Product: Brother PT-E110VP Handheld Label Printer. Category: Brother. Subcategory: Label Printer. Price: 8,500৳8,800৳.

Product: Brother PT-D410 Desktop Label Printer. Category: Brother. Subcategory: Label Printer. Price: 10,000৳10,500৳.
",239,392381,392620
1631,recursive,"
Product: Brother QL-800 Professional Label Printer. Category: Brother. Subcategory: Label Printer. Price: Up Coming.

Product: Brother QL-820NWB Ultra Flexible Professional Label Printer. Category: Brother. Subcategory: Label Printer. Price: Out Of Stock.
",257,392620,392877
1632,recursive,"
Product: Brother PT-P900W Lebel Printer. Category: Brother. Subcategory: Label Printer. Price: Out Of Stock.

Product: Bixolon SRP-E302 Thermal Receipt Printer. Category: Bixolon. Subcategory: POS Printer. Price: 13,500৳.
",223,392877,393100
1633,recursive,"
Product: Bixolon SRP-350II Thermal POS Printer. Category: Bixolon. Subcategory: POS Printer. Price: Up Coming.

Product: Xprinter XP-420B Thermal Barcode Printer. Category: Label Printer. Price: 10,000৳.
",205,393100,393305
1634,recursive,"
Product: Xprinter XP-TT424B Thermal Transfer Barcode Label Printer. Category: Label Printer. Price: 15,000৳15,500৳.

Product: Xprinter XP-T451B Thermal Transfer Label Printer. Category: Label Printer. Price: 14,000৳.
",218,393305,393523
1635,recursive,"
Product: Xprinter XP-T261B 2 Inch Wristband Label Printer. Category: Label Printer. Price: 23,000৳25,000৳.

Product: Xprinter XP-G480E 4-Inch Industrial Label Printer. Category: Xprinter. Subcategory: Label Printer. Price: 90,000৳.
",233,393523,393756
1636,recursive,"
Product: M10 Inkjet Handheld Printer. Category: Others. Subcategory: Label Printer. Price: 28,500৳.

Product: Toshiba MR-3032 Automatic Document Feeder (RADF). Category: Toshiba. Subcategory: Photocopier. Price: 32,000৳33,000৳.
",229,393756,393985
1637,recursive,"
Product: Toshiba e-Studio 2523A A3 Multifunction Digital Photocopier. Category: Toshiba. Subcategory: Photocopier. Price: 44,000৳46,000৳.

Product: Toshiba MR-3033C Automatic Document Feeder (RADF). Category: Toshiba. Subcategory: Photocopier. Price: 49,000৳52,000৳.
",268,393985,394253
1638,recursive,"
Product: Toshiba e-Studio 2323AMW Multifunction Monochrome Photocopier. Category: Toshiba. Subcategory: Photocopier. Price: 55,500৳58,500৳.

Product: Toshiba e-Studio 2523AD Duplex Multifunction Photocopier. Category: Toshiba. Subcategory: Photocopier. Price: 55,000৳59,000৳.
",277,394253,394530
1639,recursive,"
Product: Toshiba e-Studio 2020AC Multifunction Digital Color Photocopier. Category: Toshiba. Subcategory: Photocopier. Price: 106,000৳110,000৳.

Product: Toshiba e-Studio 2021AC Multifunctional A3 Color Photocopier. Category: Toshiba. Subcategory: Photocopier. Price: 110,000৳115,000৳.
",287,394530,394817
1640,recursive,"
Product: Toshiba e-Studio 2528A Multifunction Digital Photocopier. Category: Toshiba. Subcategory: Photocopier. Price: 149,000৳157,000৳.

Product: Toshiba e-Studio 3028A Multifunction Digital Photocopier. Category: Toshiba. Subcategory: Photocopier. Price: 190,000৳195,000৳.
",276,394817,395093
1641,recursive,"
Product: Toshiba e-studio 4528A Multifunction Photocopier with RADF. Category: Toshiba. Subcategory: Photocopier. Price: 365,000৳370,000৳.

Product: Toshiba e-Studio 2323AMS Multifunctional Monochrome Photocopier. Category: Toshiba. Subcategory: Photocopier. Price: Up Coming.
",278,395093,395371
1642,recursive,"
Product: Toshiba e-Studio 2823AM Photocopier. Category: Toshiba. Subcategory: Photocopier. Price: Up Coming.

Product: Toshiba e-Studio 2520AC Multifunction Digital Color Photocopier. Category: Toshiba. Subcategory: Photocopier. Price: Up Coming.
",248,395371,395619
1643,recursive,"
Product: Toshiba e-Studio 3528A Multifunction Digital Photocopier. Category: Toshiba. Subcategory: Photocopier. Price: Up Coming.

Product: Toshiba e-studio 4618a Multifunction Photocopier. Category: Toshiba. Subcategory: Photocopier. Price: Up Coming.
",254,395619,395873
1644,recursive,"
Product: Toshiba e-Studio 3025AC Multifunction Digital Color Photocopier. Category: Toshiba. Subcategory: Photocopier. Price: Up Coming.

Product: Toshiba e-Studio 5528A Multifunctional Monochrome Photocopier With RADF. Category: Toshiba. Subcategory: Photocopier. Price: Up Coming.
",284,395873,396157
1645,recursive,"
Product: Toshiba e-Studio 2323AM Multi-Function Duplex Copier. Category: Toshiba. Subcategory: Photocopier. Price: Out Of Stock.

Product: Toshiba e-Studio 2823AMW Multifunction Monochrome Photocopier. Category: Toshiba. Subcategory: Photocopier. Price: Out Of Stock.
",269,396157,396426
1646,recursive,"
Product: Toshiba e-Studio 6528A Duplex Photocopier Machine With RADF. Category: Toshiba. Subcategory: Photocopier. Price: Out Of Stock.

Product: GoDEX G500 Thermal Transfer Label Printer. Category: GoDEX. Subcategory: Label Printer. Price: 28,000৳29,000৳.
",258,396426,396684
1647,recursive,"
Product: GoDEX G530 Thermal Transfer Label Printer. Category: GoDEX. Subcategory: Label Printer. Price: 43,000৳.

Product: RICOH MP 2014 Multifunction Copier. Category: Photocopier. Price: 56,000৳60,500৳.
",206,396684,396890
1648,recursive,"
Product: Sharp AR-7024 Multifunctional Photocopier. Category: Photocopier. Price: 63,500৳67,000৳.

Product: HP LaserJet MFP M438dn Multifunction Mono Laser Printer. Category: Photocopier. Price: 74,000৳79,000৳.

Product: RICOH MP 2014D Multifunction Copier. Category: Photocopier. Price: 71,500৳.
",298,396890,397188
1649,recursive,"
Product: Canon ImageRUNNER 2224 A3 Monochrome Laser Multifunctional Photocopier. Category: Photocopier. Price: 90,000৳.

Product: Sharp BP-20M24L Digital Multifunction Photocopier. Category: Photocopier. Price: 95,000৳.
",221,397188,397409
1650,recursive,"
Product: Canon imageRUNNER Advance iR1643i Monochrome Laser Photocopier. Category: Photocopier. Price: 125,000৳130,000৳.

Product: Canon ImageRUNNER 2224N A3 Monochrome Laser Multifunctional Photocopier. Category: Photocopier. Price: 135,000৳.
",245,397409,397654
1651,recursive,"
Product: HP LaserJet MFP M443nda Multifunction Mono Laser Photocopier. Category: Photocopier. Price: 130,000৳.

Product: Canon imageRUNNER 2425 A3 Monochrome Laser Multifunctional Photocopier. Category: Photocopier. Price: 145,000৳.
",234,397654,397888
1652,recursive,"
Product: RICOH M 2701 Black and White Multifunctional Photocopier. Category: Photocopier. Price: 180,000৳190,000৳.

Product: HP LaserJet Pro MFP M438n Mono Laser Printer. Category: HP. Subcategory: Photocopier. Price: Up Coming.
",230,397888,398118
1653,recursive,"
Product: HP LaserJet MFP M438nda Multifunction Mono Laser Printer. Category: HP. Subcategory: Photocopier. Price: Up Coming.

Product: RICOH M2702 Black and White Multifunctional Photocopier. Category: Ricoh. Subcategory: Photocopier. Price: 230,000৳235,000৳.
",261,398118,398379
1654,recursive,"
Product: RICOH IM 2500 A3 Black and White Multifunction Printer. Category: Ricoh. Subcategory: Photocopier. Price: 245,000৳.

Product: Ricoh DX 2430 Color Digital Duplicator Photocopier. Category: Ricoh. Subcategory: Photocopier. Price: 280,000৳295,000৳.
",256,398379,398635
1655,recursive,"
Product: RICOH IM 5000 Black and White Multifunction Photocopier. Category: Ricoh. Subcategory: Photocopier. Price: 560,000৳565,000৳.

Product: RICOH IM 6000 Black and White Multifunction Photocopier. Category: Ricoh. Subcategory: Photocopier. Price: 740,000৳.
",262,398635,398897
1656,recursive,"
Product: RICOH MP 2555SP Multifunction Copier. Category: Ricoh. Subcategory: Photocopier. Price: Out Of Stock.

Product: RICOH M2700 Black and White Photocopier. Category: Ricoh. Subcategory: Photocopier. Price: Out Of Stock.
",227,398897,399124
1657,recursive,"
Product: RICOH MP 3055SP Black and White Multifunction Photocopier. Category: Ricoh. Subcategory: Photocopier. Price: Out Of Stock.

Product: RICOH IM 3000 A3 Black and White Multifunction Printer. Category: Ricoh. Subcategory: Photocopier. Price: Out Of Stock.
",263,399124,399387
1658,recursive,"
Product: RICOH M C2000 Full Colour Multifunction Photocopier. Category: Ricoh. Subcategory: Photocopier. Price: Out Of Stock.

Product: RICOH MP 4055SP Black and White Multifunction Photocopier. Category: Ricoh. Subcategory: Photocopier. Price: Out Of Stock.
",260,399387,399647
1659,recursive,"
Product: RICOH IM 4000 Black and White Multifunction Photocopier. Category: Ricoh. Subcategory: Photocopier. Price: Out Of Stock.

Product: RICOH MP 5055SP A3 Black and White Multifunction Photocopier. Category: Ricoh. Subcategory: Photocopier. Price: Out Of Stock.
",267,399647,399914
1660,recursive,"
Product: RICOH IM C2500 Color Laser Multifunction Photocopier. Category: Ricoh. Subcategory: Photocopier. Price: Out Of Stock.

Product: RICOH MP 6055SP A3 Black and White Multifunction Photocopier. Category: Ricoh. Subcategory: Photocopier. Price: Out Of Stock.
",264,399914,400178
1661,recursive,"
Product: Sharp BP-30M28 Digital Photocopier. Category: Sharp. Subcategory: Photocopier. Price: 220,000৳.

Product: Sharp BP-30M31 Digital Multifunction Photocopier. Category: Sharp. Subcategory: Photocopier. Price: 260,000৳.
",226,400178,400404
1662,recursive,"
Product: Sharp BP-30M35 Digital Multifunction Photocopier. Category: Sharp. Subcategory: Photocopier. Price: 355,000৳.

Product: Sharp BP-30C25 Digital Color Multifunctional Photocopier. Category: Sharp. Subcategory: Photocopier. Price: 360,000৳.
",248,400404,400652
1663,recursive,"
Product: Sharp BP-50M45 Multifunction Monochrome Photocopier. Category: Sharp. Subcategory: Photocopier. Price: 565,000৳.

Product: Sharp BP-50M55 Multifunction Monochrome Photocopier. Category: Sharp. Subcategory: Photocopier. Price: 620,000৳.
",246,400652,400898
1664,recursive,"
Product: Sharp MX-3561 A3 Multifunction Color Photocopier. Category: Sharp. Subcategory: Photocopier. Price: Up Coming.

Product: Sharp MX-B350Z Multifunctional Photocopier. Category: Sharp. Subcategory: Photocopier. Price: Up Coming.
",236,400898,401134
1665,recursive,"
Product: SHARP MX-M5050 DIGITAL PHOTOCOPIER WITH DUPLEX FEEDER. Category: Sharp. Subcategory: Photocopier. Price: Out Of Stock.

Product: Sharp MX M356NV Digital Photocopier. Category: Sharp. Subcategory: Photocopier. Price: Out Of Stock.
",240,401134,401374
1666,recursive,"
Product: Sharp AR 6031N Digital Photocopier with Duplex and Network. Category: Sharp. Subcategory: Photocopier. Price: Out Of Stock.

Product: Sharp MX-M315NV A3 Multifunctional Desktop Photocopier. Category: Sharp. Subcategory: Photocopier. Price: Out Of Stock.
",264,401374,401638
1667,recursive,"
Product: Sharp MX-M265NV A3 Multifunctional Desktop Photocopier. Category: Sharp. Subcategory: Photocopier. Price: Out Of Stock.

Product: SHARP AR-6020NV Multifunction Copier. Category: Sharp. Subcategory: Photocopier. Price: Out Of Stock.
",242,401638,401880
1668,recursive,"
Product: Sharp AR-7024D Multifunctional Duplex Photocopier. Category: Sharp. Subcategory: Photocopier. Price: Out Of Stock.

Product: Sharp DX-2000U A3 Color Digital Multifunction Photocopier. Category: Sharp. Subcategory: Photocopier. Price: Out Of Stock.
",258,401880,402138
1669,recursive,"
Product: Sharp BP-20C25 Color Digital Photocopier. Category: Sharp. Subcategory: Photocopier. Price: Out Of Stock.

Product: Sharp MX-M5051 Digital Multifunction Photocopier. Category: Sharp. Subcategory: Photocopier. Price: Out Of Stock.
",240,402138,402378
1670,recursive,"
Product: HP 17A Black Original LaserJet Toner Cartridge (For P102A, 130a). Category: HP. Subcategory: Toner. Price: 8,000৳.

Product: HP 103AD Dual Pack Black Original Neverstop Laser Toner Reload Kit. Category: HP. Subcategory: Toner. Price: 2,600৳2,700৳.
",258,402378,402636
1671,recursive,"
Product: HP 90A Black Original LaserJet Toner (For LJ M601N, D, DN, 602N, D, DN). Category: HP. Subcategory: Toner. Price: 23,000৳23,500৳.

Product: HP 304A Black Original LaserJet Toner Cartridge (Bundle With Full Set). Category: HP. Subcategory: Toner. Price: 5,500৳.
",271,402636,402907
1672,recursive,"
Product: HP 304A Cyan Original LaserJet Toner Cartridge (Bundle With Full Set). Category: HP. Subcategory: Toner. Price: 5,500৳.

Product: HP 304A Yellow Original LaserJet Toner Cartridge (Bundle With Full Set). Category: HP. Subcategory: Toner. Price: 5,500৳.
",262,402907,403169
1673,recursive,"
Product: HP 304A Magenta Original LaserJet Toner Cartridge (Bundle With Full Set). Category: HP. Subcategory: Toner. Price: 5,500৳.

Product: HP 335X High Yield Black Original LaserJet Toner Cartridge. Category: HP. Subcategory: Toner. Price: 6,200৳.
",252,403169,403421
1674,recursive,"
Product: HP 107A Black Original Laser Toner Cartridge. Category: HP. Subcategory: Toner. Price: 6,500৳.

Product: HP 215A Black LaserJet Toner (Bundle With Full Set). Category: HP. Subcategory: Toner. Price: 7,000৳.
",217,403421,403638
1675,recursive,"
Product: HP 166A Black Original Laser Toner Cartridge. Category: HP. Subcategory: Toner. Price: 6,500৳7,000৳.

Product: HP 136A Black Original LaserJet Toner. Category: HP. Subcategory: Toner. Price: 7,300৳.
",209,403638,403847
1676,recursive,"
Product: HP 215A Cyan LaserJet Toner (Bundle With Full Set). Category: HP. Subcategory: Toner. Price: 7,400৳.

Product: HP 215A Magenta LaserJet Toner (Bundle With Full Set). Category: HP. Subcategory: Toner. Price: 7,400৳.
",225,403847,404072
1677,recursive,"
Product: HP 215A Yellow LaserJet Toner (Bundle With Full Set). Category: HP. Subcategory: Toner. Price: 7,400৳.

Product: HP 56X Black Toner for M436N, DN, NDA Laserjet. Category: HP. Subcategory: Toner. Price: 7,500৳.
",220,404072,404292
1678,recursive,"
Product: HP 26A Black Original LaserJet Toner Cartridge (For M402DN). Category: HP. Subcategory: Toner. Price: 15,900৳.

Product: HP 87A Black Original LaserJet Toner (CF287A). Category: HP. Subcategory: Toner. Price: 31,000৳32,000৳.
",235,404292,404527
1679,recursive,"
Product: HP 128A-C Cyan Original LaserJet Toner Cartridge For CP 1525, M1415 Printer. Category: HP. Subcategory: Toner. Price: 4,000৳5,000৳.

Product: HP 44A Black Original Laser Toner Cartridge. Category: HP. Subcategory: Toner. Price: 7,200৳7,500৳.
",252,404527,404779
1680,recursive,"
Product: Canon imageRUNNER 2925i A3 Multifunctional Monochrome Laser Photocopier. Category: Canon. Subcategory: Photocopier. Price: 350,000৳.

Product: Canon imageRUNNER ADVANCE DX C3922i A3 Multifunctional Laser Photocopier. Category: Canon. Subcategory: Photocopier. Price: 485,000৳490,000৳.
",295,404779,405074
1681,recursive,"
Product: Canon imageRUNNER ADVANCE DX C3830i A3 Color Laser Multifunctional Photocopier. Category: Canon. Subcategory: Photocopier. Price: 550,000৳.

Product: Canon imageRUNNER ADVANCE DX C3926i A3 Multifunctional Laser Photocopier. Category: Canon. Subcategory: Photocopier. Price: 560,000৳.
",294,405074,405368
1682,recursive,"
Product: Canon imageRUNNER ADVANCE DX C3930i A3 Multifunctional Laser Photocopier. Category: Canon. Subcategory: Photocopier. Price: 595,000৳.

Product: Canon imageRUNNER ADVANCE DX C3935i A3 Multifunctional Laser Photocopier. Category: Canon. Subcategory: Photocopier. Price: 890,000৳.
",288,405368,405656
1683,recursive,"
Product: Canon imageRUNNER ADVANCE DX 6855i Multifunctional Photocopier. Category: Canon. Subcategory: Photocopier. Price: 1,050,000৳.

Product: Canon imageRUNNER ADVANCE DX 6860i A3 Multifunctional Monochrome Laser Photocopier. Category: Canon. Subcategory: Photocopier. Price: 1,350,000৳.
",292,405656,405948
1684,recursive,"
Product: Canon imageRUNNER ADVANCE DX C5840i A3 Color Laser Multifunctional Photocopier. Category: Canon. Subcategory: Photocopier. Price: 1,420,000৳.

Product: Canon imageRUNNER ADVANCE DX C5860i A3 Multifunction Laser Photocopier. Category: Canon. Subcategory: Photocopier. Price: 1,930,000৳.
",296,405948,406244
1685,recursive,"
Product: Canon imageRUNNER ADVANCE DX C5870i A3 Multifunction Color Laser Photocopier. Category: Canon. Subcategory: Photocopier. Price: 2,150,000৳.

Product: Canon imageRUNNER 2935i A3 Multifunctional Monochrome Laser Photocopier. Category: Canon. Subcategory: Photocopier. Price: Pre Order.
",294,406244,406538
1686,recursive,"
Product: Canon Metal Pedestal/Trolley Model-45/25. Category: Canon. Subcategory: Photocopier. Price: Out Of Stock.

Product: Canon iR 2006N Digital Copier. Category: Canon. Subcategory: Photocopier. Price: Out Of Stock.
",221,406538,406759
1687,recursive,"
Product: Canon imageRUNNER C3120 Color Multi functional Photocopier. Category: Canon. Subcategory: Photocopier. Price: Out Of Stock.

Product: Canon imageRUNNER Advance DX 4735i Monochrome Multi-Functional Laser Photocopier. Category: Canon. Subcategory: Photocopier. Price: Out Of Stock.
",290,406759,407049
1688,recursive,"
Product: FujiFilm Waste Toner Box for FujiFilm Laser Printer. Category: Fujifilm. Subcategory: Toner. Price: 3,000৳.

Product: Fujifilm CT203491 Cyan Original LaserJet Toner Cartridge. Category: Fujifilm. Subcategory: Toner. Price: 8,500৳.
",241,407049,407290
1689,recursive,"
Product: Fujifilm CT203492 Magenta Original LaserJet Toner Cartridge. Category: Fujifilm. Subcategory: Toner. Price: 8,500৳.

Product: Fujifilm CT203493 Yellow Original LaserJet Toner Cartridge. Category: Fujifilm. Subcategory: Toner. Price: 8,500৳.
",251,407290,407541
1690,recursive,"
Product: Fujifilm CT203490 Black Original LaserJet Toner Cartridge. Category: Fujifilm. Subcategory: Toner. Price: 8,500৳.

Product: Pantum TL-C2310H Black Toner. Category: Pantum. Subcategory: Toner. Price: 1,400৳.
",217,407541,407758
1691,recursive,"
Product: Pantum TL-2310H Black Toner for BP2300 Series. Category: Pantum. Subcategory: Toner. Price: 1,400৳.

Product: Pantum PC-216RB Refill Kit. Category: Pantum. Subcategory: Toner. Price: 1,300৳1,500৳.
",207,407758,407965
1692,recursive,"
Product: Pantum TN-411H Black Refill Kit. Category: Pantum. Subcategory: Toner. Price: 1,500৳.

Product: Pantum TN-411X Black Refill Kit. Category: Pantum. Subcategory: Toner. Price: 1,750৳.

Product: Pantum PC-211EV Toner. Category: Pantum. Subcategory: Toner. Price: 2,100৳.
",278,407965,408243
1693,recursive,"
Product: Pantum NT-C216B High-capacity Toner. Category: Pantum. Subcategory: Toner. Price: 2,350৳.

Product: Pantum TL-411H Black Toner. Category: Pantum. Subcategory: Toner. Price: 4,700৳.

Product: Pantum TL-5120 Black Toner. Category: Pantum. Subcategory: Toner. Price: 5,000৳.
",282,408243,408525
1694,recursive,"
Product: Pantum PC-310 Toner Black. Category: Pantum. Subcategory: Toner. Price: 5,500৳.

Product: Pantum TL-411X Black Toner. Category: Pantum. Subcategory: Toner. Price: 5,800৳.

Product: Pantum TL-425X High-capacity Toner Cartridge Black. Category: Pantum. Subcategory: Toner. Price: 5,900৳.
",296,408525,408821
1695,recursive,"
Product: Pantum DL-410 Drum Unit. Category: Pantum. Subcategory: Toner. Price: 6,000৳.

Product: Pantum CTL-1100M Magenta Color Toner (Bundle With Full Set). Category: Pantum. Subcategory: Toner. Price: 6,000৳.
",212,408821,409033
1696,recursive,"
Product: Pantum CTL-1100Y Yellow Color Toner (Bundle With Full Set). Category: Pantum. Subcategory: Toner. Price: 6,000৳.

Product: Pantum CTL-1100C Cyan Color Toner (Bundle With Full Set). Category: Pantum. Subcategory: Toner. Price: 6,000৳.
",244,409033,409277
1697,recursive,"
Product: Pantum PD-219 Toner Cartridge Black. Category: Pantum. Subcategory: Toner. Price: 4,500৳6,000৳.

Product: Pantum CTL-1100K Black Color Toner (Bundle With Full Set). Category: Pantum. Subcategory: Toner. Price: 5,700৳.
",228,409277,409505
1698,recursive,"
Product: Pantum TL-5130T Black Toner. Category: Pantum. Subcategory: Toner. Price: 7,000৳.

Product: Pantum TL-5130HT Black Toner. Category: Pantum. Subcategory: Toner. Price: 8,500৳.

Product: G&G CB435A/85A Black Universal Toner. Category: Toner. Price: 800৳.
",263,409505,409768
1699,recursive,"
Product: Print-Rite 80A / 505A LaserJet Toner. Category: Toner. Price: 850৳.

Product: True Trust 76A Black Toner Without Chip. Category: Toner. Price: 850৳.

Product: True Trust 79A Black Toner With Chip. Category: Toner. Price: 750৳.
",237,409768,410005
1700,recursive,"
Product: Starink 85A Black LaserJet Toner. Category: Toner. Price: 900৳.

Product: Starink 26A Black LaserJet Toner. Category: Toner. Price: 900৳.

Product: Print-Rite TN-630 Black LaserJet Toner. Category: Toner. Price: 900৳.
",228,410005,410233
1701,recursive,"
Product: Print-Rite 83A Black LaserJet Toner. Category: Toner. Price: 900৳.

Product: Power Print TN-107A Toner Without Chip. Category: Toner. Price: 880৳900৳.

Product: Starink 17A Black LaserJet Toner. Category: Toner. Price: 900৳.
",235,410233,410468
1702,recursive,"
Product: Starink 80A Black LaserJet Toner. Category: Toner. Price: 900৳.

Product: True Trust 26A Black Toner. Category: Toner. Price: 900৳.

Product: G&G W1107A Black Toner Without Chip. Category: Toner. Price: 900৳.
",219,410468,410687
1703,recursive,"
Product: Brother TN-B028 Black Toner Cartridge. Category: Brother. Subcategory: Toner. Price: 2,000৳.

Product: Brother TN-2305 Toner. Category: Brother. Subcategory: Toner. Price: Out Of Stock.

Product: Brother TN-273M Magenta Toner. Category: Brother. Subcategory: Toner. Price: 7,300৳.
",291,410687,410978
1704,recursive,"
Product: Brother TN-273C Cyan Toner. Category: Brother. Subcategory: Toner. Price: 7,300৳.

Product: Brother TN-273Y Yellow Toner. Category: Brother. Subcategory: Toner. Price: 7,300৳.

Product: Brother TN-2355 Toner. Category: Brother. Subcategory: Toner. Price: 7,600৳8,000৳.
",279,410978,411257
1705,recursive,"
Product: Brother TN-2455 Toner. Category: Brother. Subcategory: Toner. Price: 8,500৳.

Product: Brother TN-3607 Black Toner Cartridge. Category: Brother. Subcategory: Toner. Price: 8,200৳8,500৳.

Product: Brother TN-461 Black Toner. Category: Brother. Subcategory: Toner. Price: 8,600৳8,900৳.
",294,411257,411551
1706,recursive,"
Product: Brother TN-273BK Black Toner. Category: Brother. Subcategory: Toner. Price: 9,300৳.

Product: Brother TN-461 Cyan Toner. Category: Brother. Subcategory: Toner. Price: 9,600৳9,800৳.

Product: Brother TN-461 Magenta Toner. Category: Brother. Subcategory: Toner. Price: 9,600৳9,800৳.
",291,411551,411842
1707,recursive,"
Product: Brother TN-461 Yellow Toner. Category: Brother. Subcategory: Toner. Price: 9,600৳9,800৳.

Product: Brother TN-3487 Toner. Category: Brother. Subcategory: Toner. Price: Up Coming.

Product: Brother TN-2405 Toner. Category: Brother. Subcategory: Toner. Price: Out Of Stock.
",282,411842,412124
1708,recursive,"
Product: Brother TN-3417 Toner. Category: Brother. Subcategory: Toner. Price: Out Of Stock.

Product: Brother TN-3467 Toner. Category: Brother. Subcategory: Toner. Price: Out Of Stock.

Product: Brother TN-3607XXL Black Toner Cartridge. Category: Brother. Subcategory: Toner. Price: Out Of Stock.
",298,412124,412422
1709,recursive,"
Product: Brother TN-2280 Toner. Category: Brother. Subcategory: Toner. Price: Out Of Stock.

Product: Power Print TN-2331 Toner Black. Category: Power Print. Subcategory: Toner. Price: 1,000৳.

Product: Power Print TN-26 Toner. Category: Power Print. Subcategory: Toner. Price: 950৳1,000৳.
",291,412422,412713
1710,recursive,"
Product: Power Print TN-1035 Toner. Category: Power Print. Subcategory: Toner. Price: 900৳1,000৳.

Product: Power Print TN-166A Toner with Chip. Category: Power Print. Subcategory: Toner. Price: 1,000৳.
",204,412713,412917
1711,recursive,"
Product: Power Print TN-410 Black Toner Without Chip. Category: Power Print. Subcategory: Toner. Price: 1,000৳.

Product: Power Print TN-2345 Toner Black. Category: Power Print. Subcategory: Toner. Price: 1,200৳.
",214,412917,413131
1712,recursive,"
Product: Power Print TN-76A Black LaserJet Toner without Chip. Category: Power Print. Subcategory: Toner. Price: 1,200৳.

Product: Power Print TN-33/308 Toner Cartridge. Category: Power Print. Subcategory: Toner. Price: 1,200৳.
",229,413131,413360
1713,recursive,"
Product: Power Print TN-211EV Black Toner. Category: Power Print. Subcategory: Toner. Price: 1,250৳.

Product: Power Print TN-216 Black Toner With Chip. Category: Power Print. Subcategory: Toner. Price: 1,300৳.
",212,413360,413572
1714,recursive,"
Product: Power Print TN-107A Toner With Chip. Category: Power Print. Subcategory: Toner. Price: 1,400৳.

Product: Power Print TN-26X Black Toner. Category: Power Print. Subcategory: Toner. Price: 1,400৳.
",205,413572,413777
1715,recursive,"
Product: Power Print TN-136A Black Toner Without Chip. Category: Power Print. Subcategory: Toner. Price: 1,450৳.

Product: Power Print TN-87A Black LaserJet Toner. Category: Power Print. Subcategory: Toner. Price: 1,500৳.
",223,413777,414000
1716,recursive,"
Product: Power Print TN-3487 Toner With Chip. Category: Power Print. Subcategory: Toner. Price: 2,200৳.

Product: Power Print TN-5120 Black Toner. Category: Power Print. Subcategory: Toner. Price: 2,600৳.
",206,414000,414206
1717,recursive,"
Product: Power Print TN-76A Black LaserJet Toner with Chip. Category: Power Print. Subcategory: Toner. Price: 3,200৳.

Product: MaxGreen NPG-51 Black Toner Canon Photocopier. Category: Canon. Subcategory: Toner. Price: 1,600৳1,700৳.
",234,414206,414440
1718,recursive,"
Product: Prime Print CRG-071 Black Toner Cartridge. Category: Canon. Subcategory: Toner. Price: 1,800৳.

Product: Canon 325 Toner Cartridge for 6030 printer. Category: Canon. Subcategory: Toner. Price: 2,800৳.
",211,414440,414651
1719,recursive,"
Product: Canon NPG-59 Toner For Canon Photocopier (Black). Category: Canon. Subcategory: Toner. Price: 2,800৳.

Product: Canon NPG-51 Toner for Canon Photocopier (Black). Category: Canon. Subcategory: Toner. Price: 3,800৳.
",224,414651,414875
1720,recursive,"
Product: Canon 326 Toner For LBP 6200 Printer. Category: Canon. Subcategory: Toner. Price: 6,000৳.

Product: Canon NPG-57 Black Toner For Canon Photocopier. Category: Canon. Subcategory: Toner. Price: 6,800৳.
",210,414875,415085
1721,recursive,"
Product: Canon 071 Black Toner Cartridge. Category: Canon. Subcategory: Toner. Price: 7,000৳.

Product: Canon 337 Black Genuine Toner Cartridge. Category: Canon. Subcategory: Toner. Price: 7,700৳8,000৳.
",204,415085,415289
1722,recursive,"
Product: Canon 308 Toner for LBP-3300 Printer. Category: Canon. Subcategory: Toner. Price: 8,300৳9,000৳.

Product: Canon NPG-68 Toner For Photocopier (Black). Category: Canon. Subcategory: Toner. Price: 9,700৳.
",212,415289,415501
1723,recursive,"
Product: Canon EP-319 Toner (Black). Category: Canon. Subcategory: Toner. Price: 10,500৳.

Product: Canon NPG-84 Black Toner Cartridge. Category: Canon. Subcategory: Toner. Price: 10,500৳.

Product: Canon NPG-67 Black Toner Cartridge. Category: Canon. Subcategory: Toner. Price: 12,000৳.
",289,415501,415790
1724,recursive,"
Product: Canon NPG-68 Black Drum Unit. Category: Canon. Subcategory: Toner. Price: 13,000৳.

Product: Canon NPG-90 Black Toner. Category: Canon. Subcategory: Toner. Price: 13,200৳13,500৳.

Product: Canon 070 Black Original LaserJet Toner. Category: Canon. Subcategory: Toner. Price: 14,900৳.
",293,415790,416083
1725,recursive,"
Product: Canon T06 Toner for Photocopier (Black). Category: Canon. Subcategory: Toner. Price: 15,500৳.

Product: Canon NPG-67 Yellow Toner Cartridge. Category: Canon. Subcategory: Toner. Price: 16,000৳.
",204,416083,416287
1726,recursive,"
Product: Canon NPG-67 Cyan Toner Cartridge. Category: Canon. Subcategory: Toner. Price: 16,000৳.

Product: Toshiba T-2323C e-studio Compatible Toner (A-Grade). Category: Toshiba. Subcategory: Toner. Price: 3,800৳.
",215,416287,416502
1727,recursive,"
Product: Toshiba T-2309E E-Studio Toner. Category: Toshiba. Subcategory: Toner. Price: 4,000৳.

Product: Toshiba T-2323C e-studio Original Toner. Category: Toshiba. Subcategory: Toner. Price: 5,000৳.
",201,416502,416703
1728,recursive,"
Product: Toshiba T-3008C e-studio Original Toner. Category: Toshiba. Subcategory: Toner. Price: 7,500৳7,900৳.

Product: Toshiba T-3028C e-studio Original Toner Cartridge. Category: Toshiba. Subcategory: Toner. Price: 7,900৳.
",226,416703,416929
1729,recursive,"
Product: Toshiba T-5018C e-studio Original Toner. Category: Toshiba. Subcategory: Toner. Price: 8,000৳8,300৳.

Product: Toshiba T-3028p e-studio Original Toner Cartridge. Category: Toshiba. Subcategory: Toner. Price: Out Of Stock.
",232,416929,417161
1730,recursive,"
Product: Toshiba T-FC415C-K Black Original Toner (Bundle With Full Set). Category: Toshiba. Subcategory: Toner. Price: 10,500৳.

Product: Toshiba T-FC425C-K Black Original Toner (Bundle With Full Set). Category: Toshiba. Subcategory: Toner. Price: 11,700৳.
",258,417161,417419
1731,recursive,"
Product: Toshiba T-FC425C-C Cyan Original Toner (Bundle With Full Set). Category: Toshiba. Subcategory: Toner. Price: 11,700৳.

Product: Toshiba T-FC425C-M Magenta Original Toner (Bundle With Full Set). Category: Toshiba. Subcategory: Toner. Price: 11,700৳.
",259,417419,417678
1732,recursive,"
Product: Toshiba T-FC425C-Y Yellow Original Toner (Bundle With Full Set). Category: Toshiba. Subcategory: Toner. Price: 11,700৳.

Product: Toshiba T-FC415C-M Magenta Original Toner (Bundle With Full Set). Category: Toshiba. Subcategory: Toner. Price: 13,000৳.
",261,417678,417939
1733,recursive,"
Product: Toshiba T-FC415C-Y Yellow Toner (Bundle With Full Set). Category: Toshiba. Subcategory: Toner. Price: 13,000৳.

Product: Toshiba T-FC415C-C Cyan Original Toner (Bundle With Full Set). Category: Toshiba. Subcategory: Toner. Price: 13,000৳.
",249,417939,418188
1734,recursive,"
Product: Toshiba T-FC415C-YMCK e-studio Color Original Toner Full Set (4 pcs). Category: Toshiba. Subcategory: Toner. Price: 49,000৳.

Product: Toshiba T-2309C e-studio Toner. Category: Toshiba. Subcategory: Toner. Price: Out Of Stock.
",237,418188,418425
1735,recursive,"
Product: Toshiba T-2309P Black LaserJet Toner. Category: Toshiba. Subcategory: Toner. Price: Out Of Stock.

Product: Toshiba T-5018P Original Black Toner. Category: Toshiba. Subcategory: Toner. Price: Out Of Stock.
",216,418425,418641
1736,recursive,"
Product: True Trust 166A Black Laser Toner Cartridge. Category: True Trust. Subcategory: Toner. Price: 1,000৳.

Product: True Trust 107A Toner With Chip. Category: True Trust. Subcategory: Toner. Price: 1,250৳.
",212,418641,418853
1737,recursive,"
Product: True Trust 151A Black Toner Without Chip. Category: True Trust. Subcategory: Toner. Price: 1,300৳.

Product: True Trust 151A Toner with Chip for 4003DN/4003DW. Category: True Trust. Subcategory: Toner. Price: 3,500৳.
",227,418853,419080
1738,recursive,"
Product: Starink TN-630 Black Toner. Category: Starink. Subcategory: Toner. Price: 1,000৳.

Product: Starink 49A Black LaserJet Toner. Category: Starink. Subcategory: Toner. Price: 1,000৳.

Product: Starink 15A Black LaserJet Toner. Category: Starink. Subcategory: Toner. Price: 1,000৳.
",288,419080,419368
1739,recursive,"
Product: Starink 76A Black LaserJet Toner without Chip. Category: Starink. Subcategory: Toner. Price: 1,100৳.

Product: Starink 12A Black LaserJet Toner. Category: Starink. Subcategory: Toner. Price: 1,200৳.
",209,419368,419577
1740,recursive,"
Product: Starink 107A Black LaserJet Toner with Chip. Category: Starink. Subcategory: Toner. Price: 1,600৳.

Product: Starink 55A Black LaserJet Toner. Category: Starink. Subcategory: Toner. Price: 1,600৳.
",207,419577,419784
1741,recursive,"
Product: Starink 56A Black LaserJet Toner. Category: Starink. Subcategory: Toner. Price: 1,750৳.

Product: Starink 76A Black LaserJet Toner with Chip. Category: Starink. Subcategory: Toner. Price: 2,200৳.
",206,419784,419990
1742,recursive,"
Product: Starink 151A LaserJet Toner Without Chip. Category: Starink. Subcategory: Toner. Price: Up Coming.

Product: Starink 48A Black LaserJet Toner. Category: Starink. Subcategory: Toner. Price: Up Coming.
",210,419990,420200
1743,recursive,"
Product: Starink 107A Black LaserJet Toner Without Chip. Category: Starink. Subcategory: Toner. Price: Up Coming.

Product: Starink 87A Black LaserJet Toner. Category: Starink. Subcategory: Toner. Price: Up Coming.
",216,420200,420416
1744,recursive,"
Product: Sharp MX-237AT Toner. Category: Sharp. Subcategory: Toner. Price: 8,400৳.

Product: Sharp MX-61AT-BA Black Toner. Category: Sharp. Subcategory: Toner. Price: 11,000৳.

Product: Sharp BP-AT300 Black Original Toner. Category: Sharp. Subcategory: Toner. Price: 12,500৳.
",277,420416,420693
1745,recursive,"
Product: Sharp BP-AT200 Black Original Toner. Category: Sharp. Subcategory: Toner. Price: 9,500৳.

Product: Sharp MX-561AT Toner. Category: Sharp. Subcategory: Toner. Price: 14,500৳.

Product: Sharp MX-61AT-CA Cyan Toner. Category: Sharp. Subcategory: Toner. Price: 23,500৳.
",276,420693,420969
1746,recursive,"
Product: Sharp MX-61AT-MA Magenta Toner. Category: Sharp. Subcategory: Toner. Price: 23,500৳.

Product: Sharp MX-61AT-YA Yellow Toner. Category: Sharp. Subcategory: Toner. Price: 23,500৳.

Product: Sharp MX-238AT Toner. Category: Sharp. Subcategory: Toner. Price: Out Of Stock.
",279,420969,421248
1747,recursive,"
Product: Sharp MX-315AT Toner. Category: Sharp. Subcategory: Toner. Price: Out Of Stock.

Product: Sharp MX-B45AT Toner. Category: Sharp. Subcategory: Toner. Price: Out Of Stock.

Product: MaxGreen 76A Black LaserJet Toner. Category: MaxGreen. Subcategory: Toner. Price: 3,500৳4,800৳.
",286,421248,421534
1748,recursive,"
Product: MaxGreen 26A Black LaserJet Toner. Category: MaxGreen. Subcategory: Toner. Price: Up Coming.

Product: MaxGreen 79A Black LaserJet Toner. Category: MaxGreen. Subcategory: Toner. Price: Up Coming.
",206,421534,421740
1749,recursive,"
Product: MaxGreen NPG-59 Black Toner Canon Photocopier. Category: MaxGreen. Subcategory: Toner. Price: Out Of Stock.

Product: MaxGreen 85A Black LaserJet Toner. Category: MaxGreen. Subcategory: Toner. Price: Out Of Stock.
",224,421740,421964
1750,recursive,"
Product: MaxGreen 107A Black LaserJet Toner with Chip. Category: MaxGreen. Subcategory: Toner. Price: Out Of Stock.

Product: G&G CE505A Black Universal Toner. Category: G&G. Subcategory: Toner. Price: 950৳.
",209,421964,422173
1751,recursive,"
Product: G&G CF226A Black Universal Toner. Category: G&G. Subcategory: Toner. Price: 1,000৳.

Product: G&G TN-660 Black Universal Toner. Category: G&G. Subcategory: Toner. Price: 1,000৳.

Product: G&G PC-211EV Black Toner. Category: G&G. Subcategory: Toner. Price: 1,200৳.
",274,422173,422447
1752,recursive,"
Product: G&G CF276A Black Toner Without Chip. Category: G&G. Subcategory: Toner. Price: 1,200৳.

Product: G&G Q5949A Black Toner. Category: G&G. Subcategory: Toner. Price: 1,200৳.

Product: G&G TL-410H Black Toner. Category: G&G. Subcategory: Toner. Price: Out Of Stock.
",272,422447,422719
1753,recursive,"
Product: G&G W1510A Black Toner Without Chip. Category: G&G. Subcategory: Toner. Price: 1,400৳.

Product: G&G W1107A Black Toner With Chip. Category: G&G. Subcategory: Toner. Price: 1,400৳.

Product: G&G TL-410X Black Toner. Category: G&G. Subcategory: Toner. Price: 1,650৳.
",276,422719,422995
1754,recursive,"
Product: G&G TL-425X Black Toner. Category: G&G. Subcategory: Toner. Price: 1,700৳.

Product: G&G TL-5120H Black Toner. Category: G&G. Subcategory: Toner. Price: 2,600৳.

Product: G&G DL-410 Black Toner. Category: G&G. Subcategory: Toner. Price: 3,000৳.
",255,422995,423250
1755,recursive,"
Product: G&G DL-425 Black Toner. Category: G&G. Subcategory: Toner. Price: 3,000৳.

Product: G&G TL-5120X Black Toner. Category: G&G. Subcategory: Toner. Price: 3,400৳.

Product: G&G CTL-1100HK Black Toner. Category: G&G. Subcategory: Toner. Price: 3,500৳.
",258,423250,423508
1756,recursive,"
Product: G&G CTL-1100HC Cyan Toner. Category: G&G. Subcategory: Toner. Price: 3,500৳.

Product: G&G CTL-1100HM Magenta Toner. Category: G&G. Subcategory: Toner. Price: 3,600৳.

Product: SafeWay 85A Compatible Toner (Black). Category: SafeWay. Subcategory: Toner. Price: 950৳.
",277,423508,423785
1757,recursive,"
Product: SafeWay 05A Compatible Toner (Black). Category: SafeWay. Subcategory: Toner. Price: 950৳1,000৳.

Product: Safeway 76A Black Toner With Chip. Category: SafeWay. Subcategory: Toner. Price: 3,000৳.
",205,423785,423990
1758,recursive,"
Product: SafeWay 49A Universal Compatible Black Toner. Category: SafeWay. Subcategory: Toner. Price: Up Coming.

Product: SafeWay 279/ 79A Compatible Toner (Black). Category: SafeWay. Subcategory: Toner. Price: Up Coming.
",223,423990,424213
1759,recursive,"
Product: SafeWay 48A Compatible Toner (Black). Category: SafeWay. Subcategory: Toner. Price: Up Coming.

Product: SafeWay 26A Compatible Toner (Black). Category: SafeWay. Subcategory: Toner. Price: Out Of Stock.
",213,424213,424426
1760,recursive,"
Product: Print-Rite 26A Black LaserJet Toner. Category: Print-Rite. Subcategory: Toner. Price: Up Coming.

Product: Print-Rite 12A Black LaserJet Toner. Category: Print-Rite. Subcategory: Toner. Price: Out Of Stock.
",217,424426,424643
1761,recursive,"
Product: Print-Rite 85A / 35A / 36A / 78A / 88A LaserJet Toner. Category: Print-Rite. Subcategory: Toner. Price: Out Of Stock.

Product: Print-Rite 79A Black LaserJet Toner. Category: Print-Rite. Subcategory: Toner. Price: Out Of Stock.
",238,424643,424881
1762,recursive,"
Product: Print-Rite 76A / 58A  Black LaserJet Toner. Category: Print-Rite. Subcategory: Toner. Price: Out Of Stock.

Product: Print-Rite 850 / 3471 LaserJet Toner. Category: Print-Rite. Subcategory: Toner. Price: Out Of Stock.
",228,424881,425109
1763,recursive,"
Product: LongPrint 30A Black Toner Cartridge. Category: LongPrint. Subcategory: Toner. Price: 1,600৳.

Product: LongPrint 136A Black Toner Without Chip. Category: LongPrint. Subcategory: Toner. Price: 1,700৳.
",210,425109,425319
1764,recursive,"
Product: LongPrint 151A Toner Without Chip. Category: LongPrint. Subcategory: Toner. Price: 2,500৳.

Product: LongPrint 136A Black Toner With Chip. Category: LongPrint. Subcategory: Toner. Price: 2,700৳.
",205,425319,425524
1765,recursive,"
Product: LongPrint 151A Toner With Chip. Category: LongPrint. Subcategory: Toner. Price: Out Of Stock.

Product: Samsung MLT-D203L Toner. Category: Samsung. Subcategory: Toner. Price: 5,000৳7,000৳.

Product: Samsung MLT-D115L Toner. Category: Samsung. Subcategory: Toner. Price: 5,000৳7,000৳.
",294,425524,425818
1766,recursive,"
Product: HP 680 Tri-color Original Ink Advantage Cartridge. Category: Cartridge. Price: 1,200৳.

Product: Brother LC3717C Cyan Ink Cartridge. Category: Cartridge. Price: 1,150৳.

Product: Brother LC3717Y Yellow Ink Cartridge. Category: Cartridge. Price: 1,150৳.
",263,425818,426081
1767,recursive,"
Product: HP 680 Original Black Ink Advantage Cartridge. Category: Cartridge. Price: Sold Out.

Product: HP 682 Tri-Color Original Ink Advantage Cartridge. Category: Cartridge. Price: 1,250৳.

Product: HP 682 Black Original Ink Advantage Cartridge. Category: Cartridge. Price: 1,300৳.
",285,426081,426366
1768,recursive,"
Product: HP 305 Black Original Ink Cartridge. Category: Cartridge. Price: 1,650৳.

Product: HP 305 Tri-color Original Ink Cartridge. Category: Cartridge. Price: 1,650৳.

Product: HP 67 Black Original Ink Cartridge. Category: Cartridge. Price: 2,000৳.
",252,426366,426618
1769,recursive,"
Product: HP 67 Tri-color Original Ink Cartridge. Category: Cartridge. Price: 2,000৳.

Product: Brother LC3719XL-C Cyan Ink Cartridge. Category: Cartridge. Price: 2,350৳.

Product: Brother LC3719XL-M Magenta Ink Cartridge. Category: Cartridge. Price: 2,350৳.
",259,426618,426877
1770,recursive,"
Product: Brother LC3719XL-Y Yellow Ink Cartridge. Category: Cartridge. Price: 2,350৳.

Product: Brother LC472XL Cyan Ink Cartridge (Bundle With Full Set). Category: Cartridge. Price: 2,400৳.

Product: Brother LC472XL Yellow Ink Cartridge (Bundle With Full Set). Category: Cartridge. Price: 2,400৳.
",299,426877,427176
1771,recursive,"
Product: Brother LC472XL Magenta Ink Cartridge (Bundle With Full Set). Category: Cartridge. Price: 2,400৳.

Product: Brother LC3719XL-BK Black Ink Cartridge. Category: Cartridge. Price: 3,100৳.
",195,427176,427371
1772,recursive,"
Product: Brother LC472XLBK Black Ink Cartridge (Bundle With Full Set). Category: Cartridge. Price: 3,100৳.

Product: Canon PG-810XL Black Ink Cartridge. Category: Cartridge. Price: 3,500৳.

Product: Canon CL-811 XL Color Cartridge. Category: Cartridge. Price: 3,500৳3,800৳.
",275,427371,427646
1773,recursive,"
Product: Canon 067 Color Laser Toner (Full Set). Category: Canon. Subcategory: Cartridge. Price: 33,000৳.

Product: Canon BCI-24 Twin Pack Black Cartridge. Category: Canon. Subcategory: Cartridge. Price: Out Of Stock.
",219,427646,427865
1774,recursive,"
Product: Canon BCI-15 Black Ink Cartridge. Category: Canon. Subcategory: Cartridge. Price: Out Of Stock.

Product: Canon 751 Cyan Cartridge. Category: Canon. Subcategory: Cartridge. Price: Out Of Stock.
",204,427865,428069
1775,recursive,"
Product: Canon 751 Magenta Cartridge. Category: Canon. Subcategory: Cartridge. Price: Out Of Stock.

Product: Canon 751 Yellow Cartridge. Category: Canon. Subcategory: Cartridge. Price: Out Of Stock.
",201,428069,428270
1776,recursive,"
Product: Canon 751BK Black Cartridge. Category: Canon. Subcategory: Cartridge. Price: Out Of Stock.

Product: Canon 302 Black Cartridge. Category: Canon. Subcategory: Cartridge. Price: Out Of Stock.

Product: Canon 302 Cyan Cartridge. Category: Canon. Subcategory: Cartridge. Price: Out Of Stock.
",298,428270,428568
1777,recursive,"
Product: Canon 302 Yellow Cartridge. Category: Canon. Subcategory: Cartridge. Price: Out Of Stock.

Product: Canon 302 Magenta Cartridge. Category: Canon. Subcategory: Cartridge. Price: Out Of Stock.
",201,428568,428769
1778,recursive,"
Product: Epson T372 Tri-Color Photo Ink Cartridge. Category: Epson. Subcategory: Cartridge. Price: Out Of Stock.

Product: Brother LC3717M Magenta Ink Cartridge. Category: Brother. Subcategory: Cartridge. Price: Up Coming.
",224,428769,428993
1779,recursive,"
Product: Brother LC3717BK Black Ink Cartridge. Category: Brother. Subcategory: Cartridge. Price: Up Coming.

Product: Brother LC675XL Yellow Original Ink Cartridge. Category: Brother. Subcategory: Cartridge. Price: Up Coming.
",227,428993,429220
1780,recursive,"
Product: Brother LC675XL Cyan Original Ink Cartridge. Category: Brother. Subcategory: Cartridge. Price: Out Of Stock.

Product: Brother LC675XL Magenta Original Ink Cartridge. Category: Brother. Subcategory: Cartridge. Price: Out Of Stock.
",241,429220,429461
1781,recursive,"
Product: Brother LC679XL Black Original Ink Cartridge. Category: Brother. Subcategory: Cartridge. Price: Out Of Stock.

Product: RICOH MP 3554S Black Print Toner Cartridge. Category: Ricoh. Subcategory: Toner. Price: 7,500৳.
",226,429461,429687
1782,recursive,"
Product: RICOH MP 2500S Black Print Toner Cartridge. Category: Ricoh. Subcategory: Toner. Price: 8,000৳.

Product: RICOH MP 2500S Cyan Print Toner Cartridge. Category: Ricoh. Subcategory: Toner. Price: 16,500৳.
",212,429687,429899
1783,recursive,"
Product: RICOH MP 2500S Yellow Print Toner Cartridge. Category: Ricoh. Subcategory: Toner. Price: 16,500৳.

Product: RICOH MP 2500S Magenta Print Toner Cartridge. Category: Ricoh. Subcategory: Toner. Price: 16,500৳.
",217,429899,430116
1784,recursive,"
Product: Ricoh MP 2014HS Black Copier Toner. Category: Ricoh. Subcategory: Toner. Price: Up Coming.

Product: RICOH MP 6054S Black Print Toner Cartridge. Category: Ricoh. Subcategory: Toner. Price: Out Of Stock.

Product: HP GT53 90-ml Black Original Ink Bottle. Category: Ink Bottle. Price: 950৳.
",299,430116,430415
1785,recursive,"
Product: HP GT52 Cyan Original Ink Bottle. Category: Ink Bottle. Price: 1,000৳1,050৳.

Product: HP GT52 Magenta Original Ink Bottle. Category: Ink Bottle. Price: 1,000৳1,050৳.

Product: HP GT52 Yellow Original Ink Bottle. Category: Ink Bottle. Price: 1,000৳1,050৳.
",266,430415,430681
1786,recursive,"
Product: Canon GI-790 Ink Bottle Black. Category: Ink Bottle. Price: 1,100৳.

Product: Canon GI-790 Ink Bottle Cyan. Category: Ink Bottle. Price: 1,100৳.

Product: Canon GI-790 Ink Bottle Magenta. Category: Ink Bottle. Price: 1,100৳.
",235,430681,430916
1787,recursive,"
Product: Canon GI-790 Ink Bottle Yellow. Category: Ink Bottle. Price: 1,100৳.

Product: Brother BTD100C Cyan Ink Bottle. Category: Ink Bottle. Price: 1,100৳.

Product: HP 45 Black Original Ink Cartridge (51645AA). Category: HP. Subcategory: Cartridge. Price: 5,000৳5,700৳.
",274,430916,431190
1788,recursive,"
Product: HP 938 Color Cartridge (Full Set). Category: HP. Subcategory: Cartridge. Price: 16,000৳.

Product: HP 933XL High Yield Magenta Original Ink Cartridge. Category: HP. Subcategory: Cartridge. Price: Out Of Stock.
",220,431190,431410
1789,recursive,"
Product: HP 933XL High Yield Cyan Original Ink Cartridge. Category: HP. Subcategory: Cartridge. Price: Out Of Stock.

Product: HP 63 Original Ink Black Cartridge. Category: HP. Subcategory: Cartridge. Price: Out Of Stock.
",223,431410,431633
1790,recursive,"
Product: HP 63 Tri-color Original Ink Cartridge. Category: HP. Subcategory: Cartridge. Price: Out Of Stock.

Product: HP 678 Tri-color Original Ink Advantage Cartridge. Category: HP. Subcategory: Cartridge. Price: Out Of Stock.
",229,431633,431862
1791,recursive,"
Product: HP 678 Black Original Ink Advantage Cartridge. Category: HP. Subcategory: Cartridge. Price: Out Of Stock.

Product: HP 932 Officejet Black Ink Cartridge. Category: HP. Subcategory: Cartridge. Price: Out Of Stock.
",223,431862,432085
1792,recursive,"
Product: HP 61 Tri-color Original Ink Cartridge. Category: HP. Subcategory: Cartridge. Price: Out Of Stock.

Product: HP 933XL High Yield Yellow Original Ink Cartridge. Category: HP. Subcategory: Cartridge. Price: Out Of Stock.
",229,432085,432314
1793,recursive,"
Product: HP 61 Black Original Ink Cartridge. Category: HP. Subcategory: Cartridge. Price: Out Of Stock.

Product: Brother BTD100M Magenta Ink Bottle. Category: Brother. Subcategory: Ink Bottle. Price: 1,100৳.
",210,432314,432524
1794,recursive,"
Product: Brother BTD100Y Yellow Ink Bottle. Category: Brother. Subcategory: Ink Bottle. Price: 1,100৳.

Product: Brother BT5000C Cyan Ink Bottle. Category: Brother. Subcategory: Ink Bottle. Price: 1,200৳.
",206,432524,432730
1795,recursive,"
Product: Brother BT5000Y Yellow Ink Bottle. Category: Brother. Subcategory: Ink Bottle. Price: 1,200৳.

Product: Brother BT5000M Megenta Ink Bottle. Category: Brother. Subcategory: Ink Bottle. Price: 1,200৳.
",209,432730,432939
1796,recursive,"
Product: Brother BTD60BK Black Ink Bottle. Category: Brother. Subcategory: Ink Bottle. Price: 1,150৳.

Product: Brother BTD100BK Black Ink Bottle. Category: Brother. Subcategory: Ink Bottle. Price: 1,300৳.
",207,432939,433146
1797,recursive,"
Product: Brother BT6000BK Black Ink Bottle. Category: Brother. Subcategory: Ink Bottle. Price: Out Of Stock.

Product: HP GT53XL 135-ml Black Ink Bottle. Category: HP. Subcategory: Ink Bottle. Price: Out Of Stock.
",215,433146,433361
1798,recursive,"
Product: Epson C13-T6732 Cyan Ink Bottle. Category: Epson. Subcategory: Ink Bottle. Price: 1,200৳.

Product: Epson C13-T6734 Yellow Ink Bottle. Category: Epson. Subcategory: Ink Bottle. Price: 1,200৳.
",202,433361,433563
1799,recursive,"
Product: Epson C13T6735 Light Cyan Ink Bottle. Category: Epson. Subcategory: Ink Bottle. Price: 1,200৳.

Product: Epson C13T6731 Black Ink Bottle. Category: Epson. Subcategory: Ink Bottle. Price: 1,200৳.
",205,433563,433768
1800,recursive,"
Product: Epson C13T6733 Magenta Ink Bottle. Category: Epson. Subcategory: Ink Bottle. Price: 1,200৳.

Product: Epson C13T6736 Light Magenta Ink Bottle. Category: Epson. Subcategory: Ink Bottle. Price: 1,200৳.
",210,433768,433978
1801,recursive,"
Product: Epson 005 Black Ink Bottle. Category: Epson. Subcategory: Ink Bottle. Price: 1,350৳.

Product: Epson 057 Black Ink Bottle. Category: Epson. Subcategory: Ink Bottle. Price: 1,250৳.

Product: Epson 057 Ink Cyan Bottle. Category: Epson. Subcategory: Ink Bottle. Price: 1,300৳1,350৳.
",290,433978,434268
1802,recursive,"
Product: Epson Perfection V39 II Photo and Document Flatbed Scanner. Category: Epson. Subcategory: Scanner. Price: 8,350৳9,000৳.

Product: Epson WorkForce ES-60W Wireless Portable Sheetfed Document Scanner. Category: Epson. Subcategory: Scanner. Price: 31,500৳32,000৳.
",270,434268,434538
1803,recursive,"
Product: Epson WorkForce DS-310 Portable Sheet-fed Document Scanner. Category: Epson. Subcategory: Scanner. Price: 37,500৳.

Product: Epson DS-1630 Flatbed and Sheet Fed Color Legal Document Scanner with ADF. Category: Epson. Subcategory: Scanner. Price: 39,000৳40,000৳.
",272,434538,434810
1804,recursive,"
Product: Epson DS-530 II Color Duplex Document Scanner. Category: Epson. Subcategory: Scanner. Price: 64,800৳65,000৳.

Product: Epson DS-870 Color Duplex Document Scanner. Category: Epson. Subcategory: Scanner. Price: 71,500৳.
",228,434810,435038
1805,recursive,"
Product: Epson DS-770II Color Duplex Document Scanner. Category: Epson. Subcategory: Scanner. Price: 74,500৳.

Product: Epson WorkForce DS-50000 A3 Flatbed Document Scanner. Category: Epson. Subcategory: Scanner. Price: 173,000৳182,000৳.
",239,435038,435277
1806,recursive,"
Product: Epson Perfection V850 Pro Color A4 Flatbed Film and Photo Scanner. Category: Epson. Subcategory: Scanner. Price: 185,000৳.

Product: Epson WorkForce DS-60000 A3 Flatbed Document Scanner with Duplex ADF. Category: Epson. Subcategory: Scanner. Price: 360,000৳365,000৳.
",277,435277,435554
1807,recursive,"
Product: Epson WorkForce DS-30 Portable Sheet-fed Document Scanner. Category: Epson. Subcategory: Scanner. Price: Up Coming.

Product: Epson WorkForce DS-970 A4 Duplex Sheet-fed Document Scanner. Category: Epson. Subcategory: Scanner. Price: Up Coming.
",254,435554,435808
1808,recursive,"
Product: Epson Perfection V800 Photo Flatbed Color Scanner (Part#B11B223201). Category: Epson. Subcategory: Scanner. Price: Out Of Stock.

Product: Epson WorkForce DS-860 Color Document Scanner. Category: Epson. Subcategory: Scanner. Price: Out Of Stock.
",256,435808,436064
1809,recursive,"
Product: Epson DS-530 Color Duplex Document Scanner. Category: Epson. Subcategory: Scanner. Price: Out Of Stock.

Product: Canon CanoScan LiDE 300 Flatbed Scanner. Category: Canon. Subcategory: Scanner. Price: 7,800৳8,200৳.
",225,436064,436289
1810,recursive,"
Product: Canon CanoScan LiDE 400 Scanner. Category: Canon. Subcategory: Scanner. Price: 10,800৳11,000৳.

Product: Canon DR-C240 Document Scanner. Category: Canon. Subcategory: Scanner. Price: 64,700৳65,000৳.
",209,436289,436498
1811,recursive,"
Product: Canon imageFORMULA CR-120 Cheque Scanner. Category: Canon. Subcategory: Scanner. Price: 112,000৳115,000৳.

Product: Canon GI-71 M Magenta Ink Bottle. Category: Canon. Subcategory: Ink Bottle. Price: 1,250৳.
",217,436498,436715
1812,recursive,"
Product: Canon GI-71 PGBK Black Ink Bottle. Category: Canon. Subcategory: Ink Bottle. Price: 1,300৳.

Product: Canon GI-71 C Cyan Ink Bottle. Category: Canon. Subcategory: Ink Bottle. Price: 1,250৳.
",200,436715,436915
1813,recursive,"
Product: Canon GI-71 Y Yellow Ink Bottle. Category: Canon. Subcategory: Ink Bottle. Price: 1,250৳.

Product: Canon PFI-050 Black Ink Bottle. Category: Canon. Subcategory: Ink Bottle. Price: 5,000৳.

Product: Canon PFI-050 Cyan Ink Bottle. Category: Canon. Subcategory: Ink Bottle. Price: 5,000৳.
",297,436915,437212
1814,recursive,"
Product: Canon PFI-050 Magenta Ink Bottle. Category: Canon. Subcategory: Ink Bottle. Price: 5,000৳.

Product: Canon PFI-050 Yellow Ink Bottle. Category: Canon. Subcategory: Ink Bottle. Price: 5,000৳.
",201,437212,437413
1815,recursive,"
Product: Plustek OpticSlim 2610 Plus Flatbed A4 Document Scanner. Category: Plustek. Subcategory: Scanner. Price: 6,300৳6,500৳.

Product: Plustek ePhoto Z300 Photo and Document Scanner. Category: Plustek. Subcategory: Scanner. Price: 15,800৳.
",244,437413,437657
1816,recursive,"
Product: Plustek OpticSlim 1680 Flatbed A3 Document Scanner. Category: Plustek. Subcategory: Scanner. Price: 35,600৳36,000৳.

Product: Plustek SmartOffice PL3060 A4 ADF Flatbed Scanner. Category: Plustek. Subcategory: Scanner. Price: 36,500৳37,500৳.
",251,437657,437908
1817,recursive,"
Product: Plustek MobileOffice S410 Plus Portable Scanner. Category: Plustek. Subcategory: Scanner. Price: Up Coming.

Product: Plustek SmartOffice PL4080 Flatbed Document Scanner. Category: Plustek. Subcategory: Scanner. Price: Up Coming.
",240,437908,438148
1818,recursive,"
Product: Plustek OpticSlim 2700 A4 Color Flatbed Scanner. Category: Plustek. Subcategory: Scanner. Price: Out Of Stock.

Product: Plustek SmartOffice PS188 High Speed Document Scanner. Category: Plustek. Subcategory: Scanner. Price: Out Of Stock.
",248,438148,438396
1819,recursive,"
Product: Plustek OpticSlim 1180 A3 Flatbed Scanner. Category: Plustek. Subcategory: Scanner. Price: Out Of Stock.

Product: Plustek SmartOffice PN30U Color Scanner. Category: Plustek. Subcategory: Scanner. Price: Out Of Stock.
",228,438396,438624
1820,recursive,"
Product: HP ScanJet Pro 2600 f1 Scanner with ADF. Category: HP. Subcategory: Scanner. Price: 30,500৳31,000৳.

Product: HP ScanJet Pro 2000 s2 Sheet-feed Scanner. Category: HP. Subcategory: Scanner. Price: 45,500৳48,000৳.
",222,438624,438846
1821,recursive,"
Product: HP ScanJet Pro 3000 s4 Sheet-feed Scanner. Category: HP. Subcategory: Scanner. Price: 69,500৳70,000৳.

Product: HP Scanjet Enterprise Flow 7000 s3 Sheet-Feed Scanner. Category: HP. Subcategory: Scanner. Price: 90,000৳95,000৳.
",236,438846,439082
1822,recursive,"
Product: HP ScanJet Pro N4600 fnw1 Wireless Network Scanner. Category: HP. Subcategory: Scanner. Price: 114,000৳115,000৳.

Product: HP Digital Sender Flow 8500 fn2 Document Capture Workstation. Category: HP. Subcategory: Scanner. Price: 415,000৳420,000৳.
",256,439082,439338
1823,recursive,"
Product: HP ScanJet Pro 3500 f1 Flatbed Scanner. Category: HP. Subcategory: Scanner. Price: Out Of Stock.

Product: HP ScanJet Pro 3600 f1 Flatbed Scanner. Category: HP. Subcategory: Scanner. Price: Out Of Stock.
",214,439338,439552
1824,recursive,"
Product: HP ScanJet Pro 4500 fn1 Network Scanner. Category: HP. Subcategory: Scanner. Price: Out Of Stock.

Product: HP Scanjet Enterprise Flow 7500 Flatbed Scanner. Category: HP. Subcategory: Scanner. Price: Out Of Stock.
",224,439552,439776
1825,recursive,"
Product: Avision FB10 A4 4800dpi Slim Flatbed Scanner. Category: Scanner. Price: 8,200৳8,500৳.

Product: Brother ADS-3100 Desktop Document Scanner. Category: Scanner. Price: 49,000৳.

Product: Brother ADS-4700W Desktop Document Scanner. Category: Scanner. Price: 65,000৳.
",273,439776,440049
1826,recursive,"
Product: Fujitsu FI-7460 Image Scanner. Category: Fujitsu. Subcategory: Scanner. Price: Call for Price.

Product: Fujitsu FI-8170 Image Scanner. Category: Fujitsu. Subcategory: Scanner. Price: Call for Price.
",210,440049,440259
1827,recursive,"
Product: Fujitsu FI-8150 Image Scanner. Category: Fujitsu. Subcategory: Scanner. Price: Call for Price.

Product: Fujitsu FI-7300NX Image Scanner. Category: Fujitsu. Subcategory: Scanner. Price: Call for Price.
",212,440259,440471
1828,recursive,"
Product: Fujitsu FI-65f Image Scanner. Category: Fujitsu. Subcategory: Scanner. Price: Call for Price.

Product: Fujitsu FI-800r Image Scanner. Category: Fujitsu. Subcategory: Scanner. Price: Call for Price.
",209,440471,440680
1829,recursive,"
Product: Fujitsu SP-1120N Image Scanner. Category: Fujitsu. Subcategory: Scanner. Price: Call for Price.

Product: Fujitsu SP-1125N Image Scanner. Category: Fujitsu. Subcategory: Scanner. Price: Call for Price.
",212,440680,440892
1830,recursive,"
Product: Kodak E1030 Document Scanner. Category: Kodak. Subcategory: Scanner. Price: Pre Order.

Product: Kodak E1040 Document Scanner. Category: Kodak. Subcategory: Scanner. Price: Pre Order.

Product: Kodak i3500 Document Scanner. Category: Kodak. Subcategory: Scanner. Price: Pre Order.
",291,440892,441183
1831,recursive,"
Product: Kodak S2070 Document Scanner. Category: Kodak. Subcategory: Scanner. Price: Pre Order.

Product: Kodak S3140 Max Document Scanner. Category: Kodak. Subcategory: Scanner. Price: Pre Order.

Product: Kodak S3120 Max Document Scanner. Category: Kodak. Subcategory: Scanner. Price: Pre Order.
",299,441183,441482
1832,recursive,"
Product: AVISION MiWand 2 Wi-Fi Pro Portable Scanner. Category: Avision. Subcategory: Scanner. Price: Up Coming.

Product: Avision AV332U Sheet fed ADF Scanner. Category: Avision. Subcategory: Scanner. Price: Up Coming.
",221,441482,441703
1833,recursive,"
Product: AVISION AD130 Document Scanner. Category: Avision. Subcategory: Scanner. Price: Up Coming.

Product: AVISION FB5000 A3 Flatbed Scanner. Category: Avision. Subcategory: Scanner. Price: Up Coming.
",205,441703,441908
1834,recursive,"
Product: AVISION AD345FWN Document Scanner. Category: Avision. Subcategory: Scanner. Price: Up Coming.

Product: Avision FB25 Slim Flatbed Scanner. Category: Avision. Subcategory: Scanner. Price: Out Of Stock.
",211,441908,442119
1835,recursive,"
Product: AVISION AD120S Document Scanner. Category: Avision. Subcategory: Scanner. Price: Out Of Stock.

Product: AVISION AD120 Document Scanner. Category: Avision. Subcategory: Scanner. Price: Out Of Stock.
",209,442119,442328
1836,recursive,"
Product: Avision AD340GWN A4 Sheet fed ADF Scanner. Category: Avision. Subcategory: Scanner. Price: Out Of Stock.

Product: AVISION FB6280E A3 Flatbed Book Scanner. Category: Avision. Subcategory: Scanner. Price: Out Of Stock.
",228,442328,442556
1837,recursive,"
Product: Avision AD250F Flatbed with ADF Scanner. Category: Avision. Subcategory: Scanner. Price: Out Of Stock.

Product: Avision AD360GWN A4 Sheet fed ADF Scanner. Category: Avision. Subcategory: Scanner. Price: Out Of Stock.
",228,442556,442784
1838,recursive,"
Product: AVISION AV5400 A3 Duplex Document Scanner. Category: Avision. Subcategory: Scanner. Price: Out Of Stock.

Product: Avision AD5800 A3 Document Scanner. Category: Avision. Subcategory: Scanner. Price: Out Of Stock.
",223,442784,443007
1839,recursive,"
Product: AVISION AD6090 A3 Duplex High-Volume Production Scanner. Category: Avision. Subcategory: Scanner. Price: Out Of Stock.

Product: Brother ADS-2800W Wired and Wireless Duplex Desktop Sheet-fed Scanner with ADF. Category: Brother. Subcategory: Scanner. Price: Out Of Stock.
",281,443007,443288
1840,recursive,"
Product: Brother ADS-1200 Auto Document Scanner. Category: Brother. Subcategory: Scanner. Price: Out Of Stock.

Product: Brother ADS-2200 Professional Document Scanner. Category: Brother. Subcategory: Scanner. Price: Out Of Stock.
",232,443288,443520
1841,recursive,"
Product: Brother ADS-4300N Professional Desktop Document Scanner. Category: Brother. Subcategory: Scanner. Price: Out Of Stock.

Product: Brother ADS-3000N Desktop Document Scanner. Category: Brother. Subcategory: Scanner. Price: Out Of Stock.
",245,443520,443765
1842,recursive,"
Product: Brother ADS-3600W Desktop Document Scanner. Category: Brother. Subcategory: Scanner. Price: Out Of Stock.

Product: Brother ADS-4900W Desktop Document Scanner. Category: Brother. Subcategory: Scanner. Price: Out Of Stock.
",232,443765,443997
1843,recursive,"
Product: Zebex Z-3250 Handy Wireless CCD Scanner. Category: ZEBEX. Subcategory: Barcode Scanner. Price: Out Of Stock.

Product: Zebex Z-3220 Barcode Scanner. Category: ZEBEX. Subcategory: Barcode Scanner. Price: Out Of Stock.
",227,443997,444224
1844,recursive,"
Product: Zebex Z-3100 Barcode Scanner. Category: ZEBEX. Subcategory: Barcode Scanner. Price: Out Of Stock.

Product: Zebex Z-3151HS High-Speed Laser Handheld Scanner. Category: ZEBEX. Subcategory: Barcode Scanner. Price: Out Of Stock.
",236,444224,444460
1845,recursive,"
Product: Zebex Z-3272 2D Image Gun Type Handheld Scanner. Category: ZEBEX. Subcategory: Barcode Scanner. Price: Out Of Stock.

Product: Winson WNL-1051 1D Wired Handheld Barcode Scanner. Category: Barcode Scanner. Price: 2,100৳2,250৳.
",236,444460,444696
1846,recursive,"
Product: Sunlux XL-6500 1D Handheld Barcode Scanner. Category: Barcode Scanner. Price: 2,200৳2,400৳.

Product: Yumite YT-100 Barcode Scanner. Category: Barcode Scanner. Price: 2,350৳2,500৳.

Product: Sunlux RH10S 1D/2D Barcode Scanner. Category: Barcode Scanner. Price: 2,750৳2,850৳.
",285,444696,444981
1847,recursive,"
Product: Winson WNL-5000g 1D Wired Laser Warehouses Handheld Barcode Scanner. Category: Barcode Scanner. Price: 2,600৳3,000৳.

Product: Sunlux XL-3206 2D Wired Barcode Scanner. Category: Barcode Scanner. Price: 2,300৳3,000৳.
",226,444981,445207
1848,recursive,"
Product: Deli ES226 Barcode Scanner. Category: Barcode Scanner. Price: 3,300৳.

Product: Sunlux XL-3600 1D/2D Handheld Barcode Scanner. Category: Barcode Scanner. Price: 3,100৳3,400৳.
",185,445207,445392
1849,recursive,"
Product: Sunlux XL-9010 1D/2D Portable Bluetooth Wireless Barcode Scanner. Category: Barcode Scanner. Price: 3,200৳3,500৳.

Product: Deli ES226W Barcode Scanner. Category: Barcode Scanner. Price: 3,800৳.

Product: Deli ES236 Barcode Scanner. Category: Barcode Scanner. Price: 3,800৳.
",285,445392,445677
1850,recursive,"
Product: Deli E14952 Handheld Barcode Scanner. Category: Barcode Scanner. Price: 3,700৳4,000৳.

Product: Sunlux XL-9309B Laser Wireless Barcode Scanner. Category: Barcode Scanner. Price: 4,200৳4,500৳.
",202,445677,445879
1851,recursive,"
Product: Winson WNI-6710g 2D CMOS Wired Handheld Barcode Scanner. Category: Barcode Scanner. Price: Out Of Stock.

Product: Sunlux XL-3620S 1D/2D Handheld Barcode Scanner. Category: Barcode Scanner. Price: 4,200৳4,700৳.
",221,445879,446100
1852,recursive,"
Product: Yumite YT-200 1D Wireless Barcode Scanner. Category: Barcode Scanner. Price: 4,750৳5,000৳.

Product: Yumite YT-1000 Barcode Scanner. Category: Barcode Scanner. Price: 4,800৳5,000৳.
",191,446100,446291
1853,recursive,"
Product: Winson WNI-S682 2D CMOS Handheld Wireless Barcode Scanner. Category: Barcode Scanner. Price: 4,200৳5,000৳.

Product: Sunlux XL-9221B 2D Wireless Barcode Scanner. Category: Barcode Scanner. Price: 5,000৳.
",214,446291,446505
1854,recursive,"
Product: Deli 14952W Barcode Scanner. Category: Deli. Subcategory: Barcode Scanner. Price: Up Coming.

Product: Deli E14884 Stand Barcode Scanner. Category: Deli. Subcategory: Barcode Scanner. Price: Up Coming.
",212,446505,446717
1855,recursive,"
Product: Winson WNI-7330DPM 2D Handheld Barcode Scanner. Category: Winson. Subcategory: Barcode Scanner. Price: 5,300৳5,800৳.

Product: Winson WNI-6213/V 2D COMS Wireless RF433 Handheld Barcode Scanner. Category: Winson. Subcategory: Barcode Scanner. Price: 5,500৳7,000৳.
",273,446717,446990
1856,recursive,"
Product: Winson WAI-5780 2D CMOS Omnidirectional Barcode Scanner. Category: Winson. Subcategory: Barcode Scanner. Price: 7,600৳10,800৳.

Product: Winson WAI-6000 1D & 2D Omnidirectional Barcode Scanner. Category: Winson. Subcategory: Barcode Scanner. Price: 8,700৳12,000৳.
",274,446990,447264
1857,recursive,"
Product: Winson WAI-7000 1D & 2D Omnidirectional Desktop Barcode Scanner. Category: Winson. Subcategory: Barcode Scanner. Price: 14,000৳15,000৳.

Product: Winson WNI-6802/V 2D CMOS Handheld Wireless Barcode Scanner. Category: Winson. Subcategory: Barcode Scanner. Price: Out Of Stock.
",286,447264,447550
1858,recursive,"
Product: Yumite YT-2202 1D/2D Wireless Barcode Scanner. Category: Yumite. Subcategory: Barcode Scanner. Price: 7,200৳8,000৳.

Product: Yumite YT-2402 2D Wireless Barcode Scanner. Category: Yumite. Subcategory: Barcode Scanner. Price: 7,800৳8,000৳.
",249,447550,447799
1859,recursive,"
Product: Yumite YT-2203 1D/2D Wireless Barcode Scanner. Category: Yumite. Subcategory: Barcode Scanner. Price: Out Of Stock.

Product: Zebra SYMBOL LS2208 GENERAL PURPOSE BARCODE SCANNER. Category: Zebra. Subcategory: Barcode Scanner. Price: 7,900৳8,300৳.
",257,447799,448056
1860,recursive,"
Product: Zebra DS2208 Corded 1D/2D Handheld Image Barcode Scanner. Category: Zebra. Subcategory: Barcode Scanner. Price: 10,000৳.

Product: Zebra Symbol DS4208 Image Barcode Scanner. Category: Zebra. Subcategory: Barcode Scanner. Price: 13,500৳14,500৳.
",254,448056,448310
1861,recursive,"
Product: Zebra Symbol DS4308 2D Barcode Scanner. Category: Zebra. Subcategory: Barcode Scanner. Price: 14,200৳14,500৳.

Product: Zebra Symbol DS9308 1D-2D-QR USB Barcode Scanner. Category: Zebra. Subcategory: Barcode Scanner. Price: 14,700৳15,500৳.
",250,448310,448560
1862,recursive,"
Product: Zebra Symbol DS9808-R General Purpose 1D/2D Barcode Scanner. Category: Zebra. Subcategory: Barcode Scanner. Price: 23,000৳23,500৳.

Product: Zebra DS2278 Cordless Handheld 2D Barcode Scanner. Category: Zebra. Subcategory: Barcode Scanner. Price: 27,000৳28,000৳.
",272,448560,448832
1863,recursive,"
Product: Zebra Symbol DS6878-SR Cordless Bluetooth 2D Barcode Scanner. Category: Zebra. Subcategory: Barcode Scanner. Price: 42,800৳44,000৳.

Product: Zebra DS4608 Handheld 2D Barcode Scanner. Category: Zebra. Subcategory: Barcode Scanner. Price: 17,000৳.
",257,448832,449089
1864,recursive,"
Product: Zebra Symbol LS1203 GENERAL PURPOSE BARCODE SCANNER. Category: Zebra. Subcategory: Barcode Scanner. Price: Out Of Stock.

Product: Zebra Symbol DS9208 Barcode Scanner. Category: Zebra. Subcategory: Barcode Scanner. Price: Out Of Stock.
",246,449089,449335
1865,recursive,"
Product: Honeywell Eclipse 5145 (1D) Handheld Barcode Scanner. Category: Honeywell. Subcategory: Barcode Scanner. Price: 6,700৳7,500৳.

Product: Honeywell Voyager 1250g General Duty Scanner. Category: Honeywell. Subcategory: Barcode Scanner. Price: 7,500৳9,000৳.
",264,449335,449599
1866,recursive,"
Product: Honeywell Voyager 9520 General Duty Scanners. Category: Honeywell. Subcategory: Barcode Scanner. Price: 11,000৳11,500৳.

Product: Honeywell Voyager MK-9540 Handheld Barcode Scanner. Category: Honeywell. Subcategory: Barcode Scanner. Price: 11,500৳.
",259,449599,449858
1867,recursive,"
Product: Honeywell 1400G 2D Barcode Scanner. Category: Honeywell. Subcategory: Barcode Scanner. Price: 11,500৳12,000৳.

Product: Honeywell Voyager 1950GSR USB Barcode Scanner. Category: Honeywell. Subcategory: Barcode Scanner. Price: 15,000৳.
",244,449858,450102
1868,recursive,"
Product: Honeywell Voyager XP 1470g Barcode Scanner. Category: Honeywell. Subcategory: Barcode Scanner. Price: 16,000৳.

Product: Honeywell Xenon MS 1900 2D Barcode Scanner. Category: Honeywell. Subcategory: Barcode Scanner. Price: 16,000৳16,500৳.
",249,450102,450351
1869,recursive,"
Product: Honeywell Voyager 1202g-bf barcode scanner. Category: Honeywell. Subcategory: Barcode Scanner. Price: 20,000৳22,000৳.

Product: Honeywell Xenon 1902 Wireless Barcode Scanner. Category: Honeywell. Subcategory: Barcode Scanner. Price: 31,000৳.
",252,450351,450603
1870,recursive,"
Product: ZKTeco ZKB202S Wireless Barcode Scanner. Category: ZKTeco. Subcategory: Barcode Scanner. Price: 6,435৳.

Product: ZKTeco ZKB201S Barcode Scanner. Category: ZKTeco. Subcategory: Barcode Scanner. Price: Up Coming.
",222,450603,450825
1871,recursive,"
Product: ZKTeco ZKB102S Barcode Scanner. Category: ZKTeco. Subcategory: Barcode Scanner. Price: Up Coming.

Product: Grandstream GRP2601 2-Line 2-SIP Carrier-Grade IP Phone with Adapter. Category: Grandstream. Subcategory: IP Phone. Price: 4,000৳4,200৳.
",255,450825,451080
1872,recursive,"
Product: Grandstream GRP2601P IP Phone With POE & Without Adapter. Category: Grandstream. Subcategory: IP Phone. Price: 4,100৳4,300৳.

Product: Grandstream GXP1610P IP Phone With PoE. Category: Grandstream. Subcategory: IP Phone. Price: 4,300৳.
",246,451080,451326
1873,recursive,"
Product: Grandstream GRP2601P Basic HD IP Phone With Adapter. Category: Grandstream. Subcategory: IP Phone. Price: 4,500৳.

Product: Grandstream GRP2602P IP Phone With POE & Without Adapter. Category: Grandstream. Subcategory: IP Phone. Price: 4,950৳5,100৳.
",259,451326,451585
1874,recursive,"
Product: Grandstream GRP2602 2-Line 4-SIP Carrier Grade IP Phone with Adapter. Category: Grandstream. Subcategory: IP Phone. Price: 5,100৳.

Product: Grandstream GRP2602P Basic HD IP Phone With Adapter. Category: Grandstream. Subcategory: IP Phone. Price: 5,100৳5,500৳.
",271,451585,451856
1875,recursive,"
Product: Grandstream GRP2601W Wi-Fi Essential HD IP Phone. Category: Grandstream. Subcategory: IP Phone. Price: 5,700৳.

Product: Grandstream GXV3450 16-Line 16-SIP PoE IP Phone. Category: Grandstream. Subcategory: IP Phone. Price: 33,000৳.
",242,451856,452098
1876,recursive,"
Product: Grandstream GRP2602G 2-Line 4-SIP PoE IP Phone without Adapter. Category: Grandstream. Subcategory: IP Phone. Price: 6,300৳.

Product: Grandstream GHP611W Wireless Hotel IP Phone with Adapter. Category: Grandstream. Subcategory: IP Phone. Price: 6,700৳.
",264,452098,452362
1877,recursive,"
Product: Grandstream GRP2604 3-Line 6-SIP Carrier Grade IP Phone with Adapter. Category: Grandstream. Subcategory: IP Phone. Price: 7,500৳.

Product: Grandstream GRP2604P 3-Line 6-SIP Carrier Grade IP Phone With POE. Category: Grandstream. Subcategory: IP Phone. Price: 8,100৳.
",279,452362,452641
1878,recursive,"
Product: Grandstream GHP621W Wireless Hotel IP Phone. Category: Grandstream. Subcategory: IP Phone. Price: 8,400৳.

Product: Grandstream GRP2612P HD IP Phone. Category: Grandstream. Subcategory: IP Phone. Price: 8,200৳.
",221,452641,452862
1879,recursive,"
Product: Grandstream GRP2602W WiFi 2-Line 4-SIP Carrier Grade IP Phone. Category: Grandstream. Subcategory: IP Phone. Price: 8,500৳.

Product: Grandstream GRP2613 HD IP Phone. Category: Grandstream. Subcategory: IP Phone. Price: 9,500৳.
",238,452862,453100
1880,recursive,"
Product: Grandstream GXP2135 Enterprise IP Phone. Category: Grandstream. Subcategory: IP Phone. Price: 10,800৳11,300৳.

Product: Grandstream GXP2130 Mid Range HD IP Phone. Category: Grandstream. Subcategory: IP Phone. Price: 11,300৳.
",235,453100,453335
1881,recursive,"
Product: Grandstream GRP2612W HD IP Phone. Category: Grandstream. Subcategory: IP Phone. Price: 11,500৳12,000৳.

Product: Sunlux XL-9600 Laser Wireless Barcode Scanner. Category: Sunlux. Subcategory: Barcode Scanner. Price: 5,500৳6,000৳.
",239,453335,453574
1882,recursive,"
Product: Sunlux RD10 2D Desktop Barcode Scanner. Category: Sunlux. Subcategory: Barcode Scanner. Price: 5,000৳6,200৳.

Product: Sunlux XL-2610 Desktop Barcode Scanner. Category: Sunlux. Subcategory: Barcode Scanner. Price: 8,000৳8,300৳.
",238,453574,453812
1883,recursive,"
Product: Sunlux XL-3610 1D/2D Handheld Barcode Scanner. Category: Sunlux. Subcategory: Barcode Scanner. Price: Up Coming.

Product: Sunlux XL-2600 Desktop Barcode Scanner. Category: Sunlux. Subcategory: Barcode Scanner. Price: Up Coming.
",239,453812,454051
1884,recursive,"
Product: Sunlux XL-2302 Desktop Barcode Scanner. Category: Sunlux. Subcategory: Barcode Scanner. Price: Up Coming.

Product: Sunlux XL-9620C 2D Wireless Handheld Barcode Scanner With Stand. Category: Sunlux. Subcategory: Barcode Scanner. Price: Out Of Stock.
",260,454051,454311
1885,recursive,"
Product: Cisco CP-3905 Unified IP Phone. Category: Cisco. Subcategory: IP Phone. Price: Out Of Stock.

Product: Cisco 6821 IP Phone for MPP Systems. Category: Cisco. Subcategory: IP Phone. Price: Out Of Stock.
",211,454311,454522
1886,recursive,"
Product: Cisco 8811 IP Phone with Multiplatform Phone Firmware. Category: Cisco. Subcategory: IP Phone. Price: Out Of Stock.

Product: Cisco 7821 IP Phone with Multiplatform Phone firmware. Category: Cisco. Subcategory: IP Phone. Price: Out Of Stock.
",252,454522,454774
1887,recursive,"
Product: Cisco 8845 IP Phone with Camera. Category: Cisco. Subcategory: IP Phone. Price: Out Of Stock.

Product: Flyingvoice P10 2 SIP IP Phone. Category: IP Phone. Price: 3,800৳4,000৳.

Product: Flyingvoice P10P 2 SIP PoE IP Phone. Category: IP Phone. Price: 3,800৳4,000৳.
",275,454774,455049
1888,recursive,"
Product: Snom D305 PoE Desk IP Phone Set. Category: IP Phone. Price: 4,300৳.

Product: DINSTAR C62UP Color Screen IP Phone with POE & Without Adapter. Category: IP Phone. Price: 4,800৳.

Product: Flyingvoice FIP11CP 3 SIP PoE IP Phone. Category: IP Phone. Price: 5,000৳.
",272,455049,455321
1889,recursive,"
Product: Flyingvoice P11P 2 SIP PoE IP Phone. Category: IP Phone. Price: 5,000৳5,200৳.

Product: Flyingvoice P11W 2 SIP Wireless IP Phone. Category: IP Phone. Price: 5,300৳5,500৳.

Product: DINSTAR C60U-W Wi-Fi IP Phone with POE & Without Adapter. Category: IP Phone. Price: 5,700৳.
",284,455321,455605
1890,recursive,"
Product: DINSTAR C63GP Color Screen IP Phone with POE & Without Adapter. Category: IP Phone. Price: 6,000৳.

Product: DINSTAR C63GP Color Screen IP Phone with POE & With Adapter. Category: IP Phone. Price: 6,500৳.
",215,455605,455820
1891,recursive,"
Product: Avaya J129 3PCC IP Phone. Category: Avaya. Subcategory: IP Phone. Price: Out Of Stock.

Product: Avaya J139 3PCC IP Phone. Category: Avaya. Subcategory: IP Phone. Price: Out Of Stock.
",194,455820,456014
1892,recursive,"
Product: SEWOO NBS-7250 1D Barcode Scanner. Category: SEWOO. Subcategory: Barcode Scanner. Price: 5,600৳7,500৳.

Product: SEWOO NBS-8580 2D Bluetooth Barcode Scanner. Category: SEWOO. Subcategory: Barcode Scanner. Price: Out Of Stock.
",236,456014,456250
1893,recursive,"
Product: SEWOO NBS-8202 2D Barcode Scanner. Category: SEWOO. Subcategory: Barcode Scanner. Price: 13,000৳.

Product: DINSTAR C64GP High-end Business IP Phone with POE & Without Adapter. Category: DINSTAR. Subcategory: IP Phone. Price: 8,500৳.
",244,456250,456494
1894,recursive,"
Product: DINSTAR C66GP High-end Business SIP Phone with POE & Without Adapter. Category: DINSTAR. Subcategory: IP Phone. Price: 9,500৳.

Product: DINSTAR C66GP High-end Business SIP Phone with POE & With Adapter. Category: DINSTAR. Subcategory: IP Phone. Price: 9,800৳.
",271,456494,456765
1895,recursive,"
Product: DINSTAR A810 Android Video IP Phone. Category: DINSTAR. Subcategory: IP Phone. Price: 50,000৳.

Product: DINSTAR C60SP Entry Level IP Phone with POE & Without Adapter. Category: DINSTAR. Subcategory: IP Phone. Price: Up Coming.
",238,456765,457003
1896,recursive,"
Product: DINSTAR C60SP Entry Level IP Phone with POE & With Adapter. Category: DINSTAR. Subcategory: IP Phone. Price: Up Coming.

Product: DINSTAR C64GP High-end Business IP Phone with POE & With Adapter. Category: DINSTAR. Subcategory: IP Phone. Price: Out Of Stock.
",269,457003,457272
1897,recursive,"
Product: DINSTAR C62UP Color Screen IP Phone with POE & With Adapter. Category: DINSTAR. Subcategory: IP Phone. Price: Out Of Stock.

Product: DINSTAR C60UP Entry Level IP Phone with POE & Without Adapter. Category: DINSTAR. Subcategory: IP Phone. Price: Out Of Stock.
",270,457272,457542
1898,recursive,"
Product: DINSTAR C61SP Entry Level IP Phone with POE & Without Adapter. Category: DINSTAR. Subcategory: IP Phone. Price: Out Of Stock.

Product: DINSTAR C60UP Entry Level IP Phone with POE & With Adapter. Category: DINSTAR. Subcategory: IP Phone. Price: Out Of Stock.
",269,457542,457811
1899,recursive,"
Product: DINSTAR C61SP Entry Level IP Phone with POE & With Adapter. Category: DINSTAR. Subcategory: IP Phone. Price: Out Of Stock.

Product: Mitel MiVoice Office 470 Basic IPABX System for 20 User. Category: Mitel. Subcategory: PABX System. Price: 125,000৳.
",260,457811,458071
1900,recursive,"
Product: Mitel MiVoice Office 470 Basic IPABX System for 50 User. Category: Mitel. Subcategory: PABX System. Price: 250,000৳.

Product: Mitel MiVoice Office 470 Basic IPABX System for 100 User. Category: Mitel. Subcategory: PABX System. Price: 450,000৳.
",255,458071,458326
1901,recursive,"
Product: Mitel MiVoice Office 470 Basic IPABX System for 150 User. Category: Mitel. Subcategory: PABX System. Price: 650,000৳.

Product: Mitel MiVoice Office 470 Basic IPABX System for 200 User. Category: Mitel. Subcategory: PABX System. Price: 850,000৳.
",256,458326,458582
1902,recursive,"
Product: Snom D717 PoE Desk IP Phone Set. Category: Snom. Subcategory: IP Phone. Price: 9,500৳.

Product: Snom D345 PoE Desk IP Phone Set. Category: Snom. Subcategory: IP Phone. Price: 13,500৳.
",195,458582,458777
1903,recursive,"
Product: Snom M55 Cordless IP Phone with Cradle. Category: Snom. Subcategory: IP Phone. Price: Up Coming.

Product: Snom M30 Cordless IP Phone with Cradle. Category: Snom. Subcategory: IP Phone. Price: Up Coming.
",214,458777,458991
1904,recursive,"
Product: Snom C520 3-SIP PoE Conference IP Phone. Category: Snom. Subcategory: IP Phone. Price: Up Coming.

Product: Snom D3 Extension Module for SNOM D3xx Series. Category: Snom. Subcategory: IP Phone. Price: Up Coming.
",222,458991,459213
1905,recursive,"
Product: Snom D335 PoE Desk IP Phone Set. Category: Snom. Subcategory: IP Phone. Price: 14,000৳.

Product: Snom D862 PoE Desk IP Phone Set. Category: Snom. Subcategory: IP Phone. Price: 22,000৳.
",196,459213,459409
1906,recursive,"
Product: Mitel 6867i SIP Phone (80C00002AAA-A). Category: Mitel. Subcategory: IP Phone. Price: Call for Price.

Product: Mitel 6863i SIP Phone (80C00005AAA-A). Category: Mitel. Subcategory: IP Phone. Price: Out Of Stock.
",222,459409,459631
1907,recursive,"
Product: Mitel 6873i SIP Phone (50006790). Category: Mitel. Subcategory: IP Phone. Price: Out Of Stock.

Product: Flyingvoice FIP14G 8 SIP PoE IP Phone. Category: Flyingvoice. Subcategory: IP Phone. Price: 8,500৳8,900৳.
",221,459631,459852
1908,recursive,"
Product: Flyingvoice FIP15G Plus 10 SIP PoE Touch Screen IP Phone. Category: Flyingvoice. Subcategory: IP Phone. Price: Up Coming.

Product: Flyingvoice FIP16Plus Portable Wireless IP Phone. Category: Flyingvoice. Subcategory: IP Phone. Price: Up Coming.
",256,459852,460108
1909,recursive,"
Product: Flyingvoice P10G 2 SIP Gigabit PoE IP Phone. Category: Flyingvoice. Subcategory: IP Phone. Price: Up Coming.

Product: Flyingvoice P10W 2 SIP Dual Band IP Phone. Category: Flyingvoice. Subcategory: IP Phone. Price: Up Coming.
",236,460108,460344
1910,recursive,"
Product: Flyingvoice P11 2 SIP IP Phone. Category: Flyingvoice. Subcategory: IP Phone. Price: Up Coming.

Product: Flyingvoice P11G 2 SIP Gigabit PoE IP Phone. Category: Flyingvoice. Subcategory: IP Phone. Price: Up Coming.
",225,460344,460569
1911,recursive,"
Product: Flyingvoice P23GW 8 SIP Gigabit IP Phone. Category: Flyingvoice. Subcategory: IP Phone. Price: Up Coming.

Product: Flyingvoice FIP11C 3 SIP IP Phone. Category: Flyingvoice. Subcategory: IP Phone. Price: Up Coming.
",225,460569,460794
1912,recursive,"
Product: Flyingvoice FIP13G 4 SIP PoE IP Phone. Category: Flyingvoice. Subcategory: IP Phone. Price: Up Coming.

Product: DINSTAR UC100-1S1O VoIP PBX for SME. Category: PABX System. Price: 19,000৳.

Product: DINSTAR UC200 Pro IP PBX System. Category: PABX System. Price: 24,000৳.
",281,460794,461075
1913,recursive,"
Product: DINSTAR UC120-1S1O VoIP PBX. Category: PABX System. Price: 25,000৳.

Product: Grandstream GCC6010W Wireless WiFi 6 IP PBX System. Category: PABX System. Price: 40,000৳.

Product: Grandstream UCM6301 500 User IP PBX VoIP Supply. Category: PABX System. Price: 42,000৳.
",277,461075,461352
1914,recursive,"
Product: Grandstream GXW4224 Analog 24 FXS Port VoIP Gateway. Category: PABX System. Price: 68,000৳.

Product: Grandstream UCM6302 IP-PBX Phone System. Category: PABX System. Price: 72,000৳.

Product: Grandstream GXW4232 32 FXS Port VoIP Gateway. Category: PABX System. Price: 78,000৳.
",287,461352,461639
1915,recursive,"
Product: DINSTAR UC350-100 High-end IP PBX. Category: PABX System. Price: 110,000৳.

Product: Grandstream UCM6510 IP PBX VoIP Supply. Category: PABX System. Price: 150,000৳.

Product: Panasonic KX-TDA100D Hybrid IP-PBX System. Category: PABX System. Price: 160,000৳.
",268,461639,461907
1916,recursive,"
Product: DINSTAR UC350-200 High-end IP PBX. Category: PABX System. Price: 175,000৳.

Product: Grandstream HA100 IP PABX Server. Category: PABX System. Price: Pre Order.

Product: Zycoo CooVox T200 IP PBX System Without Module. Category: PABX System. Price: Up Coming.
",269,461907,462176
1917,recursive,"
Product: Zycoo CooVox T100-S IP PBX System. Category: PABX System. Price: Up Coming.

Product: Zycoo CooVox T100-A202 IP PBX System. Category: Zycoo. Subcategory: PABX System. Price: Up Coming.
",195,462176,462371
1918,recursive,"
Product: Grandstream UCM6204 IP PBX VoIP Supply. Category: Grandstream. Subcategory: PABX System. Price: Out Of Stock.

Product: Grandstream UCM6202 IP PBX VoIP Supply. Category: Grandstream. Subcategory: PABX System. Price: Out Of Stock.
",240,462371,462611
1919,recursive,"
Product: Grandstream UCM6208 IP PBX VoIP Supply. Category: Grandstream. Subcategory: PABX System. Price: Out Of Stock.

Product: Kington KT-168 Multi-Currency Detection Machine. Category: Kington. Subcategory: Money Counting Machine. Price: 7,000৳7,800৳.
",256,462611,462867
1920,recursive,"
Product: Kington Plus AL 6600W Premium Money Counting Machine. Category: Kington. Subcategory: Money Counting Machine. Price: 14,500৳.

Product: Kington Plus 7200T Pro Max Money Counting Machine. Category: Kington. Subcategory: Money Counting Machine. Price: 13,500৳15,000৳.
",276,462867,463143
1921,recursive,"
Product: Kington Plus 6600T Pro Max Money Counting Machine. Category: Kington. Subcategory: Money Counting Machine. Price: 15,500৳.

Product: Kington Plus AL-6900T Pro Max Money Counting Machine. Category: Kington. Subcategory: Money Counting Machine. Price: 17,000৳18,000৳.
",276,463143,463419
1922,recursive,"
Product: Kington Plus AL 6700T Pro Max Money Counting Machine. Category: Kington. Subcategory: Money Counting Machine. Price: 18,000৳20,000৳.

Product: Kington JB-2000S Money Counting Machine. Category: Kington. Subcategory: Money Counting Machine. Price: 108,000৳118,000৳.
",275,463419,463694
1923,recursive,"
Product: Kington NC-3000 Money Counting Machine. Category: Kington. Subcategory: Money Counting Machine. Price: Up Coming.

Product: Kington KT-900 Money Counting Machine. Category: Kington. Subcategory: Money Counting Machine. Price: Out Of Stock.
",250,463694,463944
1924,recursive,"
Product: APOLLO AP-800S Money Counting Machine. Category: Apollo. Subcategory: Money Counting Machine. Price: Out Of Stock.

Product: Domens DMS-1580T Automatic Money Counter Machine. Category: Domens. Subcategory: Money Counting Machine. Price: Up Coming.
",258,463944,464202
1925,recursive,"
Product: Domens DMS-1380T Automatic Money Counter Machine. Category: Domens. Subcategory: Money Counting Machine. Price: Up Coming.

Product: Domens DMS-1180T Automatic Money Counter Machine. Category: Domens. Subcategory: Money Counting Machine. Price: Up Coming.
",266,464202,464468
1926,recursive,"
Product: Domens DMS-1080T Automatic Money Counter Machine. Category: Domens. Subcategory: Money Counting Machine. Price: Up Coming.

Product: Domens DMS-9200 Automatic Money Counter Machine. Category: Domens. Subcategory: Money Counting Machine. Price: Out Of Stock.
",268,464468,464736
1927,recursive,"
Product: Chihua CH-600A Money Counting Machine. Category: Chihua. Subcategory: Money Counting Machine. Price: 215,000৳239,500৳.

Product: Yumite 5800UD Money Counter Machine. Category: Yumite. Subcategory: Money Counting Machine. Price: 13,500৳.
",247,464736,464983
1928,recursive,"
Product: Yumite MCM-650 Money Counter Machine. Category: Yumite. Subcategory: Money Counting Machine. Price: 135,000৳.

Product: Yumite VE-870 Vacuum Money Counter Machine. Category: Yumite. Subcategory: Money Counting Machine. Price: 140,000৳.
",246,464983,465229
1929,recursive,"
Product: Safescan s15 LED Type UV Detector. Category: Money Counting Machine. Price: 2,200৳2,500৳.

Product: Safescan s20 Money Counting Machine With Fake Note Detector. Category: Money Counting Machine. Price: 12,500৳.
",221,465229,465450
1930,recursive,"
Product: Deli E3904 Money Counting Machine. Category: Money Counting Machine. Price: 13,000৳.

Product: Julong SY-100 Desktop Money Counting Machine. Category: Money Counting Machine. Price: 13,000৳14,000৳.
",208,465450,465658
1931,recursive,"
Product: Safescan S6300 Money Counting Machine With Fake Note Detector. Category: Money Counting Machine. Price: 14,000৳.

Product: Maxsell Mx-600 Money Counting Machine. Category: Money Counting Machine. Price: 100,000৳.
",223,465658,465881
1932,recursive,"
Product: Tay-Chian TC-2000S Money Counting Machine. Category: Money Counting Machine. Price: 116,000৳135,000৳.

Product: Namibind Turbojet Floor Standing Money Counting Machine. Category: Namibind. Subcategory: Money Counting Machine. Price: Out Of Stock.
",257,465881,466138
1933,recursive,"
Product: Deli ET001 15L Paper Shredder. Category: Deli. Subcategory: Paper Shredder. Price: 12,000৳13,000৳.

Product: Deli E9952 23L Paper Shredder. Category: Deli. Subcategory: Paper Shredder. Price: 15,000৳16,000৳.
",218,466138,466356
1934,recursive,"
Product: Deli E9917-EU 31L Paper Shredder. Category: Deli. Subcategory: Paper Shredder. Price: 27,500৳29,000৳.

Product: Deli ET099 25 Sheets 31L Paper Shredder. Category: Deli. Subcategory: Paper Shredder. Price: 28,500৳31,000৳.
",231,466356,466587
1935,recursive,"
Product: Deli E9911-EU 16L Paper Shredder. Category: Deli. Subcategory: Paper Shredder. Price: Up Coming.

Product: Deli E9903-EU 23L Paper Shredder. Category: Deli. Subcategory: Paper Shredder. Price: Up Coming.
",214,466587,466801
1936,recursive,"
Product: Deli ET089 30L Paper Shredder. Category: Deli. Subcategory: Paper Shredder. Price: Up Coming.

Product: Deli 9904 8 Sheet Paper Shredder. Category: Deli. Subcategory: Paper Shredder. Price: Up Coming.
",211,466801,467012
1937,recursive,"
Product: Deli 9914 6 Sheet Paper Shredder. Category: Deli. Subcategory: Paper Shredder. Price: Up Coming.

Product: Deli 9902 Paper Shredder. Category: Deli. Subcategory: Paper Shredder. Price: Up Coming.
",206,467012,467218
1938,recursive,"
Product: Deli 9905 Paper Shredder. Category: Deli. Subcategory: Paper Shredder. Price: Up Coming.

Product: Deli 9906 Paper Shredder. Category: Deli. Subcategory: Paper Shredder. Price: Up Coming.
",198,467218,467416
1939,recursive,"
Product: Deli 9932 2 Sheet Mini Paper Shredder. Category: Deli. Subcategory: Paper Shredder. Price: Out Of Stock.

Product: Deli ET016 Paper Shredder. Category: Deli. Subcategory: Paper Shredder. Price: Out Of Stock.
",218,467416,467634
1940,recursive,"
Product: Deli 9915 Anion Paper Shredder. Category: Deli. Subcategory: Paper Shredder. Price: Out Of Stock.

Product: Deli E14400 30L Paper Shredder. Category: Deli. Subcategory: Paper Shredder. Price: Out Of Stock.
",216,467634,467850
1941,recursive,"
Product: Deli E14403 Paper Shredder. Category: Deli. Subcategory: Paper Shredder. Price: Out Of Stock.

Product: OFITECH OS1205C Paper Shredder Machine. Category: Paper Shredder. Price: 12,500৳13,500৳.
",203,467850,468053
1942,recursive,"
Product: Ofitech OS1801Ci Elite Heavy Duty Paper Shredder. Category: Paper Shredder. Price: 21,300৳22,500৳.

Product: Ofitech OS2502Ci Paper Shredder. Category: Paper Shredder. Price: 29,000৳31,000৳.

Product: Ofitech OS1201D Paper Shredder. Category: Paper Shredder. Price: Up Coming.
",287,468053,468340
1943,recursive,"
Product: Aurora AS1219CE Paper Shredder. Category: Paper Shredder. Price: Up Coming.

Product: Xtreme OS1501-12C MaxShred 12 Sheets Cross Cut Paper Shredder. Category: Paper Shredder. Price: Up Coming.

Product: Aurora AS2030CD Paper Shredder. Category: Paper Shredder. Price: Up Coming.
",289,468340,468629
1944,recursive,"
Product: Aurora AS1060SB Paper Shredder. Category: Paper Shredder. Price: Out Of Stock.

Product: Xtreme OS2502Ci 25 Sheets Cross Cut Paper Shredder. Category: Xtreme. Subcategory: Paper Shredder. Price: Out Of Stock.
",219,468629,468848
1945,recursive,"
Product: OFITECH OS808-9M Micro Cut Paper Shredder. Category: Ofitech. Subcategory: Paper Shredder. Price: Out Of Stock.

Product: Insta360 X3 Waterproof 360 Action Camera. Category: Insta360. Subcategory: Action Camera. Price: 43,440৳46,900৳.
",245,468848,469093
1946,recursive,"
Product: Insta360 Ace Pro 8K Waterproof Action Camera. Category: Insta360. Subcategory: Action Camera. Price: 42,900৳46,300৳.

Product: Insta360 X4 Waterproof 8K 360 Action Camera. Category: Insta360. Subcategory: Action Camera. Price: 54,500৳62,000৳.
",253,469093,469346
1947,recursive,"
Product: Insta360 X5 Waterproof 8K 360° Action Camera. Category: Insta360. Subcategory: Action Camera. Price: 65,900৳71,000৳.

Product: Insta360 X5 Starter Bundle 8K 360° Action Camera. Category: Insta360. Subcategory: Action Camera. Price: 72,500৳77,000৳.
",258,469346,469604
1948,recursive,"
Product: Insta360 ONE RS 4K Edition Waterproof Action Camera. Category: Insta360. Subcategory: Action Camera. Price: Out Of Stock.

Product: Insta360 Ace Pro 2 8K AI-Powered Action Camera. Category: Insta360. Subcategory: Action Camera. Price: Out Of Stock.
",259,469604,469863
1949,recursive,"
Product: Insta360 X5 Essentials Bundle Action Camera. Category: Insta360. Subcategory: Action Camera. Price: 78,690৳84,000৳.

Product: Insta360 ONE RS Twin Edition Waterproof Action Camera. Category: Insta360. Subcategory: Action Camera. Price: Out Of Stock.
",260,469863,470123
1950,recursive,"
Product: DJI Osmo Action 5 Pro Standard Combo Action Camera. Category: DJI. Subcategory: Action Camera. Price: 42,000৳.

Product: DJI Osmo Action 5 Pro Adventure Combo Action Camera. Category: DJI. Subcategory: Action Camera. Price: 51,000৳60,000৳.
",250,470123,470373
1951,recursive,"
Product: DJI Osmo 360 Adventure Combo. Category: DJI. Subcategory: Action Camera. Price: 59,400৳64,000৳.

Product: DJI Osmo 360 Standard Combo. Category: DJI. Subcategory: Action Camera. Price: Up Coming.
",206,470373,470579
1952,recursive,"
Product: DJI Action 2 Power Combo 128GB Storage 4K Action Camera. Category: DJI. Subcategory: Action Camera. Price: Out Of Stock.

Product: DJI Osmo Action 3 Standard Combo Action Camera. Category: DJI. Subcategory: Action Camera. Price: Out Of Stock.
",253,470579,470832
1953,recursive,"
Product: DJI Action 2 Dual-Screen Combo 4K Action Camera. Category: DJI. Subcategory: Action Camera. Price: Out Of Stock.

Product: DJI Osmo Action 4 Standard Combo Action Camera. Category: DJI. Subcategory: Action Camera. Price: Out Of Stock.
",245,470832,471077
1954,recursive,"
Product: DJI Osmo Action 3 Adventure Combo Action Camera. Category: DJI. Subcategory: Action Camera. Price: Out Of Stock.

Product: DJI Osmo Action 4 Adventure Combo Action Camera. Category: DJI. Subcategory: Action Camera. Price: Out Of Stock.
",246,471077,471323
1955,recursive,"
Product: DJI Osmo Pocket 3 Gimbal Stabilizer Action Camera. Category: DJI. Subcategory: Action Camera. Price: 56,000৳60,400৳.

Product: DJI Osmo Pocket 3 Creator Combo 3 Axis Gimbal Stabilizer Action Camera. Category: DJI. Subcategory: Action Camera. Price: 69,499৳75,500৳.
",275,471323,471598
1956,recursive,"
Product: DJI Osmo Pocket 2 Creator Combo 3 Axis Gimbal Stabilizer Action Camera. Category: DJI. Subcategory: Action Camera. Price: Out Of Stock.

Product: Akaso EK7000 12MP 4K WiFi Action Camera. Category: AKASO. Subcategory: Action Camera. Price: 8,500৳9,000৳.
",263,471598,471861
1957,recursive,"
Product: AKASO Brave 7 LE 20MP 4K Waterproof Dual Screen Wi-Fi Remote Control Action Camera. Category: AKASO. Subcategory: Action Camera. Price: 14,200৳15,000৳.
",162,471861,472023
1958,recursive,"
Product: AKASO V50X 20MP 4K Waterproof Touch Screen Wifi Action Camera. Category: AKASO. Subcategory: Action Camera. Price: 10,700৳18,000৳.
",141,472023,472164
1959,recursive,"
Product: Akaso EK7000 Pro 16MP 4K Ultra HD Waterproof Touch Screen WiFi Remote Control Action Camera. Category: AKASO. Subcategory: Action Camera. Price: Out Of Stock.
",169,472164,472333
1960,recursive,"
Product: AKASO Brave 7 20MP 4K Waterproof Touch Screen Wifi Remote Control Action Camera. Category: AKASO. Subcategory: Action Camera. Price: Out Of Stock.

Product: GoPro HERO13 27MP Waterproof Touch Screen 5.3K Action Camera. Category: GoPro. Subcategory: Action Camera. Price: 44,500৳57,500৳.
",297,472333,472630
1961,recursive,"
Product: GoPro Media Mod for HERO9/HERO10/HERO11 Black. Category: GoPro. Subcategory: Action Camera. Price: Out Of Stock.

Product: GoPro HERO9 Black 20MP 5K Ultra HD Touch Screen Waterproof Action Camera. Category: GoPro. Subcategory: Action Camera. Price: Out Of Stock.
",273,472630,472903
1962,recursive,"
Product: GoPro HERO10 Black 23MP 5.3K Ultra HD Waterproof Touch Screen Action Camera with Accessories Bundle. Category: GoPro. Subcategory: Action Camera. Price: Out Of Stock.
",177,472903,473080
1963,recursive,"
Product: GoPro HERO11 Black 27MP 5.3K Waterproof Touch Screen Action Camera. Category: GoPro. Subcategory: Action Camera. Price: Out Of Stock.

Product: GoPro HERO12 27MP Waterproof Touch Screen 5.3K Action Camera. Category: GoPro. Subcategory: Action Camera. Price: Out Of Stock.
",282,473080,473362
1964,recursive,"
Product: GoPro HERO11 Black Creator Edition 27MP 5.3K Waterproof Touch Screen Action Camera. Category: GoPro. Subcategory: Action Camera. Price: Out Of Stock.
",160,473362,473522
1965,recursive,"
Product: GoPro HERO12 Creator Edition 27MP Waterproof Touch Screen 5.3K Action Camera. Category: GoPro. Subcategory: Action Camera. Price: Out Of Stock.

Product: SJCAM SJ4000 Air Full Hd Wi-Fi Waterproof Sports Action Camera. Category: Action Camera. Subcategory: Camera. Price: 4,500৳4,700৳.
",295,473522,473817
1966,recursive,"
Product: CB77 4G Portable Body Camera. Category: Action Camera. Subcategory: Camera. Price: 3,800৳4,800৳.

Product: S11 4G Portable Body Camera. Category: Action Camera. Subcategory: Camera. Price: 4,400৳4,800৳.
",213,473817,474030
1967,recursive,"
Product: CS05 1080P Wi-Fi Body Camera. Category: Action Camera. Subcategory: Camera. Price: 2,800৳3,000৳.

Product: CS06 1080P Wi-Fi Body Camera. Category: Action Camera. Subcategory: Camera. Price: 3,150৳4,500৳.
",214,474030,474244
1968,recursive,"
Product: L15 Ultra HD 4K Wifi Portable Body Camera. Category: Action Camera. Subcategory: Camera. Price: 4,500৳6,000৳.

Product: CS07 1080P Wi-Fi Body Camera. Category: Action Camera. Subcategory: Camera. Price: 2,100৳3,000৳.
",227,474244,474471
1969,recursive,"
Product: CS11 2K Wi-Fi Body Camera. Category: Action Camera. Subcategory: Camera. Price: 3,250৳3,500৳.

Product: CS12 1440P Wi-Fi Body Camera. Category: Action Camera. Subcategory: Camera. Price: 4,400৳6,000৳.
",211,474471,474682
1970,recursive,"
Product: L13 1080P Wi-Fi Body Camera. Category: Action Camera. Subcategory: Camera. Price: 3,400৳4,500৳.

Product: A100 1080P Wi-Fi Body Camera. Category: Action Camera. Subcategory: Camera. Price: 3,250৳4,500৳.
",213,474682,474895
1971,recursive,"
Product: A32 1080P Wi-Fi Body Camera. Category: Action Camera. Subcategory: Camera. Price: 3,300৳5,000৳.

Product: A18 1080P Wi-Fi Body Camera. Category: Action Camera. Subcategory: Camera. Price: 2,400৳3,500৳.
",212,474895,475107
1972,recursive,"
Product: MC81 1080P Wi-Fi Body Camera. Category: Action Camera. Subcategory: Camera. Price: 4,200৳6,000৳.

Product: SJCAM SJ4000 Dual Screen Full HD WiFi Waterproof Sports Action Camera. Category: Action Camera. Subcategory: Camera. Price: 6,000৳6,200৳.
",255,475107,475362
1973,recursive,"
Product: Ausek AT-S9R Combo 4K WiFi Action Camera. Category: Action Camera. Subcategory: Camera. Price: 6,200৳7,200৳.

Product: Ausek AT-M40R Combo 5K Wifi Waterproof Action Camera. Category: Action Camera. Subcategory: Camera. Price: 6,200৳8,000৳.
",250,475362,475612
1974,recursive,"
Product: AUSEK AT-Q60TR Combo 4K Dual Screen WiFi Action Camera. Category: Action Camera. Subcategory: Camera. Price: 7,200৳8,500৳.

Product: Ausek AT-M40R Touch Combo 5K WiFi Waterproof Action Camera. Category: Action Camera. Subcategory: Camera. Price: 6,990৳8,500৳.
",270,475612,475882
1975,recursive,"
Product: Ausek AT-M40R Touch Wireless Mic Combo 5K WiFi Waterproof Action Camera. Category: Action Camera. Subcategory: Camera. Price: 7,400৳8,500৳.
",150,475882,476032
1976,recursive,"
Product: SJCAM SJ6 Legend 16MP 4K Wi-Fi Waterproof Touch Screen Sports Action Camera. Category: SJCAM. Subcategory: Action Camera. Price: 10,000৳11,000৳.

Product: SJCAM SJ8 Dual Screen Sports Action Camera. Category: SJCAM. Subcategory: Action Camera. Price: 9,800৳11,200৳.
",276,476032,476308
1977,recursive,"
Product: SJCAM SJ6 Pro 24MP 4K Wi-Fi Dual Screen Waterproof Sports Action Camera. Category: SJCAM. Subcategory: Action Camera. Price: 11,000৳11,800৳.

Product: SJCAM A20 Wearable Multipurpose Portable Body Camera. Category: SJCAM. Subcategory: Action Camera. Price: 13,490৳15,000৳.
",283,476308,476591
1978,recursive,"
Product: SJCAM SJ10X 12MP 4K Wi-Fi Waterproof Action Camera. Category: SJCAM. Subcategory: Action Camera. Price: 13,200৳19,000৳.

Product: SJCAM A50 20MP 4K Portable Body Camera. Category: SJCAM. Subcategory: Action Camera. Price: 15,800৳21,000৳.
",248,476591,476839
1979,recursive,"
Product: SJCAM SJ20 Dual Lens WiFi Action Camera. Category: SJCAM. Subcategory: Action Camera. Price: 20,990৳26,000৳.

Product: SJCAM SJ8 Air Wi-Fi Waterproof Action Camera. Category: SJCAM. Subcategory: Action Camera. Price: Up Coming.
",238,476839,477077
1980,recursive,"
Product: SJCAM C200 4K WiFi Waterproof Action Camera. Category: SJCAM. Subcategory: Action Camera. Price: Up Coming.

Product: SJCAM C400 4K 16MP Handheld Action Camera. Category: SJCAM. Subcategory: Action Camera. Price: 19,900৳26,000৳.
",239,477077,477316
1981,recursive,"
Product: SJCAM C200 4K 16M 6-Axis Gyroscope Stabilization Waterproof Action Camera. Category: SJCAM. Subcategory: Action Camera. Price: 8,800৳9,800৳.

Product: SJCAM SJ11 Active 4K Dual Screen WiFi Waterproof Action Camera. Category: SJCAM. Subcategory: Action Camera. Price: 14,100৳16,000৳.
",293,477316,477609
1982,recursive,"
Product: SJCAM C300 4K Dual Screen WiFi Action Camera. Category: SJCAM. Subcategory: Action Camera. Price: 12,900৳17,000৳.

Product: SJCAM SJ8 Pro 12MP 4K Wi-Fi Dual Screen Waterproof Action Camera. Category: SJCAM. Subcategory: Action Camera. Price: Out Of Stock.
",266,477609,477875
1983,recursive,"
Product: SJCAM C100 Plus 4K Portable Action Camera. Category: SJCAM. Subcategory: Action Camera. Price: Out Of Stock.

Product: SJCAM SJ20 Dual Lens WiFi Action Camera Combo. Category: SJCAM. Subcategory: Action Camera. Price: Out Of Stock.
",242,477875,478117
1984,recursive,"
Product: Feiyu Pocket 3 Cordless Detachable 3-Axis Gimbal Camera. Category: Feiyu. Subcategory: Action Camera. Price: 32,450৳35,000৳.

Product: ORDRO M3 5K Gimbal Stabilizer Action Camera. Category: ORDRO. Subcategory: Action Camera. Price: 20,900৳24,000৳.
",258,478117,478375
1985,recursive,"
Product: ORDRO M5 5K 3 Axis Gimbal Stabilizer Action Camera. Category: ORDRO. Subcategory: Action Camera. Price: 23,900৳28,500৳.

Product: Ausek AT-M44R 5K Wifi Waterproof Action Camera. Category: AUSEK. Subcategory: Action Camera. Price: 5,900৳9,000৳.
",254,478375,478629
1986,recursive,"
Product: Ausek AT-M82TR 6k WiFi Waterproof Action Camera. Category: AUSEK. Subcategory: Action Camera. Price: 11,800৳16,000৳.

Product: Ausek AT-M86TR 8k WiFi Waterproof Action Camera. Category: AUSEK. Subcategory: Action Camera. Price: 16,000৳.
",247,478629,478876
1987,recursive,"
Product: Ausek AT-S84T 6K 30fps Waterproof Action Camera. Category: AUSEK. Subcategory: Action Camera. Price: Up Coming.

Product: AUSEK AT-M60TR Combo 5K Waterproof Action Camera. Category: AUSEK. Subcategory: Action Camera. Price: Out Of Stock.
",248,478876,479124
1988,recursive,"
Product: AUSEK AT-S81TR Wireless Waterproof Action Camera. Category: AUSEK. Subcategory: Action Camera. Price: Out Of Stock.

Product: Ausek AT-S81TR Combo 5K 30fps EIS Waterproof Action Camera. Category: AUSEK. Subcategory: Action Camera. Price: Out Of Stock.
",262,479124,479386
1989,recursive,"
Product: Ausek AT-S81TR Wireless Mic Combo 5K WIFI Action Camera. Category: AUSEK. Subcategory: Action Camera. Price: Out Of Stock.

Product: Blisbond GO3 4K Portable Action Camera. Category: Blisbond. Subcategory: Action Camera. Price: 7,600৳9,000৳.
",252,479386,479638
1990,recursive,"
Product: Blisbond Pro3 4K Portable Dual-Screen Action Camera. Category: Blisbond. Subcategory: Action Camera. Price: 12,400৳15,000৳.

Product: Blisbond Fly3 4K Wi-Fi Waterproof Action Camera. Category: Blisbond. Subcategory: Action Camera. Price: 14,800৳18,000৳.
",264,479638,479902
1991,recursive,"
Product: TELESIN Allin BOX Portable Storage Charger for GoPro Hero 9/10/11 with 2 Batteries. Category: Action Camera Accessories. Subcategory: Action Camera. Price: 4,600৳.

Product: Insta360 GO 2 Lens Guard. Category: Action Camera Accessories. Subcategory: Action Camera. Price: 803৳.
",288,479902,480190
1992,recursive,"
Product: Insta360 GO 2 Easy Clip. Category: Action Camera Accessories. Subcategory: Action Camera. Price: 803৳.

Product: Insta360 GO 2 Pet Strap Mount. Category: Action Camera Accessories. Subcategory: Action Camera. Price: 803৳.
",232,480190,480422
1993,recursive,"
Product: Insta360 X3 Action Camera Lens Cap. Category: Action Camera Accessories. Subcategory: Action Camera. Price: 580৳990৳.

Product: Insta360 ONE RS Action Camera Lens Cap. Category: Action Camera Accessories. Subcategory: Action Camera. Price: 1,490৳.
",258,480422,480680
1994,recursive,"
Product: TELESIN Professional 45M Waterproof Diving Case For GoPro Hero9. Category: Action Camera Accessories. Subcategory: Action Camera. Price: 1,249৳1,600৳.

Product: Insta360 ONE X2 Carry Case. Category: Action Camera Accessories. Subcategory: Action Camera. Price: 1,617৳.
",279,480680,480959
1995,recursive,"
Product: Insta360 One RS Mounting Bracket. Category: Action Camera Accessories. Subcategory: Action Camera. Price: 2,410৳.

Product: Insta360 ONE RS Cold Shoe. Category: Action Camera Accessories. Subcategory: Action Camera. Price: 2,410৳.
",241,480959,481200
1996,recursive,"
Product: Insta360 All-Purpose Mini Tripod. Category: Action Camera Accessories. Subcategory: Action Camera. Price: 2,999৳3,300৳.

Product: Insta360 2-In-1 Invisible Selfie Stick & Tripod. Category: Action Camera Accessories. Subcategory: Action Camera. Price: Out Of Stock.
",275,481200,481475
1997,recursive,"
Product: Insta360 ONE RS Core Battery Base. Category: Action Camera Accessories. Subcategory: Action Camera. Price: 2,800৳3,320৳.

Product: Insta360 One X2 Fast Charging Hub. Category: Action Camera Accessories. Subcategory: Action Camera. Price: 4,015৳.
",256,481475,481731
1998,recursive,"
Product: TELESIN 3 Slots Battery Charger For GoPro Hero 9/10 with 2 Pcs Batteries Set. Category: Action Camera Accessories. Subcategory: Action Camera. Price: 4,200৳.
",168,481731,481899
1999,recursive,"
Product: Insta360 ONE RS Dive Case for 4K Boost Lens. Category: Action Camera Accessories. Subcategory: Action Camera. Price: 6,050৳.
",135,481899,482034
2000,recursive,"
Product: K&F Concept GOPRO HERO9/10 Action Camera HD Filter Set (ND8+ND16+ND32+CPL). Category: Action Camera Accessories. Subcategory: Action Camera. Price: 8,000৳9,500৳.
",172,482034,482206
2001,recursive,"
Product: Insta360 ONE RS Core Bundle with One RS Core, Battery and Frame. Category: Action Camera Accessories. Subcategory: Action Camera. Price: 27,900৳.

Product: Insta360 Motorcycle Mount Bundle. Category: Action Camera Accessories. Subcategory: Action Camera. Price: Out Of Stock.
",286,482206,482492
2002,recursive,"
Product: GoPro Dual Battery Charger + Enduro 2 Pack Batteries. Category: Action Camera Accessories. Subcategory: Action Camera. Price: 12,500৳13,500৳.

Product: Canon EF-S 18-55mm f/3.5-5.6 III Camera Lens. Category: Camera Lenses. Subcategory: Camera. Price: 8,000৳8,500৳.
",275,482492,482767
2003,recursive,"
Product: CANON EF-S 18-55mm f/3.5-5.6 IS STM Lens. Category: Camera Lenses. Subcategory: Camera. Price: 10,500৳11,000৳.

Product: Sony E PZ 16-50mm f/3.5-5.6 OSS Camera Lens. Category: Camera Lenses. Subcategory: Camera. Price: 15,500৳16,000৳.
",245,482767,483012
2004,recursive,"
Product: Canon EF 50mm f/1.8 STM Lens. Category: Camera Lenses. Subcategory: Camera. Price: 16,500৳19,000৳.

Product: FUJIFILM XC 15-45mm f/3.5-5.6 OIS PZ Camera Lens. Category: Camera Lenses. Subcategory: Camera. Price: 17,500৳18,000৳.
",238,483012,483250
2005,recursive,"
Product: Nikon NIKKOR Z DX 16-50mm f/3.5-6.3 VR Lens. Category: Camera Lenses. Subcategory: Camera. Price: 13,000৳15,000৳.

Product: Nikon AF-S Nikkor 50mm f/1.8G Lens. Category: Camera Lenses. Subcategory: Camera. Price: 26,000৳30,000৳.
",239,483250,483489
2006,recursive,"
Product: Sony E 55-210mm f/4.5-6.3 OSS Lens. Category: Camera Lenses. Subcategory: Camera. Price: 25,500৳29,500৳.

Product: Sony FE 28-60mm f/4-5.6 Camera Lens. Category: Camera Lenses. Subcategory: Camera. Price: 29,000৳33,000৳.
",231,483489,483720
2007,recursive,"
Product: Sony E 50mm f/1.8 OSS Lens. Category: Camera Lenses. Subcategory: Camera. Price: 29,000৳32,000৳.

Product: Nikon AF-S DX NIKKOR 18-140mm f/3.5-5.6G ED VR Lens. Category: Camera Lenses. Subcategory: Camera. Price: 29,000৳30,500৳.
",239,483720,483959
2008,recursive,"
Product: Sony FE 50mm f/1.8 Full Frame Lens. Category: Camera Lenses. Subcategory: Camera. Price: 29,000৳30,500৳.

Product: Sony FE 28-70mm f/3.5-5.6 OSS Camera Lens. Category: Camera Lenses. Subcategory: Camera. Price: 33,000৳42,000৳.
",237,483959,484196
2009,recursive,"
Product: Nikon NIKKOR Z 24-50mm f/4-6.3 Lens. Category: Camera Lenses. Subcategory: Camera. Price: 24,000৳28,000৳.

Product: Nikon NIKKOR Z DX 24mm f/1.7 Lens. Category: Camera Lenses. Subcategory: Camera. Price: 37,000৳38,000৳.
",230,484196,484426
2010,recursive,"
Product: Canon RF-S 55-210mm f/5-7.1 IS STM Lens. Category: Camera Lenses. Subcategory: Camera. Price: 39,000৳40,000৳.

Product: Nikon NIKKOR Z DX 50-250mm f/4.5-6.3 VR Lens. Category: Camera Lenses. Subcategory: Camera. Price: 38,000৳40,000৳.
",245,484426,484671
2011,recursive,"
Product: FUJIFILM XF 35mm f/2 R WR Camera Lens. Category: Camera Lenses. Subcategory: Camera. Price: 42,000৳43,000৳.

Product: Nikon NIKKOR Z 28mm f/2.8 SE Lens. Category: Camera Lenses. Subcategory: Camera. Price: 31,000৳38,000৳.
",232,484671,484903
2012,recursive,"
Product: Nikon NIKKOR Z 28-75mm f/2.8 Camera Lens. Category: Camera Lenses. Subcategory: Camera. Price: 100,000৳112,000৳.

Product: Sony FE 85mm F/1.8 Lens. Category: Sony. Subcategory: Camera Lenses. Price: 50,500৳58,000৳.
",225,484903,485128
2013,recursive,"
Product: Sony E PZ 18-105mm f/4G OSS Lens. Category: Sony. Subcategory: Camera Lenses. Price: 57,000৳60,000৳.

Product: Sony E 18-135mm f/3.5-5.6 OSS Camera Lens. Category: Sony. Subcategory: Camera Lenses. Price: 58,500৳64,000৳.
",231,485128,485359
2014,recursive,"
Product: Sony Sonnar T FE 55mm F1.8 ZA Lens. Category: Sony. Subcategory: Camera Lenses. Price: 59,000৳63,000৳.

Product: Sony E 10-18mm f/4 OSS Camera Lens. Category: Sony. Subcategory: Camera Lenses. Price: 67,000৳68,000৳.
",226,485359,485585
2015,recursive,"
Product: Sony Vario-Tessar T* FE 24-70mm f/4 ZA OSS Lens. Category: Sony. Subcategory: Camera Lenses. Price: 65,000৳72,000৳.

Product: Sony FE 20mm f/1.8 G Camera Lens. Category: Sony. Subcategory: Camera Lenses. Price: 85,000৳95,000৳.
",237,485585,485822
2016,recursive,"
Product: Sony FE 24-105mm f-4 G OSS Camera Lens. Category: Sony. Subcategory: Camera Lenses. Price: 99,000৳107,000৳.

Product: Sony FE 90mm f/2.8 Macro G OSS Lens. Category: Sony. Subcategory: Camera Lenses. Price: 90,000৳100,000৳.
",233,485822,486055
2017,recursive,"
Product: Sony FE 24mm f/1.4 GM Camera Lens. Category: Sony. Subcategory: Camera Lenses. Price: 123,000৳130,000৳.

Product: Sony FE 85mm f/1.4 GM Lens. Category: Sony. Subcategory: Camera Lenses. Price: 135,000৳145,000৳.
",221,486055,486276
2018,recursive,"
Product: Sony FE 14mm f/1.8 GM Lens. Category: Sony. Subcategory: Camera Lenses. Price: 140,000৳142,000৳.

Product: Sony FE 35mm f/1.8 Full Frame Lens. Category: Sony. Subcategory: Camera Lenses. Price: 62,500৳70,000৳.
",220,486276,486496
2019,recursive,"
Product: Sony FE 35mm f/1.4 GM Lens. Category: Sony. Subcategory: Camera Lenses. Price: 126,000৳135,000৳.

Product: Nikon AF-S NIKKOR 85mm f/1.8G Lens. Category: Nikon. Subcategory: Camera Lenses. Price: 45,000৳49,000৳.
",221,486496,486717
2020,recursive,"
Product: Nikon NIKKOR Z 24-70mm f4 S Camera Lens. Category: Nikon. Subcategory: Camera Lenses. Price: 62,000৳65,000৳.

Product: Nikon NIKKOR Z 35mm f/1.8 S Lens. Category: Nikon. Subcategory: Camera Lenses. Price: 75,000৳80,000৳.
",231,486717,486948
2021,recursive,"
Product: Nikon NIKKOR Z 85mm f/1.8 S Lens. Category: Nikon. Subcategory: Camera Lenses. Price: 78,000৳85,000৳.

Product: Nikon NIKKOR Z 24-200mm f/4-6.3 VR Lens. Category: Nikon. Subcategory: Camera Lenses. Price: 91,000৳99,000৳.
",231,486948,487179
2022,recursive,"
Product: Nikon NIKKOR Z 24mm f/1.8 S Lens. Category: Nikon. Subcategory: Camera Lenses. Price: 98,000৳100,000৳.

Product: Nikon NIKKOR Z 24-120mm f/4 S Lens. Category: Nikon. Subcategory: Camera Lenses. Price: 112,000৳124,000৳.
",229,487179,487408
2023,recursive,"
Product: Nikon NIKKOR Z 70-180mm f/2.8 Lens. Category: Nikon. Subcategory: Camera Lenses. Price: 140,000৳149,000৳.

Product: Nikon NIKKOR Z 180-600mm f/5.6-6.3 VR Lens. Category: Nikon. Subcategory: Camera Lenses. Price: 187,000৳195,000৳.
",240,487408,487648
2024,recursive,"
Product: Nikon NIKKOR Z 50mm f/1.2 S Lens. Category: Nikon. Subcategory: Camera Lenses. Price: 198,000৳202,000৳.

Product: Nikon NIKKOR Z 400mm f/4.5 VR S Lens. Category: Nikon. Subcategory: Camera Lenses. Price: 375,000৳380,000৳.
",232,487648,487880
2025,recursive,"
Product: Nikon NIKKOR Z 28mm f/2.8 Lens. Category: Nikon. Subcategory: Camera Lenses. Price: 37,000৳40,000৳.

Product: Canon RF 85mm f/1.2 L USM Camera Lens. Category: Canon. Subcategory: Camera Lenses. Price: 270,000৳280,000৳.
",229,487880,488109
2026,recursive,"
Product: Canon RF 28mm f/2.8 STM Camera Lens. Category: Canon. Subcategory: Camera Lenses. Price: 34,000৳40,000৳.

Product: Canon RF 24mm f/1.8 Macro IS STM Camera Lens. Category: Canon. Subcategory: Camera Lenses. Price: 59,000৳62,000৳.
",239,488109,488348
2027,recursive,"
Product: Canon RF 24-105mm f/4-7.1 IS STM Camera Lens. Category: Canon. Subcategory: Camera Lenses. Price: 50,000৳53,000৳.

Product: Canon RF-S18-150mm f/3.5-6.3 IS STM Lens. Category: Canon. Subcategory: Camera Lenses. Price: 50,000৳58,000৳.
",244,488348,488592
2028,recursive,"
Product: Canon EF 24-105mm f/4L IS USM Lens. Category: Canon. Subcategory: Camera Lenses. Price: 60,000৳66,000৳.

Product: Canon RF 35mm f/1.8 Macro IS STM Lens. Category: Canon. Subcategory: Camera Lenses. Price: 60,000৳70,000৳.
",231,488592,488823
2029,recursive,"
Product: Canon RF 100mm f/2.8 L Macro IS USM Lens. Category: Canon. Subcategory: Camera Lenses. Price: 138,000৳140,000৳.

Product: Canon RF 24-70mm f/2.8 L IS USM Lens. Category: Canon. Subcategory: Camera Lenses. Price: 240,000৳243,000৳.
",240,488823,489063
2030,recursive,"
Product: Canon RF 70-200mm f/2.8L IS USM Camera Lens. Category: Canon. Subcategory: Camera Lenses. Price: 260,000৳280,000৳.

Product: Canon RF 100-500mm f/4.5-7.1L IS USM Camera Lens. Category: Canon. Subcategory: Camera Lenses. Price: 320,000৳325,000৳.
",255,489063,489318
2031,recursive,"
Product: Canon EF-S 10-18mm f/4.5-5.6 IS STM Lens. Category: Canon. Subcategory: Camera Lenses. Price: 27,500৳29,500৳.

Product: Canon RF 16mm f/2.8 STM Lens. Category: Canon. Subcategory: Camera Lenses. Price: 34,000৳39,000৳.
",228,489318,489546
2032,recursive,"
Product: Canon RF 85mm f/2 Macro IS STM Lens. Category: Canon. Subcategory: Camera Lenses. Price: 72,000৳75,000৳.

Product: Canon RF 24-105mm f/4 L IS USM Camera Lens. Category: Canon. Subcategory: Camera Lenses. Price: 127,000৳130,000৳.
",239,489546,489785
2033,recursive,"
Product: Canon EF-S 55-250mm f/4-5.6 IS STM Telephoto Zoom Lens. Category: Canon. Subcategory: Camera Lenses. Price: Out Of Stock.

Product: Sony ZV-1F 20.1 MP 4K Vlogging Digital Camera. Category: Sony. Subcategory: Digital Camera. Price: 57,000৳65,000৳.
",257,489785,490042
2034,recursive,"
Product: Sony ZV-E10 24.2MP 4k Touchscreen Vlogging Digital Camera with 16-50mm Lens. Category: Sony. Subcategory: Digital Camera. Price: 78,500৳85,000৳.

Product: Sony ZV-1 II 21.0MP Digital Camera. Category: Sony. Subcategory: Digital Camera. Price: 81,000৳88,000৳.
",269,490042,490311
2035,recursive,"
Product: Sony ZV-1 20.1MP Vlogging 4K Digital Camera for Content Creator. Category: Sony. Subcategory: Digital Camera. Price: Out Of Stock.

Product: FUJIFILM X100V Digital Camera. Category: Fujifilm. Subcategory: Digital Camera. Price: Out Of Stock.
",252,490311,490563
2036,recursive,"
Product: Canon PowerShot G7 X Mark III 20.2MP Digital Camera. Category: Canon. Subcategory: Digital Camera. Price: 166,000৳175,000৳.

Product: Canon EOS 2000D DSLR Camera (Body Only). Category: DSLR. Subcategory: Camera. Price: 38,000৳43,000৳.
",245,490563,490808
2037,recursive,"
Product: Canon EOS 4000D 18MP DSLR Camera With 18-55mm Lens. Category: DSLR. Subcategory: Camera. Price: 42,300৳49,000৳.

Product: Canon EOS 3000D 18MP DSLR Camera With EF-S 18-55mm III Lens. Category: DSLR. Subcategory: Camera. Price: 41,000৳47,000৳.
",253,490808,491061
2038,recursive,"
Product: Canon EOS 2000D 24.1MP Full HD Wi-Fi DSLR Camera With EF-S 18-55mm f/3.5-5.6 III Lens. Category: DSLR. Subcategory: Camera. Price: 42,500৳51,000৳.

Product: Canon EOS 1500D 24.1MP DSLR Camera With 18-55mm Lens. Category: DSLR. Subcategory: Camera. Price: 47,500৳52,000৳.
",281,491061,491342
2039,recursive,"
Product: Canon EOS 2000D 24.1MP Full HD WI-FI DSLR Camera with 18-55mm IS II Kit Lens. Category: DSLR. Subcategory: Camera. Price: 43,500৳53,000৳.

Product: Canon EOS 250D DSLR Camera (Body Only). Category: DSLR. Subcategory: Camera. Price: 59,000৳65,000৳.
",258,491342,491600
2040,recursive,"
Product: Canon EOS 250D 24.1MP Full HD WI-FI DSLR Camera with 18-55mm III KIT Lens. Category: DSLR. Subcategory: Camera. Price: 63,500৳71,000৳.

Product: Canon EOS 250D 24.1MP Full HD WI-FI DSLR Camera with 18-55mm IS STM KIT Lens. Category: DSLR. Subcategory: Camera. Price: 64,500৳72,000৳.
",293,491600,491893
2041,recursive,"
Product: Canon EOS 850D DSLR Camera (Body Only). Category: DSLR. Subcategory: Camera. Price: 95,000৳105,000৳.

Product: Canon EOS 850D 24.1 MP With 18-55mm IS STM Lens 4K UHD WI-FI Touchscreen DSLR Camera. Category: DSLR. Subcategory: Camera. Price: 103,000৳115,000৳.
",269,491893,492162
2042,recursive,"
Product: Canon EOS 6D Mark II DSLR Camera (Only Body). Category: DSLR. Subcategory: Camera. Price: 129,000৳132,000৳.

Product: Canon EOS 90D 32.5MP 4K WI-FI Touchscreen DSLR Camera (Body Only). Category: DSLR. Subcategory: Camera. Price: Out Of Stock.
",253,492162,492415
2043,recursive,"
Product: Canon EOS 90D 32.5MP DSLR Camera with 18-55MM STM Lens. Category: DSLR. Subcategory: Camera. Price: Out Of Stock.

Product: Canon EOS 90D 32.5MP DSLR Camera with EF-S 18-135mm IS USM Lens. Category: DSLR. Subcategory: Camera. Price: Out Of Stock.
",257,492415,492672
2044,recursive,"
Product: Sony FDR-AX43 4K Handycam Camcorder. Category: Handycam. Subcategory: Camera. Price: 92,000৳105,000৳.

Product: Sony HDR-CX405 9.2MP 30X Optical Zoom Full HD Handycam. Category: Handycam. Subcategory: Camera. Price: Out Of Stock.
",240,492672,492912
2045,recursive,"
Product: FUJIFILM XF 18-55mm f/2.8-4 R LM OIS Camera Lens. Category: FUJIFILM. Subcategory: Camera Lenses. Price: 50,000৳51,000৳.

Product: FUJIFILM XF 90mm f/2 R LM WR Camera Lens. Category: FUJIFILM. Subcategory: Camera Lenses. Price: 73,000৳75,000৳.
",254,492912,493166
2046,recursive,"
Product: FUJIFILM XF 16-55mm f2.8 R LM WR Camera Lens. Category: FUJIFILM. Subcategory: Camera Lenses. Price: 128,000৳130,000৳.

Product: FUJIFILM XF 50mm f/2 R WR Camera Lens. Category: FUJIFILM. Subcategory: Camera Lenses. Price: Pre Order.
",244,493166,493410
2047,recursive,"
Product: FUJIFILM XC 35mm f/2 Camera Lens. Category: FUJIFILM. Subcategory: Camera Lenses. Price: Up Coming.

Product: FUJIFILM XF 18mm f/2 R Camera Lens. Category: FUJIFILM. Subcategory: Camera Lenses. Price: Up Coming.
",222,493410,493632
2048,recursive,"
Product: FUJIFILM XF 23mm f/1.4 R Camera Lens. Category: FUJIFILM. Subcategory: Camera Lenses. Price: Up Coming.

Product: FUJIFILM XF 100-400mm f/4.5-5.6 R LM OIS WR Camera Lens. Category: FUJIFILM. Subcategory: Camera Lenses. Price: Up Coming.
",247,493632,493879
2049,recursive,"
Product: FUJIFILM GF 32-64mm f/4 R LM WR Camera Lens. Category: FUJIFILM. Subcategory: Camera Lenses. Price: Up Coming.

Product: FUJIFILM GF 80mm f/1.7 R WR Camera Lens. Category: FUJIFILM. Subcategory: Camera Lenses. Price: Up Coming.
",238,493879,494117
2050,recursive,"
Product: FUJIFILM XF 27mm f/2.8 R WR Camera Lens. Category: FUJIFILM. Subcategory: Camera Lenses. Price: Out Of Stock.

Product: FUJIFILM XF 16mm f/1.4 R WR Camera Lens. Category: FUJIFILM. Subcategory: Camera Lenses. Price: Out Of Stock.
",240,494117,494357
2051,recursive,"
Product: FUJIFILM XF 16-80mm f/4 R OIS WR Camera Lens. Category: FUJIFILM. Subcategory: Camera Lenses. Price: Out Of Stock.

Product: FUJIFILM XF 70-300mm f/4-5.6 R LM OIS WR Camera Lens. Category: FUJIFILM. Subcategory: Camera Lenses. Price: Out Of Stock.
",258,494357,494615
2052,recursive,"
Product: FUJIFILM XF 56mm f/1.2 R WR Camera Lens. Category: FUJIFILM. Subcategory: Camera Lenses. Price: Out Of Stock.

Product: FUJIFILM XF 10-24mm f/4 R OIS WR Lens. Category: FUJIFILM. Subcategory: Camera Lenses. Price: Out Of Stock.
",238,494615,494853
2053,recursive,"
Product: Nikon Z50 20.9MP Wi-Fi Mirrorless Digital Camera(Only Body). Category: Mirrorless Camera. Subcategory: Camera. Price: 80,000৳88,000৳.

Product: Sony Alpha A6400 Mirrorless Digital Camera (Body Only). Category: Mirrorless Camera. Subcategory: Camera. Price: 83,000৳88,000৳.
",283,494853,495136
2054,recursive,"
Product: Canon EOS R100 Mirrorless Camera with 18-45mm Lens. Category: Mirrorless Camera. Subcategory: Camera. Price: 67,000৳77,000৳.

Product: Canon EOS R50 Mirrorless Camera With 18-45mm Lens. Category: Mirrorless Camera. Subcategory: Camera. Price: 84,000৳90,000৳.
",269,495136,495405
2055,recursive,"
Product: Canon EOS RP Mirrorless Digital Camera (Body Only). Category: Mirrorless Camera. Subcategory: Camera. Price: 89,000৳95,000৳.

Product: Nikon Z50 20.9MP Wi-Fi Mirrorless Digital Camera with 16-50mm Lens. Category: Mirrorless Camera. Subcategory: Camera. Price: 92,000৳98,000৳.
",286,495405,495691
2056,recursive,"
Product: Canon EOS R10 Mirrorless Digital Camera (Body Only). Category: Mirrorless Camera. Subcategory: Camera. Price: 95,000৳103,000৳.

Product: Sony Alpha A6400 Mirrorless Digital Camera with 16-50mm Lens. Category: Mirrorless Camera. Subcategory: Camera. Price: 94,000৳105,000৳.
",283,495691,495974
2057,recursive,"
Product: Canon EOS R10 Mirrorless Camera With 18-45mm Lens. Category: Mirrorless Camera. Subcategory: Camera. Price: 102,000৳109,000৳.

Product: Nikon Z5 Full Frame Mirrorless Digital Camera (Body Only). Category: Mirrorless Camera. Subcategory: Camera. Price: 102,000৳118,000৳.
",280,495974,496254
2058,recursive,"
Product: Nikon D7500 Mirrorless Camera with 18-140mm Lens. Category: Mirrorless Camera. Subcategory: Camera. Price: 111,000৳119,000৳.

Product: Sony ZV-E10 II Mirrorless Camera with 16-50mm Lens. Category: Mirrorless Camera. Subcategory: Camera. Price: 119,000৳125,000৳.
",272,496254,496526
2059,recursive,"
Product: Canon EOS RP Mirrorless Camera with 24-105mm f/4-7.1 Lens. Category: Mirrorless Camera. Subcategory: Camera. Price: 132,000৳140,000৳.

Product: Sony A6400 Mirrorless Camera With 18-135mm Lens. Category: Mirrorless Camera. Subcategory: Camera. Price: 138,000৳147,000৳.
",278,496526,496804
2060,recursive,"
Product: Canon EOS R8 Mirrorless Camera(Only Body). Category: Mirrorless Camera. Subcategory: Camera. Price: 138,000৳148,000৳.

Product: Canon EOS R10 Mirrorless Camera With RF-S18-150mm f/3.5-6.3 IS STM Lens. Category: Mirrorless Camera. Subcategory: Camera. Price: 141,000৳150,000৳.
",286,496804,497090
2061,recursive,"
Product: Sony Alpha A7 III Mirrorless Digital Camera (Only Body). Category: Mirrorless Camera. Subcategory: Camera. Price: 146,000৳155,000৳.

Product: Sony Alpha 7C Compact Mirrorless Full-frame Camera (Only Body). Category: Mirrorless Camera. Subcategory: Camera. Price: 141,000৳155,000৳.
",291,497090,497381
2062,recursive,"
Product: FUJIFILM X-T50 Mirrorless Camera (Body Only). Category: Mirrorless Camera. Subcategory: Camera. Price: 154,000৳160,000৳.

Product: Canon EOS R8 Mirrorless Camera with RF 24-50mm f/4.5-6.3 IS STM Lens. Category: Mirrorless Camera. Subcategory: Camera. Price: 155,000৳165,000৳.
",286,497381,497667
2063,recursive,"
Product: Canon EOS R6 Mark II Mirrorless Camera (Only Body). Category: Canon. Subcategory: Mirrorless Camera. Price: 216,000৳227,000৳.

Product: Canon EOS R5 Mirrorless Digital Camera (Only Body). Category: Canon. Subcategory: Mirrorless Camera. Price: 315,000৳325,000৳.
",272,497667,497939
2064,recursive,"
Product: Canon EOS R6 Mark II Mirrorless Camera with 24-105mm f/4 Lens. Category: Canon. Subcategory: Mirrorless Camera. Price: 345,000৳360,000৳.

Product: Canon EOS R5 Mark II Mirrorless Digital Camera (Only Body). Category: Canon. Subcategory: Mirrorless Camera. Price: Out Of Stock.
",287,497939,498226
2065,recursive,"
Product: Nikon Z5 Mirrorless Camera with 24-70mm f/4 Lens. Category: Nikon. Subcategory: Mirrorless Camera. Price: 168,000৳180,000৳.

Product: Nikon Z6 II Full Frame Mirrorless Digital Camera (Body Only). Category: Nikon. Subcategory: Mirrorless Camera. Price: 175,000৳185,000৳.
",280,498226,498506
2066,recursive,"
Product: Nikon Zf 24.5MP Mirrorless Camera(Only Body). Category: Nikon. Subcategory: Mirrorless Camera. Price: 199,000৳205,000৳.

Product: Nikon Z6 III Mirrorless Camera (Body Only). Category: Nikon. Subcategory: Mirrorless Camera. Price: 240,000৳260,000৳.
",258,498506,498764
2067,recursive,"
Product: Nikon Z7 II Full Frame Mirrorless Digital Camera (Body Only). Category: Nikon. Subcategory: Mirrorless Camera. Price: 270,000৳280,000৳.

Product: Nikon Z8 45.7MP Mirrorless Camera(Only Body). Category: Nikon. Subcategory: Mirrorless Camera. Price: 340,000৳390,000৳.
",276,498764,499040
2068,recursive,"
Product: Nikon Z9 Mirrorless Camera(Only Body). Category: Nikon. Subcategory: Mirrorless Camera. Price: 580,000৳595,000৳.

Product: Transcend DrivePro Body 30 Video Camera Camcorder. Category: Transcend. Subcategory: Dash Cam. Price: Up Coming.
",246,499040,499286
2069,recursive,"
Product: Transcend DrivePro 230 Dash Camera. Category: Transcend. Subcategory: Dash Cam. Price: Out Of Stock.

Product: Transcend DrivePro 20 Motorcycle Dashcam. Category: Transcend. Subcategory: Dash Cam. Price: Out Of Stock.
",228,499286,499514
2070,recursive,"
Product: Transcend DrivePro 550 Dual Lens Dash Camera. Category: Transcend. Subcategory: Dash Cam. Price: Out Of Stock.

Product: Transcend DrivePro Body 60 Cylindrical Camera. Category: Transcend. Subcategory: Dash Cam. Price: Out Of Stock.
",243,499514,499757
2071,recursive,"
Product: Sony Alpha A6700 Mirrorless Camera (Body Only). Category: Sony. Subcategory: Mirrorless Camera. Price: 147,500৳170,000৳.

Product: Sony Alpha a7R IIIA Full-Frame Mirrorless Camera (Body Only). Category: Sony. Subcategory: Mirrorless Camera. Price: 195,000৳210,000৳.
",276,499757,500033
2072,recursive,"
Product: Sony Alpha A7C II Full Frame Mirrorless Camera (Only Body). Category: Sony. Subcategory: Mirrorless Camera. Price: 197,000৳210,000৳.

Product: Sony a7 IV 33MP Mirrorless Digital Camera (Body Only). Category: Sony. Subcategory: Mirrorless Camera. Price: 214,000৳230,000৳.
",281,500033,500314
2073,recursive,"
Product: Sony ZV-E1 Mirrorless Camera(Only Body). Category: Sony. Subcategory: Mirrorless Camera. Price: 227,000৳239,000৳.

Product: Sony a7R IVA 61MP Mirrorless Digital Camera (Body Only). Category: Sony. Subcategory: Mirrorless Camera. Price: 252,000৳265,000৳.
",264,500314,500578
2074,recursive,"
Product: Sony Alpha 7R IV 61MP Mirrorless Digital Camera (Body Only). Category: Sony. Subcategory: Mirrorless Camera. Price: 252,000৳265,000৳.

Product: Sony a7CR Mirrorless Camera (Body Only). Category: Sony. Subcategory: Mirrorless Camera. Price: 310,000৳320,000৳.
",268,500578,500846
2075,recursive,"
Product: Sony Alpha 7S III Mirrorless Full-frame Camera (Only Body). Category: Sony. Subcategory: Mirrorless Camera. Price: 318,000৳340,000৳.

Product: Sony a7R V 61MP Mirrorless Camera (Only Body). Category: Sony. Subcategory: Mirrorless Camera. Price: 345,000৳375,000৳.
",273,500846,501119
2076,recursive,"
Product: Sony Alpha A9 III Full Frame Mirrorless Camera (Only Body). Category: Sony. Subcategory: Mirrorless Camera. Price: 610,000৳650,000৳.

Product: Sony Alpha 1 Mirrorless Digital Camera (Body Only). Category: Sony. Subcategory: Mirrorless Camera. Price: 650,000৳700,000৳.
",278,501119,501397
2077,recursive,"
Product: Sony Alpha a1 II Mirrorless Camera (Body Only). Category: Sony. Subcategory: Mirrorless Camera. Price: 780,000৳830,000৳.

Product: Sony Alpha a7C Mirrorless Camera with 28-60mm Lens. Category: Sony. Subcategory: Mirrorless Camera. Price: Out Of Stock.
",262,501397,501659
2078,recursive,"
Product: 70mai A400 2K QHD Dash Cam Set. Category: Dash Cam. Subcategory: Camera. Price: Out Of Stock.

Product: 70mai Dash Cam Pro Plus+ Rear Cam Set. Category: Dash Cam. Subcategory: Camera. Price: Out Of Stock.
",215,501659,501874
2079,recursive,"
Product: 70mai M500 Dash Cam. Category: Dash Cam. Subcategory: Camera. Price: Out Of Stock.

Product: 70mai A800S 4K Dash Cam. Category: Dash Cam. Subcategory: Camera. Price: Out Of Stock.
",190,501874,502064
2080,recursive,"
Product: Panasonic AG-CX6 4K Professional Camcorder. Category: Video Camera. Subcategory: Camera. Price: 180,000৳183,000৳.

Product: Sony Alpha FX30 Cinema Line Camera (Body Only). Category: Video Camera. Subcategory: Camera. Price: 202,000৳219,000৳.
",252,502064,502316
2081,recursive,"
Product: Sony PXW-Z90 4K HDR XDCAM Camcorder. Category: Video Camera. Subcategory: Camera. Price: 245,000৳250,000৳.

Product: Sony HXR-NX5R Full HD compact professional NXCAM camcorder. Category: Video Camera. Subcategory: Camera. Price: 345,000৳350,000৳.
",257,502316,502573
2082,recursive,"
Product: Sony PXW-Z150 4K XDCAM Camcorder. Category: Video Camera. Subcategory: Camera. Price: 385,000৳420,000৳.

Product: Sony Alpha FX3 Cinema Line Full-frame Camera (Body Only). Category: Video Camera. Subcategory: Camera. Price: 415,000৳430,000৳.
",252,502573,502825
2083,recursive,"
Product: Sony FX6 Full-Frame Cinema Line Camera (Body Only). Category: Video Camera. Subcategory: Camera. Price: 635,000৳660,000৳.

Product: Sony PXW-FX9 XDCAM 6K Full-Frame Camcorder (Body Only). Category: Video Camera. Subcategory: Camera. Price: 1,380,000৳1,420,000৳.
",272,502825,503097
2084,recursive,"
Product: Panasonic HC-pv100 Professional Camcorder. Category: Video Camera. Subcategory: Camera. Price: Out Of Stock.

Product: Panasonic AG-UX90ED 4K Professional Camcorder. Category: Video Camera. Subcategory: Camera. Price: Out Of Stock.
",242,503097,503339
2085,recursive,"
Product: Panasonic AG-CX7 4K Professional Camcorder. Category: Video Camera. Subcategory: Camera. Price: Out Of Stock.

Product: FUJIFILM X-S20 Mirrorless Camera (Only Body). Category: FUJIFILM. Subcategory: Mirrorless Camera. Price: 151,000৳165,000৳.
",253,503339,503592
2086,recursive,"
Product: FUJIFILM X-T5 Mirrorless Camera (Body Only). Category: FUJIFILM. Subcategory: Mirrorless Camera. Price: 206,000৳225,000৳.

Product: FUJIFILM X-T5 Mirrorless Camera with 18-55mm Lens. Category: FUJIFILM. Subcategory: Mirrorless Camera. Price: 240,000৳260,000৳.
",270,503592,503862
2087,recursive,"
Product: FUJIFILM X-T3 Mirrorless Digital Camera (Body Only). Category: FUJIFILM. Subcategory: Mirrorless Camera. Price: Up Coming.

Product: FUJIFILM X-T30 II Mirrorless Camera (Body Only) Silver. Category: FUJIFILM. Subcategory: Mirrorless Camera. Price: Up Coming.
",269,503862,504131
2088,recursive,"
Product: FUJIFILM X-T30 II Mirrorless Camera with 18-55mm Lens. Category: FUJIFILM. Subcategory: Mirrorless Camera. Price: Up Coming.

Product: FUJIFILM X-T4 Mirrorless Digital Camera (Body Only). Category: FUJIFILM. Subcategory: Mirrorless Camera. Price: Up Coming.
",268,504131,504399
2089,recursive,"
Product: FUJIFILM X-Pro3 Mirrorless Camera (Body Only). Category: FUJIFILM. Subcategory: Mirrorless Camera. Price: Up Coming.

Product: FUJIFILM X-M5 Mirrorless Camera (Body Only). Category: FUJIFILM. Subcategory: Mirrorless Camera. Price: Out Of Stock.
",255,504399,504654
2090,recursive,"
Product: FUJIFILM X-S10 Mirrorless Digital Camera (Body Only). Category: FUJIFILM. Subcategory: Mirrorless Camera. Price: Out Of Stock.

Product: FUJIFILM X-T30 II Mirrorless Camera with XC 15-45mm OIS PZ Lens. Category: FUJIFILM. Subcategory: Mirrorless Camera. Price: Out Of Stock.
",285,504654,504939
2091,recursive,"
Product: FUJIFILM X-E4 Mirrorless Camera with 27mm Lens Silver. Category: FUJIFILM. Subcategory: Mirrorless Camera. Price: Out Of Stock.

Product: FUJIFILM X-T4 Mirrorless Camera with 18-55mm Lens. Category: FUJIFILM. Subcategory: Mirrorless Camera. Price: Out Of Stock.
",272,504939,505211
2092,recursive,"
Product: Godox TT600 Speedlite Master Slave Off GN60 Camera Flash. Category: Camera Flash. Subcategory: Camera Accessories. Price: 8,000৳8,500৳.

Product: Godox VING V850II Li-Ion Flash Kit. Category: Camera Flash. Subcategory: Camera Accessories. Price: 12,000৳15,000৳.
",272,505211,505483
2093,recursive,"
Product: Godox Ving V860III TTL Li-Ion Flash Kit for Canon Cameras. Category: Camera Flash. Subcategory: Camera Accessories. Price: 17,500৳18,500৳.

Product: Godox Ving V860III TTL Li-Ion Flash Kit for Nikon Cameras. Category: Camera Flash. Subcategory: Camera Accessories. Price: 18,500৳19,500৳.
",298,505483,505781
2094,recursive,"
Product: Godox Ving V860III TTL Li-Ion Flash Kit for FUJIFILM Cameras. Category: Camera Flash. Subcategory: Camera Accessories. Price: 18,500৳19,500৳.

Product: Godox V1 Flash for FUJIFILM. Category: Camera Flash. Subcategory: Camera Accessories. Price: 19,500৳20,500৳.
",271,505781,506052
2095,recursive,"
Product: Godox V1 Flash for Sony. Category: Camera Flash. Subcategory: Camera Accessories. Price: 19,500৳20,500৳.

Product: Godox V1 Flash for Canon. Category: Camera Flash. Subcategory: Camera Accessories. Price: 19,500৳20,500৳.
",231,506052,506283
2096,recursive,"
Product: Godox AD200Pro TTL Pocket Flash Kit. Category: Camera Flash. Subcategory: Camera Accessories. Price: 32,000৳34,000৳.

Product: Godox AD600BM Witstro Manual All-In-One Outdoor Flash. Category: Camera Flash. Subcategory: Camera Accessories. Price: 48,000৳50,000৳.
",272,506283,506555
2097,recursive,"
Product: Godox VING V860IIC TTL Li-Ion Flash Kit for Canon Cameras. Category: Camera Flash. Subcategory: Camera Accessories. Price: Up Coming.

Product: Godox V350S Flash for Sony Camera. Category: Camera Flash. Subcategory: Camera Accessories. Price: Out Of Stock.
",267,506555,506822
2098,recursive,"
Product: Godox QT400IIM Flash Head. Category: Camera Flash. Subcategory: Camera Accessories. Price: Out Of Stock.

Product: K&F Concept 3 in 1 Camera Cleaning Kit. Category: Camera Accessories. Subcategory: Camera. Price: 980৳.
",229,506822,507051
2099,recursive,"
Product: K&F Concept 4 in 1 DSLR Camera Cleaning Kit. Category: Camera Accessories. Subcategory: Camera. Price: 1,300৳1,350৳.

Product: K&F Concept KF34.042 Portable Metal Light Stand. Category: Camera Accessories. Subcategory: Camera. Price: 1,900৳2,400৳.
",258,507051,507309
2100,recursive,"
Product: Simpex Premium Light Stand Mark III. Category: Camera Accessories. Subcategory: Camera. Price: 1,500৳1,600৳.

Product: K&F Concept 49mm Blue Multi Coated HMC C Series CPL Camera Lens Filter. Category: Camera Accessories. Subcategory: Camera. Price: 1,650৳1,700৳.
",273,507309,507582
2101,recursive,"
Product: K&F Concept 52mm Blue Multi Coated HMC C Series CPL Camera Lens Filter. Category: Camera Accessories. Subcategory: Camera. Price: 1,650৳1,700৳.
",154,507582,507736
2102,recursive,"
Product: K&F Concept 55mm Blue Multi Coated HMC C Series CPL Camera Lens Filter. Category: Camera Accessories. Subcategory: Camera. Price: 1,650৳1,700৳.
",154,507736,507890
2103,recursive,"
Product: K&F Concept 58mm Blue Multi Coated HMC C Series CPL Camera Lens Filter. Category: Camera Accessories. Subcategory: Camera. Price: 1,650৳1,700৳.

Product: K&F Concept KF13.203 Waterproof Camera Lens Pouch Case Bag. Category: Camera Accessories. Subcategory: Camera. Price: 3,200৳4,200৳.
",296,507890,508186
2104,recursive,"
Product: K&F Concept KF13.202 Waterproof Camera Lens Pouch Case Bag. Category: Camera Accessories. Subcategory: Camera. Price: 3,000৳4,000৳.

Product: K&F Concept KF13.201 Waterproof Camera Lens Pouch Case Bag. Category: Camera Accessories. Subcategory: Camera. Price: 2,600৳3,200৳.
",284,508186,508470
2105,recursive,"
Product: K&F Concept KF13.189 Waterproof Camera Lens Pouch Case Bag. Category: Camera Accessories. Subcategory: Camera. Price: 2,400৳3,000৳.

Product: Nikon DSLR Camera Bag. Category: Camera Accessories. Subcategory: Camera. Price: 700৳1,000৳.
",245,508470,508715
2106,recursive,"
Product: Canon DSLR Camera Bag. Category: Camera Accessories. Subcategory: Camera. Price: 700৳1,000৳.

Product: K&F Concept KF13.117 4 Pocket Premium Filter Pouch Case Bag. Category: Camera Accessories. Subcategory: Camera. Price: 1,800৳1,900৳.
",246,508715,508961
2107,recursive,"
Product: K&F Concept KF13.167 Digital Camera Bag. Category: Camera Accessories. Subcategory: Camera. Price: 1,800৳2,000৳.
",123,508961,509084
2108,recursive,"
Product: K&F Concept ND2-ND400 62mm Fader Slim Professional Variable Neutral Density Camera Lens Filter. Category: Camera Accessories. Subcategory: Camera. Price: 2,000৳2,070৳.
",178,509084,509262
2109,recursive,"
Product: K&F Concept 49mm HMC ND2-ND400 Variable C Series ND Camera Lens Filter. Category: Camera Accessories. Subcategory: Camera. Price: 2,200৳2,250৳.
",154,509262,509416
2110,recursive,"
Product: K&F Concept 58mm HMC ND2-ND400 Variable C Series ND Camera Lens Filter. Category: Camera Accessories. Subcategory: Camera. Price: 2,200৳2,250৳.

Product: K&F Concept 49mm MRC ND1000 NANO-X PRO ND Camera Lens Filter. Category: Camera Accessories. Subcategory: Camera. Price: 2,200৳2,250৳.
",298,509416,509714
2111,recursive,"
Product: FUJIFILM INSTAX mini Instant Film (10 Sheets). Category: Instant Camera. Subcategory: Camera. Price: 2,000৳2,200৳.

Product: FUJIFILM INSTAX mini Instant Film (20 Sheets). Category: Instant Camera. Subcategory: Camera. Price: 3,100৳3,300৳.
",250,509714,509964
2112,recursive,"
Product: FUJIFILM INSTAX mini 12 Instant Film Camera. Category: Instant Camera. Subcategory: Camera. Price: 13,500৳15,000৳.

Product: FUJIFILM Instax Mini EVO Hybrid Instant Camera. Category: Instant Camera. Subcategory: Camera. Price: Up Coming.
",248,509964,510212
2113,recursive,"
Product: FUJIFILM INSTAX mini 11 Instant Film Camera. Category: Instant Camera. Subcategory: Camera. Price: Out Of Stock.

Product: K&F Concept 67mm Blue Multi Coated HMC C Series CPL Camera Lens Filter. Category: Lens Filter. Subcategory: Camera Accessories. Price: 2,200৳2,250৳.
",282,510212,510494
2114,recursive,"
Product: K&F Concept 52mm HMC ND2-ND400 Variable C Series ND Camera Lens Filter. Category: Lens Filter. Subcategory: Camera Accessories. Price: 2,300৳2,350৳.
",159,510494,510653
2115,recursive,"
Product: K&F Concept 55mm HMC ND2-ND400 Variable C Series ND Camera Lens Filter. Category: Lens Filter. Subcategory: Camera Accessories. Price: 2,300৳2,350৳.
",159,510653,510812
2116,recursive,"
Product: K&F Concept ND2-ND400 72mm Fader Slim Professional Variable Neutral Density Camera Lens Filter. Category: Lens Filter. Subcategory: Camera Accessories. Price: 2,350৳2,415৳.
",183,510812,510995
2117,recursive,"
Product: K&F Concept ND2-ND400 77mm Fader Slim Professional Variable Neutral Density Camera Lens Filter. Category: Lens Filter. Subcategory: Camera Accessories. Price: Out Of Stock.
",183,510995,511178
2118,recursive,"
Product: K&F Concept 62mm HMC ND2-ND400 Variable C Series ND Camera Lens Filter. Category: Lens Filter. Subcategory: Camera Accessories. Price: 2,400৳2,470৳.
",159,511178,511337
2119,recursive,"
Product: K&F Concept 72mm Blue Multi Coated HMC C Series CPL Camera Lens Filter. Category: Lens Filter. Subcategory: Camera Accessories. Price: 2,550৳2,600৳.
",159,511337,511496
2120,recursive,"
Product: K&F Concept SKU.2180V1 Matte Box Kit With Two 4×5.65″ Square Filters. Category: Lens Adapter. Subcategory: Camera Accessories. Price: 10,990৳14,900৳.
",160,511496,511656
2121,recursive,"
Product: K&F Concept SKU.2181V1 Matte Box Kit With Two 4×5.65″ Square Filters. Category: Lens Adapter. Subcategory: Camera Accessories. Price: 17,500৳21,000৳.
",160,511656,511816
2122,recursive,"
Product: K&F Concept SKU.2182V1 Matte Box Kit With ND4+ND32 and Two 4×5.65″ Square Filters. Category: Lens Adapter. Subcategory: Camera Accessories. Price: 22,500৳26,000৳.
",173,511816,511989
2123,recursive,"
Product: K&F Concept SKU.2364V1 Matte Box Kit With Two 4×5.65″ Square Filters. Category: Lens Adapter. Subcategory: Camera Accessories. Price: 9,000৳11,000৳.
",159,511989,512148
2124,recursive,"
Product: Viltrox EF-EOS M Lens Mount Adapter for Canon Cameras. Category: Lens Adapter. Subcategory: Camera Accessories. Price: 6,700৳7,000৳.

Product: Viltrox EF-EOS R Pro Lens Mount Adapter for Canon EF. Category: Lens Adapter. Subcategory: Camera Accessories. Price: 7,500৳8,000৳.
",285,512148,512433
2125,recursive,"
Product: Viltrox EF 1.4x Extender Teleconverter for Canon EF. Category: Lens Adapter. Subcategory: Camera Accessories. Price: 13,000৳14,000৳.

Product: Viltrox EF-NEX IV Lens Mount Adapter for Canon EF-Mount Lens. Category: Lens Adapter. Subcategory: Camera Accessories. Price: 13,900৳14,500৳.
",295,512433,512728
2126,recursive,"
Product: Sigma MC-11 Mount Converter/Lens Adapter (Sigma EF-Mount Lenses to Sony E). Category: Lens Adapter. Subcategory: Camera Accessories. Price: 20,500৳21,500৳.
",166,512728,512894
2127,recursive,"
Product: Nikon FTZ II Lens Mount Adapter for Nikon Cameras. Category: Lens Adapter. Subcategory: Camera Accessories. Price: 24,500৳29,000৳.

Product: Nikon Z Teleconverter TC-1.4x for Nikon Camera. Category: Lens Adapter. Subcategory: Camera Accessories. Price: 69,000৳70,000৳.
",279,512894,513173
2128,recursive,"
Product: Viltrox EF-EOS R Lens Mount Adapter for Canon EF. Category: Lens Adapter. Subcategory: Camera Accessories. Price: Out Of Stock.
",138,513173,513311
2129,recursive,"
Product: Viltrox EF-L Lens Mount Adapter for Canon EF or EF-S-Mount Lens to L-Mount Camera. Category: Lens Adapter. Subcategory: Camera Accessories. Price: Out Of Stock.
",171,513311,513482
2130,recursive,"
Product: Simpex 400 LED professional Video light with Battery and Charger. Category: Studio Light. Subcategory: Camera Accessories. Price: 4,500৳4,700৳.

Product: Simpex Led Video Light 520 with Battery & Charger. Category: Studio Light. Subcategory: Camera Accessories. Price: 5,300৳6,000৳.
",293,513482,513775
2131,recursive,"
Product: Yongnuo YN300 II LED Variable-Color On-Camera Light. Category: Studio Light. Subcategory: Camera Accessories. Price: 6,800৳7,000৳.

Product: Yongnuo YN360 II RGB LED Light Stick. Category: Studio Light. Subcategory: Camera Accessories. Price: 12,000৳14,000৳.
",269,513775,514044
2132,recursive,"
Product: Yongnuo LUX200 Bi-Color LED Camera Light. Category: Studio Light. Subcategory: Camera Accessories. Price: 32,000৳34,000৳.

Product: Yongnuo YN-600II LED Variable-Color On-Camera Light. Category: Studio Light. Subcategory: Camera Accessories. Price: 12,500৳14,500৳.
",275,514044,514319
2133,recursive,"
Product: Yongnuo YN300 III LED Variable-Color On-Camera Light. Category: Studio Light. Subcategory: Camera Accessories. Price: 7,200৳7,500৳.

Product: Godox SL60IID Daylight LED Video Light. Category: Studio Light. Subcategory: Camera Accessories. Price: 16,800৳18,000৳.
",272,514319,514591
2134,recursive,"
Product: Zhiyun MOLUS G60 60W Bi-Color Pocket COB Light. Category: Studio Light. Subcategory: Camera Accessories. Price: 17,300৳19,000৳.

Product: Godox LC500R RGB LED Light Stick (24""). Category: Studio Light. Subcategory: Camera Accessories. Price: 18,500৳19,000৳.
",268,514591,514859
2135,recursive,"
Product: Yongnuo YN1200 LED Panel Light. Category: Studio Light. Subcategory: Camera Accessories. Price: 21,500৳23,000৳.

Product: Godox SL150W II LED Video Light. Category: Studio Light. Subcategory: Camera Accessories. Price: 29,500৳32,000৳.
",245,514859,515104
2136,recursive,"
Product: Godox LED500LR Bi-Color Video Light. Category: Studio Light. Subcategory: Camera Accessories. Price: 16,500৳18,500৳.

Product: Godox SK400II-V Studio Flash Monolight. Category: Studio Light. Subcategory: Camera Accessories. Price: 18,000৳20,000৳.
",257,515104,515361
2137,recursive,"
Product: Godox ML60 Daylight LED Monolight. Category: Studio Light. Subcategory: Camera Accessories. Price: 20,500৳23,000৳.

Product: Godox ML60Bi Bi-Color LED Monolight. Category: Studio Light. Subcategory: Camera Accessories. Price: 25,500৳27,500৳.
",252,515361,515613
2138,recursive,"
Product: Godox ML60IIBi Bi-Color LED Monolight Handgrip Kit. Category: Studio Light. Subcategory: Camera Accessories. Price: 22,000৳25,000৳.

Product: Godox SL200III Daylight LED Video Light. Category: Studio Light. Subcategory: Camera Accessories. Price: 34,300৳37,000৳.
",273,515613,515886
2139,recursive,"
Product: Godox Studio Speedlite 60x90cm Rectangular Softbox. Category: Softbox. Subcategory: Camera Accessories. Price: 6,500৳7,000৳.

Product: Phottix Raja 65cm Quick-Folding SoftBox. Category: Softbox. Subcategory: Camera Accessories. Price: 9,000৳9,500৳.
",259,515886,516145
2140,recursive,"
Product: NEEWER 26''/65cm Octagonal Softbox. Category: Softbox. Subcategory: Camera Accessories. Price: 9,500৳10,000৳.

Product: Phottix Raja 85cm Quick-Folding Softbox. Category: Softbox. Subcategory: Camera Accessories. Price: 12,000৳13,500৳.
",246,516145,516391
2141,recursive,"
Product: Godox Photo Studio 80cm Portable Octagon Umbrella Softbox. Category: Softbox. Subcategory: Camera Accessories. Price: Out Of Stock.

Product: NEEWER NS65L Lantern Softbox One Step Quick Release. Category: Softbox. Subcategory: Camera Accessories. Price: Out Of Stock.
",278,516391,516669
2142,recursive,"
Product: K&F Concept KF18.0012 4-in-1 U-Shape Curved Foldable Lighting Reflector Panel With Carrying Bag. Category: Softbox. Subcategory: Camera Accessories. Price: 11,500৳15,000৳.
",182,516669,516851
2143,recursive,"
Product: Godox P90L 35"" Deep Parabolic Softbox. Category: Softbox. Subcategory: Camera Accessories. Price: 9,000৳10,000৳.

Product: K&F Concept KF31.030 Quick Release Plate. Category: Camera Tripod. Subcategory: Camera. Price: 700৳750৳.
",238,516851,517089
2144,recursive,"
Product: Digipod TR-452 Camera Tripod. Category: Camera Tripod. Subcategory: Camera. Price: 1,450৳1,650৳.

Product: Digipod TR-564 Camera Tripod. Category: Camera Tripod. Subcategory: Camera. Price: 1,650৳2,000৳.
",214,517089,517303
2145,recursive,"
Product: Digipod TR-462 Camera Tripod. Category: Camera Tripod. Subcategory: Camera. Price: 1,800৳1,950৳.

Product: K&F Concept MS-01 Versatile Flexible Gorillapod Phone Tripod. Category: Camera Tripod. Subcategory: Camera. Price: 2,200৳3,000৳.
",246,517303,517549
2146,recursive,"
Product: Telesin MT-11 Multifunctional Octopus Tripod. Category: Camera Tripod. Subcategory: Camera. Price: 1,350৳1,450৳.

Product: K&F Concept KF31.029V3 BH-25 Camera Tripod Ball Head. Category: Camera Tripod. Subcategory: Camera. Price: 2,500৳2,700৳.
",254,517549,517803
2147,recursive,"
Product: K&F Concept KF31.049 BH-26 Tripod Ball Head. Category: Camera Tripod. Subcategory: Camera. Price: 3,000৳3,200৳.

Product: K&F Concept KF31.023V3 BH-28L Professional Tripod Ball Head. Category: Camera Tripod. Subcategory: Camera. Price: 3,000৳3,300৳.
",260,517803,518063
2148,recursive,"
Product: Digipod TR-688V DSLR Camera Tripod. Category: Camera Tripod. Subcategory: Camera. Price: 3,100৳3,450৳.

Product: K&F Concept KF31.037 Tripod Extension Arm Centre Column. Category: Camera Tripod. Subcategory: Camera. Price: 3,800৳4,200৳.
",247,518063,518310
2149,recursive,"
Product: Yunteng VCT-691 Camera Tripod. Category: Camera Tripod. Subcategory: Camera. Price: 3,500৳3,550৳.

Product: Jmary KP-2599 Professional Camera Tripod and Monopod. Category: Camera Tripod. Subcategory: Camera. Price: 3,300৳3,600৳.
",239,518310,518549
2150,recursive,"
Product: Yunteng VCT-880 Aluminum Camera Tripod. Category: Camera Tripod. Subcategory: Camera. Price: 4,500৳4,600৳.

Product: Qihe QH-J260 Heavy Duty Professional Studio Light Stand. Category: Camera Tripod. Subcategory: Camera. Price: 2,500৳2,500৳.
",251,518549,518800
2151,recursive,"
Product: Yunteng VCT-998 Protable Camera Tripod. Category: Camera Tripod. Subcategory: Camera. Price: 5,000৳5,400৳.

Product: Yunteng VCT-999 Camera Tripod. Category: Camera Tripod. Subcategory: Camera. Price: 5,700৳6,000৳.
",225,518800,519025
2152,recursive,"
Product: K&F Concept KF09.101 Portable Camera Tripod. Category: Camera Tripod. Subcategory: Camera. Price: 7,000৳8,000৳.

Product: K&F Concept KF09.115 K234A0 Aluminum Portable Video Tripod. Category: Camera Tripod. Subcategory: Camera. Price: 7,000৳8,000৳.
",259,519025,519284
2153,recursive,"
Product: K&F Concept B234A1 Portable Tripod with Monopod. Category: Camera Tripod. Subcategory: Camera. Price: 9,500৳9,700৳.

Product: K&F Concept NP-FZ100 Dual Slot Quick Charger. Category: Battery & Charger. Subcategory: Camera Accessories. Price: 2,500৳2,600৳.
",265,519284,519549
2154,recursive,"
Product: K&F Concept NP-FW50 Dual Slot Quick Charger. Category: Battery & Charger. Subcategory: Camera Accessories. Price: 2,500৳2,700৳.

Product: K&F Concept EN-EL15C Camera Battery With Type C Charging Port. Category: Battery & Charger. Subcategory: Camera Accessories. Price: 5,200৳6,000৳.
",294,519549,519843
2155,recursive,"
Product: K&F Concept LP-E17 Dual Slot Battery Charger with Type-C Cable. Category: Battery & Charger. Subcategory: Camera Accessories. Price: 1,900৳2,500৳.
",157,519843,520000
2156,recursive,"
Product: K&F Concept NP-F 4-Channel Battery Charger with LCD Display. Category: Battery & Charger. Subcategory: Camera Accessories. Price: 6,500৳8,000৳.
",154,520000,520154
2157,recursive,"
Product: K&F Concept NP-W235 Dual Slot Battery Charger with Type-C Cable. Category: Battery & Charger. Subcategory: Camera Accessories. Price: 1,900৳2,500৳.
",158,520154,520312
2158,recursive,"
Product: K&F Concept LP-E6NH Dual Slot Battery Charger with Type-C Cable. Category: Battery & Charger. Subcategory: Camera Accessories. Price: 1,900৳2,500৳.
",158,520312,520470
2159,recursive,"
Product: K&F Concept EN-EL15 Dual Slot Battery Charger with Type-C Cable. Category: Battery & Charger. Subcategory: Camera Accessories. Price: 1,900৳2,500৳.
",158,520470,520628
2160,recursive,"
Product: K&F Concept NP-W235 Camera Battery for Fujifilm Camera. Category: Battery & Charger. Subcategory: Camera Accessories. Price: 2,800৳3,500৳.

Product: K&F Concept NP-FZ100 Camera Battery for Sony Camera. Category: Battery & Charger. Subcategory: Camera Accessories. Price: 4,000৳5,000৳.
",295,520628,520923
2161,recursive,"
Product: K&F Concept EN-EL15 2100mAh Camera Battery for Nikon Camera. Category: Battery & Charger. Subcategory: Camera Accessories. Price: 2,000৳2,500৳.

Product: K&F Concept LP-E17 Camera Battery for Canon Camera. Category: Battery & Charger. Subcategory: Camera Accessories. Price: 2,000৳2,500৳.
",299,520923,521222
2162,recursive,"
Product: K&F Concept NP-FW50 1100mAh Camera Battery for Sony Camera. Category: Battery & Charger. Subcategory: Camera Accessories. Price: 2,000৳2,500৳.
",153,521222,521375
2163,recursive,"
Product: K&F Concept LP-E10 Dual Camera Battery with Dual Charger. Category: Battery & Charger. Subcategory: Camera Accessories. Price: 4,300৳5,000৳.
",151,521375,521526
2164,recursive,"
Product: K&F Concept NP-F970 Dual Camera Battery with Dual Charger. Category: Battery & Charger. Subcategory: Camera Accessories. Price: 9,500৳11,000৳.
",153,521526,521679
2165,recursive,"
Product: K&F Concept NP-FW50 Camera Battery with Type-C Cable. Category: Battery & Charger. Subcategory: Camera Accessories. Price: 3,000৳3,200৳.
",147,521679,521826
2166,recursive,"
Product: K&F Concept KF13.106 4-Pocket Filter Case for Round or Square ND CPL 100x100mm. Category: Camera Bag. Subcategory: Camera Accessories. Price: 3,600৳3,900৳.
",166,521826,521992
2167,recursive,"
Product: K&F Concept KF13.062V1 Multifunctional Waterproof Camera Shoulder Backpack. Category: Camera Bag. Subcategory: Camera Accessories. Price: 5,100৳6,000৳.
",162,521992,522154
2168,recursive,"
Product: K&F Concept KF13.171 Beta Series 05L Sling Camera Backpack. Category: Camera Bag. Subcategory: Camera Accessories. Price: 4,700৳5,500৳.

Product: K&F Concept KF13.141 10L Beta Series Sling Camera Backpack. Category: Camera Bag. Subcategory: Camera Accessories. Price: 4,500৳4,600৳.
",292,522154,522446
2169,recursive,"
Product: K&F Concept KF13.157V3 Multifunctional Waterproof Camera Side Bag. Category: Camera Bag. Subcategory: Camera Accessories. Price: 4,900৳5,200৳.

Product: K&F Concept KF13.140 15L Beta DSLR Camera Backpack. Category: Camera Bag. Subcategory: Camera Accessories. Price: 6,400৳8,500৳.
",291,522446,522737
2170,recursive,"
Product: K&F Concept KF13.044 Multifunctional Waterproof Camera Backpack. Category: Camera Bag. Subcategory: Camera Accessories. Price: 6,800৳7,000৳.
",151,522737,522888
2171,recursive,"
Product: K&F Concept KF13.129 Multifunctional Waterproof Collapsible 2 in 1 Camera Backpack with Side Bag. Category: Camera Bag. Subcategory: Camera Accessories. Price: 6,800৳7,000৳.
",184,522888,523072
2172,recursive,"
Product: K&F Concept KF13.087 Multifunctional Waterproof Large Camera Backpack Blue. Category: Camera Bag. Subcategory: Camera Accessories. Price: 7,000৳7,200৳.

Product: K&F Concept KF13.119 Large Camera Backpack. Category: Camera Bag. Subcategory: Camera Accessories. Price: 7,000৳7,200৳.
",292,523072,523364
2173,recursive,"
Product: K&F Concept KF13.122 Professional Camera Backpack. Category: Camera Bag. Subcategory: Camera Accessories. Price: 7,000৳7,200৳.

Product: K&F Concept KF13.096V1 Professional Camera Backpack. Category: Camera Bag. Subcategory: Camera Accessories. Price: 7,000৳7,200৳.
",276,523364,523640
2174,recursive,"
Product: Wonderful DB2820 DSLR Camera Lens Dry Cabinet Box S Size. Category: Dry Cabinet. Subcategory: Camera Accessories. Price: Up Coming.

Product: WONDERFUL PC-7226 Waterproof Safety Professional Hard Case For Camera. Category: Dry Cabinet. Subcategory: Camera Accessories. Price: Up Coming.
",297,523640,523937
2175,recursive,"
Product: Wonderful DB3820 DSLR Camera Lens Dry Cabinet Box. Category: Dry Cabinet. Subcategory: Camera Accessories. Price: Out Of Stock.

Product: Wonderful DB3826 DSLR Camera Lens Dry Cabinet Box M Size. Category: Dry Cabinet. Subcategory: Camera Accessories. Price: Out Of Stock.
",283,523937,524220
2176,recursive,"
Product: Wonderful DB3828 DSLR Camera Lens Dry Cabinet Box. Category: Dry Cabinet. Subcategory: Camera Accessories. Price: Out Of Stock.

Product: Manbily KF-0 Camera Tripod Ball Head. Category: Manbily. Subcategory: Camera Tripod. Price: Up Coming.
",251,524220,524471
2177,recursive,"
Product: Digipod TR-472 Camera Tripod. Category: Digipod. Subcategory: Camera Tripod. Price: 1,900৳2,300৳.

Product: Libec TH-650EX Video Tripod with Fluid Tilter. Category: Libec. Subcategory: Camera Tripod. Price: 27,000৳32,000৳.
",233,524471,524704
2178,recursive,"
Product: Libec TH-X Camera Tripod. Category: Libec. Subcategory: Camera Tripod. Price: 34,000৳38,000৳.

Product: K&F Concept K254A3 Portable Tripod with Monopod. Category: K&F Concept. Subcategory: Camera Tripod. Price: 9,800৳10,000৳.
",236,524704,524940
2179,recursive,"
Product: K&F Concept KF09.087V4 S210 Aluminum Overhead Camera Tripod. Category: K&F Concept. Subcategory: Camera Tripod. Price: 10,500৳11,000৳.
",145,524940,525085
2180,recursive,"
Product: K&F Concept KF09.123 K254C2 BH-36L Portable Carbon Fiber Camera Tripod. Category: K&F Concept. Subcategory: Camera Tripod. Price: 11,200৳11,500৳.
",156,525085,525241
2181,recursive,"
Product: K&F Concept KF09.112 T255A3 Aluminum Ball Head Camera Tripod. Category: K&F Concept. Subcategory: Camera Tripod. Price: 11,500৳12,000৳.

Product: K&F Concept SA254T2 Lightweight Aluminum Compact Tripod. Category: K&F Concept. Subcategory: Camera Tripod. Price: 12,000৳12,500৳.
",287,525241,525528
2182,recursive,"
Product: K&F Concept KF09.109 D254C1 BH-28L Ball Head Carbon Fiber Camera Tripod. Category: K&F Concept. Subcategory: Camera Tripod. Price: 14,500৳15,000৳.
",157,525528,525685
2183,recursive,"
Product: K&F Concept KF09.086V1 T254A8 BH-28L Aluminum Overhead Camera Tripod. Category: K&F Concept. Subcategory: Camera Tripod. Price: 14,500৳15,000৳.
",154,525685,525839
2184,recursive,"
Product: K&F Concept K234A7+FH-03 Professional Video Tripod with Fluid Head. Category: K&F Concept. Subcategory: Camera Tripod. Price: 14,900৳17,000৳.
",152,525839,525991
2185,recursive,"
Product: K&F Concept KF31.087 FH-03 Professional Fluid Video Head For Pan & Tilt. Category: K&F Concept. Subcategory: Camera Tripod. Price: 8,200৳10,900৳.

Product: K&F Concept S225A1+BH-25 Portable Desktop Tripod. Category: K&F Concept. Subcategory: Camera Tripod. Price: 7,500৳8,000৳.
",288,525991,526279
2186,recursive,"
Product: K&F Concept B174A1 Portable Video Tripod. Category: K&F Concept. Subcategory: Camera Tripod. Price: 3,000৳3,500৳.

Product: Kingjoy VT-866 Aluminum Alloy Professional Camera Tripod. Category: Kingjoy. Subcategory: Camera Tripod. Price: Up Coming.
",257,526279,526536
2187,recursive,"
Product: Yunteng VCT-391 Camera Tripod. Category: Yunteng. Subcategory: Camera Tripod. Price: Up Coming.

Product: Yunteng VCT-590 Camera Tripod. Category: Yunteng. Subcategory: Camera Tripod. Price: Up Coming.
",212,526536,526748
2188,recursive,"
Product: Yunteng VCT-668 Camera Tripod. Category: Yunteng. Subcategory: Camera Tripod. Price: Out Of Stock.

Product: Jmary KP-2294 Professional Over Head Camera Tripod. Category: Jmary. Subcategory: Camera Tripod. Price: 3,400৳3,500৳.
",237,526748,526985
2189,recursive,"
Product: Jmary KP-2264 Professional Camera Tripod. Category: Jmary. Subcategory: Camera Tripod. Price: Out Of Stock.

Product: Manfrotto BeFree One Aluminium Travel Tripod with Head. Category: Manfrotto. Subcategory: Camera Tripod. Price: 11,500৳12,000৳.
",256,526985,527241
2190,recursive,"
Product: Manfrotto Off Road Ultra Lightweight Portable Aluminum Travel Tripod with Ball Head. Category: Manfrotto. Subcategory: Camera Tripod. Price: Out Of Stock.

Product: Fantech SS100 Tongsis Bluetooth Selfie Stick Tripod. Category: Fantech. Subcategory: Camera Tripod. Price: Out Of Stock.
",296,527241,527537
2191,recursive,"
Product: Fantech SS170 Tongsis Bluetooth Selfie Stick Tripod. Category: Fantech. Subcategory: Camera Tripod. Price: Out Of Stock.

Product: Meari S1 Plus 3MP Indoor Pan/Tilt Portable WiFi Camera. Category: Meari. Subcategory: Portable WiFi Camera. Price: 2,475৳2,700৳.
",270,527537,527807
2192,recursive,"
Product: Meari S2 Plus 3MP Outdoor Smart PTZ WiFi Camera. Category: Meari. Subcategory: Portable WiFi Camera. Price: 4,950৳5,450৳.

Product: Meari N2 3MP Outdoor Smart PTZ WiFi Camera With Solar Panel. Category: Meari. Subcategory: Portable WiFi Camera. Price: 8,625৳9,500৳.
",276,527807,528083
2193,recursive,"
Product: Meari N1 3MP Outdoor Smart WiFi Camera With Built-in Battery. Category: Meari. Subcategory: Portable WiFi Camera. Price: 7,475৳8,250৳.

Product: Meari V1 3MP Outdoor 4G PTZ Camera With Battery & Solar Panel. Category: Meari. Subcategory: Portable WiFi Camera. Price: Out Of Stock.
",291,528083,528374
2194,recursive,"
Product: Meari S3 3MP+3MP Dual-Lens Indoor Pan/Tilt Portable WiFi Camera. Category: Meari. Subcategory: Portable WiFi Camera. Price: Out Of Stock.

Product: Meari L1 Plus 3MP Outdoor Fixed Smart WiFi Camera. Category: Meari. Subcategory: Portable WiFi Camera. Price: Out Of Stock.
",282,528374,528656
2195,recursive,"
Product: Meari M1 2MP Indoor Fixed Smart Wi‑Fi Camera. Category: Meari. Subcategory: Portable WiFi Camera. Price: Out Of Stock.

Product: Meari S4 4MP Outdoor PTZ Smart WiFi Camera. Category: Meari. Subcategory: Portable WiFi Camera. Price: Out Of Stock.
",256,528656,528912
2196,recursive,"
Product: Imou Ranger Mini 3MP 2K Pan & Tilt Portable Wi-Fi Camera. Category: Portable WiFi Camera. Subcategory: Security. Price: 2,450৳2,500৳.

Product: EZVIZ CP1 Lite 2MP Pan & Tilt WiFi Dome IP Camera. Category: Portable WiFi Camera. Subcategory: Security. Price: 1,800৳.
",275,528912,529187
2197,recursive,"
Product: TP-Link Tapo C200C 2MP Wi-Fi IP Camera. Category: Portable WiFi Camera. Subcategory: Security. Price: 2,000৳.

Product: Tenda CP3 Pro 3MP WIFI Pan/Tilt Camera. Category: Portable WiFi Camera. Subcategory: Security. Price: 2,090৳2,300৳.
",246,529187,529433
2198,recursive,"
Product: TP-Link Tapo C202 2MP Pan & Tilt Wi-Fi Security Camera. Category: Portable WiFi Camera. Subcategory: Security. Price: 2,090৳2,390৳.

Product: Dahua DH-IPC-H3AE 3MP Indoor Fixed-focal Wi-Fi Pan & Tilt WiFi Camera. Category: Portable WiFi Camera. Subcategory: Security. Price: 1,936৳2,050৳.
",299,529433,529732
2199,recursive,"
Product: Havit IPC20 (2.0MP) Wi-Fi Dome IP Camera (Built-in Audio). Category: Portable WiFi Camera. Subcategory: Security. Price: 2,400৳2,500৳.

Product: Imou Ranger 2 WiFi Camera with 360 Degree Coverage. Category: Portable WiFi Camera. Subcategory: Security. Price: 2,140৳2,550৳.
",283,529732,530015
2200,recursive,"
Product: Imou IPC-K6CP-3H0WEB 3MP Wi-Fi Camera. Category: Portable WiFi Camera. Subcategory: Security. Price: 2,236৳2,600৳.

Product: Dahua DH-IPC-H5AE 5MP Indoor Pan & Tilt portable WiFi Camera. Category: Portable WiFi Camera. Subcategory: Security. Price: 2,430৳2,700৳.
",273,530015,530288
2201,recursive,"
Product: Tenda CP6 2K Security Pan Tilt Camera. Category: Portable WiFi Camera. Subcategory: Security. Price: 2,063৳2,250৳.

Product: Jovision JVS-HD301C 2.0MP Wi-Fi Camera. Category: Portable WiFi Camera. Subcategory: Security. Price: 2,249৳2,800৳.
",251,530288,530539
2202,recursive,"
Product: Tenda CP7 360° 4MP Pan Tilt Security Wifi IP Camera. Category: Portable WiFi Camera. Subcategory: Security. Price: 2,740৳3,100৳.

Product: ZKTeco C2B2 2MP Pan/Tilt WIFI Camera. Category: Portable WiFi Camera. Subcategory: Security. Price: 1,920৳3,200৳.
",263,530539,530802
2203,recursive,"
Product: ZKTeco C3A2 2MP Outdoor WIFI Camera. Category: Portable WiFi Camera. Subcategory: Security. Price: 2,140৳2,250৳.

Product: EZVIZ CS-H6c Pro 3MP Pan & Tilt Smart Portable WiFi Camera. Category: Portable WiFi Camera. Subcategory: Security. Price: 1,984৳3,200৳.
",269,530802,531071
2204,recursive,"
Product: Imou IPC-K6C-5H1WEB 5MP Wi-Fi Camera. Category: Portable WiFi Camera. Subcategory: Security. Price: 2,656৳3,200৳.

Product: Jovision JVS-H950E 3MP Wi-Fi Network IP Camera. Category: Jovision. Subcategory: Portable WiFi Camera. Price: 2,300৳2,750৳.
",258,531071,531329
2205,recursive,"
Product: Jovision JVS-H320C 3MP Pan/Tilt Wi-Fi Camera. Category: Jovision. Subcategory: Portable WiFi Camera. Price: 4,900৳.

Product: Jovision JVS-H322C 3MP Full-Color Pan/Tilt Wi-Fi Camera. Category: Jovision. Subcategory: Portable WiFi Camera. Price: 6,500৳.
",263,531329,531592
2206,recursive,"
Product: Jovision JVS-N97-X3 3MP Full-Color Wi-Fi Pan Tilt Camera. Category: Jovision. Subcategory: Portable WiFi Camera. Price: 6,600৳7,000৳.

Product: Jovision JVS-N98-X3 3MP Dual-Lens Full-Color Wi-Fi PTZ Camera. Category: Jovision. Subcategory: Portable WiFi Camera. Price: 6,890৳8,500৳.
",293,531592,531885
2207,recursive,"
Product: Jovision JVS-H930E 3MP Wi-Fi Pan Tilt IP Camera. Category: Jovision. Subcategory: Portable WiFi Camera. Price: Out Of Stock.

Product: Jovision JVS-N96-X3 3MP Wi-Fi Full-Color Pan Tilt IP Camera. Category: Jovision. Subcategory: Portable WiFi Camera. Price: Out Of Stock.
",282,531885,532167
2208,recursive,"
Product: Dahua DH-PFM3250D-1210BS 12V 1A Power Adapter. Category: Security. Price: 380৳.

Product: Hikvision DS-1H18-A 1080P 2MP Video Balun for CC Camera. Category: Security. Price: 250৳.

Product: ZKTeco EX-802 Exit Button. Category: Security. Price: 350৳450৳.
",264,532167,532431
2209,recursive,"
Product: Nexakey A86H Exit Button For DoorLock. Category: Security. Price: 650৳.

Product: Hikvision DS-2CE76D0T-ITPF 2 MP Indoor Fixed Turret Camera. Category: Security. Price: 1,030৳1,400৳.
",193,532431,532624
2210,recursive,"
Product: Hikvision DS-2CE16D0T-EXLPF (3.6mm) 2MP Smart Hybrid Light Bullet CC Camera. Category: Security. Price: 1,375৳.

Product: Hikvision DS-2CE76D0T-EXLPF (2.8mm) 2MP Smart Hybrid Light Dome CC Camera. Category: Security. Price: 1,375৳.
",242,532624,532866
2211,recursive,"
Product: Hikvision DS-2CE16D0T-ITF 2MP Bullet CCTV Camera. Category: Security. Price: 1,550৳.

Product: Hikvision DS-2CE11D0T-PIRLO 2MP Bullet CCTV Camera. Category: Security. Price: Out Of Stock.
",198,532866,533064
2212,recursive,"
Product: Hikvision DS-2CE76D0T-LPFS 2MP Dual Light Audio Fixed Turret Camera. Category: Security. Price: 1,705৳.

Product: Uniview UAC-T112-F28 Turret Analog Camera. Category: Security. Price: 1,650৳.
",202,533064,533266
2213,recursive,"
Product: Hikvision DS-2CE16D0T-LPFS 2MP Dual Light Audio Fixed Mini Bullet Camera. Category: Security. Price: 1,705৳.

Product: Uniview UAC-B112-F40 Bullet Analog Camera. Category: Security. Price: 1,200৳1,700৳.
",213,533266,533479
2214,recursive,"
Product: Dahua HAC-B1A21P-U-IL 2MP Smart Dual Light HDCVI Bullet CC Camera. Category: Security. Price: 1,150৳1,700৳.

Product: Dahua HAC-T1A21P-U-IL 2MP Smart Dual Light HDCVI Eyeball CC Camera. Category: Security. Price: 999৳1,700৳.
",235,533479,533714
2215,recursive,"
Product: ZKTeco ZK-D100S Hand Held Metal Detector. Category: Security. Price: 1,800৳.

Product: Imou Bulb Cam WiFi Camera. Category: Imou. Subcategory: Portable WiFi Camera. Price: 3,150৳3,500৳.
",196,533714,533910
2216,recursive,"
Product: Imou Bullet 2E 3MP Outdoor WiFi IP Camera. Category: Imou. Subcategory: Portable WiFi Camera. Price: 3,145৳3,700৳.

Product: Imou Cruiser SC 5MP 3K Pan & Tilt Wi-Fi IP Camera. Category: Imou. Subcategory: Portable WiFi Camera. Price: Out Of Stock.
",258,533910,534168
2217,recursive,"
Product: Imou Ranger Dual Lens 6MP Pan & Tilt WiFi Camera. Category: Imou. Subcategory: Portable WiFi Camera. Price: 4,900৳5,500৳.

Product: Imou Cruiser 4G Dome IP Camera. Category: Imou. Subcategory: Portable WiFi Camera. Price: 4,446৳5,700৳.
",246,534168,534414
2218,recursive,"
Product: Imou Rex VT 5MP Wi-Fi IP Camera with Display. Category: Imou. Subcategory: Portable WiFi Camera. Price: 5,550৳5,900৳.

Product: Imou Cruiser Dual Lens 6MP 2K Outdoor WiFi Camera. Category: Imou. Subcategory: Portable WiFi Camera. Price: 7,690৳8,000৳.
",261,534414,534675
2219,recursive,"
Product: Imou Ranger S2 2MP 360-degree Portable WiFi Camera. Category: Imou. Subcategory: Portable WiFi Camera. Price: Out Of Stock.

Product: Imou IPC-TA22CP Ranger 2C IP Camera. Category: Imou. Subcategory: Portable WiFi Camera. Price: Out Of Stock.
",253,534675,534928
2220,recursive,"
Product: Imou Ranger RC 3MP Indoor Portable Wi-Fi Camera. Category: Imou. Subcategory: Portable WiFi Camera. Price: Out Of Stock.

Product: Imou REX 2D 3MP Indoor Pan & Tilt WiFi Camera. Category: Imou. Subcategory: Portable WiFi Camera. Price: Out Of Stock.
",260,534928,535188
2221,recursive,"
Product: Imou Ranger Pro IP Camera with 360 Degree Coverage. Category: Imou. Subcategory: Portable WiFi Camera. Price: Out Of Stock.

Product: Imou Cruiser SE 2MP Outdoor Pan & Tilt Wi-Fi Camera. Category: Imou. Subcategory: Portable WiFi Camera. Price: Out Of Stock.
",269,535188,535457
2222,recursive,"
Product: Imou IPC-S21FEP Cruiser SE 2MP Outdoor Pan & Tilt Wi-Fi Camera. Category: Imou. Subcategory: Portable WiFi Camera. Price: Out Of Stock.

Product: Imou Rex 4MP Dome Wifi IP Camera. Category: Imou. Subcategory: Portable WiFi Camera. Price: Out Of Stock.
",262,535457,535719
2223,recursive,"
Product: Imou Cruiser 2 3MP Outdoor Security Wi-Fi Camera. Category: Imou. Subcategory: Portable WiFi Camera. Price: Out Of Stock.

Product: EZVIZ H3c 3MP Wi-Fi Smart Home Outdoor Security Camera with Audio. Category: EZVIZ. Subcategory: Portable WiFi Camera. Price: 4,200৳4,700৳.
",282,535719,536001
2224,recursive,"
Product: EZVIZ CS-H8c 3MP PoE Pan & Tilt WiFi Camera. Category: EZVIZ. Subcategory: Portable WiFi Camera. Price: 5,990৳.

Product: EZVIZ CS-H6C Pro 5MP Pan & Tilt Portable WiFi Camera. Category: EZVIZ. Subcategory: Portable WiFi Camera. Price: 3,190৳3,300৳.
",259,536001,536260
2225,recursive,"
Product: EZVIZ CS-H8c Pro 3MP 2K Pan & Tilt Wi-Fi IP Camera. Category: EZVIZ. Subcategory: Portable WiFi Camera. Price: 4,250৳.

Product: EZVIZ H6 5MP Pan & Tilt Wi-Fi Smart Home Security Camera. Category: EZVIZ. Subcategory: Portable WiFi Camera. Price: 4,850৳5,200৳.
",270,536260,536530
2226,recursive,"
Product: EZVIZ H8C 4G 3MP Pan & Tilt Smart Home Security Camera. Category: EZVIZ. Subcategory: Portable WiFi Camera. Price: 5,050৳5,400৳.

Product: EZVIZ H7c 4MP Dual Lens 2K Pan & Tilt Portable WiFi Camera. Category: EZVIZ. Subcategory: Portable WiFi Camera. Price: 4,750৳5,500৳.
",282,536530,536812
2227,recursive,"
Product: EZVIZ H3c 4MP Wi-Fi Smart Home Outdoor Security Camera with Audio. Category: EZVIZ. Subcategory: Portable WiFi Camera. Price: 4,900৳5,600৳.

Product: EZVIZ CS-H8c Pro 5MP 3K Pan & Tilt Wi-Fi IP Camera. Category: EZVIZ. Subcategory: Portable WiFi Camera. Price: 4,800৳.
",279,536812,537091
2228,recursive,"
Product: EZVIZ H9c Dual 2K 3MP+3MP Pan & Tilt WiFi Camera. Category: EZVIZ. Subcategory: Portable WiFi Camera. Price: 6,699৳6,900৳.

Product: EZVIZ CS-CB2 2MP Outdoor Wi-Fi Smart Home Battery Security Camera. Category: EZVIZ. Subcategory: Portable WiFi Camera. Price: 6,500৳6,800৳.
",283,537091,537374
2229,recursive,"
Product: EZVIZ EB5 4K 8MP Type-C Outdoor WiFi Camera With Solar Battery. Category: EZVIZ. Subcategory: Portable WiFi Camera. Price: 13,800৳.

Product: EZVIZ CS-H6C 360° Pan & Tilt Smart Home Security Camera. Category: EZVIZ. Subcategory: Portable WiFi Camera. Price: Out Of Stock.
",282,537374,537656
2230,recursive,"
Product: EZVIZ CS-C6N 2MP Wi-Fi PT IP Camera. Category: EZVIZ. Subcategory: Portable WiFi Camera. Price: Out Of Stock.

Product: EZVIZ H6c Pro 2MP Pan & Tilt Smart Home Security Camera. Category: EZVIZ. Subcategory: Portable WiFi Camera. Price: Out Of Stock.
",260,537656,537916
2231,recursive,"
Product: EZVIZ H6c Pro 4MP Pan & Tilt Smart Home Security Camera. Category: EZVIZ. Subcategory: Portable WiFi Camera. Price: Out Of Stock.

Product: EZVIZ CS-H6C Pro 4MP Pan & Tilt Smart Portable WiFi Camera. Category: EZVIZ. Subcategory: Portable WiFi Camera. Price: Out Of Stock.
",283,537916,538199
2232,recursive,"
Product: EZVIZ CS-C3N A0-3G2WFL1 Wifi Bullet 2mp Outdoor IP Camera. Category: EZVIZ. Subcategory: Portable WiFi Camera. Price: Out Of Stock.

Product: Tenda CH3-WCA Smart Full-Color Night Vision Wi-Fi IP Camera. Category: Tenda. Subcategory: Portable WiFi Camera. Price: Out Of Stock.
",286,538199,538485
2233,recursive,"
Product: Tenda CP3 360° 2MP Pan Tilt Security Wifi IP Camera. Category: Tenda. Subcategory: Portable WiFi Camera. Price: Out Of Stock.

Product: Tenda CH3-WCA v2.0 Smart Full-Color Night Vision Wi-Fi IP Camera. Category: Tenda. Subcategory: Portable WiFi Camera. Price: 4,000৳.
",279,538485,538764
2234,recursive,"
Product: Tenda CH7-WCA 4MP AI Smart Outdoor Pan & Tilt WiFi Camera. Category: Tenda. Subcategory: Portable WiFi Camera. Price: Out Of Stock.

Product: Tenda CH9-WCA 6MP Dual-lens Smart Outdoor Pan & Tilt WiFi Camera. Category: Tenda. Subcategory: Portable WiFi Camera. Price: Out Of Stock.
",291,538764,539055
2235,recursive,"
Product: Tenda CP3 V3 360° 3MP Pan Tilt Security Wi-Fi IP Camera. Category: Tenda. Subcategory: Portable WiFi Camera. Price: Out Of Stock.

Product: TP-Link Tapo C320WS 4MP Outdoor Wi-Fi Night Vision Security Camera. Category: TP-Link. Subcategory: Portable WiFi Camera. Price: 4,002৳4,350৳.
",293,539055,539348
2236,recursive,"
Product: TP-Link Tapo C225 4MP Pan/Tilt AI Home Security Wi-Fi Camera. Category: TP-Link. Subcategory: Portable WiFi Camera. Price: 4,441৳4,700৳.

Product: TP-Link Tapo C200 2MP Home Security Wi-Fi Dome IP Camera. Category: TP-Link. Subcategory: Portable WiFi Camera. Price: Out Of Stock.
",290,539348,539638
2237,recursive,"
Product: TP-Link Tapo C210 3MP Pan & Tilt Wi-Fi Security Camera. Category: TP-Link. Subcategory: Portable WiFi Camera. Price: Out Of Stock.

Product: TP-Link Tapo C212 3MP Pan & Tilt Wi-Fi Security Camera. Category: TP-Link. Subcategory: Portable WiFi Camera. Price: Out Of Stock.
",282,539638,539920
2238,recursive,"
Product: TP-Link Tapo C310 Outdoor Security Wi-Fi IP Camera. Category: TP-Link. Subcategory: Portable WiFi Camera. Price: Out Of Stock.

Product: TP-Link Tapo C500 2MP Outdoor Pan Tilt Security WiFi IP Camera. Category: TP-Link. Subcategory: Portable WiFi Camera. Price: Out Of Stock.
",286,539920,540206
2239,recursive,"
Product: Xiaomi Mi C200 360° 1080P Home Security Smart Camera. Category: Xiaomi. Subcategory: Portable WiFi Camera. Price: Out Of Stock.

Product: Xiaomi Mi MJSXJ05CM 360° Motion Detection WiFi Security Camera White. Category: Xiaomi. Subcategory: Portable WiFi Camera. Price: Out Of Stock.
",292,540206,540498
2240,recursive,"
Product: Imilab CMSXJ16A 360° 1080P Basic Home Security Camera White. Category: Xiaomi. Subcategory: Portable WiFi Camera. Price: Out Of Stock.

Product: Xiaomi Mi MJSXJ10CM 360° Kamepa Home Wi-Fi Security Camera White. Category: Xiaomi. Subcategory: Portable WiFi Camera. Price: Out Of Stock.
",295,540498,540793
2241,recursive,"
Product: Imilab C20 360° 2MP Home Security Dome Wi-Fi IP Camera. Category: Xiaomi. Subcategory: Portable WiFi Camera. Price: Out Of Stock.
",140,540793,540933
2242,recursive,"
Product: Xiaomi Mi MJSXJ03HL Magnetic Mount 360° 2K Smart Home Security WiFi Camera. Category: Xiaomi. Subcategory: Portable WiFi Camera. Price: Out Of Stock.
",160,540933,541093
2243,recursive,"
Product: Xiaomi Mi XMC01 C300 360° 2K Smart Home Security WiFi Camera. Category: Xiaomi. Subcategory: Portable WiFi Camera. Price: Out Of Stock.

Product: Xiaomi C301 3MP 2K 360° Smart WiFi Camera. Category: Xiaomi. Subcategory: Portable WiFi Camera. Price: Out Of Stock.
",273,541093,541366
2244,recursive,"
Product: Xiaomi Mi MWC14 1080p 2MP Wireless Outdoor Security Wifi IP Camera. Category: Xiaomi. Subcategory: Portable WiFi Camera. Price: Out Of Stock.
",152,541366,541518
2245,recursive,"
Product: Xiaomi Mi MWC13 1080p 2MP Wireless Outdoor Security Wifi IP Camera. Category: Xiaomi. Subcategory: Portable WiFi Camera. Price: Out Of Stock.

Product: Vimtag 843 2MP Outdoor PTZ 360° WiFi IP Camera. Category: Vimtag. Subcategory: Portable WiFi Camera. Price: 6,900৳.
",278,541518,541796
2246,recursive,"
Product: Vimtag 843 2MP Outdoor PTZ 360° 3G/4G IP Camera. Category: Vimtag. Subcategory: Portable WiFi Camera. Price: Out Of Stock.

Product: Jovision JVS-N933-KDL-PE 3MP Full Color Dome IP Camera. Category: Jovision. Subcategory: IP Camera. Price: 2,900৳.
",258,541796,542054
2247,recursive,"
Product: Jovision JVS-N937-SDL 3MP Full-Color PoE Dome IP Camera. Category: Jovision. Subcategory: IP Camera. Price: 4,200৳.

Product: Jovision JVS-N537-SDL 5MP Full-Color Video Audio PoE IP Camera. Category: Jovision. Subcategory: IP Camera. Price: 4,400৳.
",259,542054,542313
2248,recursive,"
Product: Jovision JVS-N517-SDL 5MP Full-Color Audio POE IP Camera. Category: Jovision. Subcategory: IP Camera. Price: 4,900৳5,500৳.

Product: Jovision JVS-N516-YDL 5MP Full-Color Video Audio PoE IP Bullet Camera. Category: Jovision. Subcategory: IP Camera. Price: 5,800৳.
",273,542313,542586
2249,recursive,"
Product: Jovision JVS-N837-UDL 8MP Full-Color Audio PoE Dome IP Camera. Category: Jovision. Subcategory: IP Camera. Price: 7,500৳.

Product: Jovision JVS-N519-PWL 5MP Full Color PoE IP Camera. Category: Jovision. Subcategory: IP Camera. Price: 9,500৳.
",253,542586,542839
2250,recursive,"
Product: Jovision JVS-N518-ZDL 5MP Full-Color Video & Audio AI Network Camera. Category: Jovision. Subcategory: IP Camera. Price: 18,000৳.

Product: Jovision JVS-N933-K1-PE 3.0MP Starlight Audio PoE Dome IP Camera. Category: Jovision. Subcategory: IP Camera. Price: Out Of Stock.
",281,542839,543120
2251,recursive,"
Product: Jovision JVS-N913-K1-PE 3MP Starlight Audio PoE IP Camera. Category: Jovision. Subcategory: IP Camera. Price: Out Of Stock.

Product: Jovision JVS-N916-KDL-PE 3MP PoE IP Camera. Category: Jovision. Subcategory: IP Camera. Price: Out Of Stock.
",253,543120,543373
2252,recursive,"
Product: Jovision JVS-N430K-SDL 8MP 4K Metal Full Color Eyeball Network Camera. Category: Jovision. Subcategory: IP Camera. Price: Out Of Stock.

Product: Jovision JVS-N410K-SDL 8MP 4K Metal Full Color Bullet Network Camera. Category: Jovision. Subcategory: IP Camera. Price: Out Of Stock.
",291,543373,543664
2253,recursive,"
Product: Hikvision HiLook IPC-B121H-C 2MP Bullet IP Camera. Category: Hikvision. Subcategory: IP Camera. Price: 1,830৳1,850৳.

Product: Hikvision HiLook IPC-T221H 2MP Dome IP Camera. Category: Hikvision. Subcategory: IP Camera. Price: 1,900৳.
",244,543664,543908
2254,recursive,"
Product: Hikvision DS-2CD1323G0E-I 2MP Basic IR Mini Dome IP-Camera. Category: Hikvision. Subcategory: IP Camera. Price: 2,695৳.

Product: Hikvision DS-2CD1T23G0-I 2MP Basic IR Bullet IP Camera. Category: Hikvision. Subcategory: IP Camera. Price: 2,860৳.
",256,543908,544164
2255,recursive,"
Product: Hikvision DS-2CD1T23G2-LIU 2MP Bullet IP Camera. Category: Hikvision. Subcategory: IP Camera. Price: 3,850৳.

Product: Hikvision DS-2CD1323G2-LIU 2MP Smart Hybrid Light Fixed Turret Network Camera. Category: Hikvision. Subcategory: IP Camera. Price: 3,410৳.
",268,544164,544432
2256,recursive,"
Product: Hikvision DS-2CD1027G2H-LIU (4mm) 2MP ColorVu Audio Bullet IP Camera. Category: Hikvision. Subcategory: IP Camera. Price: 4,400৳.

Product: Hikvision DS-2CD1327G0-L 2MP ColorVu PoE IP Camera. Category: Hikvision. Subcategory: IP Camera. Price: 3,785৳4,350৳.
",268,544432,544700
2257,recursive,"
Product: Hikvision DS-2CD1327G2H-LIU 2MP 2.8mm Audio Dome Network IP Camera. Category: Hikvision. Subcategory: IP Camera. Price: 4,400৳.

Product: Hikvision DS-2CD1143G2-LIU 4MP Smart Hybrid Light Fixed Dome Network Camera. Category: Hikvision. Subcategory: IP Camera. Price: 5,170৳.
",285,544700,544985
2258,recursive,"
Product: Hikvision DS-2CD1043G2-LIU 4MP Smart Hybrid Light Bullet IP Camera. Category: Hikvision. Subcategory: IP Camera. Price: 4,950৳.

Product: Hikvision DS-2CD1T43G2-LIU 4MP Bullet IP Camera. Category: Hikvision. Subcategory: IP Camera. Price: 5,300৳5,400৳.
",263,544985,545248
2259,recursive,"
Product: Hikvision DS-2CD2023G2-IU 2MP AcuSense Built-In-Mic Fixed Bullet IP Camera. Category: Hikvision. Subcategory: IP Camera. Price: 5,500৳.

Product: Hikvision DS-2CD1163G2-LIU 6MP Smart Hybrid Light Dome IP Camera. Category: Hikvision. Subcategory: IP Camera. Price: 5,500৳.
",282,545248,545530
2260,recursive,"
Product: Hikvision DS-2CD1347G2H-LIU 4 MP ColorVu Fixed Turret Network Camera. Category: Hikvision. Subcategory: IP Camera. Price: 5,830৳.
",140,545530,545670
2261,recursive,"
Product: Hikvision DS-2DE2C400MWG-E (4mm) 4MP Fixed Outdoor Smart Hybrid-light PT IP Camera. Category: Hikvision. Subcategory: IP Camera. Price: 6,499৳7,000৳.

Product: Hikvision DS-2CD2T43G2-4I 4MP IP Bullet Camera. Category: Hikvision. Subcategory: IP Camera. Price: 8,300৳8,500৳.
",284,545670,545954
2262,recursive,"
Product: Hikvision  DS-2CD1043G2-LIUF 4MP Smart Hybrid Light Bullet IP Camera. Category: Hikvision. Subcategory: IP Camera. Price: Up Coming.

Product: Hikvision DS-2CD1T23G2-I 2MP Fixed Bullet Network Camera. Category: Hikvision. Subcategory: IP Camera. Price: Out Of Stock.
",277,545954,546231
2263,recursive,"
Product: Hikvision DS-2CD1223G0E-I 2MP Basic IR Mini Bullet IP-Camera. Category: Hikvision. Subcategory: IP Camera. Price: Out Of Stock.

Product: Dahua DH-IPC-HDW1230T2-S5 2MP Dome IP Camera. Category: Dahua. Subcategory: IP Camera. Price: 2,590৳2,700৳.
",256,546231,546487
2264,recursive,"
Product: Dahua DH-IPC-HFW1230TL2-S5 2MP Bullet IP Camera. Category: Dahua. Subcategory: IP Camera. Price: 2,590৳2,800৳.

Product: Dahua DH-IPC-HFW1239TL1-A-IL 2MP Smart Dual Light Bullet IP Camera. Category: Dahua. Subcategory: IP Camera. Price: 3,350৳3,950৳.
",261,546487,546748
2265,recursive,"
Product: Dahua DH-IPC-HDW1239V-A-IL 2MP Smart Dual Light Eyeball IP Camera. Category: Dahua. Subcategory: IP Camera. Price: 3,950৳.

Product: Dahua DH-IPC-HFW1230S1-A 2MP 30 Meter IR Bullet Network Camera. Category: Dahua. Subcategory: IP Camera. Price: 3,700৳4,000৳.
",269,546748,547017
2266,recursive,"
Product: Dahua DH-IPC-HDW1230S-S5 2MP IR Dome Network Camera. Category: Dahua. Subcategory: IP Camera. Price: 4,200৳.

Product: Dahua DH-IPC-HFW1439TL1-A-IL 4MP Smart Dual Light Bullet IP Camera. Category: Dahua. Subcategory: IP Camera. Price: 3,800৳4,550৳.
",259,547017,547276
2267,recursive,"
Product: Dahua DH-IPC-HDW1439V-A-IL 4MP Smart Dual Light Eyeball IP Camera. Category: Dahua. Subcategory: IP Camera. Price: 3,800৳4,550৳.

Product: Dahua IPC-HFW1230S1P 2MP IR-30M Bullet Network Camera. Category: Dahua. Subcategory: IP Camera. Price: Out Of Stock.
",266,547276,547542
2268,recursive,"
Product: Dahua IPC-HDW1230T1P 2MP IR-30M IR Eyeball Camera. Category: Dahua. Subcategory: IP Camera. Price: Out Of Stock.

Product: Dahua IPC-HDW1239T1P-LED 2MP Lite Full-color Fixed-focal Eyeball Network Camera. Category: Dahua. Subcategory: IP Camera. Price: Out Of Stock.
",276,547542,547818
2269,recursive,"
Product: Dahua IPC-HDW1239T1-A-LED 2.0MP Full color Audio Dome IP Camera. Category: Dahua. Subcategory: IP Camera. Price: Out Of Stock.

Product: Dahua IPC-HDW1230T1-A 2MP IR 30M Dome Network IP Camera. Category: Dahua. Subcategory: IP Camera. Price: Out Of Stock.
",266,547818,548084
2270,recursive,"
Product: Dahua IPC-HFW1239S1P-LED 2MP Lite Full-color Fixed-focal Bullet Network Camera. Category: Dahua. Subcategory: IP Camera. Price: Out Of Stock.

Product: Dahua IPC-HFW1239S1-A-LED 2MP Full-Color Audio Bullet IP Camera. Category: Dahua. Subcategory: IP Camera. Price: Out Of Stock.
",289,548084,548373
2271,recursive,"
Product: Dahua DH-IPC-HFW1431S1-S4 4MP IR Fixed-focal Bullet Camera. Category: Dahua. Subcategory: IP Camera. Price: Out Of Stock.

Product: Dahua DH-IPC-HDW1431T1-S4 4MP IR Fixed-focal Eyeball IP Camera. Category: Dahua. Subcategory: IP Camera. Price: Out Of Stock.
",268,548373,548641
2272,recursive,"
Product: Dahua DH-IPC-HFW1439S1-LED-S4 4MP Lite Full-color Bullet IP Camera. Category: Dahua. Subcategory: IP Camera. Price: Out Of Stock.

Product: Dahua IPC-HDW1431S 4 Megapixel WDR IR Eyeball Network Camera. Category: Dahua. Subcategory: IP Camera. Price: Out Of Stock.
",274,548641,548915
2273,recursive,"
Product: Dahua DH-IPC-HDW1439T1P-A-LED-S4 4MP Full-color Fixed-focal Eyeball IP Camera. Category: Dahua. Subcategory: IP Camera. Price: Out Of Stock.

Product: TP-Link VIGI C420I 2MP IR Turret IP Camera. Category: IP Camera. Subcategory: Security. Price: 2,700৳.
",264,548915,549179
2274,recursive,"
Product: TP-Link VIGI C420I 2MP 4mm Lens IR Turret IP Camera. Category: IP Camera. Subcategory: Security. Price: 2,106৳2,700৳.

Product: TP-Link VIGI C400HP 3MP IR Turret IP Camera. Category: IP Camera. Subcategory: Security. Price: 2,372৳2,790৳.
",248,549179,549427
2275,recursive,"
Product: Uniview IPC3612LB-SF28(40)-A 2MP Fixed  IR Dome IP Camera. Category: IP Camera. Subcategory: Security. Price: 2,800৳.

Product: TP-Link VIGI C340I 4MP IR Bullet IP Camera. Category: IP Camera. Subcategory: Security. Price: 2,800৳2,900৳.
",247,549427,549674
2276,recursive,"
Product: TP-Link VIGI C320I 2.8mm 2MP IR Bullet IP Camera. Category: IP Camera. Subcategory: Security. Price: 2,690৳3,000৳.

Product: TP-Link VIGI C430I 3MP 4mm Lens IR Turret IP Camera. Category: IP Camera. Subcategory: Security. Price: 2,650৳3,290৳.
",253,549674,549927
2277,recursive,"
Product: TP-Link VIGI C220I 2MP IR Dome IP Camera. Category: IP Camera. Subcategory: Security. Price: 3,050৳3,300৳.

Product: TP-Link VIGI C220I 2MP 4mm Lens IR Dome IP Camera. Category: IP Camera. Subcategory: Security. Price: 2,888৳3,319৳.
",243,549927,550170
2278,recursive,"
Product: TP-Link VIGI C440I 4MP IR Turret IP Camera. Category: IP Camera. Subcategory: Security. Price: 2,700৳3,349৳.

Product: TP-Link VIGI C440I 4MP 4mm Lens IR Turret IP Camera. Category: IP Camera. Subcategory: Security. Price: 2,700৳3,349৳.
",247,550170,550417
2279,recursive,"
Product: Uniview IPC2123LB-AF40KM-G 3MP HD Fixed IR Bullet IP Camera. Category: IP Camera. Subcategory: Security. Price: 3,500৳.

Product: Uniview IPC3613LB-AF28K-G 3MP HD IR Fixed Eyeball IP Camera. Category: Uniview. Subcategory: IP Camera. Price: 2,450৳3,650৳.
",265,550417,550682
2280,recursive,"
Product: Uniview IPC2122LB-SF40-A 2MP IR Mini IP Bullet Camera. Category: Uniview. Subcategory: IP Camera. Price: 2,900৳3,790৳.

Product: Uniview IPC2122LB-TS-F 2MP Fixed Bullet Network Camera. Category: Uniview. Subcategory: IP Camera. Price: 4,000৳.
",253,550682,550935
2281,recursive,"
Product: Uniview IPC322LB-SF28-A 2MP Vandal-resistant Network IR Dome Camera. Category: Uniview. Subcategory: IP Camera. Price: 4,000৳.

Product: Uniview IPC2122LB-DSF28KM 2MP Mini Fixed Bullet Network Camera. Category: Uniview. Subcategory: IP Camera. Price: 4,190৳.
",269,550935,551204
2282,recursive,"
Product: Uniview IPC3612LB-SF28-A 2MP Mini Fixed  IR Dome IP Camera. Category: Uniview. Subcategory: IP Camera. Price: 4,200৳.

Product: Uniview IPC3612ER3-PF40-B 2MP IR Fixed Dome IP Camera. Category: Uniview. Subcategory: IP Camera. Price: 4,300৳.
",251,551204,551455
2283,recursive,"
Product: Uniview IPC222ER-F36 2MP IR Bullet IP Camera. Category: Uniview. Subcategory: IP Camera. Price: 4,500৳.

Product: Uniview IPC3612LB-AF28KT-WL 2MP HD Fixed Dome IP Camera. Category: Uniview. Subcategory: IP Camera. Price: 4,650৳.
",239,551455,551694
2284,recursive,"
Product: Uniview IPC2122LB-ADF40KM-G 2MP HD WDR Fixed IR Bullet IP Camera. Category: Uniview. Subcategory: IP Camera. Price: 4,900৳.

Product: Uniview IPC2123LR3-PF40M-F 3MP Mini Fixed Bullet IP Camera. Category: Uniview. Subcategory: IP Camera. Price: 4,950৳.
",262,551694,551956
2285,recursive,"
Product: Uniview IPC2122LE-ADF40KMC-WL 2MP ColorHunter Fixed Bullet Network Camera. Category: Uniview. Subcategory: IP Camera. Price: 5,300৳.

Product: Uniview IPC3612ER3-PF28-C 2MP Fixed Dome Network Camera. Category: Uniview. Subcategory: IP Camera. Price: Out Of Stock.
",274,551956,552230
2286,recursive,"
Product: Uniview IPC3614LR3-PF28 4MP Fixed Dome Network Camera. Category: Uniview. Subcategory: IP Camera. Price: 5,500৳.

Product: Uniview IPC3612LE-ADF28KC-WL 2MP Fixed Eyeball Network Camera. Category: Uniview. Subcategory: IP Camera. Price: 5,500৳.
",254,552230,552484
2287,recursive,"
Product: Uniview IPC3614LB- SF28- A 4MP Fixed IR Eyeball Dome IP Camera. Category: Uniview. Subcategory: IP Camera. Price: 5,500৳.

Product: Uniview IPC2124LB-SF40-A 4MP Fixed Bullet Network Camera. Category: Uniview. Subcategory: IP Camera. Price: 4,200৳5,740৳.
",264,552484,552748
2288,recursive,"
Product: Uniview IPC2124LR5-DUPF40M-F 4MP EasyStar Mini Fixed Bullet IP Camera. Category: Uniview. Subcategory: IP Camera. Price: 5,900৳6,500৳.
",145,552748,552893
2289,recursive,"
Product: Hikvision DS-2DE5425IW-AE(T5) 4MP 25X Zoom PTZ Camera (Wall Mount & Without Adapter). Category: Hikvision. Subcategory: PTZ Camera. Price: 53,800৳57,000৳.
",165,552893,553058
2290,recursive,"
Product: Hikvision DS-2AE4223TI-D HD1080P Turbo IR PTZ Dome Camera. Category: Hikvision. Subcategory: PTZ Camera. Price: Out Of Stock.

Product: Hikvision DS-2AE4225TI-D 2MP HD1080P Turbo IR PTZ Dome Camera. Category: Hikvision. Subcategory: PTZ Camera. Price: Out Of Stock.
",276,553058,553334
2291,recursive,"
Product: Hikvision DS-2AE5223TI-A HD1080P Turbo IR PTZ Dome Camera. Category: Hikvision. Subcategory: PTZ Camera. Price: Out Of Stock.

Product: Hikvision DS-2DE5225IW-AE 2MP Network 265+ Comprasion IR PTZ Dome Camera. Category: Hikvision. Subcategory: PTZ Camera. Price: Out Of Stock.
",287,553334,553621
2292,recursive,"
Product: Hikvision DS-2DE5220I-AE HD1080P Defog IR PTZ Camera. Category: Hikvision. Subcategory: PTZ Camera. Price: Out Of Stock.

Product: TP-Link VIGI C330I 3MP IR Bullet IP Camera. Category: TP-Link. Subcategory: IP Camera. Price: 3,600৳.
",243,553621,553864
2293,recursive,"
Product: TP-Link VIGI C430I Lens 2.8mm 3MP IR Turret IP Camera. Category: TP-Link. Subcategory: IP Camera. Price: 2,650৳3,650৳.

Product: TP-Link VIGI C230I (2.8MM) 3MP IR Dome Network IP Camera. Category: TP-Link. Subcategory: IP Camera. Price: 3,030৳3,650৳.
",261,553864,554125
2294,recursive,"
Product: TP-Link VIGI C430 3MP Full-Color Audio Turret IP Camera. Category: TP-Link. Subcategory: IP Camera. Price: 2,800৳3,800৳.

Product: TP-Link VIGI C430 3MP 4mm Lens Full-Color Audio Turret IP Camera. Category: TP-Link. Subcategory: IP Camera. Price: 3,344৳3,800৳.
",271,554125,554396
2295,recursive,"
Product: TP-Link VIGI C340I 4MP 4mm Lens IR Bullet IP Camera. Category: TP-Link. Subcategory: IP Camera. Price: 3,949৳.

Product: TP-Link VIGI C340I 4MP 6mm Lens IR Bullet IP Camera. Category: TP-Link. Subcategory: IP Camera. Price: 2,700৳3,949৳.
",248,554396,554644
2296,recursive,"
Product: TP-Link VIGI C230I 3MP 4mm Lens IR Dome IP Camera. Category: TP-Link. Subcategory: IP Camera. Price: 3,990৳.

Product: TP-Link VIGI C230I Mini 3MP IR Audio Dome IP Camera. Category: TP-Link. Subcategory: IP Camera. Price: 4,100৳.
",240,554644,554884
2297,recursive,"
Product: TP-Link VIGI C330 3MP 4mm Lens Full-Color Audio Bullet IP Camera. Category: TP-Link. Subcategory: IP Camera. Price: 3,100৳4,100৳.

Product: Dahua HAC-HFW1200CLP-IL-A 2MP Smart Dual Light Audio Bullet CC Camera. Category: CC Camera. Subcategory: Security. Price: 1,440৳1,800৳.
",286,554884,555170
2298,recursive,"
Product: Dahua HAC-HFW-1200RP 2MP HDCVI IR BULLET Camera. Category: CC Camera. Subcategory: Security. Price: 1,499৳1,900৳.

Product: Dahua HAC-HDW-1200RP 2MP DOME Camera. Category: CC Camera. Subcategory: Security. Price: 1,499৳1,900৳.
",237,555170,555407
2299,recursive,"
Product: Hikvision DS-2CE76D0T-ITMF 2 MP Indoor Fixed Turret Camera. Category: CC Camera. Subcategory: Security. Price: 1,450৳1,900৳.

Product: Dahua HAC-B2A21P 2MP HDCVI IR Bullet Camera. Category: CC Camera. Subcategory: Security. Price: 1,800৳2,000৳.
",255,555407,555662
2300,recursive,"
Product: Hikvision DS-2CE16H0T-ITPFS 5MP Audio Mini Bullet Camera. Category: CC Camera. Subcategory: Security. Price: 1,550৳2,000৳.

Product: HikVision DS-2CE16D0T-ITPFS 2MP Audio Fixed Mini Bullet Camera. Category: CC Camera. Subcategory: Security. Price: 1,500৳2,100৳.
",272,555662,555934
2301,recursive,"
Product: Dahua HAC-T1A51P 5MP HDCVI IR Dome Camera. Category: CC Camera. Subcategory: Security. Price: 1,950৳2,100৳.

Product: Hikvision DS-2CE10DF0T-PFS 2MP ColorVu Audio Fixed Mini Bullet Camera. Category: CC Camera. Subcategory: Security. Price: 2,300৳.
",258,555934,556192
2302,recursive,"
Product: HikVision DS-2CE17H0T-IT3F 5MP Fixed Bullet Camera. Category: Hikvision. Subcategory: CC Camera. Price: 2,200৳.

Product: HikVision DS-2CE17D0T-LFS 2MP Smart Hybrid Light Audio Fixed Bullet Camera. Category: Hikvision. Subcategory: CC Camera. Price: 2,365৳.
",268,556192,556460
2303,recursive,"
Product: Hikvision DS-2CE70DF0T-MFS 2MP ColorVu Audio Fixed Turret Camera. Category: Hikvision. Subcategory: CC Camera. Price: 2,475৳.

Product: Hikvision DS-2CE10DF0T-FS 2MP ColorVu Audio Fixed Mini Bullet Camera. Category: Hikvision. Subcategory: CC Camera. Price: 2,475৳.
",276,556460,556736
2304,recursive,"
Product: Hikvision DS-2CE16K0T-LFS 5.0MP 3K Mini Bullet CC Camera. Category: Hikvision. Subcategory: CC Camera. Price: 2,600৳2,700৳.

Product: Hikvision DS-2CE71H0T-PIRLO 5 MP PIR Fixed Turret Camera. Category: Hikvision. Subcategory: CC Camera. Price: 2,700৳.
",262,556736,556998
2305,recursive,"
Product: Hikvision DS-2CE12DF0T-FS 2MP ColorVu Audio Bullet Camera. Category: Hikvision. Subcategory: CC Camera. Price: 2,805৳.

Product: HikVision DS-2CE18D0T-LFS 2MP Smart Hybrid Light Audio Fixed Bullet Camera. Category: Hikvision. Subcategory: CC Camera. Price: 3,300৳.
",275,556998,557273
2306,recursive,"
Product: Hikvision DS-2CE70KF0T-MFS 3K ColorVu Audio Fixed Turret Camera. Category: Hikvision. Subcategory: CC Camera. Price: 3,630৳.

Product: Uniview UAC-T115-F28 Turret Analog Camera. Category: Uniview. Subcategory: CC Camera. Price: 2,400৳.
",246,557273,557519
2307,recursive,"
Product: Uniview UAC-B115-F40 Bullet Analog Camera. Category: Uniview. Subcategory: CC Camera. Price: Out Of Stock.

Product: Uniview UAC-B112-F40-W 2MP ColourHunter HD Fixed Mini Bullet Analog Camera. Category: Uniview. Subcategory: CC Camera. Price: 1,950৳2,650৳.
",267,557519,557786
2308,recursive,"
Product: Uniview UAC-T112-F28-W 2MP ColourHunter HD Fixed Turret Analog Camera. Category: Uniview. Subcategory: CC Camera. Price: 2,650৳.

Product: Uniview UAC-B115-F40-W 5MP ColourHunter HD Fixed Mini Bullet Analog Camera. Category: Uniview. Subcategory: CC Camera. Price: 3,500৳.
",283,557786,558069
2309,recursive,"
Product: Uniview UAC-T115-F28-W 5MP ColourHunter HD Fixed Turret Analog Camera. Category: Uniview. Subcategory: CC Camera. Price: 4,250৳.

Product: Uniview UAC-P112-AF40-W 2MP ColorHunter Analog PT Camera. Category: Uniview. Subcategory: CC Camera. Price: Out Of Stock.
",271,558069,558340
2310,recursive,"
Product: Jovision JVS-N43-Z25 4MP 25x Zoom Starlight AI PTZ Camera. Category: PTZ Camera. Subcategory: Security. Price: 36,500৳.

Product: Dahua SD49225DB-HNY 2MP IR Network PTZ Camera. Category: PTZ Camera. Subcategory: Security. Price: 37,500৳.
",248,558340,558588
2311,recursive,"
Product: Uniview IPC742SR9-PZ30-32G 1080P Zoom Lens IR PTZ Camera. Category: PTZ Camera. Subcategory: Security. Price: Call for Price.

Product: Uniview IPC744SR5-PF60-32G 4MP Fixed Lens IR PT Camera. Category: PTZ Camera. Subcategory: Security. Price: Call for Price.
",270,558588,558858
2312,recursive,"
Product: Uniview IPC6424SR-X25-VF 4MP 25x PTZ Dome Network Camera. Category: PTZ Camera. Subcategory: Security. Price: Call for Price.

Product: Uniview IPC6622SR-X33-VF 2MP 33x PTZ Dome Network Camera. Category: PTZ Camera. Subcategory: Security. Price: Call for Price.
",272,558858,559130
2313,recursive,"
Product: Uniview TR-WE45-A-IN PTZ Dome Wall Mount. Category: PTZ Camera. Subcategory: Security. Price: Call for Price.

Product: Uniview KB-1100 Four-Dimensional Joystick Control for PTZ Camera. Category: PTZ Camera. Subcategory: Security. Price: Call for Price.
",264,559130,559394
2314,recursive,"
Product: Dahua SD5A432GB-HNR 4MP 32x Starlight IR Network PTZ Camera. Category: PTZ Camera. Subcategory: Security. Price: Call for Price.

Product: Srihome SH045B 2MP Full Color Night Vision IP PTZ Camera. Category: PTZ Camera. Subcategory: Security. Price: Out Of Stock.
",273,559394,559667
2315,recursive,"
Product: Dahua SD2A200HB-GN-AW-PV-S2 2MP Full-color Network PTZ Camera. Category: PTZ Camera. Subcategory: Security. Price: Out Of Stock.

Product: Dahua SD2A200HB-GN-A-PV-S2 2MP Full-color Network PTZ Camera. Category: PTZ Camera. Subcategory: Security. Price: Out Of Stock.
",277,559667,559944
2316,recursive,"
Product: TP-Link VIGI C540 4MP Full-Color IP PTZ Camera. Category: PTZ Camera. Subcategory: Security. Price: Out Of Stock.

Product: TP-Link VIGI C540-W 4MP Full-Color Wi-Fi IP PTZ Camera. Category: PTZ Camera. Subcategory: Security. Price: Out Of Stock.
",256,559944,560200
2317,recursive,"
Product: Dahua SD2A500HB-GN-AW-PV-S2 5MP Full-color Network PTZ Camera. Category: PTZ Camera. Subcategory: Security. Price: Out Of Stock.

Product: TP-Link VIGI C540V 4MP Full-Color Dual-Lens IP PTZ Camera. Category: PTZ Camera. Subcategory: Security. Price: Out Of Stock.
",274,560200,560474
2318,recursive,"
Product: TP-Link VIGI C540S 4MP ColorPro Night Vision PTZ Camera. Category: PTZ Camera. Subcategory: Security. Price: Out Of Stock.

Product: Uniview IPC675LFW-AX4DUPKC-VG 5MP LightHunter Active Deterrence Mini PTZ Camera. Category: PTZ Camera. Subcategory: Security. Price: 18,500৳.
",285,560474,560759
2319,recursive,"
Product: Dahua DH-SD49225-HC-LA 2MP 25x Starlight IR PTZ HDCVI Camera. Category: PTZ Camera. Subcategory: Security. Price: Out Of Stock.

Product: Dahua HAC-B1A51P 5MP HDCVI IR Bullet Camera. Category: Dahua. Subcategory: CC Camera. Price: 2,200৳.
",249,560759,561008
2320,recursive,"
Product: DAHUA HAC-HFW1200TLP 2MP HDCVI IR Bullet Camera. Category: Dahua. Subcategory: CC Camera. Price: 1,950৳2,250৳.

Product: Dahua HAC-HDW1200CLQP-IL-A 2MP Eyeball CC Camera. Category: Dahua. Subcategory: CC Camera. Price: 1,550৳2,250৳.
",243,561008,561251
2321,recursive,"
Product: Dahua HAC-T1A51 5MP HDCVI IR Eyeball Camera. Category: Dahua. Subcategory: CC Camera. Price: 2,500৳.

Product: Dahua DH-HAC-HDW1500CLQP-IL-A 5MP Dual Light HDCVI Dome Camera. Category: Dahua. Subcategory: CC Camera. Price: 2,350৳2,500৳.
",247,561251,561498
2322,recursive,"
Product: Dahua HAC-HFW1500CLP-IL-A 5MP Smart Dual Light Audio Bullet Camera. Category: Dahua. Subcategory: CC Camera. Price: 2,400৳2,700৳.

Product: Dahua HAC-HFW1200TLMP-IL-A 2MP Smart Dual Light HDCVI Fixed-focal Bullet Camera. Category: Dahua. Subcategory: CC Camera. Price: 2,800৳.
",287,561498,561785
2323,recursive,"
Product: Dahua HAC-HDW1500TLMP-IL-A 5MP Smart Dual Light HDCVI Eyeball Dome Camera. Category: Dahua. Subcategory: CC Camera. Price: 2,950৳3,200৳.

Product: Dahua HAC-HFW1500TLMP-IL-A 5MP Smart Dual Light HDCVI Bullet CC Camera. Category: Dahua. Subcategory: CC Camera. Price: 3,850৳.
",285,561785,562070
2324,recursive,"
Product: Dahua DH-HAC-HDW1509TLQP-A-LED 5MP Color HDCVI Eyeball Camera. Category: Dahua. Subcategory: CC Camera. Price: 3,608৳4,400৳.

Product: Dahua DH-HAC-HFW1509MHP-A-LED 5MP Color HDCVI Bullet Camera. Category: Dahua. Subcategory: CC Camera. Price: 4,550৳5,900৳.
",268,562070,562338
2325,recursive,"
Product: Dahua-HAC-T1A21P 2MP HDCVI IR Eyeball camera. Category: Dahua. Subcategory: CC Camera. Price: Out Of Stock.

Product: Dahua HAC-B1A21P 2MP HDCVI IR Bullet Camera. Category: Dahua. Subcategory: CC Camera. Price: Out Of Stock.
",235,562338,562573
2326,recursive,"
Product: Dahua SD49225XA-HNR 2MP 25X Starlight IR WizSense Network PTZ Camera. Category: Dahua. Subcategory: PTZ Camera. Price: Out Of Stock.

Product: Dahua SD5A225GB-HNR 2MP 25x Starlight IR WizSense Network PTZ Camera. Category: Dahua. Subcategory: PTZ Camera. Price: Out Of Stock.
",286,562573,562859
2327,recursive,"
Product: Dahua SD5A432XA-HNR 4MP 32X Starlight IR WizSense Network PTZ Camera. Category: Dahua. Subcategory: PTZ Camera. Price: Out Of Stock.

Product: Tiandy TC-H324S 2MP 25× Starlight IR PTZ Camera. Category: Tiandy. Subcategory: PTZ Camera. Price: Out Of Stock.
",266,562859,563125
2328,recursive,"
Product: Tiandy TC-H344S 4MP 25× Starlight IR PTZ Camera. Category: Tiandy. Subcategory: PTZ Camera. Price: Out Of Stock.

Product: Dahua 2 unit CC camera package. Category: Dahua. Subcategory: CC Camera Package. Price: 9,900৳13,500৳.
",236,563125,563361
2329,recursive,"
Product: Dahua 3 unit Cc camera package. Category: Dahua. Subcategory: CC Camera Package. Price: 10,590৳15,500৳.

Product: Dahua 4 unit CC camera package. Category: Dahua. Subcategory: CC Camera Package. Price: 10,999৳18,000৳.
",228,563361,563589
2330,recursive,"
Product: Dahua 5 unit Cc camera package. Category: Dahua. Subcategory: CC Camera Package. Price: 14,990৳21,500৳.

Product: Dahua 6 unit Cc camera package. Category: Dahua. Subcategory: CC Camera Package. Price: 16,990৳24,000৳.
",228,563589,563817
2331,recursive,"
Product: Dahua 8 unit Cc camera package. Category: Dahua. Subcategory: CC Camera Package. Price: 17,999৳29,000৳.

Product: Dahua 16 unit Cc camera package. Category: Dahua. Subcategory: CC Camera Package. Price: 34,990৳50,500৳.
",229,563817,564046
2332,recursive,"
Product: TP-Link 2 Unit IP Camera Package. Category: TP-Link. Subcategory: IP Camera Package. Price: 19,500৳.

Product: TP-Link 4 Unit IP Camera Package. Category: TP-Link. Subcategory: IP Camera Package. Price: 29,000৳.
",222,564046,564268
2333,recursive,"
Product: TP-Link 6 Unit IP Camera Package. Category: TP-Link. Subcategory: IP Camera Package. Price: 40,000৳.

Product: Hikvision 2 Unit IP Camera Package. Category: Hikvision. Subcategory: IP Camera Package. Price: 15,990৳19,250৳.
",233,564268,564501
2334,recursive,"
Product: Hikvision 3 Unit IP Camera Package. Category: Hikvision. Subcategory: IP Camera Package. Price: 18,500৳23,500৳.

Product: Hikvision 4 Unit IP Camera Package. Category: Hikvision. Subcategory: IP Camera Package. Price: 20,990৳28,000৳.
",244,564501,564745
2335,recursive,"
Product: Hikvision 5 Unit IP Camera Package. Category: Hikvision. Subcategory: IP Camera Package. Price: 24,500৳33,000৳.

Product: Hikvision 6 Unit IP Camera Package. Category: Hikvision. Subcategory: IP Camera Package. Price: 27,500৳37,000৳.
",244,564745,564989
2336,recursive,"
Product: HIKVISION 2 unit 1080P night vision security cc camera Package. Category: CC Camera Package. Subcategory: Security. Price: 9,990৳13,000৳.

Product: HIKVISION 3 unit 1080P night vision security cc camera Package. Category: CC Camera Package. Subcategory: Security. Price: 10,590৳15,300৳.
",297,564989,565286
2337,recursive,"
Product: HIKVISION 4 unit 1080P night vision security cc camera Package. Category: CC Camera Package. Subcategory: Security. Price: 10,999৳17,900৳.

Product: HIKVISION 5 unit 1080P night vision security cc camera Package. Category: CC Camera Package. Subcategory: Security. Price: 14,990৳21,500৳.
",298,565286,565584
2338,recursive,"
Product: HIKVISION 6 unit 1080P night vision security cc camera Package. Category: CC Camera Package. Subcategory: Security. Price: 16,990৳24,500৳.

Product: HIKVISION 8 unit 1080P night vision security cc camera Package. Category: CC Camera Package. Subcategory: Security. Price: 17,999৳29,750৳.
",298,565584,565882
2339,recursive,"
Product: Uniview IPC6322SR-X22P-D 2MP 22x PTZ Dome Network Camera. Category: Uniview. Subcategory: PTZ Camera. Price: Out Of Stock.

Product: Uniview IPC6222ER-X30 2MP 30x IR Network PTZ Dome Camera. Category: Uniview. Subcategory: PTZ Camera. Price: Out Of Stock.
",266,565882,566148
2340,recursive,"
Product: Uniview IPC6322SR-X33UP-D 2MP 33x PTZ Dome Network Camera. Category: Uniview. Subcategory: PTZ Camera. Price: Out Of Stock.

Product: Uniview IPC6222ER-X30P 2MP 30x IR Network PTZ Dome Camera. Category: Uniview. Subcategory: PTZ Camera. Price: Out Of Stock.
",268,566148,566416
2341,recursive,"
Product: Uniview IPC6253SR-X33 3MP 33x IR Network PTZ Dome Camera. Category: Uniview. Subcategory: PTZ Camera. Price: Out Of Stock.

Product: Dahua DH-IPC-HFW1230TL2-S5 2 Unit IP Camera With Package. Category: Dahua. Subcategory: IP Camera Package. Price: 14,500৳19,500৳.
",273,566416,566689
2342,recursive,"
Product: Dahua DH-IPC-HFW1230TL2-S5 3 Unit IP Camera With Package. Category: Dahua. Subcategory: IP Camera Package. Price: 17,490৳24,000৳.

Product: Dahua DH-IPC-HFW1230TL2-S5 4 Unit IP Camera With Package. Category: Dahua. Subcategory: IP Camera Package. Price: 20,500৳29,000৳.
",280,566689,566969
2343,recursive,"
Product: Dahua DH-IPC-HFW1230TL2-S5 5 Unit IP Camera With Package. Category: Dahua. Subcategory: IP Camera Package. Price: 27,500৳35,000৳.

Product: Dahua DH-IPC-HFW1230TL2-S5 6 Unit IP Camera With Package. Category: Dahua. Subcategory: IP Camera Package. Price: 30,990৳40,000৳.
",280,566969,567249
2344,recursive,"
Product: Hikvision DS-7104HGHI-ECO/M1 4 Channel Mini 1U DVR. Category: Hikvision. Subcategory: DVR. Price: 2,075৳2,400৳.

Product: Hikvision DS-7108HGHI-M1/T 08 Channel Mini 1U DVR. Category: Hikvision. Subcategory: DVR. Price: 3,050৳3,410৳.
",243,567249,567492
2345,recursive,"
Product: Hikvision DS-7108HGHI-M1/ECO 08 Channel Mini 1U DVR. Category: Hikvision. Subcategory: DVR. Price: 3,200৳.

Product: HIKVISION DS-7204HGHI-F1 4-CH Turbo HD 720P DVR. Category: Hikvision. Subcategory: DVR. Price: 4,200৳.
",230,567492,567722
2346,recursive,"
Product: Hikvision DS-7108HGHI-F1/N 8 CH 1MP (720P) Turbo HD DVR. Category: Hikvision. Subcategory: DVR. Price: 5,000৳.

Product: Hikvision IDS-7104HQHI-M1-S 4 Channel 1080P Mini 1U H.265 AcuSense DVR. Category: Hikvision. Subcategory: DVR. Price: 4,179৳.
",257,567722,567979
2347,recursive,"
Product: Hikvision DS-7116HGHI-M1 16 Channel DVR. Category: Hikvision. Subcategory: DVR. Price: 6,050৳.

Product: Hikvision iDS-7108HQHI-M1/S 8 Channel 1080P Mini 1U H.265 AcuSense DVR. Category: Hikvision. Subcategory: DVR. Price: 5,665৳.
",241,567979,568220
2348,recursive,"
Product: HIKVISION DS-7216HGHI-K1 16-CH Turbo HD 720P DVR. Category: Hikvision. Subcategory: DVR. Price: 8,000৳.

Product: Hikvision IDS-7208HQHI-M2/XT 8 Channel 1U H.265 AcuSense DVR. Category: Hikvision. Subcategory: DVR. Price: 9,500৳.
",240,568220,568460
2349,recursive,"
Product: Hikvision iDS-7116HQHI-M1/S 16 Channel AcuSense DVR. Category: Hikvision. Subcategory: DVR. Price: 9,350৳.

Product: Hikvision IDS-7232HQHI-M2-S 32 Channel 1080p 1U H.265 AcuSense DVR. Category: Hikvision. Subcategory: DVR. Price: 32,000৳.
",250,568460,568710
2350,recursive,"
Product: Hikvision IDS-7232HQHI-M2/XT 32 Channel 1080p 1U H.265 AcuSense DVR. Category: Hikvision. Subcategory: DVR. Price: 32,000৳.

Product: Hikvision DS-7104HGHI-K1 4-Ch 1080p Lite Mini 1U H.265 DVR. Category: Hikvision. Subcategory: DVR. Price: Out Of Stock.
",264,568710,568974
2351,recursive,"
Product: HIKVISION DS-7104HGHI-F1 4 Channel Turbo HD 720P DVR. Category: Hikvision. Subcategory: DVR. Price: Out Of Stock.

Product: HIKVISION DS-7104HQHI-K1 4-CH Turbo HD 1080P DVR. Category: Hikvision. Subcategory: DVR. Price: Out Of Stock.
",244,568974,569218
2352,recursive,"
Product: Hikvision DS-7108HGHI-K1 8-CH Turbo HD 1080P DVR. Category: Hikvision. Subcategory: DVR. Price: Out Of Stock.

Product: Hikvision IDS-7204HUHI-M1-S 4 Channel 1 HDD 1U H.265 AcuSense DVR. Category: Hikvision. Subcategory: DVR. Price: Out Of Stock.
",257,569218,569475
2353,recursive,"
Product: HIKVISION DS-7204HQHI-K1 4-CH Turbo HD 1080P DVR. Category: Hikvision. Subcategory: DVR. Price: Out Of Stock.

Product: HIKVISION DS-7208HGHI-F1 8-CH Turbo HD 720P DVR. Category: Hikvision. Subcategory: DVR. Price: Out Of Stock.
",239,569475,569714
2354,recursive,"
Product: Jovision CloudSee JVS-D6008-S3 DVR. Category: Jovision. Subcategory: DVR. Price: 3,800৳.

Product: Jovision CloudSee JVS-D6016-S3 DVR. Category: Jovision. Subcategory: DVR. Price: 5,000৳7,000৳.
",204,569714,569918
2355,recursive,"
Product: Uniview NVR301-04LS2 4 Channel 1 SATA NVR. Category: NVR. Subcategory: Security. Price: 4,000৳.

Product: Hikvision DS-7104NI-Q1/M 4 Channel Mini 1U NVR. Category: NVR. Subcategory: Security. Price: 4,620৳.
",217,569918,570135
2356,recursive,"
Product: Dahua NVR1104HS-S3/H 4 Channel Network Video Recorder (NVR). Category: NVR. Subcategory: Security. Price: 4,090৳4,500৳.

Product: Hikvision HiLook NVR-108MH-D 8-Channel 1080p NVR. Category: NVR. Subcategory: Security. Price: 4,700৳.
",243,570135,570378
2357,recursive,"
Product: Jovision JVS-ND6610-HD 10 Channel H.265 1 SATA NVR. Category: NVR. Subcategory: Security. Price: 5,400৳.

Product: Uniview NVR301-04S 4 Channel NVR. Category: NVR. Subcategory: Security. Price: 5,500৳.
",212,570378,570590
2358,recursive,"
Product: Hikvision DS-7108NI-Q1/M 8 Channel Network Video Recorder (NVR). Category: NVR. Subcategory: Security. Price: 5,720৳.

Product: Uniview NVR301-08S3 8CH 4K NVR. Category: NVR. Subcategory: Security. Price: 6,000৳.
",223,570590,570813
2359,recursive,"
Product: Hikvision DS-7604NI-Q1 4 Channel 4K NVR. Category: NVR. Subcategory: Security. Price: 5,900৳6,500৳.

Product: Dahua NVR1108HS-S3/H 8 Channel Network Video Recorder (NVR). Category: NVR. Subcategory: Security. Price: 5,299৳6,600৳.
",240,570813,571053
2360,recursive,"
Product: Uniview NVR301-08S2 8 Channel 4K NVR. Category: NVR. Subcategory: Security. Price: 5,850৳6,600৳.

Product: TP-Link VIGI NVR1004H-4P 4 Channel PoE+ Network Video Recorder (NVR). Category: NVR. Subcategory: Security. Price: Out Of Stock.
",246,571053,571299
2361,recursive,"
Product: EZVIZ CS-X5S-8W 8 Channel Wireless NVR. Category: NVR. Subcategory: Security. Price: 5,199৳5,500৳.

Product: Dahua imou NVR1108HS-W-S2 8 Channel Wi-Fi NVR. Category: NVR. Subcategory: Security. Price: 7,900৳.
",219,571299,571518
2362,recursive,"
Product: Dahua DHI-NVR1104HS-P-S3/H 04-Channel Compact 1U Lite POE NVR. Category: NVR. Subcategory: Security. Price: 7,900৳.

Product: TP-Link VIGI NVR1016H V1 16 Channel NVR. Category: NVR. Subcategory: Security. Price: 6,962৳7,500৳.
",236,571518,571754
2363,recursive,"
Product: Hikvision DS-7608NI-Q2 8 Channel 1U 4K NVR. Category: NVR. Subcategory: Security. Price: 9,900৳.

Product: Uniview NVR301-16S3 16 Channel 1 SATA NVR. Category: NVR. Subcategory: Security. Price: 9,200৳.
",213,571754,571967
2364,recursive,"
Product: Uniview NVR301-16E2 16 Channel NVR. Category: NVR. Subcategory: Security. Price: 9,600৳.

Product: Hikvision DS-7616NI-Q1 16 Channel Network Video Recorder (NVR). Category: NVR. Subcategory: Security. Price: 10,000৳10,500৳.
",234,571967,572201
2365,recursive,"
Product: Dahua NVR1108HS-8P-S3/H 8 Channel Network Video Recorder (NVR). Category: Dahua. Subcategory: NVR. Price: 10,500৳.

Product: Dahua NVR2216-4KS3 16 Channel Lite Network Video Recorder (NVR). Category: Dahua. Subcategory: NVR. Price: 12,500৳.
",251,572201,572452
2366,recursive,"
Product: Dahua NVR4232-4KS3 32 Channel 1U 2 HDD Network Video Recorder (NVR). Category: Dahua. Subcategory: NVR. Price: 17,800৳21,500৳.

Product: Dahua NVR5216-EI 16 Channels 1U 2HDDs WizSense Network Video Recorder (NVR). Category: Dahua. Subcategory: NVR. Price: 25,000৳.
",275,572452,572727
2367,recursive,"
Product: Dahua NVR4432-EI 32 Channel WizSense Network Video Recorder (NVR). Category: Dahua. Subcategory: NVR. Price: 37,500৳.

Product: Dahua NVR5832-EI 32 Channels 8HDD 2U Network Video Recorder. Category: Dahua. Subcategory: NVR. Price: 57,999৳59,500৳.
",257,572727,572984
2368,recursive,"
Product: Dahua NVR5464-EI 64 Channel 4HDD 1.5U WizSense NVR. Category: Dahua. Subcategory: NVR. Price: 65,000৳.

Product: Dahua NVR5864-EI 64 Channels NVR. Category: Dahua. Subcategory: NVR. Price: 75,500৳.
",208,572984,573192
2369,recursive,"
Product: Dahua imou NVR1104HS-W-S2 4 Channel Wi-Fi NVR. Category: Dahua. Subcategory: NVR. Price: Out Of Stock.

Product: Dahua imou N18P 8 Channel PoE NVR. Category: Dahua. Subcategory: NVR. Price: Out Of Stock.
",214,573192,573406
2370,recursive,"
Product: Dahua NVR4116HS-4KS3 16 Channel Smart 1U 1HDD Network Video Recorder (NVR). Category: Dahua. Subcategory: NVR. Price: Out Of Stock.

Product: DAHUA NVR4116HS-4KS2 16 Channel Compact 1U Lite Network Video Recorder (NVR). Category: Dahua. Subcategory: NVR. Price: Out Of Stock.
",286,573406,573692
2371,recursive,"
Product: Dahua DHI-NVR4216-4KS2/L 16 Channel 1U 2HDDs (NVR). Category: Dahua. Subcategory: NVR. Price: Out Of Stock.

Product: Dahua NVR4208-8P-4KS2 8 Channel 1U Network Video Recorder (NVR). Category: Dahua. Subcategory: NVR. Price: Out Of Stock.
",249,573692,573941
2372,recursive,"
Product: Dahua NVR4216-4KS3 16 Channel Smart Network Video Recorder (NVR). Category: Dahua. Subcategory: NVR. Price: Out Of Stock.

Product: Dahua NVR4232-EI 32 Channel 1U 2HDDs WizSense NVR. Category: Dahua. Subcategory: NVR. Price: Out Of Stock.
",249,573941,574190
2373,recursive,"
Product: Hikvision DS-7616NI-Q2 16-CH 4k NVR. Category: Hikvision. Subcategory: NVR. Price: 11,000৳.

Product: Hikvision DS-7632NXI-K2 AcuSense 32-Channel 4K NVR. Category: Hikvision. Subcategory: NVR. Price: 20,350৳.
",219,574190,574409
2374,recursive,"
Product: Hikvision DS-7732NXI-K4 AcuSense 32-Channel 4K NVR. Category: Hikvision. Subcategory: NVR. Price: 29,500৳.

Product: Hikvision DS-7764NI-M4 64 Channel 4HDD 8K NVR. Category: Hikvision. Subcategory: NVR. Price: 51,700৳.
",229,574409,574638
2375,recursive,"
Product: Hikvision DS-8664NXI-I8/S 64 Channel 2U AcuSense 4K NVR. Category: Hikvision. Subcategory: NVR. Price: 71,500৳.

Product: Hikvision DS-8632NI-K8 Embedded 4K NVR. Category: Hikvision. Subcategory: NVR. Price: 68,000৳.
",227,574638,574865
2376,recursive,"
Product: Hikvision DS-9664NI-M8 64 Channel 4K NVR. Category: Hikvision. Subcategory: NVR. Price: 135,000৳.

Product: Hikvision DS-9632NI-M8 32 Channel 2U 8K Network Video Recorder (NVR). Category: Hikvision. Subcategory: NVR. Price: Up Coming.
",245,574865,575110
2377,recursive,"
Product: Hikvision DS-7604NI-K1 4 Channel Network Video Recorder (NVR). Category: Hikvision. Subcategory: NVR. Price: Out Of Stock.

Product: Hikvision DS-7608NI-Q1 8 Channel Network Video Recorder (NVR). Category: Hikvision. Subcategory: NVR. Price: Out Of Stock.
",266,575110,575376
2378,recursive,"
Product: Hikvision DS-7604NI-Q1/4P 4-Channel 1U 4 PoE 4K NVR. Category: Hikvision. Subcategory: NVR. Price: Out Of Stock.

Product: Hikvision DS-7616NXI-Q2 16-CH 4k NVR. Category: Hikvision. Subcategory: NVR. Price: Out Of Stock.
",231,575376,575607
2379,recursive,"
Product: Hikvision DS-7608NI-Q1/8P 8-Channel 1U 8 PoE 4K NVR. Category: Hikvision. Subcategory: NVR. Price: Out Of Stock.

Product: Hikvision DS-7616NI-K2 4K resolution 16 channel IP Network Video Recorder (NVR). Category: Hikvision. Subcategory: NVR. Price: Out Of Stock.
",274,575607,575881
2380,recursive,"
Product: Jovision JVS-ND7932-HV 32CH H.265 NVR. Category: Jovision. Subcategory: NVR. Price: 15,000৳.

Product: Jovision JVS-ND7932-DV 32CH H.265 FHD NVR. Category: Jovision. Subcategory: NVR. Price: 26,500৳.
",210,575881,576091
2381,recursive,"
Product: Jovision JVS-ND6616-H2 Series NVR. Category: Jovision. Subcategory: NVR. Price: Out Of Stock.

Product: Jovision JVS-ND7608-HP 8CH H.265 4K NVR. Category: Jovision. Subcategory: NVR. Price: Out Of Stock.
",214,576091,576305
2382,recursive,"
Product: Jovision JVS-ND6632-H2 Series NVR. Category: Jovision. Subcategory: NVR. Price: Out Of Stock.

Product: Jovision JVS-ND6604-HD 4CH H.265 NVR. Category: Jovision. Subcategory: NVR. Price: Out Of Stock.
",211,576305,576516
2383,recursive,"
Product: TP-Link VIGI NVR4032H 32 Channel NVR. Category: TP-Link. Subcategory: NVR. Price: 28,000৳28,190৳.

Product: TP-Link VIGI NVR1004H 4 Channel Network Video Recorder (NVR). Category: TP-Link. Subcategory: NVR. Price: Out Of Stock.
",238,576516,576754
2384,recursive,"
Product: TP-Link VIGI NVR1008H 8 Channel Network Video Recorder (NVR). Category: TP-Link. Subcategory: NVR. Price: Out Of Stock.

Product: TP-Link VIGI NVR1008H-8P 8 Channel PoE+ Network Video Recorder (NVR). Category: TP-Link. Subcategory: NVR. Price: Out Of Stock.
",268,576754,577022
2385,recursive,"
Product: Uniview NVR302-16S 16 Channel 4K NVR. Category: Uniview. Subcategory: NVR. Price: 10,700৳12,800৳.

Product: Uniview NVR302-16S2 16 Channel 2 HDD NVR. Category: Uniview. Subcategory: NVR. Price: 15,000৳.
",213,577022,577235
2386,recursive,"
Product: Uniview NVR302-32S 32 Channel 4K 2 HDDs NVR. Category: Uniview. Subcategory: NVR. Price: 15,300৳17,500৳.

Product: Uniview NVR304-32S 32 Channel 4K 4 HDDs NVR. Category: Uniview. Subcategory: NVR. Price: 24,000৳.
",223,577235,577458
2387,recursive,"
Product: Uniview NVR302-16E-P16 16 Channel 2 HDD PoE NVR. Category: Uniview. Subcategory: NVR. Price: 30,000৳.

Product: Uniview NVR304-16E 16 Channel 4K 4HDDs NVR. Category: Uniview. Subcategory: NVR. Price: 31,000৳.
",219,577458,577677
2388,recursive,"
Product: Uniview NVR304-16EP 16 Channel 4 HDDs NVR. Category: Uniview. Subcategory: NVR. Price: 35,000৳.

Product: Uniview NVR508-64B 64 Channel 4K NVR. Category: Uniview. Subcategory: NVR. Price: 49,500৳.
",207,577677,577884
2389,recursive,"
Product: Uniview NVR308-16X 16 Channel 4K 8HDDs NVR. Category: Uniview. Subcategory: NVR. Price: 55,000৳.

Product: Uniview NVR308-64X 64 Channel 4K NVR. Category: Uniview. Subcategory: NVR. Price: Call for Price.
",215,577884,578099
2390,recursive,"
Product: Uniview NVR516-64 64 Channel 4K 16 HDDs RAID NVR. Category: Uniview. Subcategory: NVR. Price: Call for Price.

Product: Uniview UNICORN Video Management System. Category: Uniview. Subcategory: NVR. Price: Call for Price.
",231,578099,578330
2391,recursive,"
Product: Uniview NVR301-08LS3-P8 8 Channel NVR. Category: Uniview. Subcategory: NVR. Price: Call for Price.

Product: Uniview NVR302-08S2-P8 8 Channel NVR. Category: Uniview. Subcategory: NVR. Price: Call for Price.
",217,578330,578547
2392,recursive,"
Product: Tiandy TC-R3220 20 Channel H.265 2HDD Network Video Recorder (NVR). Category: Tiandy. Subcategory: NVR. Price: Up Coming.

Product: Tiandy TC-R3240 40 Channel H.265 2HDD Network Video Recorder (NVR). Category: Tiandy. Subcategory: NVR. Price: Up Coming.
",264,578547,578811
2393,recursive,"
Product: Tiandy TC-R3232 32 Channel H.265 2HDD Network Video Recorder (NVR). Category: Tiandy. Subcategory: NVR. Price: Up Coming.

Product: Tiandy TC-R3105 5 Channel 8TB HDD NVR. Category: Tiandy. Subcategory: NVR. Price: Out Of Stock.
",238,578811,579049
2394,recursive,"
Product: Tiandy TC-R3110 10 Channel 8TB HDD NVR. Category: Tiandy. Subcategory: NVR. Price: Out Of Stock.

Product: Tiandy TC-R3104 4 Channel PoE NVR. Category: Tiandy. Subcategory: NVR. Price: Out Of Stock.
",209,579049,579258
2395,recursive,"
Product: Tiandy TC-R3105 5 Channel PoE NVR. Category: Tiandy. Subcategory: NVR. Price: Out Of Stock.

Product: Tiandy TC-R3108 8 Channel PoE NVR. Category: Tiandy. Subcategory: NVR. Price: Out Of Stock.
",204,579258,579462
2396,recursive,"
Product: Tiandy TC-R3110 10 Channel PoE NVR. Category: Tiandy. Subcategory: NVR. Price: Out Of Stock.

Product: DAHUA DH-XVR1B04-I 4-Channel Digital Video Recorder. Category: Dahua. Subcategory: XVR. Price: 2,450৳2,950৳.
",222,579462,579684
2397,recursive,"
Product: Dahua XVR1B08-I 8 Channel Penta-brid 1080N/720p Cooper 1U XVR. Category: Dahua. Subcategory: XVR. Price: 2,550৳3,500৳.

Product: Dahua XVR1B16-I 16-Channel Penta-brid Compact Digital Video Recorder. Category: Dahua. Subcategory: XVR. Price: 5,600৳6,200৳.
",265,579684,579949
2398,recursive,"
Product: Dahua XVR1B04H-I 4 Channel Penta-brid 5M-N/1080p Cooper DVR. Category: Dahua. Subcategory: XVR. Price: 4,499৳6,500৳.

Product: DAHUA XVR5104HS-I2 4-Channel Digital Video Recorder. Category: Dahua. Subcategory: XVR. Price: Out Of Stock.
",246,579949,580195
2399,recursive,"
Product: Dahua XVR1B08H-I 8 Channel Penta-brid 5M-N/1080p Cooper DVR. Category: Dahua. Subcategory: XVR. Price: 6,099৳7,900৳.

Product: DAHUA XVR1B16H 16 Channel Penta-brid 4M-N/1080P Cooper 1U Digital Video Recorder. Category: Dahua. Subcategory: XVR. Price: 10,999৳12,500৳.
",277,580195,580472
2400,recursive,"
Product: Dahua DHI-XVR4232AN 32 Channel Digital Video Recorder. Category: Dahua. Subcategory: XVR. Price: 22,000৳.

Product: Dahua XVR5232AN-I3 32 Channel Penta-brid WizSense Digital Video Recorder. Category: Dahua. Subcategory: XVR. Price: 27,900৳29,500৳.
",258,580472,580730
2401,recursive,"
Product: DAHUA XVR5108HS-I2 8-Channel Digital Video Recorder. Category: Dahua. Subcategory: XVR. Price: Out Of Stock.

Product: Dahua DH-XVR4216AN-I 16 Channel Penta-brid WizSense Digital Video Recorder. Category: Dahua. Subcategory: XVR. Price: 16,000৳.
",256,580730,580986
2402,recursive,"
Product: DAHUA XVR5116HS-S2 16 Channel Digital Video Recorder. Category: Dahua. Subcategory: XVR. Price: Out Of Stock.

Product: DAHUA XVR5216AN-I2 16-Channel Digital Video Recorder. Category: Dahua. Subcategory: XVR. Price: Out Of Stock.
",240,580986,581226
2403,recursive,"
Product: DAHUA XVR5216AN-I3 16CH Penta-brid 5MP WizSense Digital Video Recorder. Category: Dahua. Subcategory: XVR. Price: Out Of Stock.

Product: Dahua XVR5216AN-S2 16 Channel Penta-brid Full HD XVR. Category: Dahua. Subcategory: XVR. Price: Out Of Stock.
",258,581226,581484
2404,recursive,"
Product: DAHUA XVR5232AN-S2 32 Channel Digital Video Recorder. Category: Dahua. Subcategory: XVR. Price: Out Of Stock.

Product: BNC JACK. Category: CC Camera Accessories. Subcategory: Security. Price: 70৳.
",208,581484,581692
2405,recursive,"
Product: AHD/CVI/TVI 720P/1080P (2MP) Video Balun for CC Camera. Category: CC Camera Accessories. Subcategory: Security. Price: 150৳250৳.

Product: 12V 2A Outdoor Waterproof AC/DC Power Adapter for CCTV Camera. Category: CC Camera Accessories. Subcategory: Security. Price: 200৳250৳.
",285,581692,581977
2406,recursive,"
Product: 12V 2A Box waterproof AC/DC Power Adapter for CCTV Camera. Category: CC Camera Accessories. Subcategory: Security. Price: 250৳400৳.

Product: High Quality RJ-6 PER MITER. Category: CC Camera Accessories. Subcategory: Security. Price: Out Of Stock.
",258,581977,582235
2407,recursive,"
Product: CC Camera Stand 10"" For IP Camera. Category: CC Camera Accessories. Subcategory: Security. Price: Out Of Stock.

Product: Uniview XVR301-04F 4 Chanel 1 SATA XVR. Category: Uniview. Subcategory: XVR. Price: 2,900৳4,000৳.
",230,582235,582465
2408,recursive,"
Product: Uniview XVR301-04G3 4 Chanel 1 SATA XVR. Category: Uniview. Subcategory: XVR. Price: 4,250৳.

Product: Uniview XVR301-08F 8 Chanel 1 SATA XVR. Category: Uniview. Subcategory: XVR. Price: 5,000৳.
",205,582465,582670
2409,recursive,"
Product: Uniview XVR301-08G3 8 Chanel 1 SATA XVR. Category: Uniview. Subcategory: XVR. Price: 5,500৳.

Product: Uniview XVR301-16G3 16 Chanel 1 SATA XVR. Category: Uniview. Subcategory: XVR. Price: 9,000৳.
",207,582670,582877
2410,recursive,"
Product: Nexakey NX-280AS Single Door Magnetic Door Lock. Category: Door Lock. Subcategory: Security. Price: 2,450৳.

Product: ZKTeco LM-2802 Electromagnetic Door Lock. Category: Door Lock. Subcategory: Security. Price: 2,399৳2,500৳.
",235,582877,583112
2411,recursive,"
Product: SmartX SX-578 WiFi Fingerprint Smart Door Lock. Category: Door Lock. Subcategory: Security. Price: 9,500৳10,000৳.

Product: SmartX SX-528 WiFi Fingerprint Smart Door Lock. Category: Door Lock. Subcategory: Security. Price: 11,700৳11,950৳.
",249,583112,583361
2412,recursive,"
Product: SmartLife M1 Smart Door Lock. Category: Door Lock. Subcategory: Security. Price: Out Of Stock.

Product: ZKTeco GL300 Fingerprint Glass Door Smart Lock. Category: Door Lock. Subcategory: Security. Price: 14,000৳15,800৳.
",230,583361,583591
2413,recursive,"
Product: ZKTeco GL300W Fingerprint WiFi Glass Door Smart Lock. Category: Door Lock. Subcategory: Security. Price: 16,450৳17,000৳.

Product: STATA Door Lock Clutch. Category: Door Lock. Subcategory: Security. Price: Out Of Stock.
",230,583591,583821
2414,recursive,"
Product: SmartLife G1 Pro Smart Glass Door Lock. Category: Door Lock. Subcategory: Security. Price: 17,999৳.

Product: ZKTeco TL800 Wi-Fi Smart Digital Door Lock. Category: Door Lock. Subcategory: Security. Price: 18,650৳19,000৳.
",231,583821,584052
2415,recursive,"
Product: SmartLife G2 Smart Glass Door Lock. Category: Door Lock. Subcategory: Security. Price: 19,999৳.

Product: SmartLife T1 Pro Smart Door Lock with 3D Face Recognition. Category: Door Lock. Subcategory: Security. Price: 19,999৳.
",235,584052,584287
2416,recursive,"
Product: STATA X9 Lite Smart Digital Door Lock. Category: Door Lock. Subcategory: Security. Price: Out Of Stock.

Product: SmartLife K1 Smart Door Lock. Category: Door Lock. Subcategory: Security. Price: 20,999৳.
",214,584287,584501
2417,recursive,"
Product: SmartX SX-Z3D-ECO Tuya WiFi Face Recognition Door Lock with Camera & Display. Category: Door Lock. Subcategory: Security. Price: 22,000৳.

Product: SmartX SX-718TT Fingerprint Smart Door Lock. Category: Door Lock. Subcategory: Security. Price: 22,900৳23,500৳.
",270,584501,584771
2418,recursive,"
Product: SmartX SX-718Pro WiFi Smart Door Lock with Camera & Display Tuya Smart Life. Category: Door Lock. Subcategory: Security. Price: 23,400৳24,500৳.

Product: SmartLife X1 Pro Smart Door Lock with Camera. Category: Door Lock. Subcategory: Security. Price: 23,499৳25,000৳.
",277,584771,585048
2419,recursive,"
Product: SmartX SX-F600 Tuya WiFi Face Recognition Door Lock with Camera & Display. Category: Door Lock. Subcategory: Security. Price: 25,000৳.

Product: ZKTeco HBL100 Hybrid Biometric Smart Door Lock with Wireless Connection. Category: Door Lock. Subcategory: Security. Price: 25,500৳.
",288,585048,585336
2420,recursive,"
Product: Jovision JVS-XD2604-FC10V 4 Channel XVR. Category: Jovision. Subcategory: XVR. Price: 5,100৳.

Product: Jovision JVS-XD2608-FC10V 8 Channel 5 In 1 XVR. Category: Jovision. Subcategory: XVR. Price: 7,100৳.
",215,585336,585551
2421,recursive,"
Product: Jovision JVS-XD2716-FC10T 16CH 1080N 5-in-1 XVR. Category: Jovision. Subcategory: XVR. Price: 9,500৳.

Product: Jovision JVS-XD2832-HE20K 32CH 5-in-1 XVR. Category: Jovision. Subcategory: XVR. Price: 23,500৳.
",219,585551,585770
2422,recursive,"
Product: Jovision JVS-XD2508-FC10T 8 Channel 5 IN 1 XVR. Category: Jovision. Subcategory: XVR. Price: Out Of Stock.

Product: ZKTeco LM-1802 Magnetic Door Lock. Category: ZKTeco. Subcategory: Door Lock. Price: Out Of Stock.
",225,585770,585995
2423,recursive,"
Product: ZKTeco LM-280 Magnetic Door Lock. Category: ZKTeco. Subcategory: Door Lock. Price: Out Of Stock.

Product: ZKTeco Al-180d Electromagnetic Double Door Lock. Category: ZKTeco. Subcategory: Door Lock. Price: Out Of Stock.
",229,585995,586224
2424,recursive,"
Product: ZKTeco Al-280d(Led) Electromagnetic Double Door Lock. Category: ZKTeco. Subcategory: Door Lock. Price: Out Of Stock.

Product: STATA X9 Plus Smart Digital Door Lock. Category: STATA. Subcategory: Door Lock. Price: Out Of Stock.
",238,586224,586462
2425,recursive,"
Product: STATA TAP Pro Smart Door Lock. Category: STATA. Subcategory: Door Lock. Price: Out Of Stock.

Product: STATA X9 Smart Digital Door Lock. Category: STATA. Subcategory: Door Lock. Price: Out Of Stock.
",209,586462,586671
2426,recursive,"
Product: STATA Bolt Smart Digital Door Lock. Category: STATA. Subcategory: Door Lock. Price: Out Of Stock.

Product: SmartX SX-N5-3D WiFi Face Recognition Door Lock with Camera & Video Doorbell. Category: SmartX. Subcategory: Door Lock. Price: 40,900৳42,500৳.
",261,586671,586932
2427,recursive,"
Product: SmartX SX-D2 WiFi Dual Side Smart Door Lock. Category: SmartX. Subcategory: Door Lock. Price: 16,500৳.

Product: SmartX SX-N5TY WiFi Door Lock with Camera & Video Doorbell Tuya Smart Life App. Category: SmartX. Subcategory: Door Lock. Price: Out Of Stock.
",266,586932,587198
2428,recursive,"
Product: SmartX SX-N500 WiFi Face Recognition Door Lock with Camera. Category: SmartX. Subcategory: Door Lock. Price: Out Of Stock.

Product: SmartLife Y1 Pro Smart Door Lock with 3D Face Recognition. Category: SmartLife. Subcategory: Door Lock. Price: 29,999৳34,500৳.
",270,587198,587468
2429,recursive,"
Product: SmartLife Z2 Pro Smart Door Lock with 3D Face Recognition. Category: SmartLife. Subcategory: Door Lock. Price: 49,999৳64,999৳.

Product: SmartLife F2 Pro Smart Door Lock with 3D Face Recognition. Category: SmartLife. Subcategory: Door Lock. Price: 24,000৳.
",267,587468,587735
2430,recursive,"
Product: SmartLife F1 Pro Smart Door Lock with 3D Face Recognition. Category: SmartLife. Subcategory: Door Lock. Price: Out Of Stock.

Product: SmartLife X2 Pro Smart Door Lock. Category: SmartLife. Subcategory: Door Lock. Price: Out Of Stock.
",245,587735,587980
2431,recursive,"
Product: SmartLife Y2 Pro Smart Door Lock with 3D Face Recognition. Category: SmartLife. Subcategory: Door Lock. Price: Out Of Stock.

Product: ZKTeco D0BPA Smart WiFi Video Door Bell. Category: Smart Door Bell. Subcategory: Security. Price: 7,100৳7,500৳.
",257,587980,588237
2432,recursive,"
Product: Hikvision DS-KIS204T Video Smart Door Bell. Category: Smart Door Bell. Subcategory: Security. Price: 10,000৳.

Product: Grandstream GDS3710 HD IP Video Door Bell System. Category: Smart Door Bell. Subcategory: Security. Price: 39,000৳.
",246,588237,588483
2433,recursive,"
Product: Tp-Link Tapo D130 Smart Wired Video Doorbell. Category: Smart Door Bell. Subcategory: Security. Price: Up Coming.

Product: Grandstream GDS3705 IP Audio Door Bell System. Category: Smart Door Bell. Subcategory: Security. Price: Up Coming.
",249,588483,588732
2434,recursive,"
Product: Grandstream GDS3702 IP Audio Door Bell System. Category: Smart Door Bell. Subcategory: Security. Price: Up Coming.

Product: Seemo Smart Video Home Security DoorBell. Category: Smart Door Bell. Subcategory: Security. Price: Out Of Stock.
",248,588732,588980
2435,recursive,"
Product: STATA Smart Video Door Bell. Category: Smart Door Bell. Subcategory: Security. Price: Out Of Stock.

Product: Tp-Link Tapo D230S1 Smart WiFi Video Doorbell. Category: Smart Door Bell. Subcategory: Security. Price: Out Of Stock.
",238,588980,589218
2436,recursive,"
Product: Hikvision Ezviz DP2C Portable Wi-Fi Peephole Video Doorbell. Category: Smart Door Bell. Subcategory: Security. Price: Out Of Stock.

Product: Onspot OSF93 Access Control. Category: Access Control. Subcategory: Security. Price: 14,000৳.
",246,589218,589464
2437,recursive,"
Product: Onspot OSF92 Access Control. Category: Access Control. Subcategory: Security. Price: 13,000৳.

Product: Nexakey NX-2052 Offline Access Control. Category: Access Control. Subcategory: Security. Price: 2,250৳.
",218,589464,589682
2438,recursive,"
Product: Zkteco TLEB101-R Exit Button with Remote. Category: Access Control. Subcategory: Security. Price: 2,299৳2,500৳.

Product: Onspot OSF42 Access Control. Category: Access Control. Subcategory: Security. Price: 10,500৳.
",226,589682,589908
2439,recursive,"
Product: ZKTeco SLK20R Biometric Fingerprint Scanner without Adapter. Category: Access Control. Subcategory: Security. Price: 4,750৳5,000৳.

Product: ZKTeco FR1200 Finger & RFID Exit Reader. Category: Access Control. Subcategory: Security. Price: 4,700৳5,500৳.
",262,589908,590170
2440,recursive,"
Product: ZKTeco K50A Fingerprint Time Attendance & Access Control Terminal with Adapter. Category: Access Control. Subcategory: Security. Price: 5,915৳6,500৳.
",160,590170,590330
2441,recursive,"
Product: ZKTeco SenseFP M1 Biometric Time & Attendance Access Control Terminal. Category: Access Control. Subcategory: Security. Price: 6,600৳.

Product: ZKTeco FR1300 Finger RFID & Password Exit Reader. Category: Access Control. Subcategory: Security. Price: Out Of Stock.
",275,590330,590605
2442,recursive,"
Product: ZKTeco K40 Time & Attendance Terminal Machine. Category: Access Control. Subcategory: Security. Price: 5,670৳6,500৳.

Product: ZKTeco K90 Fingerprint Time & Attendance and Access Control Terminal. Category: Access Control. Subcategory: Security. Price: 5,727৳6,900৳.
",277,590605,590882
2443,recursive,"
Product: ZKTeco MB20-VL Multibiometric Time Attendance Access Control. Category: Access Control. Subcategory: Security. Price: 8,199৳8,300৳.
",142,590882,591024
2444,recursive,"
Product: ZKTeco MB10-VL Hybrid Biometric Time & Attendance and Access Control Terminal. Category: Access Control. Subcategory: Security. Price: 7,480৳8,500৳.

Product: ZKTeco iClock9000-G (GPRS/3G) Time Attendance Terminal Machine. Category: Access Control. Subcategory: Security. Price: 10,500৳.
",298,591024,591322
2445,recursive,"
Product: ZKTeco MB10-VL Wi-fi Biometric Time & Attendance and Access Control Terminal. Category: Access Control. Subcategory: Security. Price: 10,500৳.

Product: ZKTeco SenseFace 2A Access Control Terminal. Category: Access Control. Subcategory: Security. Price: 9,999৳10,500৳.
",279,591322,591601
2446,recursive,"
Product: ZKTeco F18 Access Control with Card & Finger Print. Category: Access Control. Subcategory: Security. Price: 9,765৳10,800৳.

Product: Hikvision DS-K1T320EFWX Face Recognition Access Control Terminal. Category: Hikvision. Subcategory: Access Control. Price: 10,400৳11,500৳.
",282,591601,591883
2447,recursive,"
Product: Hikvision DS-K1T320EFWX-B Face Recognition Access Control. Category: Hikvision. Subcategory: Access Control. Price: 11,400৳11,500৳.

Product: Hikvision DS-K1T343EFWX Face Recognition Access Control Terminal. Category: Hikvision. Subcategory: Access Control. Price: 13,800৳.
",284,591883,592167
2448,recursive,"
Product: Hikvision DS-K1T342EX-E1 Face Recognition Access Control Terminal. Category: Hikvision. Subcategory: Access Control. Price: 16,000৳.

Product: Hikvision DS-K1T342EFWX-E1 Face Recognition Access Control Terminal. Category: Hikvision. Subcategory: Access Control. Price: 17,500৳.
",288,592167,592455
2449,recursive,"
Product: Hikvision DS-K1T8005EFWX-B Fingerprint Access Control. Category: Hikvision. Subcategory: Access Control. Price: Up Coming.

Product: Hikvision DS-K1T344EBFWX-E1 Face Recognition Access Control. Category: Hikvision. Subcategory: Access Control. Price: Up Coming.
",272,592455,592727
2450,recursive,"
Product: Hikvision DS-K1201AEF Fingerprint Reader. Category: Hikvision. Subcategory: Access Control. Price: Up Coming.

Product: Hikvision DS-K1801 Card Reader With Keyboard. Category: Hikvision. Subcategory: Access Control. Price: Up Coming.
",244,592727,592971
2451,recursive,"
Product: Hikvision DS-K1T342EFWX Face Recognition Access Control Terminal. Category: Hikvision. Subcategory: Access Control. Price: Up Coming.

Product: Hikvision DS-K1T320EX Face Recognition Access Control Terminal. Category: Hikvision. Subcategory: Access Control. Price: Out Of Stock.
",289,592971,593260
2452,recursive,"
Product: Hikvision DS-K1A8503EF Fingerprint Time Attendance Terminal. Category: Hikvision. Subcategory: Access Control. Price: Out Of Stock.

Product: Hikvision DS-K1T320EFX Face Recognition Access Control Terminal. Category: Hikvision. Subcategory: Access Control. Price: Out Of Stock.
",288,593260,593548
2453,recursive,"
Product: Hikvision DS-K1T321EX Face Recognition Access Control Terminal. Category: Hikvision. Subcategory: Access Control. Price: Out Of Stock.

Product: Hikvision DS-K1T321EFX Face Recognition Access Control Terminal. Category: Hikvision. Subcategory: Access Control. Price: Out Of Stock.
",291,593548,593839
2454,recursive,"
Product: Hikvision DS-K1T321EFWX Face Recognition Access Control Terminal. Category: Hikvision. Subcategory: Access Control. Price: Out Of Stock.

Product: Hikvision DS-K1T343EFX Face Recognition Access Control Terminal. Category: Hikvision. Subcategory: Access Control. Price: Out Of Stock.
",293,593839,594132
2455,recursive,"
Product: Hikvision DS-K1T343EX Face Recognition Access Control Terminal. Category: Hikvision. Subcategory: Access Control. Price: Out Of Stock.

Product: Hikvision DS-K1T321EFWX-B Face Recognition Access Control Terminal. Category: Hikvision. Subcategory: Access Control. Price: Out Of Stock.
",294,594132,594426
2456,recursive,"
Product: Hikvision DS-K1T341CMF Face Recognition Access Control Terminal. Category: Hikvision. Subcategory: Access Control. Price: Out Of Stock.
",146,594426,594572
2457,recursive,"
Product: Onspot OS456F Biometric Face Recognition Time Attendance Recorder & Access Control. Category: Onspot. Subcategory: Access Control. Price: 22,000৳.

Product: Onspot OS930F Access Control. Category: Onspot. Subcategory: Access Control. Price: Out Of Stock.
",265,594572,594837
2458,recursive,"
Product: Onspot OSF75 Access Control with Battary Backup. Category: Onspot. Subcategory: Access Control. Price: 8,000৳.

Product: TRENDnet TK-207K 2-Port USB KVM Switch Kit. Category: KVM Switch. Subcategory: Security. Price: 4,550৳.
",235,594837,595072
2459,recursive,"
Product: TRENDnet TK-407K 4-Port USB KVM Switch Kit. Category: KVM Switch. Subcategory: Security. Price: 8,400৳.

Product: TRENDnet TK-803R 8-Port Rack Mount KVM Switch. Category: KVM Switch. Subcategory: Security. Price: 24,500৳.
",232,595072,595304
2460,recursive,"
Product: Safenet SN-KC6808S 8-Port Stacking VGA KVM. Category: KVM Switch. Subcategory: Security. Price: 143,000৳.

Product: COTE KVM-0819M 8 Port KVM Switch with 19"" Console. Category: KVM Switch. Subcategory: Security. Price: 160,000৳.
",239,595304,595543
2461,recursive,"
Product: Safenet SN-KC7808S 8-Port TP KVM. Category: KVM Switch. Subcategory: Security. Price: 190,000৳.

Product: COTE KVM-1619M 16 Port KVM Switch with 19"" Console. Category: KVM Switch. Subcategory: Security. Price: 195,000৳.
",230,595543,595773
2462,recursive,"
Product: Safenet SN-KC7816S 16-Port TP KVM. Category: KVM Switch. Subcategory: Security. Price: 247,000৳.

Product: Micronet SP214EL 4-PORT KVM SWITCH WITH 4 PS/2 CABLE. Category: KVM Switch. Subcategory: Security. Price: Out Of Stock.
",237,595773,596010
2463,recursive,"
Product: Micronet SP218D 8 Port USB IP KVM With 8 KVM Cable. Category: KVM Switch. Subcategory: Security. Price: Out Of Stock.

Product: Micronet SP226D 16 PORT Combo KVM with 16 Cable. Category: KVM Switch. Subcategory: Security. Price: Out Of Stock.
",253,596010,596263
2464,recursive,"
Product: Safenet SN-KC6816S 16-Port Stacking VGA KVM. Category: KVM Switch. Subcategory: Security. Price: Out Of Stock.

Product: ZKTeco F22 Fingerprint Time Attendance and Access Control Terminal. Category: ZKTeco. Subcategory: Access Control. Price: 9,720৳10,800৳.
",268,596263,596531
2465,recursive,"
Product: ZKTeco F19 Fingerprint Standalone Access Control. Category: ZKTeco. Subcategory: Access Control. Price: 9,625৳12,500৳.

Product: ZKTeco MB360 Fingerprint Time Attendance Terminal. Category: ZKTeco. Subcategory: Access Control. Price: 12,300৳13,400৳.
",260,596531,596791
2466,recursive,"
Product: ZKTeco SenseFace 3A AI Based Access Control Terminal. Category: ZKTeco. Subcategory: Access Control. Price: 16,399৳17,000৳.

Product: ZKTeco iClock260 Fingerprint Time Attendance and Access Control Terminal. Category: ZKTeco. Subcategory: Access Control. Price: 17,300৳.
",281,596791,597072
2467,recursive,"
Product: Tipsoi Prompt P40 Biometric Time Attendance & Access Control Terminal. Category: Tipsoi. Subcategory: Access Control. Price: 10,000৳.

Product: Tipsoi TF-80 Biometric Time Attendance & Access Control Terminal. Category: Tipsoi. Subcategory: Access Control. Price: 20,000৳.
",283,597072,597355
2468,recursive,"
Product: Tipsoi Prompt P205 Biometric Time Attendance & Access Control Terminal. Category: Tipsoi. Subcategory: Access Control. Price: 17,500৳.

Product: Tipsoi Prompt P310 Biometric Time Attendance & Access Control Terminal. Category: Tipsoi. Subcategory: Access Control. Price: 27,000৳.
",290,597355,597645
2469,recursive,"
Product: Tipsoi Fastface 5 Lite Time Attendance & Access Control Terminal. Category: Tipsoi. Subcategory: Access Control. Price: 32,000৳.

Product: Tipsoi Fastface 5 Time Attendance & Access Control Terminal. Category: Tipsoi. Subcategory: Access Control. Price: 42,000৳.
",273,597645,597918
2470,recursive,"
Product: Tipsoi Fastface 5 Pro Time Attendance & Access Control Terminal. Category: Tipsoi. Subcategory: Access Control. Price: 50,000৳.

Product: Tipsoi Fastface 5 Pro FP Biometric Time Attendance & Access Control Terminal. Category: Tipsoi. Subcategory: Access Control. Price: 55,000৳.
",289,597918,598207
2471,recursive,"
Product: Tipsoi Fastface 7 Time Attendance & Access Control Terminal. Category: Tipsoi. Subcategory: Access Control. Price: 60,000৳.

Product: Tipsoi Fastface 8 Time Attendance & Access Control Terminal. Category: Tipsoi. Subcategory: Access Control. Price: 80,000৳.
",268,598207,598475
2472,recursive,"
Product: Tipsoi Fastface Go Lite Time Attendance & Access Control Terminal. Category: Tipsoi. Subcategory: Access Control. Price: 40,500৳.

Product: NexaKey K2RR Touchless Exit Button with Remote. Category: NexaKey. Subcategory: Access Control. Price: Out Of Stock.
",267,598475,598742
2473,recursive,"
Product: Deli ET520 Digital Safe Box / Locker / Vault. Category: Digital Locker & Vault. Subcategory: Security. Price: Out Of Stock.

Product: Deli ET580 Fireproof Digital Safe Box / Locker / Vault. Category: Digital Locker & Vault. Subcategory: Security. Price: 21,500৳22,000৳.
",280,598742,599022
2474,recursive,"
Product: Deli ET595 Fingerprint Password Digital Safe Box / Locker / Vault. Category: Digital Locker & Vault. Subcategory: Security. Price: 23,000৳.
",150,599022,599172
2475,recursive,"
Product: Deli ET592 Fingerprint Password Digital Safe Box / Locker / Vault. Category: Digital Locker & Vault. Subcategory: Security. Price: 24,000৳.

Product: Deli ET581 Fireproof Digital Safe Box / Locker / Vault. Category: Digital Locker & Vault. Subcategory: Security. Price: 24,500৳.
",289,599172,599461
2476,recursive,"
Product: Deli ET596 Fingerprint Password Digital Safe Box / Locker / Vault. Category: Digital Locker & Vault. Subcategory: Security. Price: 26,000৳.
",150,599461,599611
2477,recursive,"
Product: Deli ET593 Fingerprint Password Digital Safe Box / Locker / Vault. Category: Digital Locker & Vault. Subcategory: Security. Price: 28,000৳.
",150,599611,599761
2478,recursive,"
Product: Deli ET594 Fingerprint Password Digital Safe Box / Locker / Vault. Category: Digital Locker & Vault. Subcategory: Security. Price: 32,000৳.
",150,599761,599911
2479,recursive,"
Product: Deli ET597 Fingerprint Password Digital Safe Box / Locker / Vault. Category: Digital Locker & Vault. Subcategory: Security. Price: 34,500৳.

Product: Deli ET600 Fireproof Digital Safe Box / Locker / Vault. Category: Digital Locker & Vault. Subcategory: Security. Price: 38,000৳.
",289,599911,600200
2480,recursive,"
Product: Deli ET601 Fireproof Digital Safe Box / Locker / Vault. Category: Digital Locker & Vault. Subcategory: Security. Price: 45,000৳.

Product: Deli ET602 Fireproof Digital Safe Box / Locker / Vault. Category: Digital Locker & Vault. Subcategory: Security. Price: 50,000৳.
",278,600200,600478
2481,recursive,"
Product: Deli 4116G Fingerprint Password Digital Safe Box / Locker / Vault. Category: Digital Locker & Vault. Subcategory: Security. Price: Up Coming.

Product: Deli ET551 Password Digital Safe Box / Locker / Vault. Category: Digital Locker & Vault. Subcategory: Security. Price: Up Coming.
",292,600478,600770
2482,recursive,"
Product: Deli ET552 Password Digital Safe Box / Locker / Vault. Category: Digital Locker & Vault. Subcategory: Security. Price: Up Coming.

Product: Deli 4117G Fingerprint Password Digital Safe Box / Locker / Vault. Category: Digital Locker & Vault. Subcategory: Security. Price: Up Coming.
",292,600770,601062
2483,recursive,"
Product: Deli 4118G Fingerprint Password Digital Safe Box / Locker / Vault. Category: Digital Locker & Vault. Subcategory: Security. Price: Up Coming.

Product: Deli 4121 Fingerprint & Digital Safe Box / Locker / Vault. Category: Digital Locker & Vault. Subcategory: Security. Price: Up Coming.
",296,601062,601358
2484,recursive,"
Product: Deli ET553 Password Digital Safe Box / Locker / Vault. Category: Digital Locker & Vault. Subcategory: Security. Price: Up Coming.

Product: Deli 4122 Fingerprint & Digital Safe Box / Locker / Vault. Category: Digital Locker & Vault. Subcategory: Security. Price: Up Coming.
",284,601358,601642
2485,recursive,"
Product: Nexakey NX-280U U Magnetic Door Lock Bracket. Category: Access Control Accessories. Subcategory: Access Control. Price: 2,450৳.

Product: ZKTeco LMB-180L L Bracket. Category: Access Control Accessories. Subcategory: Access Control. Price: 500৳.
",255,601642,601897
2486,recursive,"
Product: ZKTeco LMB-280L L Bracket. Category: Access Control Accessories. Subcategory: Access Control. Price: 600৳.

Product: Nexakey NX-280ZL EM Magnetic Door Lock Bracket. Category: Access Control Accessories. Subcategory: Access Control. Price: 1,400৳.
",257,601897,602154
2487,recursive,"
Product: ZKTeco LMB-280U Electromagnetic Lock U Bracket. Category: Access Control Accessories. Subcategory: Access Control. Price: 799৳850৳.

Product: ZKTeco LMB-280Z Z Bracket. Category: Access Control Accessories. Subcategory: Access Control. Price: 699৳750৳.
",263,602154,602417
2488,recursive,"
Product: Zkteco LMB-280ZL Electromagnetic Lock Z & L Bracket. Category: Access Control Accessories. Subcategory: Access Control. Price: 1,300৳1,500৳.

Product: ZKTeco LMB-180U U Bracket. Category: Access Control Accessories. Subcategory: Access Control. Price: Out Of Stock.
",276,602417,602693
2489,recursive,"
Product: ZKTeco LMB-180Z Bracket. Category: Access Control Accessories. Subcategory: Access Control. Price: Out Of Stock.

Product: ZKTeco ZK-D1010L Walk Through Metal Detector. Category: Entrance Control. Subcategory: Security. Price: 39,500৳42,500৳.
",253,602693,602946
2490,recursive,"
Product: ZKTeco ZK-D1065S Walk Through 6 Zones Metal Detector. Category: Entrance Control. Subcategory: Security. Price: 55,000৳.

Product: Hikvision DS-TMG300-DL(3.4~6m telescopic) Straight Pole Barrier Gate. Category: Entrance Control. Subcategory: Security. Price: 55,000৳.
",278,602946,603224
2491,recursive,"
Product: Hikvision DS-TMG301-DL(2+2m) Folding Pole Barrier Gate. Category: Entrance Control. Subcategory: Security. Price: 55,000৳.

Product: Hikvision DS-TMG301-DR(2+2m) Folding Pole Barrier Gate. Category: Entrance Control. Subcategory: Security. Price: 55,000৳.
",266,603224,603490
2492,recursive,"
Product: Hikvision DS-TMG4B0-RA 6 Meter Straight Pole Barrier Gate. Category: Entrance Control. Subcategory: Security. Price: 55,000৳.

Product: ZKTeco ZK-D2180 Walk Through 18 Zones Metal Detector. Category: Entrance Control. Subcategory: Security. Price: 65,500৳.
",267,603490,603757
2493,recursive,"
Product: ZKTeco ZK-D1065 Walk Through 6 Zones Metal Detector. Category: Entrance Control. Subcategory: Security. Price: 63,000৳.

Product: ZKTeco ZK-D3180 Walk Through 18 Zones Metal Detector. Category: Entrance Control. Subcategory: Security. Price: 90,000৳105,000৳.
",269,603757,604026
2494,recursive,"
Product: Hikvision ISD-SG6550SA-2CL X-ray Intelligent Security Inspection System. Category: Entrance Control. Subcategory: Security. Price: 110,000৳.
",151,604026,604177
2495,recursive,"
Product: ZKTeco ZK-TS2022 Pro Tripod Turnstile With Controller Fingerprint and RFID Reader. Category: Entrance Control. Subcategory: Security. Price: 125,000৳.

Product: ZKTeco ZK-D4330 Walk Through 33 Zones Metal Detector. Category: Entrance Control. Subcategory: Security. Price: 210,000৳.
",293,604177,604470
2496,recursive,"
Product: ZKTeco PB4130L/R Parking Barrier. Category: Entrance Control. Subcategory: Security. Price: Up Coming.

Product: ZKTeco ZKX5030A Single Energy X-ray Baggage Scanner. Category: Entrance Control. Subcategory: Security. Price: Up Coming.
",245,604470,604715
2497,recursive,"
Product: ZKTeco TS2000 Pro Tripod Turnstile with Controller Fingerprint and RFID Reader. Category: Entrance Control. Subcategory: Security. Price: Up Coming.
",159,604715,604874
2498,recursive,"
Product: Hikvision ISD-SG5030SA-CL X-ray Intelligent Security Inspection System. Category: Entrance Control. Subcategory: Security. Price: Up Coming.

Product: Hikvision ISD-SMG1118L Walk Through Metal Detector. Category: Entrance Control. Subcategory: Security. Price: Up Coming.
",282,604874,605156
2499,recursive,"
Product: Hikvision ISD-SMG106 Walk Through Metal Detector. Category: Entrance Control. Subcategory: Security. Price: Up Coming.

Product: Hikvision NP-SH100 Hand Held Metal Detector. Category: Entrance Control. Subcategory: Security. Price: Up Coming.
",253,605156,605409
2500,recursive,"
Product: Starlink Mini Kit. Category: Starlink. Subcategory: Networking. Price: 26,500৳36,499৳.

Product: Starlink Standard Kit. Category: Starlink. Subcategory: Networking. Price: 49,500৳60,999৳.
",198,605409,605607
2501,recursive,"
Product: Starlink Flat High Performance Kit. Category: Starlink. Subcategory: Networking. Price: 185,000৳189,000৳.

Product: Starlink Mini 15 Meter DC Power Cable for Mini KIT. Category: Starlink. Subcategory: Networking. Price: Up Coming.
",241,605607,605848
2502,recursive,"
Product: Starlink Standard Power Supply Mount for Standard KIT. Category: Starlink. Subcategory: Networking. Price: Up Coming.

Product: Starlink Mini 5 Meter USB Type-C Power Cable for Mini KIT. Category: Starlink. Subcategory: Networking. Price: Up Coming.
",260,605848,606108
2503,recursive,"
Product: Starlink Mini 15 Meter RJ45 Ethernet Cable for Mini KIT. Category: Starlink. Subcategory: Networking. Price: Up Coming.

Product: Starlink Mini 30 Meter DC Power Cable for Mini KIT. Category: Starlink. Subcategory: Networking. Price: Up Coming.
",255,606108,606363
2504,recursive,"
Product: Starlink Mini Mobility Mount for Mini KIT. Category: Starlink. Subcategory: Networking. Price: Up Coming.

Product: Starlink Standard Pipe Adapter Mount for Standard KIT. Category: Starlink. Subcategory: Networking. Price: Up Coming.
",244,606363,606607
2505,recursive,"
Product: Starlink Standard Mobility Mount for Standard KIT. Category: Starlink. Subcategory: Networking. Price: Up Coming.

Product: Starlink Mini Pipe Adapter and Flat Mount for Mini KIT. Category: Starlink. Subcategory: Networking. Price: Up Coming.
",253,606607,606860
2506,recursive,"
Product: Starlink Vehicle Roof Rack Mount for Starlink Mini KIT. Category: Starlink. Subcategory: Networking. Price: Up Coming.

Product: Starlink Standard 15 Meter RJ45 Ethernet Cable for Standard KIT. Category: Starlink. Subcategory: Networking. Price: Up Coming.
",267,606860,607127
2507,recursive,"
Product: Starlink Gen 3 Router Mount. Category: Starlink. Subcategory: Networking. Price: Up Coming.

Product: Starlink Mini Wall Mount for Mini KIT. Category: Starlink. Subcategory: Networking. Price: Up Coming.
",214,607127,607341
2508,recursive,"
Product: Starlink Mini Travel Kit. Category: Starlink. Subcategory: Networking. Price: Up Coming.

Product: Starlink Standard Wall Mount for Standard KIT. Category: Starlink. Subcategory: Networking. Price: Up Coming.
",219,607341,607560
2509,recursive,"
Product: Starlink Standard Roof Rack Mount for Standard KIT. Category: Starlink. Subcategory: Networking. Price: Up Coming.

Product: Starlink Standard 45 Meter RJ45 Ethernet Cable for Standard KIT. Category: Starlink. Subcategory: Networking. Price: Up Coming.
",263,607560,607823
2510,recursive,"
Product: Vivanco VCA20 2 Port Faceplate with Shutter. Category: Networking. Price: 175৳.

Product: CommScope 2225211-1 Single Port Faceplate. Category: Networking. Price: 190৳.

Product: R&M CAT6 2-Port Faceplate. Category: Networking. Price: 200৳.
",250,607823,608073
2511,recursive,"
Product: Rosenberger CP21-112-10 Dual Port Faceplate. Category: Networking. Price: 170৳200৳.

Product: Vention IBEGH 2M Cat.6 UTP Patch Cord Cable. Category: Networking. Price: 200৳.

Product: Vention IBELH 2M Cat.6 UTP Patch Cord Cable Blue. Category: Networking. Price: 200৳.
",279,608073,608352
2512,recursive,"
Product: Vention IBEOH 2M Cat.6 UTP Patch Cord Cable Orange. Category: Networking. Price: 200৳.

Product: Vention IBEPH 2M Cat.6 UTP Patch Cord Cable Pink. Category: Networking. Price: 200৳.

Product: Vention IBERH 2M Cat.6 UTP Patch Cord Cable Red. Category: Networking. Price: 200৳.
",286,608352,608638
2513,recursive,"
Product: Vention IBEYH 2M Cat.6 UTP Patch Cord Cable Yellow. Category: Networking. Price: 200৳.

Product: CommScope FPS-BS-2P-W 2-Ports Faceplate Kit. Category: Networking. Price: 210৳.

Product: Dintek 1303-12011CH 1-Port Wall Plate with Shutter. Category: Networking. Price: 220৳.
",284,608638,608922
2514,recursive,"
Product: Dintek 1303-12010CH 2-Port Wall Plate with Shutter. Category: Networking. Price: 220৳.

Product: CommScope 2225212-1 Dual Port Faceplate. Category: Networking. Price: 220৳.

Product: D-Link NFP-0WHI11 Single Faceplate. Category: Networking. Price: 240৳.
",264,608922,609186
2515,recursive,"
Product: Safenet 34-3551BL 0.5 Meter Cat6 LSZH UTP Patch Cord Blue. Category: Networking. Price: 250৳.

Product: Safenet 34-3551YL 0.5 Meter Cat6 LSZH UTP Patch Cord Yellow. Category: Networking. Price: 250৳.
",210,609186,609396
2516,recursive,"
Product: TP-Link TL-WR820N 300Mbps WiFi Router. Category: TP-Link. Subcategory: Router. Price: 1,150৳1,190৳.

Product: TP-Link TL-WR840N 300Mbps Wireless Router. Category: TP-Link. Subcategory: Router. Price: 1,350৳1,390৳.
",224,609396,609620
2517,recursive,"
Product: TP-Link TL-WR850N WiFi Router. Category: TP-Link. Subcategory: Router. Price: 1,390৳.

Product: TP-Link TL-WR841N 300Mbps Wireless Router. Category: TP-Link. Subcategory: Router. Price: 1,510৳1,590৳.
",210,609620,609830
2518,recursive,"
Product: Tp-link TL-WR845N 300Mbps Wireless Router. Category: TP-Link. Subcategory: Router. Price: 1,650৳1,679৳.

Product: TP-Link TD-W8961N 300Mbps ADSL2+ Modem Router. Category: TP-Link. Subcategory: Router. Price: 1,796৳1,890৳.
",232,609830,610062
2519,recursive,"
Product: TP-Link Archer C24 AC750 Dual-Band WiFi Router. Category: TP-Link. Subcategory: Router. Price: 1,804৳1,899৳.

Product: TP-Link Archer C54 AC1200 Dual Band Wi-Fi Router. Category: TP-Link. Subcategory: Router. Price: 2,081৳2,179৳.
",240,610062,610302
2520,recursive,"
Product: TP-Link Archer C50 AC1200 Dual Band Wi-Fi Router. Category: TP-Link. Subcategory: Router. Price: 2,165৳2,279৳.

Product: TP-Link Deco E4 AC1200 Dual-band Mesh Router (1 Pack). Category: TP-Link. Subcategory: Router. Price: 2,649৳.
",241,610302,610543
2521,recursive,"
Product: TP-Link Archer C64 AC1200 Dual-Band Gigabit WiFi Router. Category: TP-Link. Subcategory: Router. Price: 3,019৳.

Product: TP-Link Archer C6 AC1200 Gigabit Router. Category: TP-Link. Subcategory: Router. Price: 3,148৳3,349৳.
",234,610543,610777
2522,recursive,"
Product: TP-Link XC220-G3 AC1200 Wireless XPON Router. Category: TP-Link. Subcategory: Router. Price: 3,325৳3,500৳.

Product: TP-Link Deco M4 AC1200 Dual-Band Mesh Router (1 Pack). Category: TP-Link. Subcategory: Router. Price: 3,308৳3,519৳.
",243,610777,611020
2523,recursive,"
Product: TP-Link Archer AX15 AX1500 Dual Band Gigabit WiFi Router. Category: TP-Link. Subcategory: Router. Price: 3,751৳3,990৳.

Product: TP-Link Archer C80 AC1900 Dual-Band Gigabit WiFi Router. Category: TP-Link. Subcategory: Router. Price: 3,799৳3,999৳.
",257,611020,611277
2524,recursive,"
Product: TP-Link TL-MR100 300Mbps 4G LTE Router. Category: TP-Link. Subcategory: Router. Price: 3,830৳3,999৳.

Product: TP-Link Archer C86 AC1900 Dual-Band Wi-Fi Router. Category: TP-Link. Subcategory: Router. Price: 3,894৳4,099৳.
",232,611277,611509
2525,recursive,"
Product: TP-Link TL-MR105 300Mbps 4G LTE Router. Category: TP-Link. Subcategory: Router. Price: 3,967৳4,099৳.

Product: TP-Link Deco S7 AC1900 Dual Band Mesh Router (1-Pack). Category: TP-Link. Subcategory: Router. Price: 4,227৳4,449৳.
",237,611509,611746
2526,recursive,"
Product: Mercusys MW306R 300Mbps WiFi Router. Category: Router. Subcategory: Networking. Price: 1,000৳1,109৳.

Product: Mercusys MW325R 300Mbps Wifi Router. Category: Router. Subcategory: Networking. Price: 1,220৳1,309৳.
",222,611746,611968
2527,recursive,"
Product: D-Link R04 N300 300mbps Smart Router. Category: Router. Subcategory: Networking. Price: 1,240৳1,350৳.

Product: Tenda F3 300mbps Wireless Router. Category: Router. Subcategory: Networking. Price: 1,375৳.
",214,611968,612182
2528,recursive,"
Product: Zyxel NBG-418N V2 300 Mbps Wireless Router. Category: Router. Subcategory: Networking. Price: 980৳1,400৳.

Product: Zyxel P-661HNU-F1 300Mbps ADSL2+ Wireless Router. Category: Router. Subcategory: Networking. Price: 1,120৳1,400৳.
",240,612182,612422
2529,recursive,"
Product: Tenda F6 300Mbps WiFi Router. Category: Router. Subcategory: Networking. Price: 1,499৳1,550৳.

Product: Mercusys MW330HP 300Mbps WiFi Router. Category: Router. Subcategory: Networking. Price: 1,529৳1,609৳.
",216,612422,612638
2530,recursive,"
Product: Mercusys AC10 AC1200 Dual Band WiFi Router. Category: Router. Subcategory: Networking. Price: 1,550৳1,609৳.

Product: Tenda AC5 AC1200 Dual-Band WiFi Router. Category: Router. Subcategory: Networking. Price: 1,891৳2,050৳.
",232,612638,612870
2531,recursive,"
Product: Mercusys AC12 AC1200 Dual Band WiFi Router. Category: Router. Subcategory: Networking. Price: 1,927৳1,980৳.

Product: Hikvision DS-3WR12C AC1200 1200Mbps Dual Band WiFi Router. Category: Router. Subcategory: Networking. Price: 1,957৳2,060৳.
",251,612870,613121
2532,recursive,"
Product: BDCOM WAP2100-WR1200G Dual-Band Gigabit WiFi Router. Category: BDCOM. Subcategory: Router. Price: Out Of Stock.

Product: Ruijie RG-EW300 Pro 300Mbps Smart WiFi Router. Category: Ruijie. Subcategory: Router. Price: 2,200৳2,250৳.
",239,613121,613360
2533,recursive,"
Product: Ruijie RG-EW1800GX PRO 1800M Dual-Band Gigabit WiFi Router. Category: Ruijie. Subcategory: Router. Price: 7,050৳7,500৳.

Product: Ruijie RG-EG105GW(T) Wi-Fi 5 1267Mbps Wireless Business Router. Category: Ruijie. Subcategory: Router. Price: 9,900৳.
",258,613360,613618
2534,recursive,"
Product: Ruijie RG-EG105G-P V2 5-Port Gigabit POE Cloud Managed Router. Category: Ruijie. Subcategory: Router. Price: 10,900৳.

Product: Ruijie RG-EW3200GX PRO 3200Mbps Gigabit WiFi Router. Category: Ruijie. Subcategory: Router. Price: 12,125৳12,500৳.
",253,613618,613871
2535,recursive,"
Product: Ruijie RG-EW1200G PRO 1300M Dual-Band Gigabit WiFi Router. Category: Ruijie. Subcategory: Router. Price: Up Coming.

Product: Ruijie RG-EW1200 1200M Dual Band WiFi Router. Category: Ruijie. Subcategory: Router. Price: Out Of Stock.
",242,613871,614113
2536,recursive,"
Product: Ruijie RG-EW1300G 1300M Dual-Band Gigabit WiFi Router. Category: Ruijie. Subcategory: Router. Price: Out Of Stock.

Product: Ruijie RG-EG105G V2 5-Port Gigabit Cloud Managed Router. Category: Ruijie. Subcategory: Router. Price: Out Of Stock.
",252,614113,614365
2537,recursive,"
Product: Ruijie RG-EG209GS Reyee 9-Port Gigabit Cloud Managed SFP Router. Category: Ruijie. Subcategory: Router. Price: Out Of Stock.

Product: Ruijie RG-EG210G-P 10-Port Gigabit Cloud Managed PoE Router. Category: Ruijie. Subcategory: Router. Price: Out Of Stock.
",266,614365,614631
2538,recursive,"
Product: Mikrotik RB941-2nD-TC (HAP lite TC) Small Home Router. Category: Mikrotik. Subcategory: Router. Price: 3,650৳.

Product: Mikrotik RB941-2nD hAP-Lite Small Home Wifi Router With Access Point. Category: Mikrotik. Subcategory: Router. Price: 3,750৳3,700৳.
",263,614631,614894
2539,recursive,"
Product: Mikrotik Hex lite RB750R2 Plastic Body Router. Category: Mikrotik. Subcategory: Router. Price: 4,845৳5,100৳.

Product: Mikrotik RB951Ui-2nD hAP Access Point Router. Category: Mikrotik. Subcategory: Router. Price: 5,400৳.
",231,614894,615125
2540,recursive,"
Product: Mikrotik RB750UPr2 hEX PoE lite 5-Port Ethernet Router. Category: Mikrotik. Subcategory: Router. Price: 6,200৳.

Product: Mikrotik Hex RB750GR3 Plastic Body Gigabit Ethernet Router. Category: Mikrotik. Subcategory: Router. Price: 6,800৳.
",248,615125,615373
2541,recursive,"
Product: Mikrotik RB952Ui-5ac2nD-TC hAP ac Lite TC Dual Band Router. Category: Mikrotik. Subcategory: Router. Price: 7,100৳8,700৳.

Product: MikroTik RBD52G-5HacD2HnD-TC hAP ac2 Dual-Concurrent Router. Category: Mikrotik. Subcategory: Router. Price: 9,200৳9,300৳.
",265,615373,615638
2542,recursive,"
Product: Mikrotik RB960PGS hEX PoE 5 Port Gigabit Router. Category: Mikrotik. Subcategory: Router. Price: 12,500৳.

Product: Mikrotik hAP ac³ 5 GbE Port Dual-Band WiFi Router. Category: Mikrotik. Subcategory: Router. Price: Out Of Stock.
",239,615638,615877
2543,recursive,"
Product: Mikrotik RB450GX4 Gigabit Ethernet Router (With Case). Category: Mikrotik. Subcategory: Router. Price: 13,800৳.

Product: Mikrotik L009UiGS-2HaxD-IN 8-Port WiFi 6 Gigabit Router. Category: Mikrotik. Subcategory: Router. Price: 16,400৳.
",246,615877,616123
2544,recursive,"
Product: Mikrotik RB3011UiAS-RM Gigabit Ethernet Router. Category: Mikrotik. Subcategory: Router. Price: 19,200৳20,000৳.

Product: Mikrotik RB4011iGS+RM 10xGigabit Ethernet Rackmount Router. Category: Mikrotik. Subcategory: Router. Price: 23,218৳24,700৳.
",256,616123,616379
2545,recursive,"
Product: Mikrotik RB1100AHX4 (Dude Edition With Sata Port) Rackmount 13X Gigabit Ethernet Router. Category: Mikrotik. Subcategory: Router. Price: 44,500৳.

Product: Mikrotik CCR2004-16G-2S+ Cloud Core Router. Category: Mikrotik. Subcategory: Router. Price: 52,999৳54,900৳.
",274,616379,616653
2546,recursive,"
Product: Mikrotik CCR2004-1G-12S+2XS Ethernet Router. Category: Mikrotik. Subcategory: Router. Price: 65,500৳.

Product: Mikrotik CCR2116-12G-4S+ 16 Core ARM CPU 10G Router. Category: Mikrotik. Subcategory: Router. Price: 104,160৳115,500৳.
",241,616653,616894
2547,recursive,"
Product: Mikrotik CCR1036-8G-2S+EM 1U rackmount 8-Port Gigabit Ethernet Router. Category: Mikrotik. Subcategory: Router. Price: 158,000৳.

Product: Mikrotik RB951Ui-2HnD Wireless SOHO Access Point Router Board. Category: Mikrotik. Subcategory: Router. Price: Out Of Stock.
",274,616894,617168
2548,recursive,"
Product: Cudy WR1200 AC1200 Dual Band WiFi Router. Category: Cudy. Subcategory: Router. Price: 2,166৳2,280৳.

Product: Cudy M1200 AC1200 Dual Band Mesh Router (1 Pack). Category: Cudy. Subcategory: Router. Price: 2,592৳2,600৳.
",228,617168,617396
2549,recursive,"
Product: Cudy WR1300 V3 AC1200 Gigabit Dual Band Wi-Fi Router. Category: Cudy. Subcategory: Router. Price: 3,040৳3,200৳.

Product: Cudy M1300 AC1200 Dual Band Gigabit Mesh Router (1 Pack). Category: Cudy. Subcategory: Router. Price: 3,072৳3,200৳.
",248,617396,617644
2550,recursive,"
Product: Cudy WR1500 AX1500 Dual Band WiFi 6 Mesh Router. Category: Cudy. Subcategory: Router. Price: 3,500৳.

Product: Cudy WR3000 AX3000 Gigabit Dual Band Smart Wi-Fi 6 Router. Category: Cudy. Subcategory: Router. Price: 4,655৳4,900৳.
",238,617644,617882
2551,recursive,"
Product: Cudy M1800 AX1800 Dual Band Mesh Router (1 Pack). Category: Cudy. Subcategory: Router. Price: 4,650৳5,000৳.

Product: Cudy M1200 AC1200 Dual Band Mesh Router (3 Pack). Category: Cudy. Subcategory: Router. Price: 7,125৳7,500৳.
",236,617882,618118
2552,recursive,"
Product: Cudy WR3600E BE3600 Gigabit Mesh Wi-Fi 7 Router. Category: Cudy. Subcategory: Router. Price: 7,410৳7,800৳.

Product: Cudy WR3600 BE3600 Gigabit Wi-Fi 7 Mesh Router. Category: Cudy. Subcategory: Router. Price: 7,999৳.
",227,618118,618345
2553,recursive,"
Product: Cudy M1300 AC1200 Dual Band Gigabit Mesh Router (3 Pack). Category: Cudy. Subcategory: Router. Price: 8,674৳9,130৳.

Product: Cudy M1800 AX1800 Dual Band Mesh Router (2 Pack). Category: Cudy. Subcategory: Router. Price: 9,310৳9,500৳.
",244,618345,618589
2554,recursive,"
Product: Cudy M3000 AX3000 2.5G Dual Band Wi-Fi 6 Mesh Router (2 Pack). Category: Cudy. Subcategory: Router. Price: 10,230৳11,000৳.

Product: Cudy WR6500 BE6500 6500Mbps Dual Band Gigabit WiFi 7 Router. Category: Cudy. Subcategory: Router. Price: 13,500৳.
",257,618589,618846
2555,recursive,"
Product: Cudy M1800 AX1800 Dual Band Mesh Router (3 Pack). Category: Cudy. Subcategory: Router. Price: 13,580৳14,000৳.

Product: Cudy M3000 AX3000 2.5G Dual Band Wi-Fi 6 Mesh Router (3 Pack). Category: Cudy. Subcategory: Router. Price: 14,520৳16,500৳.
",253,618846,619099
2556,recursive,"
Product: Cudy WR300 N300 300mbps WiFi Router. Category: Cudy. Subcategory: Router. Price: Out Of Stock.

Product: Cudy MF4 4G LTE Sim Supported Mobile Wi-Fi Router. Category: Cudy. Subcategory: Router. Price: Out Of Stock.
",224,619099,619323
2557,recursive,"
Product: Cudy LT400 4G 300 Mbps Sim Supported Wireless Router. Category: Cudy. Subcategory: Router. Price: 4,399৳4,450৳.

Product: Cudy X6 AX1800 Dual Band Smart WiFi Router. Category: Cudy. Subcategory: Router. Price: Out Of Stock.
",234,619323,619557
2558,recursive,"
Product: Tenda HG6 N300 Wi-Fi GPON ONT Router. Category: Tenda. Subcategory: Router. Price: 2,325৳2,400৳.

Product: Tenda AC10 AC1200 Dual Band Gigabit WiFi Router. Category: Tenda. Subcategory: Router. Price: 3,072৳3,200৳.
",225,619557,619782
2559,recursive,"
Product: Tenda TX2L Pro AX1500 Dual-Band Gigabit Wi-Fi 6 Router. Category: Tenda. Subcategory: Router. Price: 3,392৳3,570৳.

Product: Tenda TX12 Pro v2.0 AX3000 Dual Band Gigabit Wi-Fi 6 Router. Category: Tenda. Subcategory: Router. Price: 3,977৳4,100৳.
",255,619782,620037
2560,recursive,"
Product: Tenda TX3000 Pro AX3000 Dual Band Gigabit Wi-Fi 6 Router. Category: Tenda. Subcategory: Router. Price: 4,171৳4,300৳.

Product: Tenda TX9 Pro AX3000 Dual-band Gigabit Wi-Fi 6 Router. Category: Tenda. Subcategory: Router. Price: 6,150৳.
",245,620037,620282
2561,recursive,"
Product: Tenda RX9 Pro AX3000 Dual Band Gigabit Wi-Fi 6 Router. Category: Tenda. Subcategory: Router. Price: 6,150৳.

Product: Tenda AC15 AC1900 Dual-Band Gigabit WiFi Router. Category: Tenda. Subcategory: Router. Price: 7,550৳7,700৳.
",236,620282,620518
2562,recursive,"
Product: Tenda Nova MW12 AC2100 Tri-band Mesh Router (3 Pack). Category: Tenda. Subcategory: Router. Price: 16,900৳.

Product: Tenda O3 Wireless 5km Outdoor Point To Point CPE. Category: Tenda. Subcategory: Router. Price: Up Coming.
",234,620518,620752
2563,recursive,"
Product: Tenda TX3 AX1800 Dual Band Gigabit WiFi 6 Router. Category: Tenda. Subcategory: Router. Price: Out Of Stock.

Product: Tenda N301 Wireless N300 Easy Setup Router. Category: Tenda. Subcategory: Router. Price: Out Of Stock.
",232,620752,620984
2564,recursive,"
Product: Tenda F9 600Mbps WiFi Router. Category: Tenda. Subcategory: Router. Price: Out Of Stock.

Product: Tenda AC6 AC1200 Smart Dual-band WiFi Router. Category: Tenda. Subcategory: Router. Price: Out Of Stock.
",214,620984,621198
2565,recursive,"
Product: Tenda AC8 AC1200 Dual-Band Gigabit Wi-Fi Router. Category: Tenda. Subcategory: Router. Price: Out Of Stock.

Product: Tenda AC21 AC2100 Dual Band Gigabit WiFi Router. Category: Tenda. Subcategory: Router. Price: Out Of Stock.
",236,621198,621434
2566,recursive,"
Product: Tenda AC23 AC2100 Dual Band Gigabit WiFi Router. Category: Tenda. Subcategory: Router. Price: Out Of Stock.

Product: D-Link COVR-C1202 AC1200 Dual-Band Mesh Router (2 Pack). Category: D-Link. Subcategory: Router. Price: 3,150৳3,500৳.
",245,621434,621679
2567,recursive,"
Product: D-Link R15 AX1500 Dual-Band WiFi Router. Category: D-Link. Subcategory: Router. Price: 4,450৳.

Product: D-Link DIR-615 Z1 300mbps WiFi Router. Category: D-Link. Subcategory: Router. Price: Out Of Stock.
",214,621679,621893
2568,recursive,"
Product: D-Link R03 N300 300mbps Smart Router. Category: D-Link. Subcategory: Router. Price: Out Of Stock.

Product: D-Link DIR-650IN N300 300mbps WiFi Router. Category: D-Link. Subcategory: Router. Price: Out Of Stock.
",221,621893,622114
2569,recursive,"
Product: D-Link DSL-2750U N300 ADSL2+ Modem Router. Category: D-Link. Subcategory: Router. Price: Out Of Stock.

Product: D-Link DIR-816 Wireless AC750 Dual Brand Router. Category: D-Link. Subcategory: Router. Price: Out Of Stock.
",232,622114,622346
2570,recursive,"
Product: D-Link DIR-806IN AC750 Dual-Band WiFi Router. Category: D-Link. Subcategory: Router. Price: Out Of Stock.

Product: D-Link DIR-819 AC750 Dual Band Router. Category: D-Link. Subcategory: Router. Price: Out Of Stock.
",225,622346,622571
2571,recursive,"
Product: D-Link DWR-921 4G LTE Router. Category: D-Link. Subcategory: Router. Price: Out Of Stock.

Product: Zyxel NBG6604 AC1200 Dual-Band WiFi Router. Category: Zyxel. Subcategory: Router. Price: 2,520৳3,199৳.
",213,622571,622784
2572,recursive,"
Product: Zyxel NBG6615 AC1200 Dual-Band WiFi Gigabit Router. Category: Zyxel. Subcategory: Router. Price: 2,975৳3,500৳.

Product: Zyxel NBG7510 AX1800 Dual-Band WiFi Gigabit Router. Category: Zyxel. Subcategory: Router. Price: 7,200৳.
",236,622784,623020
2573,recursive,"
Product: Zyxel Armor G1 AC2600 Multi-Gigabit WiFi Router. Category: Zyxel. Subcategory: Router. Price: 14,999৳.

Product: Zyxel NBG 6503 AC750 Dual-Band WiFi Router. Category: Zyxel. Subcategory: Router. Price: 19,760৳.
",221,623020,623241
2574,recursive,"
Product: Zyxel Armor G5 AX6000 Multi-Gigabit WiFi Router. Category: Zyxel. Subcategory: Router. Price: 24,500৳.

Product: Zyxel P-660HN-T1A 150Mbps ADSL2+ Wireless Gateway. Category: Zyxel. Subcategory: Router. Price: Call for Price.
",235,623241,623476
2575,recursive,"
Product: TOTOLINK X6000R AX3000 Dual Band Gigabit WiFi Router. Category: TOTOLINK. Subcategory: Router. Price: 2,909৳4,475৳.

Product: TOTOLINK T8 AC1200 Smart Home Mesh Router (2 Pack). Category: TOTOLINK. Subcategory: Router. Price: 4,500৳.
",244,623476,623720
2576,recursive,"
Product: TOTOLINK X5000R AX1800 Dual Band Gigabit WiFi Router. Category: TOTOLINK. Subcategory: Router. Price: 5,000৳.

Product: TOTOLINK A702R_V4 1200Mbps Dual Band WiFi Router. Category: TOTOLINK. Subcategory: Router. Price: Out Of Stock.
",242,623720,623962
2577,recursive,"
Product: ASUS RT-N12+ 300Mbps Wifi Router. Category: ASUS. Subcategory: Router. Price: 2,185৳2,300৳.

Product: ASUS RT-AX52 AX1800 Dual Band WiFi Router. Category: ASUS. Subcategory: Router. Price: 5,840৳6,600৳.
",213,623962,624175
2578,recursive,"
Product: ASUS RT-AX57 AX3000 Dual Band WiFi Router. Category: ASUS. Subcategory: Router. Price: 10,260৳13,500৳.

Product: ASUS RT-AX59U AX4200 Dual Band WiFi Router. Category: ASUS. Subcategory: Router. Price: 13,775৳14,500৳.
",227,624175,624402
2579,recursive,"
Product: ASUS TUF Gaming AX4200 Dual-Band WiFi 6 Gaming Router. Category: ASUS. Subcategory: Router. Price: 15,575৳17,500৳.

Product: ASUS RT-BE58U BE3600 Dual Band WiFi 7 Gaming Router. Category: ASUS. Subcategory: Router. Price: 17,266৳17,800৳.
",248,624402,624650
2580,recursive,"
Product: ASUS RT-AX82U AX5400 Dual-Band WiFi Gaming Router. Category: ASUS. Subcategory: Router. Price: 19,000৳.

Product: ASUS TUF Gaming AX6000 Dual Band WiFi Gaming Router. Category: ASUS. Subcategory: Router. Price: 21,500৳22,000৳.
",237,624650,624887
2581,recursive,"
Product: ASUS RT-AX89X AX6000 Dual Band WiFi Gaming Router. Category: ASUS. Subcategory: Router. Price: 43,500৳.

Product: Asus ROG Rapture GT-AX11000 Tri-Band WiFi Gaming Router. Category: ASUS. Subcategory: Router. Price: 48,500৳49,000৳.
",241,624887,625128
2582,recursive,"
Product: ASUS ROG Rapture GT-AX11000 Pro Tri-Band WiFi Gaming Router. Category: ASUS. Subcategory: Router. Price: 60,500৳61,000৳.

Product: ASUS RT-AC1200 V2 Dual-Band WiFi Router. Category: ASUS. Subcategory: Router. Price: Out Of Stock.
",240,625128,625368
2583,recursive,"
Product: Asus RT-AC1200G+ Dual Band WiFi Router. Category: ASUS. Subcategory: Router. Price: Out Of Stock.

Product: ASUS RT-AX53U AX1800 Dual-Band WiFi Router. Category: ASUS. Subcategory: Router. Price: Out Of Stock.
",220,625368,625588
2584,recursive,"
Product: Asus RT-AC66U Dual-band AC1750 Wifi Gigabit Router. Category: ASUS. Subcategory: Router. Price: Out Of Stock.

Product: ASUS RT-AX55 AX1800 Dual Band WiFi Router. Category: ASUS. Subcategory: Router. Price: Out Of Stock.
",231,625588,625819
2585,recursive,"
Product: ASUS RT-AX58U AX3000 Dual Band WiFi Router. Category: ASUS. Subcategory: Router. Price: Out Of Stock.

Product: ASUS RT-AX5400 AX5400 Dual-Band WiFi Router. Category: ASUS. Subcategory: Router. Price: Out Of Stock.
",225,625819,626044
2586,recursive,"
Product: ASUS TUF Gaming AX5400 Dual Band WiFi Gaming Router. Category: ASUS. Subcategory: Router. Price: Out Of Stock.

Product: ASUS ROG Rapture GT-AC2900 WiFi Gaming Router. Category: ASUS. Subcategory: Router. Price: Out Of Stock.
",236,626044,626280
2587,recursive,"
Product: Cisco C1111-4P ISR 1100 4 Ports Dual GE WAN Ethernet Router. Category: Cisco. Subcategory: Router. Price: 84,500৳.

Product: Cisco C1111-8P Integrated Services Router. Category: Cisco. Subcategory: Router. Price: 95,000৳160,000৳.
",240,626280,626520
2588,recursive,"
Product: Cisco ISR4331/K9 Integrated Service Router With SEC license. Category: Cisco. Subcategory: Router. Price: 230,000৳.

Product: Cisco ISR4221-SEC Integrated Service Router. Category: Cisco. Subcategory: Router. Price: Call for Price.
",242,626520,626762
2589,recursive,"
Product: Cisco RV042 Dual WAN 4-Port VPN Router. Category: Cisco. Subcategory: Router. Price: 5,000৳6,500৳.

Product: Cisco C891F Integrated Service Router. Category: Cisco. Subcategory: Router. Price: Out Of Stock.
",217,626762,626979
2590,recursive,"
Product: Planet WDRT-1202AC Dual Band Gigabit WiFi Router. Category: Planet. Subcategory: Router. Price: 2,070৳2,200৳.

Product: Grandstream GWN7052 1270Mbps Dual Band Gigabit WiFi Router. Category: Grandstream. Subcategory: Router. Price: 7,000৳.
",249,626979,627228
2591,recursive,"
Product: Grandstream GWN7001 6-Port WAN Gigabit VPN Router. Category: Grandstream. Subcategory: Router. Price: 7,800৳.

Product: Grandstream GWN7052F 1270Mbps Dual Band Gigabit WiFi Router. Category: Grandstream. Subcategory: Router. Price: 12,500৳.
",251,627228,627479
2592,recursive,"
Product: Grandstream GWN7003 9-Port WAN Gigabit VPN Router. Category: Grandstream. Subcategory: Router. Price: 13,000৳14,300৳.

Product: Grandstream GWN7002 4-Port WAN Gigabit VPN Router. Category: Grandstream. Subcategory: Router. Price: Up Coming.
",251,627479,627730
2593,recursive,"
Product: Grandstream GWN7062 1770Mbps Dual Band Wi-Fi 6 Router. Category: Grandstream. Subcategory: Router. Price: Up Coming.

Product: Mercusys MR30G AC1200 Dual Band Gigabit Router. Category: Mercusys. Subcategory: Router. Price: 2,366৳2,490৳.
",247,627730,627977
2594,recursive,"
Product: Mercusys AC12G AC1300 1300Mbps Dual Band Gigabit Router. Category: Mercusys. Subcategory: Router. Price: 2,450৳2,500৳.

Product: Mercusys MR60X AX1500 Dual Band Gigabit WiFi 6 Router. Category: Mercusys. Subcategory: Router. Price: 2,949৳.
",250,627977,628227
2595,recursive,"
Product: Mercusys AC12G AC1200 Dual Band Gigabit Router. Category: Mercusys. Subcategory: Router. Price: 2,450৳2,549৳.

Product: Mercusys Halo H30G AC1300 Dual Band Gigabit Mesh Router (2 Pack). Category: Mercusys. Subcategory: Router. Price: 5,150৳.
",252,628227,628479
2596,recursive,"
Product: Mercusys Halo H50G AC1900 Dual Band Gigabit Mesh Router (2 Pack). Category: Mercusys. Subcategory: Router. Price: 6,490৳.

Product: Mercusys MR20 AC750 Dual-Band WiFi Router. Category: Mercusys. Subcategory: Router. Price: Up Coming.
",244,628479,628723
2597,recursive,"
Product: Mercusys Halo H30 AC1200 Dual-Band Mesh Router (2 Pack). Category: Mercusys. Subcategory: Router. Price: Up Coming.

Product: Mercusys Halo H30 AC1200 Dual-Band Mesh Router (3 Pack). Category: Mercusys. Subcategory: Router. Price: Up Coming.
",252,628723,628975
2598,recursive,"
Product: Mercusys Halo H30G AC1300 Dual Band Gigabit Mesh Router (3 Pack). Category: Mercusys. Subcategory: Router. Price: Up Coming.

Product: Mercusys Halo H70X AX1800 Dual Band WiFi Mesh Router (2 Pack). Category: Mercusys. Subcategory: Router. Price: Up Coming.
",267,628975,629242
2599,recursive,"
Product: Mercusys Halo H70X AX1800 Dual Band WiFi Mesh Router (3 Pack). Category: Mercusys. Subcategory: Router. Price: Up Coming.

Product: Mercusys MW155R 150 Mbps Wireless N Wifi Router. Category: Mercusys. Subcategory: Router. Price: Out Of Stock.
",253,629242,629495
2600,recursive,"
Product: Mercusys MW301R 300Mbps WiFi Router. Category: Mercusys. Subcategory: Router. Price: Out Of Stock.

Product: Mercusys MW302R 300mbps WiFi Router. Category: Mercusys. Subcategory: Router. Price: Out Of Stock.
",218,629495,629713
2601,recursive,"
Product: Prolink PRC3801 AC1200 Dual Band Gigabit Router. Category: PROLINK. Subcategory: Router. Price: 3,300৳.

Product: Netgear R6850 Wireless AC2000 Dual-Band Gigabit WiFi Router. Category: NETGEAR. Subcategory: Router. Price: 6,300৳6,500৳.
",246,629713,629959
2602,recursive,"
Product: Netgear Orbi RBR350 AX1800 Dual-Band WiFi 6 Mesh Router. Category: NETGEAR. Subcategory: Router. Price: 15,000৳16,000৳.

Product: Netgear Orbi RBS750 AX4200 Tri-Band Mesh Router. Category: NETGEAR. Subcategory: Router. Price: 27,500৳.
",245,629959,630204
2603,recursive,"
Product: Netgear Orbi RBK352 AX1800 Dual Band Mesh Router (2 Pack). Category: NETGEAR. Subcategory: Router. Price: 27,000৳29,000৳.

Product: Netgear Nighthawk RAX70 AX6600 Tri-Band WiFi Router. Category: NETGEAR. Subcategory: Router. Price: 31,000৳32,200৳.
",258,630204,630462
2604,recursive,"
Product: Netgear Orbi RBS850 AX6000 Tri-Band Mesh Router. Category: NETGEAR. Subcategory: Router. Price: 40,000৳.

Product: Netgear ORBI RBK353 Ax1800 Dual Band Mesh Router (3-Pack). Category: NETGEAR. Subcategory: Router. Price: 40,000৳42,000৳.
",247,630462,630709
2605,recursive,"
Product: Netgear Orbi RBK852 AX6000 Tri-Band Mesh Router (2 Pack). Category: NETGEAR. Subcategory: Router. Price: 86,000৳.

Product: Netgear Orbi RBS350 AX1800 WiFi 6 Dual-band Mesh Add-on Satellite. Category: NETGEAR. Subcategory: Router. Price: Out Of Stock.
",262,630709,630971
2606,recursive,"
Product: Netgear RAX10 AX1800 Dual-Band WiFi Router. Category: NETGEAR. Subcategory: Router. Price: Out Of Stock.

Product: Netgear Orbi Pro SRS60 AC3000 Tri Band Add-on Satellite. Category: NETGEAR. Subcategory: Router. Price: Out Of Stock.
",243,630971,631214
2607,recursive,"
Product: Netgear RAX40 AX3000 Nighthawk Dual-Band WiFi Router. Category: NETGEAR. Subcategory: Router. Price: Out Of Stock.

Product: Netgear Nighthawk MK62 AX1800 Mesh Router (2 Pack). Category: NETGEAR. Subcategory: Router. Price: Out Of Stock.
",248,631214,631462
2608,recursive,"
Product: Netgear Nighthawk RAX50 AX5400 Dual-Band Wi-Fi Router. Category: NETGEAR. Subcategory: Router. Price: Out Of Stock.

Product: Netgear RAX120 AX6000 Nighthawk Dual-Band WiFi Router. Category: NETGEAR. Subcategory: Router. Price: Out Of Stock.
",252,631462,631714
2609,recursive,"
Product: Netgear Nighthawk XR1000 AX5400 Pro Gaming WiFi 6 Router. Category: NETGEAR. Subcategory: Router. Price: Out Of Stock.

Product: Netgear Nighthawk RAX200 AX11000 Tri-Band WiFi Router. Category: NETGEAR. Subcategory: Router. Price: Out Of Stock.
",255,631714,631969
2610,recursive,"
Product: Netgear ORBI RBK853 AX6000 Tri-Band Mesh Router (3-Pack). Category: NETGEAR. Subcategory: Router. Price: 130,000৳.

Product: Netgear Orbi RBK752 AX4200 Tri-band Mesh Router (2 Pack). Category: NETGEAR. Subcategory: Router. Price: Out Of Stock.
",254,631969,632223
2611,recursive,"
Product: Tenda A301 Wireless N300 Universal Range Extender. Category: Tenda. Subcategory: WiFi Range Extender. Price: 1,770৳.

Product: Tenda A9 Wireless N300 Universal Range Extender. Category: Tenda. Subcategory: WiFi Range Extender. Price: Out Of Stock.
",258,632223,632481
2612,recursive,"
Product: Tenda A18 AC1200 Dual Band WiFi Repeater. Category: Tenda. Subcategory: WiFi Range Extender. Price: Out Of Stock.

Product: Netis W1 300Mbps WiFi Router. Category: Netis. Subcategory: Router. Price: Up Coming.
",220,632481,632701
2613,recursive,"
Product: Netis DL4312 150 Mbps Wireless N ADSL+Modem Router. Category: Netis. Subcategory: Router. Price: Up Coming.

Product: Netis DL4323 300Mbps Wireless N ADSL2+ Modem Router. Category: Netis. Subcategory: Router. Price: Up Coming.
",237,632701,632938
2614,recursive,"
Product: Netis WF2375 AC600 Wireless Dual Band High Power Outdoor AP Router. Category: Netis. Subcategory: Router. Price: Up Coming.

Product: Netis Wf2419E 300Mbps Wireless N Router. Category: Netis. Subcategory: Router. Price: Out Of Stock.
",244,632938,633182
2615,recursive,"
Product: Netis WF2409E 300Mbps Wireless N Router. Category: Netis. Subcategory: Router. Price: Out Of Stock.

Product: Netis W4 300Mbps WiFi Router. Category: Netis. Subcategory: Router. Price: Out Of Stock.
",209,633182,633391
2616,recursive,"
Product: Netis N5 AC1200 Dual Band WiFi Router. Category: Netis. Subcategory: Router. Price: Out Of Stock.

Product: Netis N3D AC1200 Dual Band WiFi Router. Category: Netis. Subcategory: Router. Price: Out Of Stock.
",217,633391,633608
2617,recursive,"
Product: Netis N2 AC1200 Dual Band Gigabit WiFi Router. Category: Netis. Subcategory: Router. Price: Out Of Stock.

Product: Netis N3 AC1200 Dual Band Gigabit WiFi Router. Category: Netis. Subcategory: Router. Price: Out Of Stock.
",232,633608,633840
2618,recursive,"
Product: Netis MW5360 300Mbps 4G LTE Router. Category: Netis. Subcategory: Router. Price: Out Of Stock.

Product: Netis N6 AX1800 Dual Band Gigabit Wi-Fi 6 Router. Category: Netis. Subcategory: Router. Price: Out Of Stock.
",224,633840,634064
2619,recursive,"
Product: TP-Link M7200 150MBPS 4G LTE Sim Supported Portable Hotspot Pocket Router. Category: TP-Link. Subcategory: Pocket Router. Price: Out Of Stock.

Product: TP-Link M7000 150Mbps 4G LTE Mobile Wi-Fi Router. Category: TP-Link. Subcategory: Pocket Router. Price: Out Of Stock.
",281,634064,634345
2620,recursive,"
Product: Mercusys MT110 SIM Supported 4G LTE Mobile Wi-Fi Pocket Router. Category: Pocket Router. Subcategory: Networking. Price: 3,167৳3,599৳.

Product: Zyxel WAH7601 4G LTE Portable Router. Category: Pocket Router. Subcategory: Networking. Price: Out Of Stock.
",264,634345,634609
2621,recursive,"
Product: TP-Link TL-WA850RE 300Mbps Universal Wi-Fi Range Extender. Category: TP-Link. Subcategory: WiFi Range Extender. Price: 1,662৳1,749৳.

Product: TP-Link TL-WA855RE 300Mbps Wi-Fi Range Extender. Category: TP-Link. Subcategory: WiFi Range Extender. Price: 1,891৳1,990৳.
",276,634609,634885
2622,recursive,"
Product: TP-Link RE200 AC750 Wi-Fi Range Extender. Category: TP-Link. Subcategory: WiFi Range Extender. Price: 1,907৳2,119৳.

Product: TP-Link RE305 AC1200 1200Mbps Dual Band WiFi Range Extender. Category: TP-Link. Subcategory: WiFi Range Extender. Price: 2,340৳2,590৳.
",271,634885,635156
2623,recursive,"
Product: TP-Link RE190 V5 AC750 750Mbps Dual Band WiFi Range Extender. Category: TP-Link. Subcategory: WiFi Range Extender. Price: Up Coming.

Product: TP-Link TL-WA860RE Range Extender with AC Passthrough. Category: TP-Link. Subcategory: WiFi Range Extender. Price: Out Of Stock.
",282,635156,635438
2624,recursive,"
Product: Xiaomi RD10M N300 300MBPS Wi-Fi Range Extender. Category: WiFi Range Extender. Subcategory: Networking. Price: 1,187৳1,290৳.

Product: D-Link DAP-1360 Wireless N Range Extender. Category: WiFi Range Extender. Subcategory: Networking. Price: 1,450৳.
",259,635438,635697
2625,recursive,"
Product: Ruijie RG-EST350 V2 5GHz 5KM Wireless Bridge. Category: WiFi Range Extender. Subcategory: Networking. Price: 20,500৳.

Product: Netgear ProSAFE WC7500 Fully Featured Centralized Wireless Management Controller. Category: WiFi Range Extender. Subcategory: Networking. Price: 61,000৳.
",292,635697,635989
2626,recursive,"
Product: Ubiquiti UDM-PRO-EU Dream Machine Professional UniFi Gateway Console. Category: WiFi Range Extender. Subcategory: Networking. Price: 95,150৳.

Product: Huawei eKitEngine AC650-128AP Gigabit Access Controller. Category: WiFi Range Extender. Subcategory: Networking. Price: 120,000৳.
",292,635989,636281
2627,recursive,"
Product: Huawei eKitEngine AC650-256AP Gigabit Access Controller. Category: WiFi Range Extender. Subcategory: Networking. Price: 155,000৳.

Product: Mercusys ME30 AC1200 Wi-Fi Range Extender. Category: WiFi Range Extender. Subcategory: Networking. Price: Up Coming.
",267,636281,636548
2628,recursive,"
Product: Mercusys MW300RE 300Mbps Wi-Fi Range Extender. Category: WiFi Range Extender. Subcategory: Networking. Price: Out Of Stock.

Product: Dlink DAP-1325 300Mbps WiFi Range Extender. Category: WiFi Range Extender. Subcategory: Networking. Price: Out Of Stock.
",265,636548,636813
2629,recursive,"
Product: Xiaomi Mi RA75 AC1200 1200Mbps WiFi Range Extender. Category: WiFi Range Extender. Subcategory: Networking. Price: Out Of Stock.

Product: Cudy RE1200 AC1200 1200Mbps Dual Band Mesh Range Extender. Category: WiFi Range Extender. Subcategory: Networking. Price: Out Of Stock.
",285,636813,637098
2630,recursive,"
Product: Hikvision DS-3WR15X 1500Mbps Dual Band WiFi 6 Router. Category: Hikvision. Subcategory: Router. Price: 3,420৳3,600৳.

Product: Tenda W6S 300Mbps In-wall Wireless Access Point. Category: Tenda. Subcategory: Access Point. Price: 3,200৳.
",245,637098,637343
2631,recursive,"
Product: Tenda W12 AC1200 Dual Band Gigabit In-Wall Access Point. Category: Tenda. Subcategory: Access Point. Price: 3,150৳3,200৳.

Product: Tenda i9 300 Mbps Ceiling Mount Access Point. Category: Tenda. Subcategory: Access Point. Price: 3,572৳3,800৳.
",253,637343,637596
2632,recursive,"
Product: Tenda B6 5GHz 11n 300Mbps Outdoor Waterproof Professional Basestation. Category: Tenda. Subcategory: Access Point. Price: 6,700৳6,800৳.

Product: Tenda W300A Wireless PoE Access Point. Category: Tenda. Subcategory: Access Point. Price: Out Of Stock.
",260,637596,637856
2633,recursive,"
Product: Tenda W1500A Wireless N150 Outdoor LR AP/Router. Category: Tenda. Subcategory: Access Point. Price: Out Of Stock.

Product: Tenda W310A 300Mbps Wireless Wall Mount Access Point. Category: Tenda. Subcategory: Access Point. Price: Out Of Stock.
",253,637856,638109
2634,recursive,"
Product: Tenda W301A Celling Mount Access Point. Category: Tenda. Subcategory: Access Point. Price: Out Of Stock.

Product: Tenda AP5 N300 Wireless Desktop Access Point. Category: Tenda. Subcategory: Access Point. Price: Out Of Stock.
",236,638109,638345
2635,recursive,"
Product: Tenda I6 Wireless N300 Access Point. Category: Tenda. Subcategory: Access Point. Price: Out Of Stock.

Product: Netgear ANT24501B ProSafe Outdoor Dual Band Omni Antenna Bundle Kit used with WND930 Access Point. Category: NETGEAR. Subcategory: Access Point. Price: 3,800৳.
",282,638345,638627
2636,recursive,"
Product: Netgear WAX615 AX3000 Dual-Band PoE Multi-Gig Insight Managed WiFi 6 Access Point. Category: NETGEAR. Subcategory: Access Point. Price: 19,500৳32,000৳.
",162,638627,638789
2637,recursive,"
Product: Netgear WAX620 AX3600 Wireless Dual-Band 2.5 Gigabit Access Point. Category: NETGEAR. Subcategory: Access Point. Price: Call for Price.

Product: NETGEAR WAX625 AX5400 Dual-Band Multi-Gig Wi-Fi 6 Access Point. Category: NETGEAR. Subcategory: Access Point. Price: Call for Price.
",289,638789,639078
2638,recursive,"
Product: NETGEAR WAX630 AX6000 Tri-Band PoE Multi-Gig WiFi 6 Access Point. Category: NETGEAR. Subcategory: Access Point. Price: Call for Price.
",145,639078,639223
2639,recursive,"
Product: Netgear WAX214 AX1800 1800Mbps Dual Band WiFi 6 Wall/Ceiling Mount PoE Powered Access Point. Category: NETGEAR. Subcategory: Access Point. Price: Out Of Stock.
",170,639223,639393
2640,recursive,"
Product: Netgear WAX610Y AX1800 Mbps Dual Band Wi-Fi 6 Outdoor PoE Access Point. Category: NETGEAR. Subcategory: Access Point. Price: Out Of Stock.
",149,639393,639542
2641,recursive,"
Product: Netgear WAX610 AX1800 Dual Band PoE Multi Gig Insight Cloud Managed WiFi 6 Access Point. Category: NETGEAR. Subcategory: Access Point. Price: Out Of Stock.
",166,639542,639708
2642,recursive,"
Product: Zyxel NWA1123ACv3 802.11ac Wave 2 Dual-Radio Ceiling Mount POE Access Point. Category: Zyxel. Subcategory: Access Point. Price: 13,000৳.

Product: Zyxel NWA50AX 802.11ax (WiFi 6) Dual-Radio PoE Access Point. Category: Zyxel. Subcategory: Access Point. Price: 14,000৳.
",278,639708,639986
2643,recursive,"
Product: Zyxel NWA210AX 802.11ax (WiFi 6) Dual-Radio POE Access Point. Category: Zyxel. Subcategory: Access Point. Price: 26,000৳.

Product: Zyxel WAX610D AX3000 Dual-Band WiFi 6 NebulaFlex Pro Access Point. Category: Zyxel. Subcategory: Access Point. Price: 30,450৳.
",269,639986,640255
2644,recursive,"
Product: Ubiquiti Cloud Key Gen2 Plus UniFi Access Point. Category: Access Point. Subcategory: Networking. Price: 28,700৳.

Product: Ubiquiti Cloud Key Gen2 Plus UniFi Access Point With POE Adapter. Category: Access Point. Subcategory: Networking. Price: Out Of Stock.
",270,640255,640525
2645,recursive,"
Product: TP-Link EAP115 300Mbps Wireless N Ceiling Mount Access Point. Category: Access Point. Subcategory: Networking. Price: 3,176৳3,490৳.

Product: TP-Link TL-WA901ND 450Mbps Wireless N Access Point. Category: Access Point. Subcategory: Networking. Price: 3,829৳3,949৳.
",274,640525,640799
2646,recursive,"
Product: IP-COM W36AP AC1200 Dual Band Gigabit In-Wall Access Point. Category: Access Point. Subcategory: Networking. Price: 4,000৳.

Product: Cudy AP1300 AC1200 1200Mbps Wireless Dual Band Indoor Access Point. Category: Access Point. Subcategory: Networking. Price: 4,600৳5,000৳.
",282,640799,641081
2647,recursive,"
Product: TP-Link EAP235-Wall Omada AC1200 Wireless MU-MIMO Gigabit Wall Plate Access Point. Category: Access Point. Subcategory: Networking. Price: 5,390৳.
",157,641081,641238
2648,recursive,"
Product: Mikrotik cAP RBcAP2nD 300mbps Dual Chain Ceiling Access Point. Category: Access Point. Subcategory: Networking. Price: 5,301৳5,700৳.

Product: Ruijie RG-RAP1200(F) Reyee Wi-Fi 5 1267Mbps Wall-mounted Access Point. Category: Access Point. Subcategory: Networking. Price: 6,700৳.
",288,641238,641526
2649,recursive,"
Product: IP-COM iUAP-AC-LITE 802.11ac Dual-Band Access Point. Category: Access Point. Subcategory: Networking. Price: 7,000৳.

Product: Grandstream GWN7602 Wi-Fi Access Point. Category: Access Point. Subcategory: Networking. Price: 8,100৳.
",241,641526,641767
2650,recursive,"
Product: TP-Link EAP615 AX1800 Wall Plate Dual-Band WiFi 6 Access Point. Category: Access Point. Subcategory: Networking. Price: 8,490৳.

Product: Edgecore ECW100 Indoor Dual-Band Access Point. Category: Access Point. Subcategory: Networking. Price: 8,700৳.
",259,641767,642026
2651,recursive,"
Product: TP-Link EAP613 AX1800 Ceiling Mount WiFi 6 Access Point. Category: Access Point. Subcategory: Networking. Price: 8,640৳9,290৳.

Product: Ruijie RG-RAP1200(P) Reyee Wi-Fi 5 1267Mbps Wall-mounted Access Point. Category: Access Point. Subcategory: Networking. Price: 9,500৳.
",282,642026,642308
2652,recursive,"
Product: MikroTik RB931-2nD hAP mini 2GHz Wireless Access Point. Category: MikroTik. Subcategory: Access Point. Price: Out Of Stock.

Product: Mikrotik cAP ac Dual Band Wall Access Point. Category: MikroTik. Subcategory: Access Point. Price: Out Of Stock.
",257,642308,642565
2653,recursive,"
Product: Mikrotik cAP XL ac Dual Band Ceiling & Wall Mounting Access point. Category: MikroTik. Subcategory: Access Point. Price: Out Of Stock.
",145,642565,642710
2654,recursive,"
Product: Xiaomi Mi R03 Wi-Fi Amplifier Pro 300Mbps Access Point, Amplifier, Repeater. Category: XIAOMI. Subcategory: WiFi Range Extender. Price: Out Of Stock.

Product: TP-Link EAP653 AX3000 Ceiling Mount WiFi 6 Access Point. Category: TP-Link. Subcategory: Access Point. Price: 9,590৳.
",288,642710,642998
2655,recursive,"
Product: Tp-Link EAP610-Outdoor AX1800 Indoor Outdoor WiFi 6 Access Point. Category: TP-Link. Subcategory: Access Point. Price: 13,290৳.

Product: TP-Link EAP625-Outdoor HD AX1800 WiFi 6 Access Point. Category: TP-Link. Subcategory: Access Point. Price: 18,590৳.
",264,642998,643262
2656,recursive,"
Product: Tp-Link EAP660 HD AX3600 Dual Band Multi-Gigabit Ceiling Mount Wireless Access Point. Category: TP-Link. Subcategory: Access Point. Price: 18,948৳21,290৳.
",165,643262,643427
2657,recursive,"
Product: TP-Link EAP115-Wall 300Mbps Wireless N Wall-Plate Access Point. Category: TP-Link. Subcategory: Access Point. Price: Out Of Stock.

Product: TP-Link CPE220 2.4GHz 300Mbps High Power Outdoor Wireless Access Point. Category: TP-Link. Subcategory: Access Point. Price: Out Of Stock.
",290,643427,643717
2658,recursive,"
Product: TP-Link CPE510 Outdoor 5GHz 300Mbps High Power Wireless Access Point. Category: TP-Link. Subcategory: Access Point. Price: Out Of Stock.

Product: TP-Link EAP225 AC1350 Wireless MU-MIMO Gigabit Ceiling Mount Access Point. Category: TP-Link. Subcategory: Access Point. Price: Out Of Stock.
",299,643717,644016
2659,recursive,"
Product: TP-Link EAP225-Outdoor AC1200 Wireless MU-MIMO Gigabit Indoor, Outdoor Access Point. Category: TP-Link. Subcategory: Access Point. Price: Out Of Stock.
",162,644016,644178
2660,recursive,"
Product: TP-Link EAP245 AC1750 Wireless Dual-Band Gigabit Ceiling Mount Access Point. Category: TP-Link. Subcategory: Access Point. Price: Out Of Stock.
",154,644178,644332
2661,recursive,"
Product: TP-Link EAP265 HD AC1750 Wireless MU-MIMO Gigabit Ceiling Mount Access Point. Category: TP-Link. Subcategory: Access Point. Price: Out Of Stock.
",155,644332,644487
2662,recursive,"
Product: TP-Link OC200 Omada Centralized Access Point Management System/Controller. Category: TP-Link. Subcategory: Access Point. Price: Out Of Stock.

Product: Tp-Link EAP620 HD AX1800 Ceiling Mount WiFi 6 Access Point. Category: TP-Link. Subcategory: Access Point. Price: Out Of Stock.
",289,644487,644776
2663,recursive,"
Product: Ubiquiti UAP-AC-LR AC1300 1300 Mbps Dual-Band Gigabit UniFi Access Point. Category: Ubiquiti. Subcategory: Access Point. Price: 13,175৳15,500৳.
",154,644776,644930
2664,recursive,"
Product: Ubiquiti Unifi 6 Lite AX1500 Mbps Gigabit Dual Band Access Point (Without POE Adapter). Category: Ubiquiti. Subcategory: Access Point. Price: 16,500৳.
",161,644930,645091
2665,recursive,"
Product: Ubiquiti UAP-AC-PRO AC1750 Mbps Gigabit Dual-Band UniFi Access Point With POE Adapter. Category: Ubiquiti. Subcategory: Access Point. Price: 22,000৳23,500৳.
",167,645091,645258
2666,recursive,"
Product: Ubiquiti Unifi 6 Pro WiFi 6 Dual Band Access Point (With Out POE Adapter). Category: Ubiquiti. Subcategory: Access Point. Price: 22,440৳26,400৳.

Product: Ubiquiti Unifi 6 Pro WiFi 6 Dual Band Access Point (With POE Adapter). Category: Ubiquiti. Subcategory: Access Point. Price: 27,300৳.
",299,645258,645557
2667,recursive,"
Product: Ubiquiti U6-LR Dual Brand 3000 Mbps Indoor Unifi Wi-Fi Access Point (With Out Adapter). Category: Ubiquiti. Subcategory: Access Point. Price: 24,640৳28,000৳.
",168,645557,645725
2668,recursive,"
Product: Ubiquiti Unifi U7 Pro WiFi 7 Tri Band Access Point (WithOut POE Adapter). Category: Ubiquiti. Subcategory: Access Point. Price: 27,456৳28,600৳.
",154,645725,645879
2669,recursive,"
Product: Ubiquiti U6-LR Dual Brand 3000 Mbps Indoor Unifi Wi-Fi Access Point (With Adapter). Category: Ubiquiti. Subcategory: Access Point. Price: 31,000৳.

Product: Ubiquiti airCube ISP Access Point Unifi Router. Category: Ubiquiti. Subcategory: Access Point. Price: Out Of Stock.
",283,645879,646162
2670,recursive,"
Product: Ubiquiti NSM5(EU) Outdoor POE Point-to-Point Nano Station Radio Device With POE Adapter. Category: Ubiquiti. Subcategory: Access Point. Price: Out Of Stock.
",167,646162,646329
2671,recursive,"
Product: Ubiquiti Unifi 6 Lite AX1500 Mbps Gigabit Dual Band Access Point With POE Adapter. Category: Ubiquiti. Subcategory: Access Point. Price: Out Of Stock.
",161,646329,646490
2672,recursive,"
Product: Ubiquiti UAP-AC-PRO AC1750 Mbps Gigabit Dual-Band UniFi Access Point Without POE Adapter. Category: Ubiquiti. Subcategory: Access Point. Price: Out Of Stock.
",168,646490,646658
2673,recursive,"
Product: Ubiquiti airFiber AF-5XHD Gigabit Outdoor Point-to-Point Radio Device With POE Adapter. Category: Ubiquiti. Subcategory: Access Point. Price: Out Of Stock.
",166,646658,646824
2674,recursive,"
Product: Ubiquiti UDM-SE-EU Dream Machine Special Edition UniFi Gateway Console. Category: Ubiquiti. Subcategory: Access Point. Price: Out Of Stock.

Product: Grandstream GWN7603 Dual-Band Wave-2 WiFi Access Point. Category: Grandstream. Subcategory: Access Point. Price: 9,800৳.
",281,646824,647105
2675,recursive,"
Product: Grandstream GWN7605 MU-MIMO Dual-Band WiFi Access Point. Category: Grandstream. Subcategory: Access Point. Price: 10,500৳.

Product: Grandstream GWN7625 MU-MIMO 2000Mbps Gigabit POE Access Point. Category: Grandstream. Subcategory: Access Point. Price: 12,960৳13,500৳.
",279,647105,647384
2676,recursive,"
Product: Grandstream GWN7624 Dual Band PoE WiFi Access Point. Category: Grandstream. Subcategory: Access Point. Price: 13,500৳.

Product: Grandstream GWN7615 Enterprise Performance Wi-Fi Access Point. Category: Grandstream. Subcategory: Access Point. Price: 13,800৳.
",268,647384,647652
2677,recursive,"
Product: Grandstream GWN7604 AX3000 3Gbps WiFi 6 Indoor Access Point. Category: Grandstream. Subcategory: Access Point. Price: 15,000৳.

Product: Grandstream GWN7630 Wi-Fi Access Point. Category: Grandstream. Subcategory: Access Point. Price: 19,200৳.
",253,647652,647905
2678,recursive,"
Product: Grandstream GWN7664E AX6000 6Gbps Giagbit WiFi 6 Indoor Access Point. Category: Grandstream. Subcategory: Access Point. Price: 30,000৳.

Product: Grandstream GWN7630LR Dual-Band PoE Outdoor Access Point. Category: Grandstream. Subcategory: Access Point. Price: Up Coming.
",282,647905,648187
2679,recursive,"
Product: Grandstream GWN7615 Enterprise Performance Wi-Fi Access Point with PoE Adapter. Category: Grandstream. Subcategory: Access Point. Price: Out Of Stock.
",161,648187,648348
2680,recursive,"
Product: Grandstream GWN7605LR Dual-Band PoE Outdoor Access Point. Category: Grandstream. Subcategory: Access Point. Price: Out Of Stock.

Product: Grandstream GWN7660 Dual Band MU-MIMO WiFi 6 Indoor Access Point. Category: Grandstream. Subcategory: Access Point. Price: Out Of Stock.
",286,648348,648634
2681,recursive,"
Product: Grandstream GWN7664LR Long-Range Outdoor Wi-Fi 6 Access Point. Category: Grandstream. Subcategory: Access Point. Price: Out Of Stock.

Product: IP-COM Pro-6-LR 802.11AX Dual-Band Long Range Access Point. Category: IP-COM. Subcategory: Access Point. Price: 11,700৳.
",275,648634,648909
2682,recursive,"
Product: IP-COM iUAP-AC-LR 802.11ac Dual-Band Long Range Access Point. Category: IP-COM. Subcategory: Access Point. Price: 12,900৳.

Product: Ruijie RG-RAP2200(E) 1267Mbps Wi-Fi 5 Ceiling Access Point. Category: Ruijie. Subcategory: Access Point. Price: 11,500৳.
",264,648909,649173
2683,recursive,"
Product: Ruijie RG-RAP6202(G) AC1300 Outdoor Omni-directional Access Point. Category: Ruijie. Subcategory: Access Point. Price: 17,500৳.

Product: Ruijie RG-RAP2266 Reyee Wi-Fi 6 AX3000 Indoor Ceiling-Mount Access Point. Category: Ruijie. Subcategory: Access Point. Price: 20,200৳.
",283,649173,649456
2684,recursive,"
Product: Ruijie RG-RAP6260(G) AX1800 Wi-Fi 6 Gigabit Outdoor Access Point. Category: Ruijie. Subcategory: Access Point. Price: 28,910৳29,500৳.

Product: Ruijie RG-RAP2260(H) Reyee Wi-Fi 6 AX6000 Ceiling Access Point. Category: Ruijie. Subcategory: Access Point. Price: Up Coming.
",281,649456,649737
2685,recursive,"
Product: Ruijie RG-RAP2200(F) 1267Mbps Wi-Fi 5 Ceiling Access Point. Category: Ruijie. Subcategory: Access Point. Price: Out Of Stock.

Product: Ruijie RG-RAP1201 Reyee Wi-Fi 5 1267Mbps Wall-mounted Access Point. Category: Ruijie. Subcategory: Access Point. Price: Out Of Stock.
",280,649737,650017
2686,recursive,"
Product: Ruijie RG-RAP1261 Reyee Wi-Fi 6 AX3000 Ultra-Thin Wall Plate Access Point. Category: Ruijie. Subcategory: Access Point. Price: Out Of Stock.
",151,650017,650168
2687,recursive,"
Product: Ruijie RG-RAP1260 Reyee Wi-Fi 6 AX3000 Dual-Band Wall Plate Access Point. Category: Ruijie. Subcategory: Access Point. Price: Out Of Stock.

Product: Ruijie RG-AP720-L 1167Mbps Wi-Fi 5 Dual-Radio Indoor Access Point. Category: Ruijie. Subcategory: Access Point. Price: Out Of Stock.
",293,650168,650461
2688,recursive,"
Product: Ruijie RG-RAP52-OD Wi-Fi 5 AC1300 Dual-Band Outdoor Access Point. Category: Ruijie. Subcategory: Access Point. Price: Out Of Stock.

Product: Ruijie RG-EST310 V2 5GHz 1KM Wireless Bridge. Category: Ruijie. Subcategory: Access Point. Price: Out Of Stock.
",264,650461,650725
2689,recursive,"
Product: Ruijie RG-RAP2260(G) AX1800 1800Mbps Wi-Fi 6 Ceiling Access Point. Category: Ruijie. Subcategory: Access Point. Price: Out Of Stock.

Product: Ruijie RG-RAP2260 Reyee Wi-Fi 6 AX3000 Ceiling Access Point. Category: Ruijie. Subcategory: Access Point. Price: Out Of Stock.
",280,650725,651005
2690,recursive,"
Product: Ruijie RG-AP820-L(V3) AX3000 3000Mbps Wi-Fi 6 Indoor Access Point. Category: Ruijie. Subcategory: Access Point. Price: Out Of Stock.

Product: Ruijie RG-RAP6262(G) AX1800 Wi-Fi 6 Outdoor Access Point. Category: Ruijie. Subcategory: Access Point. Price: Out Of Stock.
",277,651005,651282
2691,recursive,"
Product: Ruijie RG-RAP2260(E) 3202Mbps Wi-Fi 6 Ceiling Access Point. Category: Ruijie. Subcategory: Access Point. Price: Out Of Stock.

Product: Cambium CnPilot e410 Wi-Fi Access Point (With Out Gigabit POE Adapter). Category: Cambium. Subcategory: Access Point. Price: 15,106৳18,200৳.
",287,651282,651569
2692,recursive,"
Product: Cambium CnPilot e410 Wi-Fi Access Point with Gigabit POE Adapter. Category: Cambium. Subcategory: Access Point. Price: 16,340৳21,500৳.

Product: Cambium XV2-21X Indoor Wi-Fi 6 Access Point (With Out Adapter). Category: Cambium. Subcategory: Access Point. Price: 24,570৳31,500৳.
",288,651569,651857
2693,recursive,"
Product: Cambium XV2-2X Wi-Fi 6 Access Point With Out Adapter. Category: Cambium. Subcategory: Access Point. Price: Out Of Stock.

Product: Cudy AP1300 Outdoor AC1200 Dual Band Gigabit Wi-Fi Access Point. Category: Cudy. Subcategory: Access Point. Price: Out Of Stock.
",270,651857,652127
2694,recursive,"
Product: Cudy AP3000 AX3000 3000Mbps Dual Band WiFi 6 Indoor Access Point. Category: Cudy. Subcategory: Access Point. Price: Out Of Stock.

Product: Cudy AP3000 Outdoor AX3000 3000Mbps Dual Band WiFi 6 Access Point. Category: Cudy. Subcategory: Access Point. Price: Out Of Stock.
",281,652127,652408
2695,recursive,"
Product: Edgecore ECW5210-L Indoor Dual-Band Access Point. Category: Edgecore. Subcategory: Access Point. Price: 18,300৳.

Product: Edgecore ECH502 Wireless Hotspot Gateway Access Point. Category: Edgecore. Subcategory: Access Point. Price: 22,000৳.
",251,652408,652659
2696,recursive,"
Product: Edgecore ECW5211-L Indoor Dual-Band Access Point. Category: Edgecore. Subcategory: Access Point. Price: Out Of Stock.

Product: TRENDnet TEW-821DAP AC1200 Dual Band PoE Access Point. Category: TRENDnet. Subcategory: Access Point. Price: 13,400৳.
",256,652659,652915
2697,recursive,"
Product: TRENDnet TEW-921DAP AX1800 Dual Band WiFi 6 PoE+ Access Point. Category: TRENDnet. Subcategory: Access Point. Price: 16,000৳.

Product: TRENDnet TEW-923DAP AX3000 Dual Band WiFi 6 PoE+ Access Point. Category: TRENDnet. Subcategory: Access Point. Price: 16,500৳.
",272,652915,653187
2698,recursive,"
Product: TRENDnet TEW-925DAP AX5400 Dual Band WiFi 6 PoE+ Access Point. Category: TRENDnet. Subcategory: Access Point. Price: 22,500৳.

Product: TRENDnet TEW-WLC100 Wireless LAN Controller. Category: TRENDnet. Subcategory: Access Point. Price: Out Of Stock.
",259,653187,653446
2699,recursive,"
Product: Zyxel GS1900-8 8-Port GbE ROHS Smart Managed Switch. Category: Zyxel. Subcategory: Network Switch. Price: 4,500৳.

Product: Zyxel GS1008HP 8-Port GbE Unmanaged PoE Switch. Category: Zyxel. Subcategory: Network Switch. Price: 6,500৳.
",243,653446,653689
2700,recursive,"
Product: Zyxel GS1100 8HP 8-port Unmanaged PoE Switch. Category: Zyxel. Subcategory: Network Switch. Price: 6,800৳.

Product: Zyxel GS1900-10HP 8-port GbE Smart Managed PoE Switch with GbE Uplink. Category: Zyxel. Subcategory: Network Switch. Price: 13,900৳.
",260,653689,653949
2701,recursive,"
Product: Zyxel MES 3500-24F 24-port FE Fiber L2 Switch with Four GbE Combo Port. Category: Zyxel. Subcategory: Network Switch. Price: 25,000৳.

Product: Zyxel GS1200-5HPV2 5-Port Web Managed PoE Gigabit Switch. Category: Zyxel. Subcategory: Network Switch. Price: Out Of Stock.
",279,653949,654228
2702,recursive,"
Product: Zyxel GS-105B v3 5-Port Desktop Gigabit Ethernet Switch. Category: Zyxel. Subcategory: Network Switch. Price: Out Of Stock.

Product: Zyxel GS-105SV2 5-Port Desktop Gigabit Ethernet Media Switch. Category: Zyxel. Subcategory: Network Switch. Price: Out Of Stock.
",273,654228,654501
2703,recursive,"
Product: Zyxel GS-108B v3 8-Port Desktop Gigabit Ethernet Switch. Category: Zyxel. Subcategory: Network Switch. Price: Out Of Stock.

Product: Zyxel GS1005HP 5 Port GbE Unmanaged Gigabit PoE Switch (60W). Category: Zyxel. Subcategory: Network Switch. Price: Out Of Stock.
",273,654501,654774
2704,recursive,"
Product: Zyxel GS1100-16-EU0103F 16 Port Gigabit Unmanaged Switch. Category: Zyxel. Subcategory: Network Switch. Price: Out Of Stock.

Product: Zyxel ES1100-24G 24-port FE Unmanaged Switch. Category: Zyxel. Subcategory: Network Switch. Price: Out Of Stock.
",258,654774,655032
2705,recursive,"
Product: Zyxel GS1100-24E v3 24-port Gigabit Unmanaged Switch. Category: Zyxel. Subcategory: Network Switch. Price: Out Of Stock.

Product: Zyxel GS1900-24E v2 24-port GbE Smart Managed Switch. Category: Zyxel. Subcategory: Network Switch. Price: Out Of Stock.
",262,655032,655294
2706,recursive,"
Product: Zyxel GS1900-24EP 24-port GbE Smart Managed PoE Switch. Category: Zyxel. Subcategory: Network Switch. Price: Out Of Stock.

Product: Tenda S105 5-port Ethernet Switch. Category: Network Switch. Subcategory: Networking. Price: 580৳.
",242,655294,655536
2707,recursive,"
Product: TP-Link LS1005 5-Port 10/100Mbps Desktop Network Switch. Category: Network Switch. Subcategory: Networking. Price: 619৳.

Product: Dlink DES-1005C 5 Port 10/100M Unmanaged Desktop Switch. Category: Network Switch. Subcategory: Networking. Price: 625৳.
",262,655536,655798
2708,recursive,"
Product: TP-Link TL-SF1005D 5-Port 10/100 Mbps Desktop Switch. Category: Network Switch. Subcategory: Networking. Price: 699৳.

Product: TP-Link LS1008 8-Port 10/100Mbps Desktop Switch. Category: Network Switch. Subcategory: Networking. Price: 739৳.
",251,655798,656049
2709,recursive,"
Product: Tenda S108 10/100 8 Port Desktop Switch White. Category: Network Switch. Subcategory: Networking. Price: 645৳750৳.

Product: TP-Link TL-SF1008D 8Port 10/100Mbps Desktop Switch. Category: Network Switch. Subcategory: Networking. Price: 859৳.
",251,656049,656300
2710,recursive,"
Product: Ruijie RG-ES05 5-Port 10/100 Mbps Unmanaged Desktop Switch. Category: Network Switch. Subcategory: Networking. Price: 899৳.

Product: C-Data CS2050G 5 Port Unmanaged Gigabit Switch. Category: Network Switch. Subcategory: Networking. Price: 1,190৳.
",258,656300,656558
2711,recursive,"
Product: Tenda SG105 5 Port Gigabit Desktop Switch. Category: Network Switch. Subcategory: Networking. Price: 1,280৳.

Product: TP-Link TL-SG1005D 5-Port Gigabit Desktop Switch. Category: Network Switch. Subcategory: Networking. Price: 1,195৳1,299৳.
",251,656558,656809
2712,recursive,"
Product: TP-Link TL-SG1008D 08 Port Gigabit Desktop Switch. Category: Network Switch. Subcategory: Networking. Price: 1,738৳1,849৳.

Product: C-Data CS2080G 8 Port Unmanaged Gigabit Switch. Category: Network Switch. Subcategory: Networking. Price: 1,850৳1,900৳.
",263,656809,657072
2713,recursive,"
Product: Tenda S106PC 6-Port 100M Unmanaged PoE Switch. Category: Network Switch. Subcategory: Networking. Price: 1,950৳.

Product: Cudy FS1006P 6-Port 10/100M PoE+ Switch. Category: Network Switch. Subcategory: Networking. Price: 2,043৳2,150৳.
",246,657072,657318
2714,recursive,"
Product: Tenda S16 16 Ports Ethernet Network Switch. Category: Network Switch. Subcategory: Networking. Price: 2,070৳2,200৳.

Product: Cudy GS108D 8 Port Gigabit Desktop Switch. Category: Network Switch. Subcategory: Networking. Price: 2,002৳2,200৳.
",251,657318,657569
2715,recursive,"
Product: Mercusys MS106LP 6-Port 10/100Mbps PoE Desktop Switch. Category: Network Switch. Subcategory: Networking. Price: 2,150৳2,219৳.

Product: Hikvision DS-3E0106MP-E/M 4 Port Unmanaged PoE Switch. Category: Network Switch. Subcategory: Networking. Price: 2,150৳2,300৳.
",274,657569,657843
2716,recursive,"
Product: Ruijie RG-ES08G 8-Port Gigabit Unmanaged Switch. Category: Network Switch. Subcategory: Networking. Price: 2,350৳.

Product: Cisco Business 150AX AX1480 Dual Band Wi-Fi 6 Access Point. Category: Cisco. Subcategory: Access Point. Price: 19,500৳.
",255,657843,658098
2717,recursive,"
Product: Huawei eKitEngine AP362 Dual-Band Wi-Fi 6 Wireless Access Point. Category: Huawei. Subcategory: Access Point. Price: 23,000৳.

Product: Huawei eKitEngine AP362E Dual-Band Wi-Fi 6 Wireless Access Point. Category: Huawei. Subcategory: Access Point. Price: 23,000৳.
",273,658098,658371
2718,recursive,"
Product: Huawei eKitEngine AP263 Dual-Band Wi-Fi 6 Wireless Access Point. Category: Huawei. Subcategory: Access Point. Price: 25,000৳.

Product: Huawei eKitEngine AP661 Dual-Band WiFi 6 Wireless Access Point. Category: Huawei. Subcategory: Access Point. Price: Call for Price.
",278,658371,658649
2719,recursive,"
Product: Huawei eKitEngine AP361 1775Mbps Dual-Band WiFi 6 Access Point. Category: Huawei. Subcategory: Access Point. Price: Call for Price.

Product: Huawei eKitEngine AP371 BE3600 Dual-Band WiFi 7 Access Point. Category: Huawei. Subcategory: Access Point. Price: Call for Price.
",282,658649,658931
2720,recursive,"
Product: Huawei eKitEngine AP772E Dual-Band Access Point. Category: Huawei. Subcategory: Access Point. Price: Call for Price.

Product: Huawei eKitEngine AP772 Dual-Band Access Point. Category: Huawei. Subcategory: Access Point. Price: Call for Price.
",253,658931,659184
2721,recursive,"
Product: Huawei eKitEngine AP271E BE3600 Dual-Band WiFi 7 Access Point. Category: Huawei. Subcategory: Access Point. Price: Up Coming.

Product: Huawei eKitEngine AP673E BE14000 Tri-Band WiFi 7 Access Point. Category: Huawei. Subcategory: Access Point. Price: Up Coming.
",272,659184,659456
2722,recursive,"
Product: BDCOM WAP2100-T512 1200Mbps Dual Band Indoor PoE Access Point. Category: BDCOM. Subcategory: Access Point. Price: 10,200৳.

Product: Cisco CBS110-24T-EU 24 Port Gigabit Ethernet Unmanaged Switch With 2 Gigabit SFP. Category: Cisco. Subcategory: Network Switch. Price: 28,000৳29,000৳.
",294,659456,659750
2723,recursive,"
Product: Cisco CBS350-8P-2G-EU 10-port Business Series Managed Network Switch. Category: Cisco. Subcategory: Network Switch. Price: 31,999৳.

Product: Cisco CBS350-8P-2G-EU 8-port GE PoE+ Gigabit Managed Switch. Category: Cisco. Subcategory: Network Switch. Price: 32,000৳.
",275,659750,660025
2724,recursive,"
Product: Cisco C1000FE-24T-4G-L Catalyst 1000 Series 24-Port Managed Switch. Category: Cisco. Subcategory: Network Switch. Price: 29,400৳33,000৳.

Product: Cisco CBS350-24T-4G-EU 24-Port Gigabit Managed Switch. Category: Cisco. Subcategory: Network Switch. Price: 33,500৳.
",274,660025,660299
2725,recursive,"
Product: Cisco SF350-24P-K9-EU 24-Port 10/100 PoE Managed Switch. Category: Cisco. Subcategory: Network Switch. Price: Out Of Stock.

Product: Cisco C1000FE-48T-4G-L 48 Port Managed Switch. Category: Cisco. Subcategory: Network Switch. Price: 45,500৳.
",253,660299,660552
2726,recursive,"
Product: Cisco CBS350-8S-E-2G 10-Port Gigabit Managed Switch. Category: Cisco. Subcategory: Network Switch. Price: 39,900৳40,700৳.

Product: Cisco CBS350-24P-4G-EU 24-Port Gigabit PoE+ SFP Managed Switch. Category: Cisco. Subcategory: Network Switch. Price: 47,040৳49,000৳.
",275,660552,660827
2727,recursive,"
Product: Cisco Catalyst C1000-24T-4G-L 24-Port Network Switch. Category: Cisco. Subcategory: Network Switch. Price: 45,045৳49,500৳.

Product: Cisco CBS350-24T-4X-EU 24-Port Gigabit Managed Switch. Category: Cisco. Subcategory: Network Switch. Price: 69,490৳.
",260,660827,661087
2728,recursive,"
Product: Cisco CBS350-48T-4G-EU 48 Port GE Gigabit Managed Switch. Category: Cisco. Subcategory: Network Switch. Price: 78,000৳78,500৳.

Product: Cisco Catalyst C1000FE-24P-4G-L 24-Port PoE Network Switch. Category: Cisco. Subcategory: Network Switch. Price: 80,000৳.
",269,661087,661356
2729,recursive,"
Product: Cisco Catalyst C1000-48T-4G-L 48 Gigabit Ethernet Network Switch. Category: Cisco. Subcategory: Network Switch. Price: 86,000৳.

Product: Cisco C1000-24P-4G-L 24 Port Gigabit POE Switch. Category: Cisco. Subcategory: Network Switch. Price: 86,400৳87,000৳.
",266,661356,661622
2730,recursive,"
Product: Cisco CBS350-24S-4G-EU 24-Port SFP Gigabit Managed Network Switch. Category: Cisco. Subcategory: Network Switch. Price: 90,000৳95,000৳.

Product: Cisco CBS350-24P-4X-EU 24 Port Gigabit PoE+ Managed Switch. Category: Cisco. Subcategory: Network Switch. Price: 105,000৳.
",279,661622,661901
2731,recursive,"
Product: Cisco C1000-24T-4X-L Catalyst 1000 Series 24-Port Managed Switch. Category: Cisco. Subcategory: Network Switch. Price: 115,000৳.

Product: Cisco CBS350-48P-4G-EU 48-port GE PoE+ Gigabit Managed Switch. Category: Cisco. Subcategory: Network Switch. Price: 123,500৳.
",275,661901,662176
2732,recursive,"
Product: Cisco C1000-24FP-4G-L 24 Port Gigabit PoE+ Compliant Managed Switch. Category: Cisco. Subcategory: Network Switch. Price: 127,000৳.

Product: Cudy FS1010P 8 Port PoE+ Unmanaged Switch. Category: Cudy. Subcategory: Network Switch. Price: Out Of Stock.
",261,662176,662437
2733,recursive,"
Product: Cudy FS1010PG 8 Port PoE+ Switch with 2 Uplink Ports. Category: Cudy. Subcategory: Network Switch. Price: 3,950৳.

Product: Cudy GS1020PS2 16-Port Gigabit PoE+ Switch with 2 Gigabit SFP Ports. Category: Cudy. Subcategory: Network Switch. Price: 19,290৳.
",264,662437,662701
2734,recursive,"
Product: Cudy GS2024S2 24-Port 2-Layer Managed Gigabit Switch with 4 Gigabit SFP Slots. Category: Cudy. Subcategory: Network Switch. Price: 20,500৳.

Product: Cudy FS108D 8 Port 10/100Mbps Desktop Switch. Category: Cudy. Subcategory: Network Switch. Price: Out Of Stock.
",272,662701,662973
2735,recursive,"
Product: Cudy GS105D 5-Port Gigabit Desktop Switch. Category: Cudy. Subcategory: Network Switch. Price: Out Of Stock.

Product: Cudy FS1016D 16-Port 10/100Mbps Desktop Switch. Category: Cudy. Subcategory: Network Switch. Price: 2,600৳.
",237,662973,663210
2736,recursive,"
Product: Cudy GS1005PTS1 5-Port Gigabit PoE+ Switch with 1 SFP Slot. Category: Cudy. Subcategory: Network Switch. Price: Out Of Stock.

Product: Cudy GS1016 16-Port Gigabit Unmanaged Switch. Category: Cudy. Subcategory: Network Switch. Price: Out Of Stock.
",258,663210,663468
2737,recursive,"
Product: Cudy GS1010PE 8 Port Gigabit PoE+ Switch. Category: Cudy. Subcategory: Network Switch. Price: Out Of Stock.

Product: Cudy FS1018PS1 16 Port PoE+ Unmanaged Switch. Category: Cudy. Subcategory: Network Switch. Price: Out Of Stock.
",240,663468,663708
2738,recursive,"
Product: Cudy GS1016E 16-Port Gigabit Unmanaged Switch. Category: Cudy. Subcategory: Network Switch. Price: Out Of Stock.

Product: Cudy GS1024E 24-Port Gigabit Rackmount Switch. Category: Cudy. Subcategory: Network Switch. Price: Out Of Stock.
",246,663708,663954
2739,recursive,"
Product: Cudy FS1026PS1 24 Port Gigabit PoE+ Unmanaged Switch. Category: Cudy. Subcategory: Network Switch. Price: Out Of Stock.

Product: Cudy GS1028PS2 24 Port Gigabit PoE+ Switch. Category: Cudy. Subcategory: Network Switch. Price: Out Of Stock.
",250,663954,664204
2740,recursive,"
Product: TP-Link LS106LP 6-Port 10/100Mbps Desktop Switch with 4-Port PoE. Category: TP-Link. Subcategory: Network Switch. Price: 2,518৳2,650৳.

Product: TP-Link TL-SF1024M 24-Port 10/100Mbps Desktop Switch. Category: TP-Link. Subcategory: Network Switch. Price: 2,869৳2,989৳.
",278,664204,664482
2741,recursive,"
Product: TP-Link TL-SF1006P 6-Port 10/100Mbps Desktop PoE Switch with 4-Port PoE+. Category: TP-Link. Subcategory: Network Switch. Price: 2,992৳3,149৳.
",153,664482,664635
2742,recursive,"
Product: TP-Link TL-SF1009P 9-Port 10/100Mbps Desktop Switch with 8-Port PoE+. Category: TP-Link. Subcategory: Network Switch. Price: 3,929৳4,180৳.

Product: TP-Link LS109P 9-Port 10/100Mbps PoE Switch With 8-Port PoE+. Category: TP-Link. Subcategory: Network Switch. Price: 4,250৳.
",284,664635,664919
2743,recursive,"
Product: TP-Link TL-SG116 16-Port Gigabit Desktop Switch. Category: TP-Link. Subcategory: Network Switch. Price: Out Of Stock.

Product: TP-Link TL-SG1016D 16-Port Gigabit Desktop/Rackmount Switch. Category: TP-Link. Subcategory: Network Switch. Price: 5,537৳5,890৳.
",268,664919,665187
2744,recursive,"
Product: TP-Link TL-SG1210P 10-Port Gigabit Desktop Switch with 8-Port PoE+. Category: TP-Link. Subcategory: Network Switch. Price: 7,075৳7,090৳.

Product: TP-Link TL-SG1024D 24-Port Gigabit Rackmount Switch. Category: TP-Link. Subcategory: Network Switch. Price: 7,145৳7,990৳.
",279,665187,665466
2745,recursive,"
Product: TP-Link TL-SG2218 JetStream 16-Port Gigabit Smart Switch with 2 SFP Ports. Category: TP-Link. Subcategory: Network Switch. Price: 11,690৳.
",149,665466,665615
2746,recursive,"
Product: TP-Link TL-SG2210MP JetStream 10-Port Gigabit Smart Switch with 8-Port PoE+. Category: TP-Link. Subcategory: Network Switch. Price: 11,197৳13,490৳.
",158,665615,665773
2747,recursive,"
Product: TP-Link SG2218P Omada 18-Port Gigabit Smart Switch with 16-Port PoE+. Category: TP-Link. Subcategory: Network Switch. Price: 18,490৳.

Product: TP-Link TL-SG1218MPE 18-Port Gigabit Easy Smart Switch with 16-Port PoE+. Category: TP-Link. Subcategory: Network Switch. Price: 18,890৳.
",292,665773,666065
2748,recursive,"
Product: TP-Link TL-SG2428P JetStream 28-Port Gigabit Smart Switch with 24-Port PoE+. Category: TP-Link. Subcategory: Network Switch. Price: 23,641৳27,490৳.
",158,666065,666223
2749,recursive,"
Product: Mikrotik CSS610-8G-2S+IN 10 Port (8 Port Gigabit + 2 Port SFP+) Managed Smart Cloud Switch. Category: MikroTik. Subcategory: Network Switch. Price: 14,000৳15,500৳.
",174,666223,666397
2750,recursive,"
Product: Mikrotik CRS305-1G-4S+IN Single Gigabit Ethernet port Switch. Category: MikroTik. Subcategory: Network Switch. Price: 17,800৳.

Product: Mikrotik CRS112-8P-4S-IN 8 port Gigabit POE Smart Switch. Category: MikroTik. Subcategory: Network Switch. Price: 23,000৳.
",270,666397,666667
2751,recursive,"
Product: Mikrotik CRS318-16P-2S+OUT 16 Port Gigabit PoE Managed Switch With 2 SFP+ Port. Category: MikroTik. Subcategory: Network Switch. Price: 33,222৳33,900৳.

Product: Mikrotik CRS326-24S+2Q+RM 26-Port Cloud Router Switch. Category: MikroTik. Subcategory: Network Switch. Price: 78,500৳.
",292,666667,666959
2752,recursive,"
Product: Mikrotik CRS309-1G-8S+IN Gigabit port Mountable Rack Switch. Category: MikroTik. Subcategory: Network Switch. Price: 34,500৳.
",136,666959,667095
2753,recursive,"
Product: Mikrotik CRS317-1G-16S+RM (16 Port SFP + 1 Port Gigabit LAN) Managed Cloud Switch. Category: MikroTik. Subcategory: Network Switch. Price: 57,000৳57,500৳.

Product: Mikrotik CRS328-24P-4S+RM 24 port Mountable Rack Switch. Category: MikroTik. Subcategory: Network Switch. Price: 63,500৳.
",297,667095,667392
2754,recursive,"
Product: Mikrotik CRS125-24G-1S-IN 24 Port Gigabit Ethernet layer 3 Smart Switch. Category: MikroTik. Subcategory: Network Switch. Price: Out Of Stock.

Product: Mikrotik CRS112-8G-4S-IN 8 Port Layer 3 Gigabit Smart Switch. Category: MikroTik. Subcategory: Network Switch. Price: Out Of Stock.
",295,667392,667687
2755,recursive,"
Product: Mikrotik CRS328-4C-20S-4S+RM 28 Port Dual Boot Switch. Category: MikroTik. Subcategory: Network Switch. Price: Out Of Stock.
",135,667687,667822
2756,recursive,"
Product: Mikrotik CSS326-24G-2S+RM SwOS powered 24 port Gigabit Ethernet switch with two SFP+ ports in 1U rackmount case. Category: MikroTik. Subcategory: Network Switch. Price: Out Of Stock.
",193,667822,668015
2757,recursive,"
Product: Tenda S110PC 10-Port 100M Unmanaged PoE Switch. Category: Tenda. Subcategory: Network Switch. Price: 3,000৳.

Product: Tenda SG108 8-Port Gigabit Desktop Switch. Category: Tenda. Subcategory: Network Switch. Price: 2,000৳3,359৳.
",239,668015,668254
2758,recursive,"
Product: Tenda TEG1016D 16 Port Gigabit Ethernet Metal Body Switch. Category: Tenda. Subcategory: Network Switch. Price: 5,292৳5,670৳.

Product: Tenda TEF1110P-8-102W 8 Port Gigabit Desktop Switch With 8-Port PoE. Category: Tenda. Subcategory: Network Switch. Price: 6,950৳.
",276,668254,668530
2759,recursive,"
Product: Tenda TEF1118P-16-150W 16 10/100Mbps PoE +1 Gigabit/SFP Slots Switch. Category: Tenda. Subcategory: Network Switch. Price: 10,001৳10,990৳.

Product: Tenda TEG5310P-8-150W 8 Port L3 Managed PoE Switch. Category: Tenda. Subcategory: Network Switch. Price: 11,900৳.
",273,668530,668803
2760,recursive,"
Product: Tenda TEF1126P-24-250W 24 Port PoE Gigabit Switch. Category: Tenda. Subcategory: Network Switch. Price: 16,200৳.

Product: Tenda TEF1218P 16-Port 10/100Mbps + 2 Gigabit Smart PoE Switch. Category: Tenda. Subcategory: Network Switch. Price: 13,200৳15,000৳.
",266,668803,669069
2761,recursive,"
Product: Tenda TEG1118P-16-250W 16GE+2SFP 16 Port Unmanaged PoE Switch. Category: Tenda. Subcategory: Network Switch. Price: 15,780৳.

Product: Tenda TEG1050F 48 Port 48GE+2SFP Ethernet Switch. Category: Tenda. Subcategory: Network Switch. Price: 22,525৳.
",257,669069,669326
2762,recursive,"
Product: Tenda TEF1226P-24-410W 24 Port PoE Smart Switch. Category: Tenda. Subcategory: Network Switch. Price: 24,200৳.

Product: Tenda TEG3224P 24-Port 10/100/1000 Mbps + 4 Shared SFP PoE Managed Switch. Category: Tenda. Subcategory: Network Switch. Price: 29,900৳.
",268,669326,669594
2763,recursive,"
Product: Tenda TEG5328P-24-410W (410W) L3 Managed PoE Switch. Category: Tenda. Subcategory: Network Switch. Price: 34,079৳.

Product: Tenda TEG3210P 8G+2SFP Managed PoE Switch. Category: Tenda. Subcategory: Network Switch. Price: Up Coming.
",242,669594,669836
2764,recursive,"
Product: Tenda SG80 8-port Gigabit Switch. Category: Tenda. Subcategory: Network Switch. Price: Out Of Stock.

Product: Hikvision DS-3E0110MP-E/M 8 Port Fast Ethernet Unmanaged PoE Switch. Category: HikVision. Subcategory: Network Switch. Price: 3,700৳.
",255,669836,670091
2765,recursive,"
Product: Hikvision DS-3E0318P-E/M(B) 16-Port Fast Ethernet Unmanaged POE Switch. Category: HikVision. Subcategory: Network Switch. Price: 17,500৳.
",148,670091,670239
2766,recursive,"
Product: Hikvision DS-3E0105P-E/M(B) 4-Port Fast Ethernet Unmanaged POE Switch. Category: HikVision. Subcategory: Network Switch. Price: Out Of Stock.

Product: Hikvision DS-3E0109P-E/M(B) 8 Port Unmanaged PoE Switch. Category: HikVision. Subcategory: Network Switch. Price: Out Of Stock.
",290,670239,670529
2767,recursive,"
Product: Hikvision DS-3E0326P-E/M(B) 24 Port Unmanaged POE Switch. Category: HikVision. Subcategory: Network Switch. Price: Out Of Stock.

Product: D Link DGS-1008A 8-Port Gigabit Easy Desktop Switch. Category: D-Link. Subcategory: Network Switch. Price: 2,790৳.
",264,670529,670793
2768,recursive,"
Product: D-Link DES-1016A-16-port 10/100M Unmanaged Switch. Category: D-Link. Subcategory: Network Switch. Price: 2,928৳3,050৳.

Product: D-link DES-F1010P-E 10 Port Unmanaged PoE Switch. Category: D-Link. Subcategory: Network Switch. Price: 5,200৳5,400৳.
",257,670793,671050
2769,recursive,"
Product: D-LINK DGS-1016A 16-Port Gigabit Unmanaged Desktop Switch. Category: D-Link. Subcategory: Network Switch. Price: 7,800৳.

Product: D-Link DGS-1024C 24-Port 10/100/1000Base Unmanaged Switch. Category: D-Link. Subcategory: Network Switch. Price: 9,310৳9,500৳.
",268,671050,671318
2770,recursive,"
Product: D-Link DES-1024C 24 Port 10/100 Unmanaged Rack Mount Switch. Category: D-Link. Subcategory: Network Switch. Price: 9,800৳.

Product: D-Link DGS-1210-28 24-Port Smart Managed Gigabit Switch. Category: D-Link. Subcategory: Network Switch. Price: Out Of Stock.
",268,671318,671586
2771,recursive,"
Product: D-Link DGS-1210-52 52-port Gigabit Smart Managed Switch. Category: D-Link. Subcategory: Network Switch. Price: Out Of Stock.

Product: Dlink DES-1008C 8 Port 10/100 Unmanaged Switch. Category: D-Link. Subcategory: Network Switch. Price: Out Of Stock.
",261,671586,671847
2772,recursive,"
Product: D-Link DES-1008P 8-Port Desktop Switch with 4 PoE Ports. Category: D-Link. Subcategory: Network Switch. Price: Out Of Stock.

Product: D-Link DGS-1008MP 8 port 10/100/1000 Giga Unmanaged PoE Desktop Switch. Category: D-Link. Subcategory: Network Switch. Price: Out Of Stock.
",285,671847,672132
2773,recursive,"
Product: D-Link DGS-1210-10P 8 Port Gigabit Switch. Category: D-Link. Subcategory: Network Switch. Price: Out Of Stock.

Product: D-Link DES-1024D 24-Ports 10/100 Fast Ethernet Unmanaged Rack Mount Switch. Category: D-Link. Subcategory: Network Switch. Price: Out Of Stock.
",275,672132,672407
2774,recursive,"
Product: D-Link DES-1210-28P Web Smart 24-Port Fast PoE Ethernet Switch. Category: D-Link. Subcategory: Network Switch. Price: Out Of Stock.

Product: D-Link DES-1210-52 48 Port Gigabit Smart Managed Switch. Category: D-Link. Subcategory: Network Switch. Price: Out Of Stock.
",277,672407,672684
2775,recursive,"
Product: D-Link DGS-1510-28X Layer 3 Lite 24 Port Gigabit 4 SFP Plus Smart Managed Gigabit Switch. Category: D-Link. Subcategory: Network Switch. Price: Out Of Stock.

Product: D-Link DGS-1210-52 48-port Gigabit Switch. Category: D-Link. Subcategory: Network Switch. Price: Out Of Stock.
",289,672684,672973
2776,recursive,"
Product: Solitine SOL-7912 12 Port 10G L3 Managed Network Switch. Category: Solitine. Subcategory: Network Switch. Price: 32,000৳.

Product: Solitine S3028X-DP 28 Port Managed Network Switch. Category: Solitine. Subcategory: Network Switch. Price: 46,500৳.
",258,672973,673231
2777,recursive,"
Product: Ruijie RG-ES106D-P V2 6-port Desktop Unmanaged PoE Switch. Category: Ruijie. Subcategory: Network Switch. Price: 4,000৳.

Product: Ruijie RG-ES205GC-P 5-Port Gigabit Smart Cloud Managed PoE Switch. Category: Ruijie. Subcategory: Network Switch. Price: 6,490৳.
",270,673231,673501
2778,recursive,"
Product: Ruijie RG-ES206GS-P 6-Port Gigabit Managed Smart PoE Switch. Category: Ruijie. Subcategory: Network Switch. Price: 7,500৳.

Product: Ruijie RG-ES216GC 16 Port Gigabit Smart Managed Switch. Category: Ruijie. Subcategory: Network Switch. Price: 11,500৳.
",262,673501,673763
2779,recursive,"
Product: Ruijie RG-ES110GDS-P 10-port Unmanaged PoE Switch. Category: Ruijie. Subcategory: Network Switch. Price: 12,500৳.

Product: Ruijie RG-ES210GC-LP 10-Port Gigabit Smart Cloud Managed PoE Switch. Category: Ruijie. Subcategory: Network Switch. Price: 12,500৳.
",266,673763,674029
2780,recursive,"
Product: Ruijie RG-ES209GC-P 9-Port Gigabit Smart Cloud Managed PoE Switch. Category: Ruijie. Subcategory: Network Switch. Price: 12,800৳.

Product: Ruijie RG-ES124GD 24-Port Gigabit Unmanaged Switch. Category: Ruijie. Subcategory: Network Switch. Price: 13,000৳.
",265,674029,674294
2781,recursive,"
Product: Ruijie RG-NBS3100-8GT2SFP 8 Port Gigabit L2 Managed Switch. Category: Ruijie. Subcategory: Network Switch. Price: 13,500৳.

Product: Ruijie RG-ES118S-LP 16-Port Desktop Unmanaged PoE Switch. Category: Ruijie. Subcategory: Network Switch. Price: 17,000৳.
",264,674294,674558
2782,recursive,"
Product: Ruijie RG-ES224GC 24-Port Gigabit Smart Cloud Managed Switch. Category: Ruijie. Subcategory: Network Switch. Price: 20,000৳.

Product: Ruijie RG-ES118GS-P 18-Port Unmanaged PoE Switch. Category: Ruijie. Subcategory: Network Switch. Price: 21,000৳.
",258,674558,674816
2783,recursive,"
Product: Ruijie RG-NBS3100-24GT4SFP 28-Port Gigabit Layer 2 Cloud Managed Switch. Category: Ruijie. Subcategory: Network Switch. Price: 21,000৳.

Product: Ruijie RG-ES126FGS-LP 24-Port Unmanaged PoE Switch. Category: Ruijie. Subcategory: Network Switch. Price: 22,000৳.
",271,674816,675087
2784,recursive,"
Product: Ruijie RG-ES126S-LP V2 24-Port Desktop Unmanaged PoE Switch. Category: Ruijie. Subcategory: Network Switch. Price: 22,500৳.

Product: Ruijie RG-NBS3100-8GT2SFP-P 8 Port Gigabit L2 Managed POE Switch. Category: Ruijie. Subcategory: Network Switch. Price: 23,500৳.
",273,675087,675360
2785,recursive,"
Product: Ruijie RG-ES218GC-P 18-Port Gigabit Smart Cloud Managed PoE Switch. Category: Ruijie. Subcategory: Network Switch. Price: Up Coming.

Product: Ruijie RG-ES08 8-Port 10/100 Mbps Unmanaged Desktop Switch. Category: Ruijie. Subcategory: Network Switch. Price: Out Of Stock.
",281,675360,675641
2786,recursive,"
Product: Netgear GS108E 8-Port Gigabit Plus Managed Desktop Switch. Category: NETGEAR. Subcategory: Network Switch. Price: 3,780৳4,200৳.

Product: Netgear GS305P 5-Port Gigabit Desktop Switch. Category: NETGEAR. Subcategory: Network Switch. Price: 8,200৳.
",257,675641,675898
2787,recursive,"
Product: Netgear GS108LP 8-Port Gigabit PoE Unmanaged Rackmount Switch (PoE Budget 60W). Category: NETGEAR. Subcategory: Network Switch. Price: 11,500৳.

Product: Netgear GS324 24-Port Gigabit Rackmount Switch. Category: NETGEAR. Subcategory: Network Switch. Price: 10,736৳12,200৳.
",283,675898,676181
2788,recursive,"
Product: Netgear GS310TP 8-Port Gigabit PoE+ Ethernet Smart Managed Pro Desktop Switch with 2 SFP Ports. Category: NETGEAR. Subcategory: Network Switch. Price: 20,500৳.

Product: Netgear GS110TP 10-Port Gigabit Ethernet Smart Switch. Category: NETGEAR. Subcategory: Network Switch. Price: 20,500৳.
",299,676181,676480
2789,recursive,"
Product: Netgear GS116LP 16-Port Gigabit Ethernet Rackmount Unmanaged PoE/PoE+ Switch. Category: NETGEAR. Subcategory: Network Switch. Price: 20,500৳23,500৳.

Product: Netgear GS724T 24 Port Smart Gigabit Managed Pro Switch. Category: NETGEAR. Subcategory: Network Switch. Price: 31,300৳.
",290,676480,676770
2790,recursive,"
Product: Netgear GS348 48-Port Gigabit Unmanaged Rackmount Switch. Category: NETGEAR. Subcategory: Network Switch. Price: 42,500৳.

Product: Netgear GS728TP 24 + 4 SFP Port Pro Safe Gigabit PoE Manage Switch. Category: NETGEAR. Subcategory: Network Switch. Price: 48,000৳48,500৳.
",281,676770,677051
2791,recursive,"
Product: Netgear GS748T 48-Port Gigabit Ethernet Smart Switch. Category: NETGEAR. Subcategory: Network Switch. Price: 64,000৳.

Product: Netgear M4250-10G2F-PoE+ AV Line 8G PoE+ 1G and SFP Managed Switch. Category: NETGEAR. Subcategory: Network Switch. Price: 75,000৳.
",270,677051,677321
2792,recursive,"
Product: Netgear GS752TP 52 Port Gigabit Ethernet Smart Switch (4SFP). Category: NETGEAR. Subcategory: Network Switch. Price: 93,500৳.

Product: Netgear M4300-28G (GSM4328S) 28 Port Stackable L3 Managed Switch. Category: NETGEAR. Subcategory: Network Switch. Price: 168,000৳.
",277,677321,677598
2793,recursive,"
Product: Netgear M4300-52G 48 Port Gigabit Stackable Managed Switch. Category: NETGEAR. Subcategory: Network Switch. Price: 215,000৳.

Product: Netgear AV Line M4250-40G8XF-PoE+ 48 Port Managed Switch. Category: NETGEAR. Subcategory: Network Switch. Price: Call for Price.
",274,677598,677872
2794,recursive,"
Product: Netgear GS316P 16 Port Gigabit Ethernet Unmanaged PoE+ Switch with Flex PoE (115W). Category: NETGEAR. Subcategory: Network Switch. Price: Call for Price.
",165,677872,678037
2795,recursive,"
Product: NETGEAR GS110EMX 8-Port Gigabit Ethernet Plus Switch. Category: NETGEAR. Subcategory: Network Switch. Price: Call for Price.

Product: NETGEAR GS316EP 16-Port PoE+ Gigabit Ethernet Plus Switch. Category: NETGEAR. Subcategory: Network Switch. Price: Call for Price.
",275,678037,678312
2796,recursive,"
Product: Netgear M4250-16XF AV Line 16-port SFP+ 10G Managed Switch. Category: NETGEAR. Subcategory: Network Switch. Price: Call for Price.

Product: Dahua PFS3009-8ET-65 8-Port POE Switch. Category: Dahua. Subcategory: Network Switch. Price: 4,900৳.
",252,678312,678564
2797,recursive,"
Product: Dahua PFS3226-24ET-240 26-Port Unmanaged PoE Switch. Category: Dahua. Subcategory: Network Switch. Price: 22,500৳.

Product: BDCOM S1200-8P2G 8 Ports PoE Switch With 2 Gigabit Ports. Category: BDCOM. Subcategory: Network Switch. Price: 4,200৳.
",254,678564,678818
2798,recursive,"
Product: BDCOM S1210-8P 8 Ports 100M Unmanaged Switch. Category: BDCOM. Subcategory: Network Switch. Price: 8,500৳.

Product: BDCOM S2510-C 8 ports Managed Switch. Category: BDCOM. Subcategory: Network Switch. Price: 9,500৳.
",226,678818,679044
2799,recursive,"
Product: BDCOM S1500-24T2S 24-Port Gigabit Switch. Category: BDCOM. Subcategory: Network Switch. Price: 10,000৳.

Product: BDCOM S1500-16P2S 16-Port Unmanaged PoE Switch. Category: BDCOM. Subcategory: Network Switch. Price: 15,200৳.
",234,679044,679278
2800,recursive,"
Product: BDCOM S1518-16P 16 ports POE Unmanaged Switch. Category: BDCOM. Subcategory: Network Switch. Price: 21,000৳.

Product: BDCOM S1500-24P2S-370 24-Port Unmanaged PoE Switch. Category: BDCOM. Subcategory: Network Switch. Price: 23,000৳.
",243,679278,679521
2801,recursive,"
Product: BDCOM S2226-P 24 Ports POE Managed Switch. Category: BDCOM. Subcategory: Network Switch. Price: 25,500৳.

Product: BDCOM S2900-24T4X 24 Ports Gigabit Switch With 4 SFP Ports. Category: BDCOM. Subcategory: Network Switch. Price: 30,740৳.
",247,679521,679768
2802,recursive,"
Product: BDCOM S2900-48P6X 48-Port POE Gigabit Managed Switch. Category: BDCOM. Subcategory: Network Switch. Price: 86,500৳.

Product: BDCOM S5828 24-Port SFP 10G L3 Managed Switch. Category: BDCOM. Subcategory: Network Switch. Price: 145,000৳.
",246,679768,680014
2803,recursive,"
Product: BDCOM S1008-D 8 Ports Unmanaged Switches. Category: BDCOM. Subcategory: Network Switch. Price: Out Of Stock.

Product: BDCOM S1008C 8 Port Unmanaged Switch. Category: BDCOM. Subcategory: Network Switch. Price: Out Of Stock.
",234,680014,680248
2804,recursive,"
Product: BDCOM S1006-4P 4-Port PoE Switch. Category: BDCOM. Subcategory: Network Switch. Price: Out Of Stock.

Product: BDCOM S1508 E 8 Ports Unmanaged Switches. Category: BDCOM. Subcategory: Network Switch. Price: Out Of Stock.
",230,680248,680478
2805,recursive,"
Product: BDCOM S1016C 16 Ports 100M Unmanaged Switch. Category: BDCOM. Subcategory: Network Switch. Price: Out Of Stock.

Product: BDCOM S1000-8P2F 8-Port 100mbps Unmanaged PoE Switch. Category: BDCOM. Subcategory: Network Switch. Price: Out Of Stock.
",253,680478,680731
2806,recursive,"
Product: BDCOM S1010-8P-120 8-Port 100mbps Multi functional PoE Switch (120W). Category: BDCOM. Subcategory: Network Switch. Price: Out Of Stock.

Product: BDCOM S1024C 24 Ports 100M Unmanaged Switch. Category: BDCOM. Subcategory: Network Switch. Price: Out Of Stock.
",269,680731,681000
2807,recursive,"
Product: BDCOM S1516v1 16 Port Unmanaged Switch. Category: BDCOM. Subcategory: Network Switch. Price: Out Of Stock.

Product: Netis ST3116P 16 Port Fast Ethernet Switch. Category: Netis. Subcategory: Network Switch. Price: 2,380৳.
",232,681000,681232
2808,recursive,"
Product: Netis P106C 6-Port Unmanaged POE Switch. Category: Netis. Subcategory: Network Switch. Price: 2,500৳3,260৳.

Product: Netis P110C 10-Port Unmanaged POE Switch. Category: Netis. Subcategory: Network Switch. Price: 3,200৳3,500৳.
",237,681232,681469
2809,recursive,"
Product: Netis PE6108GH 8 Port Gigabit Ethernet PoE Switch. Category: Netis. Subcategory: Network Switch. Price: 8,500৳.

Product: Netis P116GH 16-Port Unmanaged POE Switch. Category: Netis. Subcategory: Network Switch. Price: 7,900৳14,290৳.
",243,681469,681712
2810,recursive,"
Product: Netis P124GH 24-Port Unmanaged POE Switch. Category: Netis. Subcategory: Network Switch. Price: 22,000৳.

Product: Grandstream GWN7700P 5 Port Gigabit PoE Network Switch. Category: Grandstream. Subcategory: Network Switch. Price: 4,200৳.
",248,681712,681960
2811,recursive,"
Product: Grandstream GWN7702 16 Port Gigabit Network Switch. Category: Grandstream. Subcategory: Network Switch. Price: 8,100৳.

Product: Grandstream GWN7701PA 8 Port Gigabit PoE Network Switch. Category: Grandstream. Subcategory: Network Switch. Price: 9,100৳.
",263,681960,682223
2812,recursive,"
Product: Grandstream GWN7703 24 Port Gigabit Network Switch. Category: Grandstream. Subcategory: Network Switch. Price: 10,500৳.

Product: Grandstream GWN7801 8 Port Gigabit Layer 2+ Managed Network Switch. Category: Grandstream. Subcategory: Network Switch. Price: 11,000৳.
",276,682223,682499
2813,recursive,"
Product: Grandstream GWN7801P 8 Port Gigabit Layer 2+ Managed PoE Network Switch. Category: Grandstream. Subcategory: Network Switch. Price: 15,000৳.

Product: Grandstream GWN7802 16 Port Gigabit Layer 2+ Managed Network Switch. Category: Grandstream. Subcategory: Network Switch. Price: 18,200৳.
",298,682499,682797
2814,recursive,"
Product: Grandstream GWN7803 24 Port Gigabit Layer 2+ Managed Network Switch. Category: Grandstream. Subcategory: Network Switch. Price: 21,400৳.

Product: Grandstream GWN7802P 16 Port Gigabit Layer 2+ Managed PoE Network Switch. Category: Grandstream. Subcategory: Network Switch. Price: 25,500৳.
",299,682797,683096
2815,recursive,"
Product: Grandstream GWN7813 24 Port Layer 3 Managed Network Switch. Category: Grandstream. Subcategory: Network Switch. Price: 27,000৳.

Product: Grandstream GWN7806 48 Port Gigabit Layer 2+ Managed Network Switch. Category: Grandstream. Subcategory: Network Switch. Price: 39,000৳.
",285,683096,683381
2816,recursive,"
Product: Grandstream GWN7831 32 Gigabit Port Layer 3 Managed Switch. Category: Grandstream. Subcategory: Network Switch. Price: 43,200৳.

Product: Grandstream GWN7803P Enterprise 24 Port Gigabit Managed PoE Switch. Category: Grandstream. Subcategory: Network Switch. Price: Call for Price.
",291,683381,683672
2817,recursive,"
Product: TRENDnet TEG-S51 5-Port Gigabit Desktop Switch. Category: TRENDnet. Subcategory: Network Switch. Price: 3,800৳.

Product: TRENDnet TEG-S83 8-Port Gigabit Desktop Switch. Category: TRENDnet. Subcategory: Network Switch. Price: 3,870৳4,500৳.
",250,683672,683922
2818,recursive,"
Product: TRENDnet TEG-S80ES 8-Port EdgeSmart Gigabit Switch. Category: TRENDnet. Subcategory: Network Switch. Price: 7,000৳.

Product: TRENDnet TPE-TG51g 5-Port Gigabit PoE+ Switch. Category: TRENDnet. Subcategory: Network Switch. Price: 7,500৳.
",247,683922,684169
2819,recursive,"
Product: TRENDnet TPE-TG83 8-Port Gigabit PoE+ Switch. Category: TRENDnet. Subcategory: Network Switch. Price: 11,900৳.

Product: TRENDnet TPE-TG82ES 8-Port EdgeSmart Gigabit PoE+ Switch. Category: TRENDnet. Subcategory: Network Switch. Price: 13,500৳.
",254,684169,684423
2820,recursive,"
Product: TRENDnet TPE-TG84 8-Port Gigabit PoE+ Switch. Category: TRENDnet. Subcategory: Network Switch. Price: 14,900৳.

Product: TRENDnet TEG-S17 16-Port Unmanaged Gigabit Switch. Category: TRENDnet. Subcategory: Network Switch. Price: 16,500৳.
",247,684423,684670
2821,recursive,"
Product: TRENDnet TEG-082WS 8-Port Web Smart Gigabit Switch With 2x SFP Ports. Category: TRENDnet. Subcategory: Network Switch. Price: 16,500৳.

Product: TRENDnet TEG-S25D 24-Port Gigabit Desktop Switch. Category: TRENDnet. Subcategory: Network Switch. Price: 17,500৳.
",270,684670,684940
2822,recursive,"
Product: TRENDnet TEG-S25 24-Port Unmanaged Gigabit Switch. Category: TRENDnet. Subcategory: Network Switch. Price: 20,000৳.

Product: TRENDnet TPE-082WS 10-Port Gigabit Web Smart PoE+ Switch. Category: TRENDnet. Subcategory: Network Switch. Price: 22,500৳.
",259,684940,685199
2823,recursive,"
Product: TRENDnet TPE-TG160H 16-Port Gigabit PoE+ Switch. Category: TRENDnet. Subcategory: Network Switch. Price: 23,500৳.

Product: TRENDnet TEG-204WS 20-Port Gigabit Web Smart Switch. Category: TRENDnet. Subcategory: Network Switch. Price: 25,500৳.
",252,685199,685451
2824,recursive,"
Product: TRENDnet TEG-284WS 28-Port Gigabit Web Smart Switch. Category: TRENDnet. Subcategory: Network Switch. Price: 30,500৳.

Product: TRENDnet TPE-TG380 8-Port Unmanaged 2.5G PoE+ Switch. Category: TRENDnet. Subcategory: Network Switch. Price: 30,500৳.
",257,685451,685708
2825,recursive,"
Product: TRENDnet TEG-30262 24-Port Gigabit Switch with 2 x 10G SFP+ Slots. Category: TRENDnet. Subcategory: Network Switch. Price: 32,000৳.

Product: TRENDnet TPE-TG182 18-Port Gigabit PoE+ Switch. Category: TRENDnet. Subcategory: Network Switch. Price: 33,500৳.
",265,685708,685973
2826,recursive,"
Product: TRENDnet TEG-30284 28-Port Web Smart Switch. Category: TRENDnet. Subcategory: Network Switch. Price: 35,900৳.

Product: TRENDnet TPE-TG182ES 18-Port EdgeSmart Gigabit PoE+ Switch. Category: TRENDnet. Subcategory: Network Switch. Price: 38,500৳.
",255,685973,686228
2827,recursive,"
Product: IP-COM G3310P-8-150W 8GE+2SFP Cloud Managed PoE Switch. Category: IP-COM. Subcategory: Network Switch. Price: 9,690৳9,900৳.

Product: IP-COM Pro-S8-150W 8 Port Gigabit ProFi Switch. Category: IP-COM. Subcategory: Network Switch. Price: 11,700৳.
",255,686228,686483
2828,recursive,"
Product: IP-COM Pro-S24 24 Port Gigabit Managed ProFi Switch. Category: IP-COM. Subcategory: Network Switch. Price: 22,500৳.

Product: IP-COM Pro-S24-410W 24 Port Gigabit ProFi Switch. Category: IP-COM. Subcategory: Network Switch. Price: 29,900৳.
",249,686483,686732
2829,recursive,"
Product: C-Data CS2082G-POE 8 Port Gigabit Ethernet Unmanaged PoE Switch. Category: C-Data. Subcategory: Network Switch. Price: 5,400৳5,700৳.

Product: C-Data CS3244GC 24 Ports Gigabit Managed Ethernet Switch. Category: C-Data. Subcategory: Network Switch. Price: 24,000৳.
",274,686732,687006
2830,recursive,"
Product: C-Data CS4244GX 24 Ports Managed Ethernet Switch. Category: C-Data. Subcategory: Network Switch. Price: 28,000৳.

Product: C-Data CS3244GS-POE 24 Ports Gigabit Managed Ethernet POE Switch. Category: C-Data. Subcategory: Network Switch. Price: 33,000৳.
",262,687006,687268
2831,recursive,"
Product: C-Data CS4244GX-POE 24 Ports Gigabit Managed Ethernet POE Switch. Category: C-Data. Subcategory: Network Switch. Price: 38,000৳.

Product: Huawei eKitEngine S110-8P2ST 8 Port Gigabit PoE+ Unmanaged Switch. Category: Huawei. Subcategory: Network Switch. Price: 16,000৳.
",279,687268,687547
2832,recursive,"
Product: Huawei eKitEngine S110-16LP2SR 16 Port Gigabit PoE+ Unmanaged Switch. Category: Huawei. Subcategory: Network Switch. Price: 22,000৳.

Product: Huawei eKitEngine S110-24T2SR 24 Port Gigabit Unmanaged Switch. Category: Huawei. Subcategory: Network Switch. Price: 24,000৳24,500৳.
",287,687547,687834
2833,recursive,"
Product: Huawei CloudEngine S310-24T4S 24 Port Gigabit Managed Switch. Category: Huawei. Subcategory: Network Switch. Price: 32,000৳.

Product: Huawei eKitEngine S110-24LP2SR 24 Port Gigabit PoE+ Unmanaged Switch. Category: Huawei. Subcategory: Network Switch. Price: 32,000৳40,000৳.
",285,687834,688119
2834,recursive,"
Product: Huawei eKitEngine S220-24T4X 24 Port Gigabit WEB-Managed Switch. Category: Huawei. Subcategory: Network Switch. Price: 40,000৳.

Product: Huawei eKitEngine S220-48T4S 48 Port Gigabit WEB-Managed Switch. Category: Huawei. Subcategory: Network Switch. Price: 56,000৳.
",276,688119,688395
2835,recursive,"
Product: Huawei CloudEngine S310-24P4S 24 Port Gigabit PoE Managed Switch. Category: Huawei. Subcategory: Network Switch. Price: 60,000৳.

Product: Huawei CloudEngine S310-48T4S 48 Port Gigabit Managed Switch. Category: Huawei. Subcategory: Network Switch. Price: 60,000৳.
",274,688395,688669
2836,recursive,"
Product: Huawei eKitEngine S220-48T4X 48 Port Gigabit WEB-Managed Switch. Category: Huawei. Subcategory: Network Switch. Price: 68,800৳.

Product: Huawei eKitEngine S220-24P4X 24 Port Gigabit PoE WEB-Managed Switch. Category: Huawei. Subcategory: Network Switch. Price: 70,000৳.
",280,688669,688949
2837,recursive,"
Product: Huawei eKitEngine S310-48T4X 48 Port Gigabit Managed Switch. Category: Huawei. Subcategory: Network Switch. Price: 85,000৳.

Product: Huawei eKitEngine S220-48P4S 48 Port Gigabit PoE WEB-Managed Switch. Category: Huawei. Subcategory: Network Switch. Price: 92,000৳.
",276,688949,689225
2838,recursive,"
Product: Huawei eKitEngine S220-48P4X 48 Port Gigabit PoE WEB-Managed Switch. Category: Huawei. Subcategory: Network Switch. Price: 101,000৳.

Product: Huawei eKitEngine S310-48P4X 48 Port Gigabit PoE Managed Switch. Category: Huawei. Subcategory: Network Switch. Price: 128,000৳.
",282,689225,689507
2839,recursive,"
Product: Huawei eKitEngine S310-24T4X 24 Port Gigabit Managed Switch. Category: Huawei. Subcategory: Network Switch. Price: Out Of Stock.

Product: Huawei eKitEngine S310-24P4X 24 Port Gigabit PoE Managed Switch. Category: Huawei. Subcategory: Network Switch. Price: Out Of Stock.
",282,689507,689789
2840,recursive,"
Product: Huawei eKitEngine S310-48P4S 48 Port Gigabit PoE Managed Switch. Category: Huawei. Subcategory: Network Switch. Price: Out Of Stock.

Product: Levelone GEP-0823 8-Port Gigabit PoE Unmanaged Switch. Category: Levelone. Subcategory: Network Switch. Price: 9,800৳.
",272,689789,690061
2841,recursive,"
Product: Levelone GEP-1221 12-Port Gigabit PoE Unmanaged Switch. Category: Levelone. Subcategory: Network Switch. Price: 15,490৳.

Product: Vsol V1124-2S 24 Port Unmanaged Gigabit Desktop Switch. Category: VSOL. Subcategory: Network Switch. Price: 9,345৳10,500৳.
",264,690061,690325
2842,recursive,"
Product: Vsol V3528E 28 Port Layer 3 Gigabit Managed Switch With SFP Port. Category: VSOL. Subcategory: Network Switch. Price: 27,000৳.

Product: Vsol V3528-P 28 Port Layer 3 Gigabit POE Managed Switch With SFP Port. Category: VSOL. Subcategory: Network Switch. Price: Up Coming.
",281,690325,690606
2843,recursive,"
Product: Vsol V3552E 48 Port Layer 3 Gigabit Managed Switch With SFP Port. Category: VSOL. Subcategory: Network Switch. Price: Up Coming.

Product: TP-Link TL-WN725N 150Mbps USB WiFi Adapter. Category: TP-Link. Subcategory: WiFi Adapter. Price: 680৳800৳.
",256,690606,690862
2844,recursive,"
Product: TP-Link TL-WN823N 300Mbps Mini Wireless N USB WiFi Adapter. Category: TP-Link. Subcategory: WiFi Adapter. Price: 945৳1,050৳.

Product: TP-Link Archer T2U Nano AC600 Dual Band Mini USB WiFi Adapter. Category: TP-Link. Subcategory: WiFi Adapter. Price: 1,441৳1,549৳.
",275,690862,691137
2845,recursive,"
Product: TP-Link Archer T3U Nano AC1300 Dual Band MU-MIMO USB WiFi Adapter. Category: TP-Link. Subcategory: WiFi Adapter. Price: 1,599৳.

Product: TP-Link Archer T2U Plus AC600 Dual Band USB WiFi Adapter. Category: TP-Link. Subcategory: WiFi Adapter. Price: 1,534৳1,649৳.
",273,691137,691410
2846,recursive,"
Product: TP-Link Archer TX20U Nano AX1800 Dual Band USB WiFi Adapter. Category: TP-Link. Subcategory: WiFi Adapter. Price: 1,777৳1,890৳.

Product: TP-Link Archer T4U AC1300 High Gain Dual Band USB WiFi Adapter. Category: TP-Link. Subcategory: WiFi Adapter. Price: 1,886৳2,050৳.
",279,691410,691689
2847,recursive,"
Product: TP-Link WN722N 150Mbps High Gain USB WiFi Adapter. Category: TP-Link. Subcategory: WiFi Adapter. Price: Out Of Stock.

Product: TP-Link Archer TX20U AX1800 Dual Band Wi-Fi 6 USB Adapter. Category: TP-Link. Subcategory: WiFi Adapter. Price: Out Of Stock.
",264,691689,691953
2848,recursive,"
Product: Cisco Firepower 1010 Next-Generation 8 Port Enterprise Firewall. Category: Firewall. Subcategory: Networking. Price: Call for Price.

Product: Cisco Firepower 1140 Next-Generation 8 Port Enterprise Firewall. Category: Firewall. Subcategory: Networking. Price: Call for Price.
",286,691953,692239
2849,recursive,"
Product: Cisco Firepower 1150 Next-Generation 8 Port Enterprise Firewall. Category: Firewall. Subcategory: Networking. Price: Call for Price.

Product: Cisco Firepower 2110 16 Port NGFW Enterprise Firewall. Category: Firewall. Subcategory: Networking. Price: Call for Price.
",276,692239,692515
2850,recursive,"
Product: SonicWall NSa 2700 16 Port Essential Edition 3-Year License Firewall. Category: Firewall. Subcategory: Networking. Price: Call for Price.

Product: SonicWall NSa 3700 24 Port Advanced Edition 5-Year License Firewall. Category: Firewall. Subcategory: Networking. Price: Call for Price.
",295,692515,692810
2851,recursive,"
Product: SonicWall TZ270 8 Port Entry Level Next-Generation Firewall. Category: Firewall. Subcategory: Networking. Price: Call for Price.

Product: SonicWall TZ270 8 Port Essential Edition 1-Year License Firewall. Category: Firewall. Subcategory: Networking. Price: Call for Price.
",283,692810,693093
2852,recursive,"
Product: SonicWall TZ370 8 Port Advanced Edition 1-Year License Firewall. Category: Firewall. Subcategory: Networking. Price: Call for Price.

Product: Cisco Firepower 1120 Next-Generation 8 Port Enterprise Firewall. Category: Firewall. Subcategory: Networking. Price: Up Coming.
",281,693093,693374
2853,recursive,"
Product: Cudy WU650 AC650 Dual Band Nano USB WiFi Adapter. Category: Cudy. Subcategory: WiFi Adapter. Price: 880৳1,000৳.

Product: Cudy WU1300S AC1300 High Gain Dual Band USB WiFi Adapter. Category: Cudy. Subcategory: WiFi Adapter. Price: 1,274৳1,200৳.
",254,693374,693628
2854,recursive,"
Product: Cudy WE3000 V1 AX3000 Dual-Band Wi-Fi 6 PCIe Adapter. Category: Cudy. Subcategory: WiFi Adapter. Price: 3,050৳.

Product: Cudy WE9300 BE9300 9300Mbps Tri-Band WiFi 7 PCI-E Adapter. Category: Cudy. Subcategory: WiFi Adapter. Price: 6,400৳.
",249,693628,693877
2855,recursive,"
Product: Cudy WU1400 AC1300 High Gain Dual Band USB WiFi Adapter. Category: Cudy. Subcategory: WiFi Adapter. Price: Out Of Stock.

Product: Vention KDRB0 USB Dual Band Wi-Fi Adapter. Category: Vention. Subcategory: WiFi Adapter. Price: 600৳.
",243,693877,694120
2856,recursive,"
Product: Vention KDTB0 AC650 USB Dual Band Wi-Fi Adapter. Category: Vention. Subcategory: WiFi Adapter. Price: 1,075৳.

Product: Mercusys MW150US N150 Nano USB WiFi Adapter. Category: WiFi Adapter. Subcategory: Networking. Price: 400৳500৳.
",241,694120,694361
2857,recursive,"
Product: Tenda W311MI AX300 Nano USB WiFi Adapter. Category: WiFi Adapter. Subcategory: Networking. Price: 446৳550৳.

Product: Mercusys MA14N AX300 Wireless USB Wi-Fi Adapter. Category: WiFi Adapter. Subcategory: Networking. Price: 500৳550৳.
",243,694361,694604
2858,recursive,"
Product: Yuanxin X-5501 150Mbps USB Wi-Fi Adapter. Category: WiFi Adapter. Subcategory: Networking. Price: 498৳600৳.

Product: Mercusys MU6H AC650 Dual Band USB WiFi Adapter. Category: WiFi Adapter. Subcategory: Networking. Price: 792৳900৳.
",242,694604,694846
2859,recursive,"
Product: Yuanxin X-5502 300Mbps Single Band USB Wi-Fi Adapter. Category: WiFi Adapter. Subcategory: Networking. Price: 783৳900৳.

Product: Mercusys MA20N AC650 Nano Dual-Band USB Wi-Fi Adapter. Category: WiFi Adapter. Subcategory: Networking. Price: 750৳770৳.
",261,694846,695107
2860,recursive,"
Product: Tenda U2 AX300 USB High Gain Wi-Fi Adapter. Category: WiFi Adapter. Subcategory: Networking. Price: 990৳1,100৳.

Product: Mercusys MA30H AC1300 Dual Band USB Wi-Fi Adapter. Category: WiFi Adapter. Subcategory: Networking. Price: 990৳1,100৳.
",251,695107,695358
2861,recursive,"
Product: Yuanxin X-5503 650Mbps Dual Band USB Wi-Fi Adapter. Category: WiFi Adapter. Subcategory: Networking. Price: 1,092৳1,200৳.

Product: Yuanxin X-5505 1300Mbps Dual Band USB Wi-Fi Adapter. Category: WiFi Adapter. Subcategory: Networking. Price: 1,350৳1,500৳.
",265,695358,695623
2862,recursive,"
Product: Vention IBEBI 3M Cat.6 UTP Patch Cord Cable. Category: Patch Cord. Subcategory: Networking. Price: 250৳.

Product: Vention IBOBG 1.5M Cat.6 UTP Right Angle Patch Cord Cable. Category: Patch Cord. Subcategory: Networking. Price: 275৳.
",244,695623,695867
2863,recursive,"
Product: Safenet 34-3011YL 1 Meter Cat6 LSZH UTP Patch Cord Yellow. Category: Patch Cord. Subcategory: Networking. Price: 300৳.

Product: Safenet 34-3011PR 1 Meter Cat6 LSZH UTP Patch Cord Purple. Category: Patch Cord. Subcategory: Networking. Price: 300৳.
",258,695867,696125
2864,recursive,"
Product: Safenet 2414-3031YL 3 Meter SM Duplex Fiber LC/APC Patch Cord. Category: Patch Cord. Subcategory: Networking. Price: 300৳.

Product: Safenet 34-5011X-BL 1 Meter Cat6 LSZH UTP Patch Cord Blue. Category: Patch Cord. Subcategory: Networking. Price: 300৳.
",262,696125,696387
2865,recursive,"
Product: Vention IBNBG LSZH 1.5M Cat6 UTP Patch Cord Cable. Category: Patch Cord. Subcategory: Networking. Price: 325৳.

Product: Rosenberger CP61-423-1P0 0.5 Meter Cat 6 UTP Patch Cord Blue. Category: Patch Cord. Subcategory: Networking. Price: 350৳.
",253,696387,696640
2866,recursive,"
Product: Rosenberger CP61-425-1P0 0.5 Meter Cat 6 UTP Patch Cord Red. Category: Patch Cord. Subcategory: Networking. Price: 350৳.

Product: Rosenberger CP61-422-1P0 0.5 Meter Cat 6 UTP Patch Cord Yellow. Category: Patch Cord. Subcategory: Networking. Price: 350৳.
",265,696640,696905
2867,recursive,"
Product: Safenet 44-5551OR 0.5 Meter Cat6A SFTP Stranded LSZH Patch Cord. Category: Patch Cord. Subcategory: Networking. Price: 350৳.

Product: Vention IBHYG 1.5M Cat.6A SFTP Patch Cord Cable Yellow. Category: Patch Cord. Subcategory: Networking. Price: 350৳.
",261,696905,697166
2868,recursive,"
Product: Tenda U1 300Mbps Ultra-Fast USB WiFi Adapter. Category: Tenda. Subcategory: WiFi Adapter. Price: Out Of Stock.

Product: Ficer FAOC-40G-QPSP-010 10 Meter OM3 Multi-Mode AOC Cable. Category: Fiber Optic Cable. Subcategory: Networking Cable. Price: 22,000৳.
",266,697166,697432
2869,recursive,"
Product: Ficer FAOC-40G-QPQP-010 10 Meter OM3 Multi-Mode AOC Cable. Category: Fiber Optic Cable. Subcategory: Networking Cable. Price: 22,500৳.
",145,697432,697577
2870,recursive,"
Product: R&M 12 Port Fiber Rack Mount LIU loaded with Singlemode 6x SC-PC DX Adapters. Category: Fiber Optic Cable. Subcategory: Networking Cable. Price: Call for Price.
",171,697577,697748
2871,recursive,"
Product: R&M 24 Port Fiber Rack Mount LIU loaded with Singlemode 12x SC-PC DX Adapters. Category: Fiber Optic Cable. Subcategory: Networking Cable. Price: Call for Price.
",172,697748,697920
2872,recursive,"
Product: R&M 6 Core Armoured Single Mode Loose Tube Fiber Optic Cable. Category: Fiber Optic Cable. Subcategory: Networking Cable. Price: Call for Price.
",155,697920,698075
2873,recursive,"
Product: R&M 12 Port Fiber Rack Mount LIU loaded with Singlemode 6x LC-PC DX Adapters. Category: Fiber Optic Cable. Subcategory: Networking Cable. Price: Call for Price.
",171,698075,698246
2874,recursive,"
Product: R&M 12 Port Fiber Rack Mount LIU loaded with Multimode 6x SC-PC DX Adapters. Category: Fiber Optic Cable. Subcategory: Networking Cable. Price: Call for Price.
",170,698246,698416
2875,recursive,"
Product: R&M 6 Port Fiber Rack Mount LIU loaded with Multimode 3x SC-PC DX Adapters. Category: Fiber Optic Cable. Subcategory: Networking Cable. Price: Call for Price.
",169,698416,698585
2876,recursive,"
Product: R&M 24 Port Fiber Rack Mount LIU loaded with Singlemode 12x LC-PC DX Adapters. Category: Fiber Optic Cable. Subcategory: Networking Cable. Price: Call for Price.
",172,698585,698757
2877,recursive,"
Product: R&M LCPC-LCPC OS2 Single Mode Fiber Optic Patch Cord 3 Meter. Category: Fiber Optic Cable. Subcategory: Networking Cable. Price: Call for Price.
",155,698757,698912
2878,recursive,"
Product: R&M SCPC-SCPC OS2 Single Mode Fiber Optic Patch Cord 3 Meter. Category: Fiber Optic Cable. Subcategory: Networking Cable. Price: Call for Price.
",155,698912,699067
2879,recursive,"
Product: R&M LCPC-SCPC OS2 Single Mode Fiber Optic Patch Cord 3 Meter. Category: Fiber Optic Cable. Subcategory: Networking Cable. Price: Call for Price.
",155,699067,699222
2880,recursive,"
Product: R&M LCPC-SCPC OM3 Multi Mode Fiber Optic Patch Cord 3 Meter. Category: Fiber Optic Cable. Subcategory: Networking Cable. Price: Call for Price.
",154,699222,699376
2881,recursive,"
Product: R&M LCPC-SCPC OM3 Multi Mode Fiber Optic Patch Cord 1 Meter. Category: Fiber Optic Cable. Subcategory: Networking Cable. Price: Call for Price.
",154,699376,699530
2882,recursive,"
Product: R&M SCPC-SCPC OM3 Multi Mode Fiber Optic Patch Cord 3 Meter. Category: Fiber Optic Cable. Subcategory: Networking Cable. Price: Call for Price.
",154,699530,699684
2883,recursive,"
Product: R&M SCPC-SCPC OM3 Multi Mode Fiber Optic Patch Cord 1 Meter. Category: Fiber Optic Cable. Subcategory: Networking Cable. Price: Call for Price.
",154,699684,699838
2884,recursive,"
Product: R&M LCPC OS2 Single Mode Fiber Optic Pigtail 1.5 Meter. Category: Fiber Optic Cable. Subcategory: Networking Cable. Price: Call for Price.

Product: R&M SCPC OS2 Single Mode Fiber Optic Pigtail 1.5 Meter. Category: Fiber Optic Cable. Subcategory: Networking Cable. Price: Call for Price.
",298,699838,700136
2885,recursive,"
Product: R&M 12 Core Armoured Single Mode Loose Tube Fiber Optic Cable. Category: Fiber Optic Cable. Subcategory: Networking Cable. Price: Up Coming.
",151,700136,700287
2886,recursive,"
Product: R&M 6 Core Armoured Multi Mode Loose Tube Fiber Optic Cable. Category: Fiber Optic Cable. Subcategory: Networking Cable. Price: Up Coming.

Product: TRENDnet TEW-808UBM Micro AC1200 Dual Band USB WiFi Adapter. Category: TRENDnet. Subcategory: WiFi Adapter. Price: 2,025৳2,250৳.
",288,700287,700575
2887,recursive,"
Product: TRENDnet TBW-108UB Micro N150 Wireless & Bluetooth USB Adapter. Category: TRENDnet. Subcategory: WiFi Adapter. Price: Out Of Stock.

Product: Nexakey NX-SL48C6 305 Meter CCA UTP Cable. Category: Networking Cable. Subcategory: Networking. Price: 3,800৳.
",263,700575,700838
2888,recursive,"
Product: Pro Tech PTN-C6-CCAM-IN-OR 305M CAT6 UTP Cable Orange. Category: Networking Cable. Subcategory: Networking. Price: 4,200৳.

Product: Pro Tech PTN-C6-CCAM-OUT-STD-BK 305M CAT6 UTP Cable Black. Category: Networking Cable. Subcategory: Networking. Price: 6,500৳.
",270,700838,701108
2889,recursive,"
Product: Pro Tech PTN-C6-CCAM-IN-WH 305M CAT6 UTP Cable White. Category: Networking Cable. Subcategory: Networking. Price: 4,200৳.

Product: D-link NCB-C6UGRYR-100 Cat6 UTP Cable. Category: Networking Cable. Subcategory: Networking. Price: 6,300৳.
",249,701108,701357
2890,recursive,"
Product: Safenet 32-3101OR 100 Meter Cat6 23AWG LSZH Solid UTP Cable Orange. Category: Networking Cable. Subcategory: Networking. Price: 6,500৳.

Product: Dahua PFM922I-6UN-C CAT6 305 Meter UTP Cable (Orange/White). Category: Networking Cable. Subcategory: Networking. Price: 8,200৳.
",285,701357,701642
2891,recursive,"
Product: Hikvision DS-1LN6UU/CCA 305 Meter CAT6 UTP Cable. Category: Networking Cable. Subcategory: Networking. Price: 8,300৳.

Product: COTE CC-2306-305M-CCA 305M Cat-6 UTP Cable Blue. Category: Networking Cable. Subcategory: Networking. Price: 7,990৳8,500৳.
",261,701642,701903
2892,recursive,"
Product: Pro Tech PTN-C6-CCA-IN-GY 305M CAT6 UTP Cable Grey. Category: Networking Cable. Subcategory: Networking. Price: 8,500৳.

Product: Hikvision DS-1LN6U-SC0 CAT6 305 Meter UTP Cable (Orange). Category: Networking Cable. Subcategory: Networking. Price: 14,900৳.
",267,701903,702170
2893,recursive,"
Product: Dahua DH-PFM920I-6UN-C CAT6 305 Meter UTP Cable Full Box. Category: Networking Cable. Subcategory: Networking. Price: Up Coming.

Product: D-Link Cat 6 UTP 24AWG Cable Full Box (305 Meters). Category: Networking Cable. Subcategory: Networking. Price: 15,500৳.
",270,702170,702440
2894,recursive,"
Product: Safenet 32-3350GR 305 Meter Cat6 23AWG Solid UTP Cable. Category: Networking Cable. Subcategory: Networking. Price: 15,700৳.

Product: Safenet 32-3350BL 305 Meter Cat6 23AWG Solid UTP Cable Blue. Category: Networking Cable. Subcategory: Networking. Price: 15,700৳.
",275,702440,702715
2895,recursive,"
Product: D-Link CAT 6 UTP Cable 305M 23AWG Grey (Original). Category: Networking Cable. Subcategory: Networking. Price: 16,700৳.

Product: Safenet 32-3351OR 305 Meter Cat6 23AWG LSZH Solid UTP Cable Orange. Category: Networking Cable. Subcategory: Networking. Price: 16,550৳16,900৳.
",284,702715,702999
2896,recursive,"
Product: Safenet 32-3351WT 305 Meter Cat6 23AWG LSZH Solid UTP Cable White. Category: Networking Cable. Subcategory: Networking. Price: 16,900৳.

Product: Rosenberger Cat6 UTP LSZH Cable. Category: Networking Cable. Subcategory: Networking. Price: 18,000৳.
",258,702999,703257
2897,recursive,"
Product: Safenet 32-3351BK 305 Meter Cat6 23AWG LSZH Solid UTP Cable Black. Category: Networking Cable. Subcategory: Networking. Price: 18,000৳.

Product: Cudy PE10 Single Port PCI Express Gigabit Lan Card. Category: LAN Card. Subcategory: Networking. Price: 696৳800৳.
",270,703257,703527
2898,recursive,"
Product: ORICO PTR-SU LAN Card. Category: LAN Card. Subcategory: Networking. Price: 680৳800৳.

Product: Yuanxin X-D2501 USB2.0 to RJ45 100Mbps Ethernet Adapter. Category: LAN Card. Subcategory: Networking. Price: 650৳800৳.
",224,703527,703751
2899,recursive,"
Product: TP-Link UE200 USB 2.0 to 100Mbps Ethernet Network Adapter. Category: LAN Card. Subcategory: Networking. Price: 879৳999৳.

Product: TP-Link TL-WN781ND 150Mbps Wireless N PCI Express LAN Card. Category: LAN Card. Subcategory: Networking. Price: 1,034৳1,149৳.
",267,703751,704018
2900,recursive,"
Product: TP-Link TG-3468 10/100/1000  Pci Express Gigabit LAN Card. Category: LAN Card. Subcategory: Networking. Price: 1,097৳1,219৳.

Product: TP-Link UE306 USB 3.0 to Gigabit Ethernet Network Adapter. Category: LAN Card. Subcategory: Networking. Price: 1,195৳1,299৳.
",270,704018,704288
2901,recursive,"
Product: TP-Link Archer T2E AC600 Dual Band Wi-Fi LAN Card. Category: LAN Card. Subcategory: Networking. Price: 1,170৳1,300৳.

Product: TP-Link UE300C USB Type-C to RJ45 Gigabit Ethernet Network Adapter. Category: LAN Card. Subcategory: Networking. Price: 1,213৳1,319৳.
",271,704288,704559
2902,recursive,"
Product: Ugreen CM204 1.5M USB-A to RJ45 Ethernet Adapter #50773. Category: LAN Card. Subcategory: Networking. Price: 1,320৳.

Product: TP-Link TL-WN881ND 300Mbps Wireless PCI LAN Card. Category: LAN Card. Subcategory: Networking. Price: 1,226৳1,409৳.
",253,704559,704812
2903,recursive,"
Product: Vention CEHBB USB 3.0 to Gigabit Ethernet Adapter. Category: LAN Card. Subcategory: Networking. Price: 1,365৳1,500৳.

Product: Baseus Hub Lite Series Type-C To RJ45 Ethernet Adapter. Category: LAN Card. Subcategory: Networking. Price: 1,600৳.
",253,704812,705065
2904,recursive,"
Product: Cudy PE25 2.5Gbps PCI Express LAN Card. Category: LAN Card. Subcategory: Networking. Price: 1,700৳.

Product: UGREEN CM209 USB-A To Ethernet Adapter #50922. Category: LAN Card. Subcategory: Networking. Price: 1,700৳.
",227,705065,705292
2905,recursive,"
Product: Levelone WNC-0601 300Mbps Wireless PCI LAN Card. Category: LAN Card. Subcategory: Networking. Price: 1,799৳.

Product: TP-Link Archer T4E AC1200 Dual Band Wi-Fi LAN Card. Category: LAN Card. Subcategory: Networking. Price: 1,786৳1,900৳.
",247,705292,705539
2906,recursive,"
Product: TRENDnet TEG-10GECTX 10 Gigabit PCIe LAN Card. Category: LAN Card. Subcategory: Networking. Price: 11,700৳.

Product: TRENDnet TEG-10GECSFP 10 Gigabit PCIe SFP+ Network Adapter. Category: LAN Card. Subcategory: Networking. Price: 11,700৳.
",249,705539,705788
2907,recursive,"
Product: Baseus Lite Series RJ45 LAN Port Ethernet Adapter. Category: LAN Card. Subcategory: Networking. Price: Out Of Stock.

Product: Rosenberger CAT.6 UTP Cable 305M (Original). Category: UTP Cable. Subcategory: Networking Cable. Price: 17,000৳.
",250,705788,706038
2908,recursive,"
Product: R&M R795138 Cat-6 U/UTP 305 Meter Network Cable. Category: UTP Cable. Subcategory: Networking Cable. Price: 14,500৳17,500৳.

Product: Solitine SOL2001-SP 1 Port 10G Layer 3 GPON OLT. Category: OLT. Subcategory: Networking. Price: 35,000৳.
",249,706038,706287
2909,recursive,"
Product: Solitine SOL1002-SP 2 Port 10G EPON OLT. Category: OLT. Subcategory: Networking. Price: 36,000৳.

Product: Solitine SOL1004-1G-DP 4 Port 1G EPON OLT. Category: OLT. Subcategory: Networking. Price: 46,500৳.
",216,706287,706503
2910,recursive,"
Product: Solitine SOL1004-DP 4 Port 10G EPON OLT. Category: OLT. Subcategory: Networking. Price: 47,000৳49,500৳.

Product: Solitine SOL1008-DP 8 Port 10G EPON OLT. Category: OLT. Subcategory: Networking. Price: 78,500৳.
",221,706503,706724
2911,recursive,"
Product: C-Data FD1604SN-B0-NDA0 G-PON OLT. Category: OLT. Subcategory: Networking. Price: 92,000৳.

Product: Solitine SOL2004-GPON-DP 4 Port 10G GPON OLT. Category: OLT. Subcategory: Networking. Price: 93,000৳.
",213,706724,706937
2912,recursive,"
Product: BDCOM GP3600-04D-2AC 4-Port GPON OLT. Category: OLT. Subcategory: Networking. Price: 94,500৳.

Product: BDCOM GP3600-04L-2AC 4-Port GPON OLT. Category: OLT. Subcategory: Networking. Price: 94,500৳.
",208,706937,707145
2913,recursive,"
Product: Vsol V1600G0-B 4 Port GPON OLT. Category: OLT. Subcategory: Networking. Price: 99,000৳.

Product: Solitine SOL2008-GPON-DP 8 Port 10G GPON OLT. Category: OLT. Subcategory: Networking. Price: 136,000৳138,500৳.
",219,707145,707364
2914,recursive,"
Product: C-Data FD1616SN-B0-NDA0 16 Port G-PON OLT. Category: OLT. Subcategory: Networking. Price: 235,000৳.

Product: Richerlink RL8004EL 4 port EPON OLT. Category: OLT. Subcategory: Networking. Price: Out Of Stock.
",218,707364,707582
2915,recursive,"
Product: BDCOM P3310C-2AC 4-Port EPON OLT. Category: OLT. Subcategory: Networking. Price: Out Of Stock.

Product: C-Data FD1104SN-R1-DAP EPON 1U OLT. Category: OLT. Subcategory: Networking. Price: Out Of Stock.
",212,707582,707794
2916,recursive,"
Product: C-Data FD1204S-B0-NDA0 4 Port E-PON OLT. Category: OLT. Subcategory: Networking. Price: Out Of Stock.

Product: BDCOM P3600-04-2AC 4-Port 10G EPON OLT. Category: OLT. Subcategory: Networking. Price: Out Of Stock.
",223,707794,708017
2917,recursive,"
Product: Richerlink RL8008ES 8 port EPON OLT. Category: OLT. Subcategory: Networking. Price: Out Of Stock.

Product: Richerlink RL8004GL 4 port GPON OLT. Category: OLT. Subcategory: Networking. Price: Out Of Stock.
",216,708017,708233
2918,recursive,"
Product: Vsol V1600D8 8 Port EPON OLT. Category: OLT. Subcategory: Networking. Price: Out Of Stock.

Product: UGREEN NW114 RJ45 Ethernet Connector #20390. Category: Connector. Subcategory: Networking. Price: 250৳.
",215,708233,708448
2919,recursive,"
Product: D-Link NKJ-C6WHI1B21 Cat6 UTP Keystone Jack. Category: Connector. Subcategory: Networking. Price: 320৳.

Product: UGREEN NW116 Anti-thunder RJ45 Ethernet Connector #30837. Category: Connector. Subcategory: Networking. Price: Out Of Stock.
",249,708448,708697
2920,recursive,"
Product: Safenet 35-3010BL Cat6 Modular Jack Blue. Category: Connector. Subcategory: Networking. Price: 350৳.

Product: Safenet 35-3010YL Cat6 Modular Jack Yellow. Category: Connector. Subcategory: Networking. Price: 350৳.
",224,708697,708921
2921,recursive,"
Product: CommScope 1375055-6 SL 110 Cat 6 U/UTP Information Outlet Modular jack. Category: Connector. Subcategory: Networking. Price: 350৳.

Product: Vention IODB0-50 RJ45 Strain Relief Boots. Category: Connector. Subcategory: Networking. Price: 300৳350৳.
",257,708921,709178
2922,recursive,"
Product: Vention IODH0-50 RJ45 Strain Relief Boots. Category: Connector. Subcategory: Networking. Price: 350৳.

Product: Vention IODL0-50 RJ45 Strain Relief Boots Blue. Category: Connector. Subcategory: Networking. Price: 350৳.
",229,709178,709407
2923,recursive,"
Product: Dintek 1305-04017 Cat6 Keystone E-jack. Category: Connector. Subcategory: Networking. Price: 370৳.

Product: Safenet 35-3010WT Cat6 Modular Jack White. Category: Connector. Subcategory: Networking. Price: 390৳.
",221,709407,709628
2924,recursive,"
Product: Hikvision DS-1CK6AP180N Cat6a RJ45 Keystone Jack. Category: Connector. Subcategory: Networking. Price: 390৳.

Product: CommScope SL110-6-BL Cat 6 RJ45 Modular Jack. Category: Connector. Subcategory: Networking. Price: 320৳420৳.
",238,709628,709866
2925,recursive,"
Product: CommScope SL110-6-RD Cat 6 RJ45 Modular Jack. Category: Connector. Subcategory: Networking. Price: 420৳.

Product: CommScope SL110-6-YL Cat 6 RJ45 Modular Jack. Category: Connector. Subcategory: Networking. Price: 420৳.
",230,709866,710096
2926,recursive,"
Product: CommScope SL110-6-GN Cat 6 RJ45 Modular Jack. Category: Connector. Subcategory: Networking. Price: 420৳.

Product: R&M R810598 CAT6 Connection Module for Panel. Category: Connector. Subcategory: Networking. Price: 450৳.
",230,710096,710326
2927,recursive,"
Product: Rosenberger Cat-6 UTP 90 Degree Toolless Ivory Pegasus (Module#CP31-13C-14). Category: Connector. Subcategory: Networking. Price: 450৳.

Product: UGREEN NW116 RJ45 Ethernet Connector #20391. Category: Connector. Subcategory: Networking. Price: 450৳.
",260,710326,710586
2928,recursive,"
Product: Micronet Cat 6 RJ45 Cable Connector-Pack Of 20 Pieces. Category: Connector. Subcategory: Networking. Price: 540৳650৳.

Product: AC Net F-95X Optical Fiber ARC Splicer Machine. Category: Splicer Machine. Subcategory: Networking. Price: 108,000৳.
",255,710586,710841
2929,recursive,"
Product: FiberFox Mini 3S Active V-Groov Clade Splicer Machine. Category: Splicer Machine. Subcategory: Networking. Price: 142,000৳143,500৳.

Product: FiberFox Mini 6SI+ Core to Core 6 Motors Set Splicer Machine. Category: Splicer Machine. Subcategory: Networking. Price: 285,000৳.
",283,710841,711124
2930,recursive,"
Product: FiberFox Mini 4S+ Active V-Groov Clade Splicer Machine. Category: Splicer Machine. Subcategory: Networking. Price: Out Of Stock.

Product: FiberFox Mini 5C+ Core to Core 6 Motors Set Splicer Machine. Category: Splicer Machine. Subcategory: Networking. Price: Out Of Stock.
",283,711124,711407
2931,recursive,"
Product: TRENDnet TPE-113GI Gigabit PoE Injector. Category: PoE Injector. Subcategory: Networking. Price: 3,000৳.

Product: TRENDnet TPE-115GI Gigabit PoE Injector. Category: PoE Injector. Subcategory: Networking. Price: 4,200৳.
",230,711407,711637
2932,recursive,"
Product: TRENDnet TPE-E100 Gigabit PoE+ Repeater. Category: PoE Injector. Subcategory: Networking. Price: 5,500৳.

Product: Tenda POE15F 10/100Mbps PoE Injector. Category: PoE Injector. Subcategory: Networking. Price: Out Of Stock.
",233,711637,711870
2933,recursive,"
Product: Tplink TL-POE150S Gigabit PoE Injector. Category: PoE Injector. Subcategory: Networking. Price: Out Of Stock.

Product: Tenda PoE30G-AT PoE Injector. Category: PoE Injector. Subcategory: Networking. Price: Out Of Stock.
",230,711870,712100
2934,recursive,"
Product: D-link DEM-310GT 1000 BASE-LX Single-Mode 10 Km LC SFP Module Transceiver (Single Unit). Category: Network Transceivers. Subcategory: Networking. Price: 1,550৳1,900৳.
",177,712100,712277
2935,recursive,"
Product: Grandstream F-MM850-550M-1.25G Multi-Mode SFP Fiber Module. Category: Network Transceivers. Subcategory: Networking. Price: 1,950৳.

Product: Ficer FSFP-C7-S13-20D LC Duplex SFP Transceiver. Category: Network Transceivers. Subcategory: Networking. Price: 2,000৳.
",273,712277,712550
2936,recursive,"
Product: IP-COM G311SM Single-Mode Optical Fiber Module. Category: Network Transceivers. Subcategory: Networking. Price: 2,300৳2,600৳.

Product: BDCOM OLT-GSFP-20+++ EPON Module. Category: Network Transceivers. Subcategory: Networking. Price: 2,625৳.
",252,712550,712802
2937,recursive,"
Product: TRENDnet TEG-MGBS20 Single Mode LC SFP Module. Category: Network Transceivers. Subcategory: Networking. Price: 3,000৳.

Product: BDCOM OLT-GSFP-C++ GPON Module. Category: Network Transceivers. Subcategory: Networking. Price: 3,360৳.
",243,712802,713045
2938,recursive,"
Product: Grandstream F-SM1310-20KM-1.25G Single Mode SFP Fiber Module. Category: Network Transceivers. Subcategory: Networking. Price: 3,500৳.

Product: Ficer FSFP-C8-S35-20D Tx1310 Rx1550 SM LC Simplex SFP Transceiver. Category: Network Transceivers. Subcategory: Networking. Price: 5,500৳.
",293,713045,713338
2939,recursive,"
Product: Ficer FSFP-C8-S53-20D Tx1550 Rx1310 SM LC Simplex SFP Transceiver. Category: Network Transceivers. Subcategory: Networking. Price: 5,500৳.

Product: Ficer FSFP-C2-S35-20D Tx1310 Rx1550 SM LC Simplex SFP Transceiver. Category: Network Transceivers. Subcategory: Networking. Price: 5,500৳.
",298,713338,713636
2940,recursive,"
Product: Ficer FSFP-C2-S53-20D Tx1550 Rx1310 SM LC Simplex SFP Transceiver. Category: Network Transceivers. Subcategory: Networking. Price: 5,500৳.

Product: Ficer FSPP-H7-M85-X3D 10G-SR Multimode LC Duplex Transceiver. Category: Network Transceivers. Subcategory: Networking. Price: 5,700৳.
",293,713636,713929
2941,recursive,"
Product: Grandstream F-MM850-300M-10G Multi-Mode SFP+ Fiber Module. Category: Network Transceivers. Subcategory: Networking. Price: 5,700৳.

Product: Ficer FSPP-H7-S13-10D 10G-LR 1310nm SM LC Duplex SFP+ Transceiver. Category: Network Transceivers. Subcategory: Networking. Price: 6,500৳.
",290,713929,714219
2942,recursive,"
Product: TRENDnet TEG-10GBS10 Single Mode LC SFP+ Module. Category: Network Transceivers. Subcategory: Networking. Price: 7,200৳.

Product: TRENDnet TEG-MGBS10/4 Single Mode LC SFP Module (4-Pack). Category: Network Transceivers. Subcategory: Networking. Price: 10,000৳.
",272,714219,714491
2943,recursive,"
Product: Cisco SFP-10G-SR Transceiver Module. Category: Network Transceivers. Subcategory: Networking. Price: 11,000৳.

Product: Ficer FSPP-H8-C27-20D 10G-BX-U Tx1270 Rx1330 SM LC Simplex SFP+ Transceiver. Category: Network Transceivers. Subcategory: Networking. Price: 12,900৳.
",280,714491,714771
2944,recursive,"
Product: Ficer FSPP-H8-C33-20D 10G-BX-D Tx1330 Rx1270 SM LC Simplex SFP+ Transceiver. Category: Network Transceivers. Subcategory: Networking. Price: 12,900৳.

Product: UGREEN NW136 Crimping Tool #70683. Category: Crimping Tool. Subcategory: Networking. Price: 1,200৳.
",270,714771,715041
2945,recursive,"
Product: TRENDnet TC-CT68 Crimping Tool. Category: Crimping Tool. Subcategory: Networking. Price: 2,400৳.

Product: Dintek 6102-01002CH RJ12/45 Crimping Tool. Category: Crimping Tool. Subcategory: Networking. Price: Out Of Stock.
",231,715041,715272
2946,recursive,"
Product: CommScope 1725150-6 Jack Termination Tool with Lacing Fixture. Category: Crimping Tool. Subcategory: Networking. Price: 11,500৳.

Product: Informate HT-568R Dual Modular Crimping Tool. Category: Crimping Tool. Subcategory: Networking. Price: Out Of Stock.
",266,715272,715538
2947,recursive,"
Product: Vention KEAB0 3 in 1 Multi-Function Cable Crimping Tool. Category: Crimping Tool. Subcategory: Networking. Price: Out Of Stock.

Product: Cote Networking Toolbox Set. Category: Crimping Tool. Subcategory: Networking. Price: Out Of Stock.
",248,715538,715786
2948,recursive,"
Product: Acnet OTAC-24D Mini Series  OTDR Black (Optical Time Domain Reflectometer). Category: OTDR. Subcategory: Networking. Price: 48,500৳.

Product: EXFO Maxtester 715B OTDR. Category: OTDR. Subcategory: Networking. Price: Out Of Stock.
",241,715786,716027
2949,recursive,"
Product: Phyhome P3 Single Port Gigabit Xpon/Gpon Onu. Category: ONU. Subcategory: Networking. Price: 1,199৳1,250৳.

Product: TP-Link XZ000-G7 1 Port Gigabit XPON Terminal. Category: ONU. Subcategory: Networking. Price: 1,250৳.
",229,716027,716256
2950,recursive,"
Product: Tenda HG1 Gpon Single Port Gigabit Optical Network Terminal (ONU). Category: ONU. Subcategory: Networking. Price: 1,150৳1,275৳.

Product: C-Data FD511G-G-F361 Single Port G-PON ONU. Category: ONU. Subcategory: Networking. Price: 1,230৳1,300৳.
",253,716256,716509
2951,recursive,"
Product: BDCOM GP1702-1G GPON ONU. Category: ONU. Subcategory: Networking. Price: 1,240৳1,325৳.

Product: C-Data FD511G-G-F680 Single Port G-PON ONU. Category: ONU. Subcategory: Networking. Price: 1,210৳1,350৳.
",212,716509,716721
2952,recursive,"
Product: VSOL V2801RD Single Port XPON ONU. Category: ONU. Subcategory: Networking. Price: 1,375৳.

Product: BDCOM GP1704-2F-E Dual Port WiFi XPON ONU. Category: ONU. Subcategory: Networking. Price: 2,100৳.
",208,716721,716929
2953,recursive,"
Product: BDCOM GP1705-2G Dual Port WiFi XPON ONU. Category: ONU. Subcategory: Networking. Price: 3,050৳3,450৳.

Product: C-Data FD514GB-PFX-R410 4 Port POE XPON ONU. Category: ONU. Subcategory: Networking. Price: 5,900৳.
",222,716929,717151
2954,recursive,"
Product: Phyhome FHR1100GZB EPON 1G ONU. Category: ONU. Subcategory: Networking. Price: Out Of Stock.

Product: Fiber-link JHHL-E801ZB Single Port EPON ONU. Category: ONU. Subcategory: Networking. Price: Out Of Stock.
",219,717151,717370
2955,recursive,"
Product: BDCOM P1501DS 1-Port EPON ONU. Category: ONU. Subcategory: Networking. Price: Out Of Stock.

Product: C-Data FD511G-E-F361 Single Port EPON ONU. Category: ONU. Subcategory: Networking. Price: Out Of Stock.
",216,717370,717586
2956,recursive,"
Product: Vsol V2801SE 1GE Secure EPON ONU. Category: ONU. Subcategory: Networking. Price: Out Of Stock.

Product: C-Data FD511G-E-F680 Single Port EPON ONU. Category: ONU. Subcategory: Networking. Price: Out Of Stock.
",219,717586,717805
2957,recursive,"
Product: VSOL V2801RE Single Port EPON ONU. Category: ONU. Subcategory: Networking. Price: Out Of Stock.

Product: C-Data FD511G-X-F680 Single Port XPON ONU. Category: ONU. Subcategory: Networking. Price: Out Of Stock.
",220,717805,718025
2958,recursive,"
Product: Vsol V2801SG XPON (G/Epon) Single Port ONU. Category: ONU. Subcategory: Networking. Price: Out Of Stock.

Product: Hikvision DS-1CM1U12 12-Slot 1U Patch Panel. Category: Patch Panel. Subcategory: Networking. Price: 1,000৳.
",233,718025,718258
2959,recursive,"
Product: Hikvision DS-1CM1U24 24-Slot 1U Patch Panel. Category: Patch Panel. Subcategory: Networking. Price: 1,200৳.

Product: Hikvision DS-1CP0U24-1U Unshielded 24-Port Patch Panel. Category: Patch Panel. Subcategory: Networking. Price: 1,350৳.
",247,718258,718505
2960,recursive,"
Product: Rosenberger 1U Metal Cable Manager Panel. Category: Patch Panel. Subcategory: Networking. Price: 1,450৳.

Product: SafeNet SNPCM1UF0 1U Wire Manager. Category: Patch Panel. Subcategory: Networking. Price: 1,850৳.
",223,718505,718728
2961,recursive,"
Product: R&M R195498 CAT6 24 Port Patch Panel. Category: Patch Panel. Subcategory: Networking. Price: 1,800৳2,000৳.

Product: R&M R195422 CAT6 Wire Manager. Category: Patch Panel. Subcategory: Networking. Price: 2,100৳.
",221,718728,718949
2962,recursive,"
Product: Vention KGAB0 Cat6 UTP 24 Port Keystone Patch Panel. Category: Patch Panel. Subcategory: Networking. Price: 2,200৳.

Product: TRENDnet TC-KP24 24-Port Blank Keystone 1U Patch Panel. Category: Patch Panel. Subcategory: Networking. Price: 2,500৳.
",255,718949,719204
2963,recursive,"
Product: Hikvision DS-1CP6U24-1U Cat6 Unshielded 24-Port Patch Panel. Category: Patch Panel. Subcategory: Networking. Price: 2,600৳.

Product: CommScope 760237046 Horizontal Cable Manager. Category: Patch Panel. Subcategory: Networking. Price: 3,000৳.
",253,719204,719457
2964,recursive,"
Product: CommScope 2269025-1 Horizontal Cable Manager. Category: Patch Panel. Subcategory: Networking. Price: 3,100৳.

Product: TRENDnet TC-KP24S 24-Port Blank Keystone Shielded 1U Patch Panel. Category: Patch Panel. Subcategory: Networking. Price: 3,200৳.
",258,719457,719715
2965,recursive,"
Product: CommScope 1427632-2 Horizontal Cable Management. Category: Patch Panel. Subcategory: Networking. Price: 3,250৳.

Product: TRENDnet TC-KP24SA 24-Port Blank Angled Keystone Shielded 1U Patch Panel. Category: Patch Panel. Subcategory: Networking. Price: 6,500৳.
",269,719715,719984
2966,recursive,"
Product: D-Link NPP-AL1BLK241 24 Port without Modular Patch Panel. Category: Patch Panel. Subcategory: Networking. Price: 7,000৳.

Product: D-Link NPP-C61BLK241 24 Port Full Loaded Patch Panel. Category: Patch Panel. Subcategory: Networking. Price: 7,500৳.
",258,719984,720242
2967,recursive,"
Product: TRENDnet TC-P24C6 24-Port Cat6 Unshielded 1U Patch Panel. Category: Patch Panel. Subcategory: Networking. Price: 7,500৳.

Product: Dintek 1406-00011PC6 Cat6 24-Port Modular Patch Panel. Category: Patch Panel. Subcategory: Networking. Price: 9,900৳.
",259,720242,720501
2968,recursive,"
Product: Safenet 10-1240BK 24-Port Shielded Patch Panel with Modular. Category: Patch Panel. Subcategory: Networking. Price: 11,500৳.

Product: D-Link HTB-3100 (A+B) Fiber Optic Media Converter (Bundle With Full Set). Category: D-Link. Subcategory: Media Converter. Price: 1,850৳2,000৳.
",288,720501,720789
2969,recursive,"
Product: TP-Link MC111CS 10/100Mbps WDM Media Converter. Category: Media Converter. Subcategory: Networking. Price: 2,079৳.

Product: TP-Link TL-FC111A-20 10/100 Mbps WDM Media Converter. Category: Media Converter. Subcategory: Networking. Price: Out Of Stock.
",262,720789,721051
2970,recursive,"
Product: TP-Link TL-FC111B-20 10/100 Mbps WDM Media Converter. Category: Media Converter. Subcategory: Networking. Price: Out Of Stock.

Product: TP-Link MC112CS 10/100Mbps WDM Media Converter. Category: Media Converter. Subcategory: Networking. Price: 2,079৳.
",262,721051,721313
2971,recursive,"
Product: TP-Link TL-FC311A-20 Gigabit WDM Media Converter. Category: Media Converter. Subcategory: Networking. Price: Out Of Stock.

Product: TP-Link TL-FC311B-20 Gigabit WDM Media Converter. Category: Media Converter. Subcategory: Networking. Price: Out Of Stock.
",266,721313,721579
2972,recursive,"
Product: TP-Link TL-FC1420 14-Slot Rackmount Chassis for Media Converter Modules. Category: Media Converter. Subcategory: Networking. Price: Out Of Stock.
",156,721579,721735
2973,recursive,"
Product: TP-Link TL-MC1400 14-Slot Rackmount Chassis For Media Conversion Network. Category: Media Converter. Subcategory: Networking. Price: Out Of Stock.

Product: Vention KEFB0 Network Cable Tester. Category: Cable Tester. Subcategory: Networking. Price: 850৳.
",265,721735,722000
2974,recursive,"
Product: Noyafa NF-468B Network Cable Tester. Category: Cable Tester. Subcategory: Networking. Price: 1,300৳1,500৳.

Product: TRENDnet TC-NT2 Network Cable Tester. Category: Cable Tester. Subcategory: Networking. Price: 5,300৳5,600৳.
",235,722000,722235
2975,recursive,"
Product: Noyafa NF-8209S Advanced Network Cable Tracker. Category: Cable Tester. Subcategory: Networking. Price: 8,900৳.

Product: Solitine Optical Power Meter with VFL & R45 Tester. Category: Cable Tester. Subcategory: Networking. Price: Out Of Stock.
",254,722235,722489
2976,recursive,"
Product: ORICO TXJ004 Multi-functional Wire Tester. Category: Cable Tester. Subcategory: Networking. Price: Out Of Stock.

Product: ORICO TXJ006 Multi-functional Wire Tracer. Category: Cable Tester. Subcategory: Networking. Price: Out Of Stock.
",246,722489,722735
2977,recursive,"
Product: Noyafa NF-488 PoE Cable Tester. Category: Cable Tester. Subcategory: Networking. Price: Out Of Stock.

Product: Noyafa NF-8601W Cable Length Tester with PoE Ping Functions. Category: Cable Tester. Subcategory: Networking. Price: Out Of Stock.
",253,722735,722988
2978,recursive,"
Product: CommScope FPS-BS-1P-W 1-Port Faceplate Kit. Category: Faceplate. Subcategory: Networking. Price: Out Of Stock.

Product: CommScope M10CF 1-Port Faceplate Kit. Category: Faceplate. Subcategory: Networking. Price: Out Of Stock.
",236,722988,723224
2979,recursive,"
Product: Panduit Pan-Net CFPUKS2SIWY Dual Port Faceplate. Category: Faceplate. Subcategory: Networking. Price: Out Of Stock.

Product: Hikvision DS-1FPA1 1-Port Faceplate. Category: Faceplate. Subcategory: Networking. Price: Out Of Stock.
",240,723224,723464
2980,recursive,"
Product: Hikvision DS-1FPA2 2-Port Faceplate. Category: Faceplate. Subcategory: Networking. Price: Out Of Stock.

Product: Red Hat Enterprise Linux Server Standard (Annual Subscription). Category: Red Hat. Subcategory: Operating System. Price: Call for Price.
",261,723464,723725
2981,recursive,"
Product: Red Hat Enterprise Linux Server Premium (Annual Subscription). Category: Red Hat. Subcategory: Operating System. Price: Call for Price.

Product: Windows Server 2025 - Device CAL. Category: Microsoft Windows. Subcategory: Operating System. Price: 5,480৳.
",265,723725,723990
2982,recursive,"
Product: Windows Server 2025 - User CAL. Category: Microsoft Windows. Subcategory: Operating System. Price: 7,020৳.

Product: Microsoft Windows 10 Professional 64bit. Category: Microsoft Windows. Subcategory: Operating System. Price: 10,500৳18,500৳.
",251,723990,724241
2983,recursive,"
Product: Microsoft Windows Server 2025 Remote Desktop Services - 1 Device CAL (CSP Perpetual). Category: Microsoft Windows. Subcategory: Operating System. Price: 19,850৳.

Product: Microsoft Windows 11 Professional. Category: Microsoft Windows. Subcategory: Operating System. Price: 20,200৳.
",293,724241,724534
2984,recursive,"
Product: Microsoft Windows Server Standard 2025 - 2 Core License Pack. Category: Microsoft Windows. Subcategory: Operating System. Price: 20,640৳.
",148,724534,724682
2985,recursive,"
Product: Windows GGWA - Windows 11 Professional - Legalization GetGenuine (CSP Perpetual). Category: Microsoft Windows. Subcategory: Operating System. Price: 25,875৳.
",168,724682,724850
2986,recursive,"
Product: Microsoft Windows Server 2019 Standard OEI DVD. Category: Microsoft Windows. Subcategory: Operating System. Price: 57,000৳.

Product: Windows Server 2025 Datacenter - 2 Core (CSP Perpetual). Category: Microsoft Windows. Subcategory: Operating System. Price: 118,795৳.
",278,724850,725128
2987,recursive,"
Product: Windows Server 2025 Standard - 16 Core License Pack. Category: Microsoft Windows. Subcategory: Operating System. Price: 165,140৳.

Product: Windows Server 2025 Datacenter - 16 Core License Pack. Category: Microsoft Windows. Subcategory: Operating System. Price: 950,640৳.
",282,725128,725410
2988,recursive,"
Product: Microsoft SQL Server 2022 Standard (CSP Perpetual). Category: Database Server Solution. Subcategory: Software. Price: 135,000৳.

Product: Microsoft SQL Server 2022 Standard 2 Core License Pack (CSP Perpetual). Category: Database Server Solution. Subcategory: Software. Price: 505,000৳.
",296,725410,725706
2989,recursive,"
Product: Microsoft SQL Server 2022 Enterprise 2 Core License Pack (CSP Perpetual). Category: Database Server Solution. Subcategory: Software. Price: 2,350,000৳.

Product: Bijoy Bayanno 2025 Bangla Typing Software For Windows. Category: Software. Price: 450৳.
",260,725706,725966
2990,recursive,"
Product: ESET Internet Security One User (Only Key). Category: Software. Price: 650৳750৳.

Product: ESET Home Security Essential Internet Security for 1 User 1 Year. Category: Software. Price: 750৳.

Product: ESET Internet Security 1 User 1 Year. Category: Software. Price: 750৳.
",281,725966,726247
2991,recursive,"
Product: ESET Internet Security 3 User for 1 Year. Category: Software. Price: 1,800৳2,099৳.

Product: Microsoft 365 F1 (1 Year Subscription). Category: Software. Price: 2,995৳.

Product: Microsoft 365 Business Basic (1 Year Subscription). Category: Software. Price: 4,450৳.
",275,726247,726522
2992,recursive,"
Product: Bijoy Ekattor For Mac Bangla Software. Category: Software. Price: 5,000৳.

Product: Office 365 F3 (1 Year Subscription). Category: Software. Price: 5,250৳.

Product: ESET Small Business Security (1 Server, 5 Windows PC). Category: Software. Price: 5,599৳.
",266,726522,726788
2993,recursive,"
Product: Microsoft 365 Personal For 1 User (01 Year Subscription). Category: Software. Price: 7,500৳.

Product: Adobe InCopy CC for Teams. Category: Software. Price: 9,295৳.

Product: Microsoft Exchange Server 2019 Standard Device CAL. Category: Software. Price: 9,565৳.
",272,726788,727060
2994,recursive,"
Product: ESET Small Business Security (Server) for 10 users. Category: Software. Price: 9,999৳.

Product: Microsoft 365 F3 (1 Year Subscription). Category: Software. Price: 10,390৳.

Product: Microsoft Exchange Server 2019 Standard User CAL. Category: Software. Price: 12,370৳.
",279,727060,727339
2995,recursive,"
Product: Microsoft Office Professional Plus 2021 English. Category: Software. Price: 13,500৳.

Product: Office 365 Enterprise E1 (1 Year Subscription). Category: Software. Price: 14,055৳.
",189,727339,727528
2996,recursive,"
Product: Office Home and Business 2024 English APAC EM Medialess. Category: Office Application. Subcategory: Software. Price: 35,000৳.

Product: Office LTSC Standard 2021. Category: Office Application. Subcategory: Software. Price: 61,720৳.
",242,727528,727770
2997,recursive,"
Product: Visual Studio Professional 2022. Category: Office Application. Subcategory: Software. Price: 65,500৳.

Product: Office LTSC Professional Plus 2021. Category: Office Application. Subcategory: Software. Price: 75,000৳.
",227,727770,727997
2998,recursive,"
Product: Microsoft 365 Family For 6 User (1 Year Subscription). Category: Office Application. Subcategory: Software. Price: Up Coming.

Product: Microsoft Office Home and Business 2016 for Mac. Category: Office Application. Subcategory: Software. Price: Out Of Stock.
",269,727997,728266
2999,recursive,"
Product: Microsoft Office Home and Business 2019. Category: Office Application. Subcategory: Software. Price: Out Of Stock.

Product: Microsoft 365 Apps for Business (1 Year Subscription). Category: Cloud Solutions. Subcategory: Software. Price: 14,500৳.
",256,728266,728522
3000,recursive,"
Product: Microsoft 365 Business Standard (1 Year Subscription). Category: Cloud Solutions. Subcategory: Software. Price: 14,800৳.

Product: Microsoft 365 Apps for Enterprise (1 Year Subscription). Category: Cloud Solutions. Subcategory: Software. Price: 15,080৳.
",264,728522,728786
3001,recursive,"
Product: Microsoft 365 Business Premium (1 Year Subscription). Category: Cloud Solutions. Subcategory: Software. Price: 31,365৳.

Product: Office 365 Enterprise E3 (1 Year Subscription). Category: Cloud Solutions. Subcategory: Software. Price: 32,325৳.
",254,728786,729040
3002,recursive,"
Product: Microsoft 365 Enterprise E3 (1 Year Subscription). Category: Cloud Solutions. Subcategory: Software. Price: 45,620৳.

Product: Office 365 Enterprise E5 (1 Year Subscription). Category: Cloud Solutions. Subcategory: Software. Price: 52,500৳.
",251,729040,729291
3003,recursive,"
Product: Microsoft 365 Enterprise E5 (1 Year Subscription). Category: Cloud Solutions. Subcategory: Software. Price: 72,230৳.

Product: Microsoft Exchange Server 2019 Standard. Category: Mail Server Solution. Subcategory: Software. Price: 106,740৳.
",250,729291,729541
3004,recursive,"
Product: Microsoft Exchange Server 2019 Enterprise. Category: Mail Server Solution. Subcategory: Software. Price: 532,000৳.

Product: ESET NOD32 Antivirus One User 1 Year. Category: For Home User. Subcategory: Antivirus. Price: Out Of Stock.
",243,729541,729784
3005,recursive,"
Product: ESET Cyber Security Pro Internet Security for Mac. Category: For Home User. Subcategory: Antivirus. Price: Out Of Stock.

Product: ESET Internet Security 2 User for 1 Year. Category: For Home User. Subcategory: Antivirus. Price: Out Of Stock.
",253,729784,730037
3006,recursive,"
Product: ESET Internet Security Single User with 03 Years License. Category: For Home User. Subcategory: Antivirus. Price: Out Of Stock.

Product: ESET Internet Security 5 User 1 Year. Category: For Home User. Subcategory: Antivirus. Price: Out Of Stock.
",256,730037,730293
3007,recursive,"
Product: ESET Small Business Security (Server) for 15 users. Category: Antivirus. Subcategory: Software. Price: 14,999৳.

Product: ESET Small Business Security (Server) for 25 users. Category: Antivirus. Subcategory: Software. Price: 25,999৳.
",244,730293,730537
3008,recursive,"
Product: Eset Xopero Backup and Recovery Software. Category: Antivirus. Subcategory: Software. Price: Call for Price.

Product: Eset Endpoint Encryption (Volume 05 to As per Customer Requirement). Category: Antivirus. Subcategory: Software. Price: Call for Price.
",265,730537,730802
3009,recursive,"
Product: ESET Protect Entry E-License Subscription. Category: Antivirus. Subcategory: Software. Price: Call for Price.

Product: Eset Endpoint Security E-License (Volume 05 to As per Customer Requirement). Category: Antivirus. Subcategory: Software. Price: Call for Price.
",274,730802,731076
3010,recursive,"
Product: ESET Home Office Security Pack New 1-year 10-user. Category: Antivirus. Subcategory: Software. Price: Out Of Stock.

Product: Adobe Acrobat Standard DC for Teams. Category: Adobe. Subcategory: Software. Price: 25,470৳.
",229,731076,731305
3011,recursive,"
Product: Adobe Fresco CC for Teams. Category: Adobe. Subcategory: Software. Price: 36,695৳.

Product: Adobe Acrobat Pro DC for Teams. Category: Adobe. Subcategory: Software. Price: 38,000৳.

Product: Adobe XD CC for Teams. Category: Adobe. Subcategory: Software. Price: 42,785৳.
",280,731305,731585
3012,recursive,"
Product: Adobe InDesign CC for Teams. Category: Adobe. Subcategory: Software. Price: 56,000৳.

Product: Adobe Audition CC - Pro for Teams. Category: Adobe. Subcategory: Software. Price: 56,000৳.

Product: Adobe Dimension for Teams. Category: Adobe. Subcategory: Software. Price: 56,000৳.
",289,731585,731874
3013,recursive,"
Product: Adobe Animate CC - Pro for Teams. Category: Adobe. Subcategory: Software. Price: 57,280৳.

Product: Adobe Acrobat Sign for Business. Category: Adobe. Subcategory: Software. Price: 60,710৳.

Product: Adobe Premiere Pro for Teams. Category: Adobe. Subcategory: Software. Price: 62,000৳.
",295,731874,732169
3014,recursive,"
Product: Adobe After Effects CC for Teams. Category: Adobe. Subcategory: Software. Price: 62,000৳.

Product: Adobe Photoshop CC for Teams. Category: Adobe. Subcategory: Software. Price: 64,000৳.

Product: Adobe Illustrator CC for Teams. Category: Adobe. Subcategory: Software. Price: 64,000৳.
",294,732169,732463
3015,recursive,"
Product: Adobe Dreamweaver CC for Teams. Category: Adobe. Subcategory: Software. Price: 66,715৳.

Product: Adobe Lightroom CC - Pro for Teams. Category: Adobe. Subcategory: Software. Price: 66,715৳.

Product: Adobe FrameMaker for Teams. Category: Adobe. Subcategory: Software. Price: 83,750৳.
",294,732463,732757
3016,recursive,"
Product: Adobe Creative Cloud for Teams All Apps. Category: Adobe. Subcategory: Software. Price: 150,975৳.

Product: Adobe Substance 3D Collection for Teams. Category: Adobe. Subcategory: Software. Price: 186,125৳.
",216,732757,732973
3017,recursive,"
Product: AnyDesk Solo License 1 User 1 Year. Category: AnyDesk. Subcategory: Software. Price: Up Coming.

Product: AnyDesk Advanced License 2 User 1 Year. Category: AnyDesk. Subcategory: Software. Price: Up Coming.
",216,732973,733189
3018,recursive,"
Product: AnyDesk Standard License 1 User 1 Year. Category: AnyDesk. Subcategory: Software. Price: Up Coming.

Product: Autodesk AutoCAD LT 2025 Commercial New Single-user ELD - Annual Subscription. Category: AutoDesk. Subcategory: Software. Price: 77,970৳.
",258,733189,733447
3019,recursive,"
Product: Autodesk InfraWorks 2025 Commercial New Single-user ELD - Annual Subscription. Category: AutoDesk. Subcategory: Software. Price: 240,000৳.

Product: Autodesk 3ds Max 2025 Commercial New Single-user ELD - Annual Subscription. Category: AutoDesk. Subcategory: Software. Price: 273,610৳.
",295,733447,733742
3020,recursive,"
Product: Autodesk Maya 2025 Commercial New Single-user ELD - Annual Subscription. Category: AutoDesk. Subcategory: Software. Price: 273,610৳.
",143,733742,733885
3021,recursive,"
Product: AutoCAD - including specialized toolsets AD Commercial New Single-user ELD Annual Subscription. Category: AutoDesk. Subcategory: Software. Price: 285,695৳.
",166,733885,734051
3022,recursive,"
Product: Autodesk Media & Entertainment Collection Single-user ELD - Annual Subscription. Category: AutoDesk. Subcategory: Software. Price: 381,295৳.

Product: Autodesk Civil 3D 2025 Commercial New Single-user ELD - Annual Subscription. Category: AutoDesk. Subcategory: Software. Price: 392,280৳.
",298,734051,734349
3023,recursive,"
Product: Autodesk Product Design & Manufacturing Collection Single-user ELD - Annual Subscription. Category: AutoDesk. Subcategory: Software. Price: 460,410৳.
",160,734349,734509
3024,recursive,"
Product: Autodesk Architecture Engineering & Construction Collection Single-user ELD - Annual Subscription. Category: AutoDesk. Subcategory: Software. Price: 502,165৳.
",169,734509,734678
3025,recursive,"
Product: VMware vSphere 6 Essentials Plus Kit for 3 hosts (Max 2 processors per host). Category: VMware. Subcategory: Software. Price: Call for Price.

Product: ASUS TS100-E11-PI4 Intel Xeon E-2336 6 Core Tower Server. Category: ASUS. Subcategory: Server. Price: Up Coming.
",275,734678,734953
3026,recursive,"
Product: ASUS TS100-E11-PI4 Intel Xeon E-2378 8 Core Tower Server. Category: ASUS. Subcategory: Server. Price: Up Coming.

Product: ASUS TS100-E11-PI4 Intel Xeon E-2334 4 Core Tower Server. Category: ASUS. Subcategory: Server. Price: Out Of Stock.
",249,734953,735202
3027,recursive,"
Product: Cisco UCS C240 M6 2U SFF 12 Core Rack Server. Category: Cisco. Subcategory: Server. Price: 710,000৳.

Product: Cisco UCS C240 M6 2U SFF 16 Core Rack Server. Category: Cisco. Subcategory: Server. Price: 820,000৳.
",222,735202,735424
3028,recursive,"
Product: Cisco UCS C240 M6 26 Core Rack Server. Category: Cisco. Subcategory: Server. Price: 2,400,000৳.

Product: Cisco UCS C240 M6 2U SFF Rack Server (10 Core). Category: Cisco. Subcategory: Server. Price: Call for Price.
",225,735424,735649
3029,recursive,"
Product: Dell PowerEdge T150 Tower Server. Category: Dell. Subcategory: Server. Price: 230,000৳.

Product: Dell PowerEdge T160 Tower Server. Category: Dell. Subcategory: Server. Price: 260,000৳.

Product: Dell PowerEdge T360 Tower Server. Category: Dell. Subcategory: Server. Price: 435,000৳.
",294,735649,735943
3030,recursive,"
Product: Dell PowerEdge T550 Tower Server. Category: Dell. Subcategory: Server. Price: Call for Price.

Product: Dell PowerEdge R450 Intel Xeon Silver 4309Y 64GB RAM 1U Rack Server. Category: Dell. Subcategory: Server. Price: 724,000৳.
",237,735943,736180
3031,recursive,"
Product: Dell PowerEdge R750xs 4314 Rack Server. Category: Dell. Subcategory: Server. Price: 833,000৳.

Product: Dell PowerEdge R760xs Intel Xeon Silver 4510 Rack Server. Category: Dell. Subcategory: Server. Price: 850,000৳.
",226,736180,736406
3032,recursive,"
Product: Dell PowerEdge R760xs Intel Xeon Silver 4514Y Rack Server. Category: Dell. Subcategory: Server. Price: 1,000,000৳.

Product: Dell PowerEdge R750 Intel Xeon Gold 5320 Rack Server. Category: Dell. Subcategory: Server. Price: Pre Order.
",244,736406,736650
3033,recursive,"
Product: Dell PowerEdge R750 Intel Xeon Silver 4314 Rack Server. Category: Dell. Subcategory: Server. Price: Call for Price.

Product: Dell PowerEdge R750 Intel Xeon Silver 4316 Rack Server. Category: Dell. Subcategory: Server. Price: Call for Price.
",252,736650,736902
3034,recursive,"
Product: Dell PowerEdge R760xs Intel Xeon Silver 4410Y Rack Server. Category: Dell. Subcategory: Server. Price: Call for Price.

Product: Dell PowerEdge R350 Intel Xeon E-2356G Rack Server. Category: Dell. Subcategory: Server. Price: Call for Price.
",251,736902,737153
3035,recursive,"
Product: Dell PowerEdge R660 Intel Xeon Gold 6426Y Rack Server. Category: Dell. Subcategory: Server. Price: Call for Price.

Product: Dell PowerEdge R660xs Intel Xeon Silver 4410Y Rack Server. Category: Dell. Subcategory: Server. Price: Call for Price.
",254,737153,737407
3036,recursive,"
Product: Dell PowerEdge R760 Intel Xeon Silver 4416+ Rack Server. Category: Dell. Subcategory: Server. Price: Call for Price.

Product: Dell PowerEdge R760xa Intel Xeon Gold 6442Y GPU Rack Server. Category: Dell. Subcategory: Server. Price: Call for Price.
",258,737407,737665
3037,recursive,"
Product: Dell PowerEdge R760xa Intel Xeon Platinum 8468 Rack GPU Server. Category: Dell. Subcategory: Server. Price: Call for Price.

Product: Dell PowerEdge R760xa Intel Xeon Silver 4514Y Rack GPU Server. Category: Dell. Subcategory: Server. Price: Call for Price.
",267,737665,737932
3038,recursive,"
Product: Dell PowerEdge R360 Xeon E-2436 Rack Server. Category: Dell. Subcategory: Server. Price: Call for Price.

Product: HPE ProLiant MicroServer Gen10 Plus v2 Ultra Micro Tower Server. Category: HPE. Subcategory: Server. Price: 185,000৳200,000৳.
",251,737932,738183
3039,recursive,"
Product: HPE ProLiant ML30 Gen10 Plus Tower Server. Category: HPE. Subcategory: Server. Price: 190,000৳215,000৳.

Product: HPE ProLiant ML30 Gen 11 4U Tower Server. Category: HPE. Subcategory: Server. Price: 280,000৳.
",219,738183,738402
3040,recursive,"
Product: HPE ProLiant DL20 Gen10 Plus Rack Server. Category: HPE. Subcategory: Server. Price: 382,500৳400,000৳.

Product: HPE ProLiant DL380 Generation 10 PLUS 64GB RAM 3 X HPE 1.2TB HDD Server. Category: HPE. Subcategory: Server. Price: Call for Price.
",255,738402,738657
3041,recursive,"
Product: HPE ProLiant DL380 Gen11 Intel Xeon Rack GPU Server. Category: HPE. Subcategory: Server. Price: Call for Price.

Product: HPE ProLiant DL380 Gen11 Intel Xeon Silver Rack Server. Category: HPE. Subcategory: Server. Price: Call for Price.
",247,738657,738904
3042,recursive,"
Product: HPE ProLiant DL380 Generation 10 PLUS 2 x Intel Xeon-Silver 4310 64GB RAM 3 x HPE 2.4TB HDD Server. Category: HPE. Subcategory: Server. Price: Call for Price.
",169,738904,739073
3043,recursive,"
Product: HPE Proliant DL380 Gen 10 Plus 64GB 2x Intel Xeon Silver 4314 2U Rack Server. Category: HPE. Subcategory: Server. Price: Call for Price.

Product: HPE ProLiant DL380 Gen 10 Plus 2x Intel Xeon Gold 5317 2U Rack Server. Category: HPE. Subcategory: Server. Price: Call for Price.
",287,739073,739360
3044,recursive,"
Product: HPE ProLiant DL380 Gen 10 Plus 2x Intel Xeon Gold 6326 2U Rack Server. Category: HPE. Subcategory: Server. Price: Call for Price.
",140,739360,739500
3045,recursive,"
Product: HPE ProLiant DL380 Generation 10 PLUS 2 x Intel Xeon-Silver 4314 64GB RAM 3 x HPE 2.4TB HDD Server. Category: HPE. Subcategory: Server. Price: Out Of Stock.

Product: Asus ESC8000A-E13P AMD EPYC 9005 GPU Server. Category: GPU Server. Subcategory: Server & Storage. Price: Pre Order.
",293,739500,739793
3046,recursive,"
Product: Asus ESC N8A-E12 AMD EPYC 9004 GPU Server. Category: GPU Server. Subcategory: Server & Storage. Price: Pre Order.

Product: Asus ESC4000-E11 5th Gen Intel Xeon Scalable GPU Server and ASUS ASMB11-iKVM. Category: GPU Server. Subcategory: Server & Storage. Price: Pre Order.
",283,739793,740076
3047,recursive,"
Product: Asus ESC N8-E11/ESC N8-E11V 5th Gen Intel Xeon Scalable GPU Server. Category: GPU Server. Subcategory: Server & Storage. Price: Pre Order.
",149,740076,740225
3048,recursive,"
Product: Asus ESC8000-E11 5th Gen Intel Xeon Scalable GPU Server and ASUS ASMB11-iKVM. Category: GPU Server. Subcategory: Server & Storage. Price: Pre Order.
",159,740225,740384
3049,recursive,"
Product: Asus ESC8000-E11P 5th Gen Intel Xeon Scalable GPU Server and ASUS ASMB11-iKVM. Category: GPU Server. Subcategory: Server & Storage. Price: Pre Order.
",160,740384,740544
3050,recursive,"
Product: Asus ESC8000A-E12 AMD EPYC 9004 GPU Server and ASUS ASMB11-iKVM. Category: GPU Server. Subcategory: Server & Storage. Price: Pre Order.

Product: Asus ESC8000A-E12P AMD EPYC 9004 GPU Server and ASUS ASMB11-iKVM. Category: GPU Server. Subcategory: Server & Storage. Price: Pre Order.
",293,740544,740837
3051,recursive,"
Product: Asus ESC4000A-E12 AMD EPYC 9004 GPU Server and ASUS ASMB11-iKVM. Category: GPU Server. Subcategory: Server & Storage. Price: Pre Order.
",146,740837,740983
3052,recursive,"
Product: Asus ESC4000-E10S 3rd Gen Intel Xeon Scalable GPU Server and ASUS ASMB10-iKVM. Category: GPU Server. Subcategory: Server & Storage. Price: Pre Order.
",160,740983,741143
3053,recursive,"
Product: Asus ESC4000A-E11 AMD EPYC 7003 & 7002 GPU Server and ASUS ASMB10-iKVM. Category: GPU Server. Subcategory: Server & Storage. Price: Pre Order.

Product: Asus ESC8000A-E11 AMD EPYC 7003 GPU Server and ASUS ASMB10-iKVM. Category: GPU Server. Subcategory: Server & Storage. Price: Pre Order.
",299,741143,741442
3054,recursive,"
Product: Asus ESC N4A-E11 AMD EPYC 7003 GPU Server and ASUS ASMB10-iKVM. Category: GPU Server. Subcategory: Server & Storage. Price: Pre Order.
",145,741442,741587
3055,recursive,"
Product: Asus ESC4000-E10 3rd Gen Intel Xeon Scalable GPU Server and ASUS ASMB10-iKVM. Category: GPU Server. Subcategory: Server & Storage. Price: Pre Order.
",159,741587,741746
3056,recursive,"
Product: Asus ESC8000 G4/10G 2nd Gen Intel Xeon Scalable GPU Server. Category: GPU Server. Subcategory: Server & Storage. Price: Pre Order.

Product: Asus ESC8000 G4 2nd Gen Intel Xeon Scalable GPU Server. Category: GPU Server. Subcategory: Server & Storage. Price: Pre Order.
",278,741746,742024
3057,recursive,"
Product: DateUp 6 Port PDU for Server Rack. Category: Server & Storage. Price: 3,000৳.

Product: DateUp 8 Port PDU for Server Rack. Category: Server & Storage. Price: 3,200৳.

Product: DateUp 8 Port PDU With 2 Meter Cable for Server Rack. Category: Server & Storage. Price: 3,500৳.
",283,742024,742307
3058,recursive,"
Product: DATEUP 6U Server Rack (600x450x370). Category: Server & Storage. Price: 11,000৳.

Product: Toten 6U 600 x 450mm Server Rack. Category: Server & Storage. Price: 11,500৳.

Product: Toten 9U 600 x 450mm Server Rack. Category: Server & Storage. Price: 12,500৳.
",267,742307,742574
3059,recursive,"
Product: DATEUP 9U Server Rack (600x450x501). Category: Server & Storage. Price: 12,500৳.

Product: Cote 6U 600 x 450mm Server Rack. Category: Server & Storage. Price: 13,000৳.

Product: DATEUP 6U Server Rack (600x600x370). Category: Server & Storage. Price: 13,000৳.
",269,742574,742843
3060,recursive,"
Product: Safenet 6U Wall Mount Network Cabinet with PDU. Category: Server & Storage. Price: 13,500৳.

Product: DATEUP 9U Server Rack (600x600x501). Category: Server & Storage. Price: 13,500৳.

Product: Toten 12U 600 x 450mm Server Rack. Category: Server & Storage. Price: 14,500৳.
",282,742843,743125
3061,recursive,"
Product: Safenet 9U Wall Mount Network Cabinet with PDU. Category: Server & Storage. Price: 14,500৳.

Product: Cote 6U 600 x 600mm Server Rack. Category: Server & Storage. Price: 14,500৳.

Product: Cote 9U 600 x 450mm Server Rack. Category: Server & Storage. Price: 14,500৳.
",276,743125,743401
3062,recursive,"
Product: Toten 6U 600 x 600mm Server Rack. Category: Server & Storage. Price: 14,500৳.

Product: Toten 9U 600 x 600mm Server Rack. Category: Server & Storage. Price: 15,000৳.

Product: DATEUP 12U Server Rack (600x450x635). Category: Server & Storage. Price: 15,000৳.
",268,743401,743669
3063,recursive,"
Product: Cote 9U 600 x 600mm Server Rack. Category: Server & Storage. Price: 15,500৳.

Product: DATEUP 12U Server Rack (600x600x635). Category: Server & Storage. Price: Out Of Stock.
",184,743669,743853
3064,recursive,"
Product: Safenet 12U Wall Mount Network Cabinet with PDU. Category: Safenet. Subcategory: Server Rack. Price: 18,000৳.

Product: Safenet 15U Wall Mount Network Cabinet with PDU. Category: Safenet. Subcategory: Server Rack. Price: 20,500৳.
",240,743853,744093
3065,recursive,"
Product: Safenet 42U Tempered Glass Door Floor Standing Server Cabinet. Category: Safenet. Subcategory: Server Rack. Price: 68,000৳.

Product: Safenet 42U Perforated Floor Standing Data Center Cabinet. Category: Safenet. Subcategory: Server Rack. Price: 120,000৳.
",265,744093,744358
3066,recursive,"
Product: Safenet 42U-XL Perforated Floor Standing Data Center Cabinet. Category: Safenet. Subcategory: Server Rack. Price: 125,000৳.

Product: Safenet 42U-XL Tempered Glass Door Floor Standing Server Cabinet. Category: Safenet. Subcategory: Server Rack. Price: 128,000৳.
",272,744358,744630
3067,recursive,"
Product: Safenet 32U 2-Post Open Frame Floor Standing Rack. Category: Safenet. Subcategory: Server Rack. Price: Out Of Stock.

Product: Safenet 32U 4-Post Open Frame Floor Standing Rack. Category: Safenet. Subcategory: Server Rack. Price: Out Of Stock.
",254,744630,744884
3068,recursive,"
Product: Safenet 42U 4-Post Open Frame Floor Standing Rack. Category: Safenet. Subcategory: Server Rack. Price: Out Of Stock.

Product: Safenet 22U Tempered Glass Door Floor Standing Server Cabinet. Category: Safenet. Subcategory: Server Rack. Price: Out Of Stock.
",266,744884,745150
3069,recursive,"
Product: Safenet 22U-XL Tempered Glass Door Floor Standing Server Cabinet. Category: Safenet. Subcategory: Server Rack. Price: Out Of Stock.

Product: Safenet 32U Tempered Glass Door Floor Standing Server Cabinet. Category: Safenet. Subcategory: Server Rack. Price: Out Of Stock.
",281,745150,745431
3070,recursive,"
Product: Cote 12U 600 x 600mm Server Rack. Category: Cote. Subcategory: Server Rack. Price: 16,000৳.

Product: Cote 15U 600 x 600mm Server Rack. Category: Cote. Subcategory: Server Rack. Price: 18,000৳.
",204,745431,745635
3071,recursive,"
Product: Cote 22U 600 x 1000mm Server Rack. Category: Cote. Subcategory: Server Rack. Price: 50,000৳.

Product: Cote 32U 600 x 1000mm Server Rack. Category: Cote. Subcategory: Server Rack. Price: 60,000৳.
",206,745635,745841
3072,recursive,"
Product: Cote 42U 800 x 1000mm Server Rack. Category: Cote. Subcategory: Server Rack. Price: 80,000৳.

Product: Cote 42U 600 x 1070mm Server Rack. Category: Cote. Subcategory: Server Rack. Price: 88,000৳.
",206,745841,746047
3073,recursive,"
Product: HP Z2 G9 SFF Core i7 14th Gen Workstation. Category: Workstation. Subcategory: Server & Storage. Price: 190,000৳.

Product: HP Z1 G9R Core i7 14th Gen Tower Desktop PC. Category: Workstation. Subcategory: Server & Storage. Price: 255,500৳.
",250,746047,746297
3074,recursive,"
Product: HP Z2 G9 Core i9 14th Gen Tower Workstation. Category: Workstation. Subcategory: Server & Storage. Price: 305,000৳.

Product: HP Z4 G5 Tower Intel Xeon W5-2445 Workstation. Category: Workstation. Subcategory: Server & Storage. Price: 540,000৳.
",254,746297,746551
3075,recursive,"
Product: Dell Precision 3420 Workstation. Category: Workstation. Subcategory: Server & Storage. Price: Call for Price.

Product: Dell Precision 5820 Tower Workstation. Category: Workstation. Subcategory: Server & Storage. Price: Call for Price.
",246,746551,746797
3076,recursive,"
Product: Dell Precision 7820 Tower Workstation. Category: Workstation. Subcategory: Server & Storage. Price: Call for Price.

Product: Dell Precision 7920 Tower Workstation. Category: Workstation. Subcategory: Server & Storage. Price: Call for Price.
",252,746797,747049
3077,recursive,"
Product: Dell Precision 7920 Rack Workstation. Category: Workstation. Subcategory: Server & Storage. Price: Call for Price.

Product: Dell Precision R3930 Rack Workstation. Category: Workstation. Subcategory: Server & Storage. Price: Call for Price.
",251,747049,747300
3078,recursive,"
Product: Lenovo ThinkStation P620 Ryzen Threadripper PRO 3955WX Workstation. Category: Workstation. Subcategory: Server & Storage. Price: Call for Price.
",155,747300,747455
3079,recursive,"
Product: Lenovo ThinkStation P3 Tower Core i7 13th Gen Workstation. Category: Workstation. Subcategory: Server & Storage. Price: Call for Price.

Product: HP Z2 Tower G9 Core i9 12th Gen Workstation. Category: Workstation. Subcategory: Server & Storage. Price: Call for Price.
",278,747455,747733
3080,recursive,"
Product: HP Z4 G5 Tower Intel Xeon W 2425 Workstation. Category: Workstation. Subcategory: Server & Storage. Price: Call for Price.

Product: Dell Precision 3660 Tower CTO BASE Workstation. Category: Workstation. Subcategory: Server & Storage. Price: Call for Price.
",268,747733,748001
3081,recursive,"
Product: Lenovo ThinkStation P340 Core i5 10th Gen Tower Workstation. Category: Workstation. Subcategory: Server & Storage. Price: Call for Price.

Product: Lenovo ThinkStation P340 Core i7 10th Gen Tower Workstation. Category: Workstation. Subcategory: Server & Storage. Price: Call for Price.
",296,748001,748297
3082,recursive,"
Product: Lenovo ThinkStation P340 Tower Workstation. Category: Workstation. Subcategory: Server & Storage. Price: Call for Price.

Product: Lenovo ThinkStation P350 Tower Workstation. Category: Workstation. Subcategory: Server & Storage. Price: Call for Price.
",262,748297,748559
3083,recursive,"
Product: Dell Precision 5860 Tower Workstation. Category: Workstation. Subcategory: Server & Storage. Price: Up Coming.

Product: Toten 15U 600 x 600mm Server Rack. Category: Toten. Subcategory: Server Rack. Price: 18,500৳.
",225,748559,748784
3084,recursive,"
Product: Toten 32U 600 x 600mm Server Rack. Category: Toten. Subcategory: Server Rack. Price: 40,000৳.

Product: Toten 22U 600 x 1000mm Server Rack. Category: Toten. Subcategory: Server Rack. Price: 43,000৳.
",209,748784,748993
3085,recursive,"
Product: Toten 32U 600 x 1000mm Server Rack. Category: Toten. Subcategory: Server Rack. Price: 50,000৳.

Product: Toten 42U 600 x 1000mm Server Rack. Category: Toten. Subcategory: Server Rack. Price: 59,000৳.
",210,748993,749203
3086,recursive,"
Product: Toten 4U 600 x 450mm Server Rack. Category: Toten. Subcategory: Server Rack. Price: Up Coming.

Product: Toten 32U 600 x 800mm Server Rack. Category: Toten. Subcategory: Server Rack. Price: Up Coming.
",211,749203,749414
3087,recursive,"
Product: Toten 42U 800 x 1000mm Server Rack. Category: Toten. Subcategory: Server Rack. Price: Up Coming.

Product: Toten 12U 600 x 600mm Server Rack. Category: Toten. Subcategory: Server Rack. Price: Out Of Stock.
",216,749414,749630
3088,recursive,"
Product: Toten 22U 600 x 600mm Server Rack. Category: Toten. Subcategory: Server Rack. Price: Out Of Stock.

Product: Toten 22U 600 x 800mm Server Rack. Category: Toten. Subcategory: Server Rack. Price: Out Of Stock.
",218,749630,749848
3089,recursive,"
Product: HP Z2 Tower G9 Core i7 13th Gen 16GB RAM Workstation. Category: HP. Subcategory: Workstation. Price: Out Of Stock.

Product: DATEUP 15U Server Rack (600x450x855). Category: DateUP. Subcategory: Server Rack. Price: 16,000৳.
",233,749848,750081
3090,recursive,"
Product: DATEUP 15U Server Rack (600x600x855). Category: DateUP. Subcategory: Server Rack. Price: 17,000৳.

Product: DateUp 32U Glass Door Server Rack (800x1000x1610). Category: DateUP. Subcategory: Server Rack. Price: 52,000৳.
",229,750081,750310
3091,recursive,"
Product: DateUp 42U Glass Door Server Rack (600x800x2055). Category: DateUP. Subcategory: Server Rack. Price: 52,500৳.

Product: DateUp 42U Glass Door Server Rack (600x1000x2055). Category: DateUP. Subcategory: Server Rack. Price: 56,000৳.
",241,750310,750551
3092,recursive,"
Product: DateUp 42U Mesh Door Server Rack (600x1000x2055). Category: DateUP. Subcategory: Server Rack. Price: 59,000৳.

Product: DateUp 42U Glass Door Server Rack (800x1000x2055). Category: DateUP. Subcategory: Server Rack. Price: 60,000৳.
",241,750551,750792
3093,recursive,"
Product: DateUp 42U Mesh Door Server Rack (800x1000x2055). Category: DateUP. Subcategory: Server Rack. Price: 65,000৳.

Product: DateUp 22U Glass Door Server Rack (600mmx800x1610). Category: DateUP. Subcategory: Server Rack. Price: Up Coming.
",244,750792,751036
3094,recursive,"
Product: DateUp 32U Server Rack (600x1000x1610). Category: DateUP. Subcategory: Server Rack. Price: Out Of Stock.

Product: Asustor DRIVESTOR 2 Lite AS1102T 2-Bays NAS Storage. Category: Asustor. Subcategory: NAS Storage. Price: 30,500৳.
",239,751036,751275
3095,recursive,"
Product: Asustor FLASHSTOR 6 FS6706T NAS Storage. Category: Asustor. Subcategory: NAS Storage. Price: 75,000৳.

Product: Asustor LOCKERSTOR 4 GEN-2 AS6704T 4-Bays NAS Storage. Category: Asustor. Subcategory: NAS Storage. Price: 98,000৳.
",238,751275,751513
3096,recursive,"
Product: Asustor LOCKERSTOR 6 Gen2 AS6706T 6-Bays NAS Storage. Category: Asustor. Subcategory: NAS Storage. Price: 135,000৳.

Product: Asustor AS6504RS Lockerstor 4RS 4-Bays NAS Enclosure. Category: Asustor. Subcategory: NAS Storage. Price: 150,000৳.
",252,751513,751765
3097,recursive,"
Product: Asustor LOCKERSTOR 8 AS6508T 8-Bays NAS Storage. Category: Asustor. Subcategory: NAS Storage. Price: 175,000৳.

Product: Asustor LOCKERSTOR 12RD AS6512RD 12-Bays NAS Storage. Category: Asustor. Subcategory: NAS Storage. Price: 335,000৳.
",247,751765,752012
3098,recursive,"
Product: Asustor LOCKERSTOR 12R Pro AS7112RDX 12-Bays NAS Storage. Category: Asustor. Subcategory: NAS Storage. Price: Call for Price.

Product: Asustor AS7116RDX Lockerstor 16R Pro 16-Bays NAS Enclosure. Category: Asustor. Subcategory: NAS Storage. Price: Call for Price.
",274,752012,752286
3099,recursive,"
Product: Asustor DRIVESTOR 4 Pro AS3304T 4-Bays NAS Storage. Category: Asustor. Subcategory: NAS Storage. Price: Out Of Stock.

Product: Asustor DRIVESTOR 4 Pro Gen2 AS3304T V2 4-Bays NAS Storage. Category: Asustor. Subcategory: NAS Storage. Price: Out Of Stock.
",264,752286,752550
3100,recursive,"
Product: Asustor AS6602T NAS Storage. Category: Asustor. Subcategory: NAS Storage. Price: Out Of Stock.

Product: Asustor AS6604T NAS Storage. Category: Asustor. Subcategory: NAS Storage. Price: Out Of Stock.
",210,752550,752760
3101,recursive,"
Product: Dell Precision 7960 Tower Workstation. Category: Dell. Subcategory: Workstation. Price: Up Coming.

Product: Dell Precision Tower 3620 XCTO BASE Workstation. Category: Dell. Subcategory: Workstation. Price: Out Of Stock.
",231,752760,752991
3102,recursive,"
Product: Dell Precision T3650 Core i7 11th Gen Workstation. Category: Dell. Subcategory: Workstation. Price: Out Of Stock.

Product: Dell Precision T3660 Core i7 12th Gen Workstation. Category: Dell. Subcategory: Workstation. Price: Out Of Stock.
",248,752991,753239
3103,recursive,"
Product: ORICO MetaBox Pro 2 Bay NAS Storage. Category: Orico. Subcategory: NAS Storage. Price: 32,000৳.

Product: ORICO MetaCube Pro 5 Bay NAS Storage. Category: Orico. Subcategory: NAS Storage. Price: 47,000৳.
",213,753239,753452
3104,recursive,"
Product: ORICO MetaBox Pro 5 Bay NAS Storage. Category: Orico. Subcategory: NAS Storage. Price: 57,000৳.

Product: ORICO 9858U3 5 Bay USB 3.0 DAS Enclosure. Category: DAS Storage. Subcategory: Server & Storage. Price: 26,900৳.
",228,753452,753680
3105,recursive,"
Product: ORICO 9758C3 5 Bay USB3.1 Type-C DAS Enclosure. Category: DAS Storage. Subcategory: Server & Storage. Price: 28,500৳.

Product: Dell EMC ME4024 Storage Array. Category: DELL. Subcategory: SAN Storage. Price: Call for Price.
",234,753680,753914
3106,recursive,"
Product: Dell EMC PowerStore 3000T Storage. Category: DELL. Subcategory: SAN Storage. Price: Call for Price.

Product: Dell EMC Unity XT 480F All-Flash Storage. Category: DELL. Subcategory: SAN Storage. Price: Call for Price.
",227,753914,754141
3107,recursive,"
Product: Dell SCv3020 Storage Array. Category: DELL. Subcategory: SAN Storage. Price: Call for Price.

Product: Dell EMC PowerStore 500T Storage. Category: DELL. Subcategory: SAN Storage. Price: Call for Price.
",212,754141,754353
3108,recursive,"
Product: Dell PowerVault ME5024 25Gb iSCSI Dual Controller Storage Array. Category: DELL. Subcategory: SAN Storage. Price: Call for Price.

Product: Dell PowerVault ME5024 12Gb SAS 8 Port Dual Controller Storage Array. Category: DELL. Subcategory: SAN Storage. Price: Call for Price.
",285,754353,754638
3109,recursive,"
Product: Dell PowerVault ME5024 32Gb FC Type-B 8 Port Dual Controller Storage Array. Category: DELL. Subcategory: SAN Storage. Price: Call for Price.
",151,754638,754789
3110,recursive,"
Product: Dell PowerVault ME5012 32Gb FC Type-B 8 Port Dual Controller Storage Array. Category: DELL. Subcategory: SAN Storage. Price: Call for Price.

Product: Dell PowerVault ME5012 25Gb iSCSI 8 Port Dual Controller Storage Array. Category: DELL. Subcategory: SAN Storage. Price: Call for Price.
",298,754789,755087
3111,recursive,"
Product: Dell EMC Unity XT 380 Hybrid Flash Storage Array. Category: DELL. Subcategory: SAN Storage. Price: Call for Price.

Product: Dell EMC Unity XT 380F Hybrid Flash Storage Array. Category: DELL. Subcategory: SAN Storage. Price: Call for Price.
",251,755087,755338
3112,recursive,"
Product: Dell EMC Unity XT 480 Hybrid Flash Storage Array. Category: DELL. Subcategory: SAN Storage. Price: Call for Price.

Product: Dell Powerflex Appliance R650 Storage Array. Category: DELL. Subcategory: SAN Storage. Price: Call for Price.
",245,755338,755583
3113,recursive,"
Product: Dell Powerflex Appliance R650 Storage Array With Jumper Cord. Category: DELL. Subcategory: SAN Storage. Price: Call for Price.

Product: Dell Powerflex Appliance R650 HCI Storage Array. Category: DELL. Subcategory: SAN Storage. Price: Call for Price.
",261,755583,755844
3114,recursive,"
Product: Dell EMC PowerStore 1000T Storage Array. Category: DELL. Subcategory: SAN Storage. Price: Call for Price.

Product: Dell EMC PowerStore 1200T Storage Array. Category: DELL. Subcategory: SAN Storage. Price: Call for Price.
",232,755844,756076
3115,recursive,"
Product: Dell PowerVault ME5012 12Gb SAS 8 Port Dual Controller Storage Array. Category: DELL. Subcategory: SAN Storage. Price: Call for Price.

Product: Dell PowerStore 500T SAS Storage Array. Category: DELL. Subcategory: SAN Storage. Price: Call for Price.
",260,756076,756336
3116,recursive,"
Product: Synology RKS-02 Sliding Rail Kit for Synology Rackmount Servers. Category: NAS Storage. Subcategory: Server & Storage. Price: 18,500৳.

Product: Synology DiskStation DS124 1-Bay NAS Enclosure. Category: NAS Storage. Subcategory: Server & Storage. Price: 24,000৳.
",273,756336,756609
3117,recursive,"
Product: Synology DiskStation DS223j 2-Bays NAS Enclosure. Category: NAS Storage. Subcategory: Server & Storage. Price: 30,000৳.

Product: Synology DiskStation DS223 2-Bays NAS Enclosure. Category: NAS Storage. Subcategory: Server & Storage. Price: 43,000৳.
",259,756609,756868
3118,recursive,"
Product: Synology DiskStation DS224+ 2-Bays NAS Enclosure. Category: NAS Storage. Subcategory: Server & Storage. Price: 50,000৳52,000৳.

Product: Synology DiskStation DS423+ 4-Bays NAS Enclosure. Category: NAS Storage. Subcategory: Server & Storage. Price: 79,500৳.
",267,756868,757135
3119,recursive,"
Product: Synology DiskStation DS923+ 4-Bays NAS Enclosure. Category: NAS Storage. Subcategory: Server & Storage. Price: 95,500৳.

Product: Synology DiskStation DS1525+ 5-Bays NAS Enclosure. Category: NAS Storage. Subcategory: Server & Storage. Price: 130,500৳.
",262,757135,757397
3120,recursive,"
Product: Synology DiskStation DS1621+ 6-Bays NAS Enclosure. Category: NAS Storage. Subcategory: Server & Storage. Price: 148,000৳.

Product: Synology DiskStation DS1823xs+ 8-Bays NAS Enclosure. Category: NAS Storage. Subcategory: Server & Storage. Price: 245,000৳.
",266,757397,757663
3121,recursive,"
Product: HP 600GB 10K RPM SAS 2.5"" Server HDD. Category: Server HDD. Subcategory: Server & Storage. Price: Call for Price.

Product: Dell 12TB 7.2K RPM SATA 6Gbps 512e 3.5"" Hot-Plug Server HDD. Category: Server HDD. Subcategory: Server & Storage. Price: Call for Price.
",271,757663,757934
3122,recursive,"
Product: HPE 900GB SAS 12G MC 15K SFF BC Server HDD. Category: Server HDD. Subcategory: Server & Storage. Price: Call for Price.

Product: HPE 2.4TB SAS 12G MC 10K SFF SC 512e Server HDD. Category: Server HDD. Subcategory: Server & Storage. Price: Call for Price.
",265,757934,758199
3123,recursive,"
Product: HP 300GB 6G 10K RPM 2.5-inch SFF SC Server SAS HDD. Category: Server HDD. Subcategory: Server & Storage. Price: Call for Price.

Product: Cisco UCS-HD4T7KS3-E 4TB 7.2K RPM SAS 3.5"" Hot Plug HDD. Category: Server HDD. Subcategory: Server & Storage. Price: Call for Price.
",281,758199,758480
3124,recursive,"
Product: DELL 1.2TB 10K RPM SAS 12Gbps 2.5"" Hot Plug HDD. Category: Server HDD. Subcategory: Server & Storage. Price: Call for Price.

Product: Cisco UCS-HD12TB10K12N 1.2TB 10K RPM 12Gbps SAS 2.5"" SFF Server HDD. Category: Server HDD. Subcategory: Server & Storage. Price: Call for Price.
",290,758480,758770
3125,recursive,"
Product: HPE P28352-B21 2.4TB 10K RPM MC SAS 2.5"" SFF Server HDD. Category: Server HDD. Subcategory: Server & Storage. Price: Call for Price.

Product: HPE LTO-6 Ultrium 6.25TB RW Data Cartridge. Category: Server HDD. Subcategory: Server & Storage. Price: Call for Price.
",273,758770,759043
3126,recursive,"
Product: Dell Server 2.5"" 300 GB 10000 Rpm HDD SAS. Category: Server HDD. Subcategory: Server & Storage. Price: Call for Price.

Product: Dell Server 2.5"" 600 GB 15000 Rpm HDD SAS. Category: Server HDD. Subcategory: Server & Storage. Price: Call for Price.
",258,759043,759301
3127,recursive,"
Product: Dell Server 300 GB 3.5"" 10000 Rpm HDD SAS. Category: Server HDD. Subcategory: Server & Storage. Price: Call for Price.

Product: Dell Server 600 GB 3.5"" 15000 Rpm HDD SAS. Category: Server HDD. Subcategory: Server & Storage. Price: Call for Price.
",258,759301,759559
3128,recursive,"
Product: HP Server 600 GB 2.5"" 10000 Rpm G8 And G9 HDD SAS. Category: Server HDD. Subcategory: Server & Storage. Price: Call for Price.

Product: HP Server 1.2TB 2.5"" 10000 Rpm G8 And G9 HDD SAS. Category: Server HDD. Subcategory: Server & Storage. Price: Call for Price.
",273,759559,759832
3129,recursive,"
Product: Dell 1TB 7.2K RPM Near-Line SAS 512n 3.5"" Hot Plug Hard Drive, CusKit. Category: Server HDD. Subcategory: Server & Storage. Price: Call for Price.
",157,759832,759989
3130,recursive,"
Product: Dell 2TB 7.2K RPM Near-Line SAS 512n 3.5"" Hot Plug Hard Drive, CusKit. Category: Server HDD. Subcategory: Server & Storage. Price: Call for Price.
",157,759989,760146
3131,recursive,"
Product: Dell 4TB 7.2K RPM Near-Line SAS 512n 3.5"" Hot Plug Hard Drive, CusKit. Category: Server HDD. Subcategory: Server & Storage. Price: Call for Price.
",157,760146,760303
3132,recursive,"
Product: Dell 8TB 7.2K RPM Near-Line SAS 512n 3.5"" Hot Plug Hard Drive, CusKit. Category: Server HDD. Subcategory: Server & Storage. Price: Call for Price.

Product: Dell Server 2.5"" HDD Bay. Category: Server HDD Bay. Subcategory: Server & Storage. Price: Call for Price.
",273,760303,760576
3133,recursive,"
Product: Dell Server 3.5"" HDD Bay. Category: Server HDD Bay. Subcategory: Server & Storage. Price: Call for Price.

Product: Samsung 16GB DDR4 3200MHz UDIMM ECC Server RAM. Category: Server RAM. Subcategory: Server & Storage. Price: Call for Price.
",250,760576,760826
3134,recursive,"
Product: DELL 64GB DDR4 3200MHz RDIMM Server RAM. Category: Server RAM. Subcategory: Server & Storage. Price: Call for Price.

Product: Samsung 32GB DDR4 3200MHz UDIMM ECC Server RAM. Category: Server RAM. Subcategory: Server & Storage. Price: Call for Price.
",261,760826,761087
3135,recursive,"
Product: Samsung 16GB DDR4 2666MHz SODIMM Server RAM. Category: Server RAM. Subcategory: Server & Storage. Price: Call for Price.

Product: Samsung 32GB DDR4 3200MHz RDIMM ECC Server RAM. Category: Server RAM. Subcategory: Server & Storage. Price: Call for Price.
",265,761087,761352
3136,recursive,"
Product: HPE 32GB DDR4 2933MHz RDIMM Server RAM. Category: Server RAM. Subcategory: Server & Storage. Price: Call for Price.

Product: HPE 16GB DDR4 2666MHz RDIMM Server RAM. Category: Server RAM. Subcategory: Server & Storage. Price: Call for Price.
",252,761352,761604
3137,recursive,"
Product: HPE 16GB DDR4 2933MHz RDIMM Server RAM. Category: Server RAM. Subcategory: Server & Storage. Price: Call for Price.

Product: HPE 16GB DDR4 2666MHz UDIMM Server RAM. Category: Server RAM. Subcategory: Server & Storage. Price: Call for Price.
",252,761604,761856
3138,recursive,"
Product: Synology 16GB DDR4 2666MHz ECC SO-DIMM RAM. Category: Server RAM. Subcategory: Server & Storage. Price: Call for Price.

Product: Intel D3-S4610 960GB 2.5"" Server SSD. Category: Server SSD. Subcategory: Server & Storage. Price: Call for Price.
",254,761856,762110
3139,recursive,"
Product: HPE 960GB SAS 12G RI SFF 2.5"" SAS Server SSD. Category: Server SSD. Subcategory: Server & Storage. Price: Call for Price.

Product: Dell 800GB SAS MU 12Gbps 2.5"" Hot-Plug SSD. Category: Server SSD. Subcategory: Server & Storage. Price: Call for Price.
",262,762110,762372
3140,recursive,"
Product: Samsung PM893 960GB SATA 6Gbps 2.5"" Server SSD. Category: Server SSD. Subcategory: Server & Storage. Price: Call for Price.

Product: Samsung PM893 480GB SATA 6Gbps 2.5"" Server SSD. Category: Server SSD. Subcategory: Server & Storage. Price: Call for Price.
",268,762372,762640
3141,recursive,"
Product: HPE 1.92TB SAS 12G RI SFF SC Server SSD. Category: Server SSD. Subcategory: Server & Storage. Price: Call for Price.

Product: Intel D3-S4510 1.92TB 2.5"" Server SSD. Category: Server SSD. Subcategory: Server & Storage. Price: Call for Price.
",252,762640,762892
3142,recursive,"
Product: Dell 240GB SSD SATA Mix Use TLC 6Gbps 512e 2.5in Drive S4600. Category: Server SSD. Subcategory: Server & Storage. Price: Call for Price.

Product: Dell 400GB SSD SATA, Mix Use MLC 6Gbps 2.5in Drive, THNSF8. Category: Server SSD. Subcategory: Server & Storage. Price: Call for Price.
",294,762892,763186
3143,recursive,"
Product: Synology SNV3410 400GB M.2 2280 NVMe PCIe SSD. Category: Server SSD. Subcategory: Server & Storage. Price: Call for Price.

Product: Synology SAT5210 960GB 2.5” Enterprise SATA SSD. Category: Server SSD. Subcategory: Server & Storage. Price: Call for Price.
",268,763186,763454
3144,recursive,"
Product: Dell 1.92TB SSD SAS Read Intensive 24Gbps 512e 2.5inch Drive. Category: Server SSD. Subcategory: Server & Storage. Price: Call for Price.

Product: Dell 960GB SATA RI SFF 2.5"" Hot Plug SSD. Category: Server SSD. Subcategory: Server & Storage. Price: Out Of Stock.
",274,763454,763728
3145,recursive,"
Product: Samsung PM893 1.92TB SATA 6Gbps 2.5"" Server SSD. Category: Server SSD. Subcategory: Server & Storage. Price: Out Of Stock.

Product: Dell 480GB MU 2.5"" SATA Hot-plug SSD. Category: Server SSD. Subcategory: Server & Storage. Price: Out Of Stock.
",255,763728,763983
3146,recursive,"
Product: Dell 1.92TB SAS RI 12Gbps 2.5"" Hot-Plug SSD. Category: Server SSD. Subcategory: Server & Storage. Price: Call for Price.

Product: Synology DiskStation DS3622xs+ 12 Bays Desktop NAS Storage. Category: Synology. Subcategory: NAS Storage. Price: Pre Order.
",265,763983,764248
3147,recursive,"
Product: Synology RackStation RS1619xs+ 4-Bays NAS Enclosure. Category: Synology. Subcategory: NAS Storage. Price: Call for Price.

Product: Synology FlashStation FS6400 24 Bays NAS Storage. Category: Synology. Subcategory: NAS Storage. Price: Call for Price.
",261,764248,764509
3148,recursive,"
Product: Synology RackStation RS1221RP+ 8-Bays NAS Enclosure. Category: Synology. Subcategory: NAS Storage. Price: Up Coming.

Product: Synology DiskStation DS120j 1-Bay NAS Server. Category: Synology. Subcategory: NAS Storage. Price: Out Of Stock.
",250,764509,764759
3149,recursive,"
Product: Synology DiskStation DS220J 2-Bays NAS Enclosure. Category: Synology. Subcategory: NAS Storage. Price: Out Of Stock.

Product: Synology DiskStation DS218 2-Bays NAS Server. Category: Synology. Subcategory: NAS Storage. Price: Out Of Stock.
",250,764759,765009
3150,recursive,"
Product: Synology DiskStation DS220+ 2-Bays NAS Enclosure. Category: Synology. Subcategory: NAS Storage. Price: Out Of Stock.

Product: Synology DiskStation DS920+ 4-Bays NAS Enclosure. Category: Synology. Subcategory: NAS Storage. Price: Out Of Stock.
",254,765009,765263
3151,recursive,"
Product: Synology RackStation RS822+ 4-Bays NAS Enclosure. Category: Synology. Subcategory: NAS Storage. Price: 168,500৳.

Product: Dell 550-Watt Hot-Plug Server Power Supply. Category: Server Power Supply. Subcategory: Server & Storage. Price: 27,000৳.
",255,765263,765518
3152,recursive,"
Product: Dell Server Redundant Power Supply. Category: Server Power Supply. Subcategory: Server & Storage. Price: Pre Order.

Product: TwinMOS EzeeHUB-23P 4-Port USB Hub. Category: Accessories. Price: 575৳750৳.

Product: UGREEN CM195 6-in-1 Type-C Hub #70410. Category: Accessories. Price: 3,300৳.
",299,765518,765817
3153,recursive,"
Product: SanDisk Ultra Dual Drive Luxe 512GB Type-C Pen Drive. Category: Accessories. Price: 6,000৳.

Product: CHARG C1B 1 Meter USB to Micro USB Cable. Category: Accessories. Price: 95৳.

Product: Oraimo OCD-114M 1 Meter USB To Micro USB Cable. Category: Accessories. Price: 100৳.
",283,765817,766100
3154,recursive,"
Product: CHARG C1C 1 Meter USB to Type C Cable. Category: Accessories. Price: 100৳.

Product: Ugreen US133 Micro USB Male to USB Female OTG Cable #10396. Category: Accessories. Price: 120৳.
",191,766100,766291
3155,recursive,"
Product: Ugreen AV162 Cannon XLR Male to 6.5mm Female Converter #80439. Category: Accessories. Price: 120৳.

Product: Ugreen AV162 6.5mm Female to Cannon XLR Male Converter #80440. Category: Accessories. Price: 120৳.
",218,766291,766509
3156,recursive,"
Product: Yison Celebrat CB-33 A-M 1 Meter USB to Micro USB Cable. Category: Accessories. Price: 125৳.

Product: Yison Celebrat CB-33 A-M-White 1 Meter USB to Micro USB Cable. Category: Accessories. Price: 125৳.
",212,766509,766721
3157,recursive,"
Product: Yison Celebrat CB-31 A-M 1 Meter USB to Micro USB Cable. Category: Accessories. Price: 131৳.

Product: Yison Celebrat CB-31 A-M-White 1 Meter USB to Micro USB Cable. Category: Accessories. Price: 131৳.
",212,766721,766933
3158,recursive,"
Product: Oraimo OCD-114C 1 Meter USB to Type C Cable. Category: Accessories. Price: 135৳.

Product: Yison Celebrat CB-33 A-C 1 Meter USB to USB Type-C Cable. Category: Accessories. Price: 145৳.
",195,766933,767128
3159,recursive,"
Product: Yison Celebrat CB-33 A-C-White 1 Meter USB to USB Type-C Cable. Category: Accessories. Price: 145৳.

Product: Havit HV-MP838 Gaming Mouse Pad. Category: Accessories. Price: 119৳150৳.

Product: Havit HV-MP837 Gaming Mouse Pad. Category: Accessories. Price: 150৳.
",272,767128,767400
3160,recursive,"
Product: Havit HV-MP839 Gaming Mouse Pad. Category: Accessories. Price: 150৳.

Product: Non-brand Apple Mouse Pad. Category: Accessories. Price: 150৳.

Product: Havit HV-MP846 Gaming Mouse Pad. Category: Mouse Pad. Subcategory: Accessories. Price: 119৳150৳.
",259,767400,767659
3161,recursive,"
Product: Fantech MP256 Gaming Mouse Pad. Category: Mouse Pad. Subcategory: Accessories. Price: 170৳.

Product: FANTECH Vigil MP292 Gaming Mousepad. Category: Mouse Pad. Subcategory: Accessories. Price: 260৳.
",209,767659,767868
3162,recursive,"
Product: Xtrike Me MP-005 Gaming Mouse Pad. Category: Mouse Pad. Subcategory: Accessories. Price: 300৳.

Product: Onikuma MP002 RGB Gaming Mousepad. Category: Mouse Pad. Subcategory: Accessories. Price: 300৳.
",210,767868,768078
3163,recursive,"
Product: Fantech Sven MP35 Gaming Mouse Pad. Category: Mouse Pad. Subcategory: Accessories. Price: 350৳.

Product: Fantech MP356 Gaming Mouse Pad. Category: Mouse Pad. Subcategory: Accessories. Price: 397৳410৳.
",212,768078,768290
3164,recursive,"
Product: Fantech Sven MP44 Gaming Mousepad. Category: Mouse Pad. Subcategory: Accessories. Price: 530৳.

Product: Fantech MP456 Gaming Mouse Pad. Category: Mouse Pad. Subcategory: Accessories. Price: 650৳.
",207,768290,768497
3165,recursive,"
Product: Fantech AGILE MP353 SE Mouse Pad. Category: Mouse Pad. Subcategory: Accessories. Price: 660৳.

Product: Rapoo VPRO V10S Anti-Skid Compact Mouse Pad. Category: Mouse Pad. Subcategory: Accessories. Price: 700৳.
",219,768497,768716
3166,recursive,"
Product: A4tech Bloody BP-45 Gaming Mouse Pad. Category: Mouse Pad. Subcategory: Accessories. Price: 799৳.

Product: Havit MP903 RGB Gaming Mouse Pad. Category: Mouse Pad. Subcategory: Accessories. Price: 799৳820৳.
",216,768716,768932
3167,recursive,"
Product: A4tech Bloody BP-45W Nyx Mirage X Savage Gaming Mouse Pad. Category: Mouse Pad. Subcategory: Accessories. Price: 849৳.

Product: Fantech AGILE MP904 Mint Edition Gaming Mousepad. Category: Mouse Pad. Subcategory: Accessories. Price: 850৳1,000৳.
",255,768932,769187
3168,recursive,"
Product: MSI Agility GD21 DRAGON TIAMAT Gaming Mouse Pad. Category: Mouse Pad. Subcategory: Accessories. Price: 1,000৳.

Product: Fantech GO K211 Bangla Keyboard. Category: Keyboard. Subcategory: Accessories. Price: 449৳.
",223,769187,769410
3169,recursive,"
Product: T-WOLF T15 104 Keys USB Wired Keyboard. Category: Keyboard. Subcategory: Accessories. Price: 450৳.

Product: PC Power 403 Wired Keyboard with Bangla. Category: Keyboard. Subcategory: Accessories. Price: 450৳.
",219,769410,769629
3170,recursive,"
Product: Havit KB271 USB Exquisite Keyboard with Bangla. Category: Keyboard. Subcategory: Accessories. Price: 399৳480৳.

Product: Havit KB2006 USB Exquisite Keyboard. Category: Keyboard. Subcategory: Accessories. Price: 500৳.
",227,769629,769856
3171,recursive,"
Product: Havit KB376 USB Multimedia Keyboard. Category: Keyboard. Subcategory: Accessories. Price: 520৳.

Product: PC Power PCGKY601 Wired Keyboard with Bangla. Category: Keyboard. Subcategory: Accessories. Price: 550৳.
",221,769856,770077
3172,recursive,"
Product: PC Power 604 Wired Keyboard with Bangla. Category: Keyboard. Subcategory: Accessories. Price: 550৳.

Product: Jedel K15 Wired Keyboard. Category: Keyboard. Subcategory: Accessories. Price: 550৳.
",205,770077,770282
3173,recursive,"
Product: T-WOLF K220 Wired Keyboard with Bangla. Category: Keyboard. Subcategory: Accessories. Price: 550৳.

Product: Havit KB241 USB Wired Keyboard. Category: Keyboard. Subcategory: Accessories. Price: 550৳.
",210,770282,770492
3174,recursive,"
Product: Micropack K203 Basic USB Keyboard. Category: Keyboard. Subcategory: Accessories. Price: 590৳.

Product: HAVIT KB224 USB Mini Keyboard. Category: Keyboard. Subcategory: Accessories. Price: 590৳.
",204,770492,770696
3175,recursive,"
Product: PC Power 602 Wired Keyboard with Bangla. Category: Keyboard. Subcategory: Accessories. Price: 600৳.

Product: Jedel K26 Wired Keyboard. Category: Keyboard. Subcategory: Accessories. Price: 600৳.
",205,770696,770901
3176,recursive,"
Product: PC Power 603 Wired Keyboard with Bangla. Category: Keyboard. Subcategory: Accessories. Price: 650৳.

Product: PC Power PCK-161 Wired Keyboard with Bangla. Category: Keyboard. Subcategory: Accessories. Price: 650৳.
",224,770901,771125
3177,recursive,"
Product: PC Power PCK-126 Mini Bangla Keyboard. Category: Keyboard. Subcategory: Accessories. Price: 650৳.

Product: Jedel KB-1000 Wired Mini Keyboard. Category: Keyboard. Subcategory: Accessories. Price: 499৳650৳.
",216,771125,771341
3178,recursive,"
Product: Rapoo NK2600 Spill- Resistant Wired Keyboard with Bangla. Category: Keyboard. Subcategory: Accessories. Price: 700৳.

Product: Havit 2218D 3.5mm Single Port Headphone. Category: Headphone. Subcategory: Accessories. Price: 800৳.
",238,771341,771579
3179,recursive,"
Product: HAVIT HV-H2178D 3.5mm Wired Headphone. Category: Headphone. Subcategory: Accessories. Price: 699৳800৳.

Product: Havit H220D Wired Headphone. Category: Headphone. Subcategory: Accessories. Price: 770৳800৳.
",216,771579,771795
3180,recursive,"
Product: Havit H206D 3.5mm double plug Stereo with Mic Headset. Category: Headphone. Subcategory: Accessories. Price: 850৳.

Product: Havit H2263D 3.5mm Metal Decoration Single Port Headphone. Category: Headphone. Subcategory: Accessories. Price: 900৳.
",254,771795,772049
3181,recursive,"
Product: Havit HV-H100d Wired Headphone. Category: Headphone. Subcategory: Accessories. Price: 900৳.

Product: Rapoo H101 Wired Stereo Headphone. Category: Headphone. Subcategory: Accessories. Price: 900৳.
",207,772049,772256
3182,recursive,"
Product: Rapoo H102 Wired Stereo Headphone. Category: Headphone. Subcategory: Accessories. Price: 799৳900৳.

Product: Microlab K250 Stereo Wired Headphone. Category: Headphone. Subcategory: Accessories. Price: 975৳.
",217,772256,772473
3183,recursive,"
Product: Fantech MARS II HQ54 Wired Gaming Headset. Category: Headphone. Subcategory: Accessories. Price: 980৳.

Product: Logitech H110 STEREO Headset (Two port). Category: Headphone. Subcategory: Accessories. Price: 1,000৳.
",226,772473,772699
3184,recursive,"
Product: Logitech H111 STEREO Headset (One port). Category: Headphone. Subcategory: Accessories. Price: 1,000৳.

Product: Xtrike Me HP-318 RGB Gaming Headphone. Category: Headphone. Subcategory: Accessories. Price: 850৳1,000৳.
",228,772699,772927
3185,recursive,"
Product: Hoco W46 Charm Bluetooth Wireless Headphone. Category: Headphone. Subcategory: Accessories. Price: 850৳1,000৳.

Product: Fantech TONE II HQ56 Gaming Headphone. Category: Headphone. Subcategory: Accessories. Price: 1,020৳.
",232,772927,773159
3186,recursive,"
Product: Havit Gamenote H754d RGB Gaming Headphone. Category: Headphone. Subcategory: Accessories. Price: 1,050৳.

Product: AULA S605 3.5 mm Wired RGB Gaming Headphone. Category: Headphone. Subcategory: Accessories. Price: 949৳1,100৳.
",236,773159,773395
3187,recursive,"
Product: Microlab K280 Supra-Aural Wired Headphone. Category: Headphone. Subcategory: Accessories. Price: 1,100৳.

Product: Havit Gamenote HV-H2032D Gaming Headphone. Category: Headphone. Subcategory: Accessories. Price: 1,150৳.
",230,773395,773625
3188,recursive,"
Product: Havit Gamenote H767d RGB Gaming Headphone. Category: Headphone. Subcategory: Accessories. Price: 1,150৳.

Product: Razer Goliathus Mobile Stealth Edition Gaming Mouse Pad. Category: RAZER. Subcategory: Mouse Pad. Price: 1,300৳.
",238,773625,773863
3189,recursive,"
Product: Razer GIGANTUS V2 Medium Soft Gaming Mouse Mat. Category: RAZER. Subcategory: Mouse Pad. Price: 1,500৳.

Product: Razer GIGANTUS V2 Large Gaming Mouse Mat. Category: RAZER. Subcategory: Mouse Pad. Price: Up Coming.
",225,773863,774088
3190,recursive,"
Product: Razer Pro Glide Medium Soft Productivity Mouse Mat. Category: RAZER. Subcategory: Mouse Pad. Price: Out Of Stock.

Product: Razer Gigantus Elite Edition Large Gaming Mouse Mat for Esports (Global). Category: RAZER. Subcategory: Mouse Pad. Price: Out Of Stock.
",270,774088,774358
3191,recursive,"
Product: Razer GIGANTUS V2 XXL Gaming Mouse Mat. Category: RAZER. Subcategory: Mouse Pad. Price: Out Of Stock.

Product: Razer Goliathus Storm Trooper Gaming Mouse Mat Extended. Category: RAZER. Subcategory: Mouse Pad. Price: Out Of Stock.
",241,774358,774599
3192,recursive,"
Product: Razer Firefly-Hard Gaming Mouse Mat (Global). Category: RAZER. Subcategory: Mouse Pad. Price: Out Of Stock.

Product: Razer Firefly V2 Hard Razer Chroma RGB lighting Gaming Mouse Mat. Category: RAZER. Subcategory: Mouse Pad. Price: Out Of Stock.
",256,774599,774855
3193,recursive,"
Product: Razer DeathAdder Essential Mouse + Razer Goliathus Speed Pikachu Limited Edition Mat Bundle. Category: RAZER. Subcategory: Mouse Pad. Price: Out Of Stock.

Product: Razer Pro Glide XXL Soft Gaming Mouse Mat. Category: RAZER. Subcategory: Mouse Pad. Price: Out Of Stock.
",280,774855,775135
3194,recursive,"
Product: Razer Strider XXL Hybrid Gaming Mouse Mat. Category: RAZER. Subcategory: Mouse Pad. Price: Out Of Stock.

Product: Razer Level Up Bundle- Cynosa Lite, Viper Mini, Gigantus V2 Combo. Category: RAZER. Subcategory: Mouse Pad. Price: Out Of Stock.
",254,775135,775389
3195,recursive,"
Product: Razer Naga Trinity - Multi-color Wired MMO Gaming Mouse (Global). Category: Mouse. Subcategory: Accessories. Price: 8,800৳.

Product: Havit HV-MS753 Optical Mouse. Category: Mouse. Subcategory: Accessories. Price: 280৳.
",230,775389,775619
3196,recursive,"
Product: Pc Power PCGMY01 Wired Mouse. Category: Mouse. Subcategory: Accessories. Price: 280৳.

Product: T-WOLF V12 Wired Mouse. Category: Mouse. Subcategory: Accessories. Price: 300৳.

Product: T-WOLF V13 Wired Mouse. Category: Mouse. Subcategory: Accessories. Price: 300৳.
",276,775619,775895
3197,recursive,"
Product: Rapoo N100 Wired Optical Mouse. Category: Mouse. Subcategory: Accessories. Price: 350৳.

Product: Lenovo 300 Wired USB Mouse. Category: Mouse. Subcategory: Accessories. Price: 350৳370৳.

Product: Havit MS70 Wired Optical Mouse. Category: Mouse. Subcategory: Accessories. Price: 380৳.
",294,775895,776189
3198,recursive,"
Product: Havit MS72 Cool RGB LED USB Gaming Mouse Black. Category: Mouse. Subcategory: Accessories. Price: 368৳400৳.

Product: Xtrike Me GM-124 USB Wired Optical Mouse. Category: Mouse. Subcategory: Accessories. Price: 299৳400৳.
",230,776189,776419
3199,recursive,"
Product: Pc Power PCM-315 Wired Mouse. Category: Mouse. Subcategory: Accessories. Price: 400৳.

Product: Pc Power PCM-316 Wired Mouse. Category: Mouse. Subcategory: Accessories. Price: 410৳.

Product: Logitech B100 Optical USB Mouse. Category: Mouse. Subcategory: Accessories. Price: 420৳.
",291,776419,776710
3200,recursive,"
Product: Logitech M90 USB Mouse. Category: Mouse. Subcategory: Accessories. Price: 420৳.

Product: A4TECH OP-720 USB Wired Mouse. Category: Mouse. Subcategory: Accessories. Price: 425৳.

Product: A4TECH OP-330 USB Wired Mouse. Category: Mouse. Subcategory: Accessories. Price: 425৳.
",284,776710,776994
3201,recursive,"
Product: HAVIT HV-MS989GT Wireless Mouse. Category: Mouse. Subcategory: Accessories. Price: 450৳.

Product: Pc Power PCM-378 Wired Mouse. Category: Mouse. Subcategory: Accessories. Price: 450৳.

Product: T-WOLF Q2 Optical Wireless Mouse. Category: Mouse. Subcategory: Accessories. Price: 480৳.
",295,776994,777289
3202,recursive,"
Product: Dareu LM106G Wireless Office Mouse. Category: Mouse. Subcategory: Accessories. Price: 490৳.

Product: Corsair MM300 PRO Splash-Proof Gaming Mouse Pad. Category: Corsair. Subcategory: Mouse Pad. Price: Out Of Stock.
",225,777289,777514
3203,recursive,"
Product: Xtrike Me GX01 Extra Large Chair Floor Mat. Category: Xtrike Me. Subcategory: Mouse Pad. Price: 800৳1,400৳.

Product: Xtrike Me MP-606 RGB Gaming Large Mouse Pad. Category: Xtrike Me. Subcategory: Mouse Pad. Price: 1,300৳.
",233,777514,777747
3204,recursive,"
Product: Xtrike Me MP-002 Cloth Surface Mouse Pad. Category: Xtrike Me. Subcategory: Mouse Pad. Price: Out Of Stock.

Product: Xtrike Me MP-204 Cloth Surface Mouse Pad. Category: Xtrike Me. Subcategory: Mouse Pad. Price: Out Of Stock.
",236,777747,777983
3205,recursive,"
Product: Xtrike Me MP-206 Large Mouse Pad. Category: Xtrike Me. Subcategory: Mouse Pad. Price: Out Of Stock.

Product: Xtrike Me MP-605 RGB Mouse Pad. Category: Xtrike Me. Subcategory: Mouse Pad. Price: Out Of Stock.
",218,777983,778201
3206,recursive,"
Product: Xtrike Me HD-214 Bluetooth Wireless Headset. Category: Bluetooth Headphone. Subcategory: Accessories. Price: 550৳850৳.

Product: Xtrike Me HD-215 Bluetooth Wireless Headset. Category: Bluetooth Headphone. Subcategory: Accessories. Price: 650৳1,050৳.
",260,778201,778461
3207,recursive,"
Product: Havit H2590BT PRO Multi-Function Wireless Headphone. Category: Bluetooth Headphone. Subcategory: Accessories. Price: 1,200৳.

Product: Awei AT6 Stereo Wireless Bluetooth Headphone. Category: Bluetooth Headphone. Subcategory: Accessories. Price: 1,049৳1,200৳.
",269,778461,778730
3208,recursive,"
Product: Hoco W35 Air Bluetooth Wireless Headphone. Category: Bluetooth Headphone. Subcategory: Accessories. Price: 1,099৳1,250৳.

Product: Havit H628BT Bluetooth Headphone. Category: Bluetooth Headphone. Subcategory: Accessories. Price: 1,150৳1,300৳.
",253,778730,778983
3209,recursive,"
Product: Awei AT8 Wireless Bluetooth Headphone. Category: Bluetooth Headphone. Subcategory: Accessories. Price: 1,199৳1,300৳.

Product: Hoco W35 Max Bluetooth Wireless Headphone. Category: Bluetooth Headphone. Subcategory: Accessories. Price: 1,275৳1,375৳.
",258,778983,779241
3210,recursive,"
Product: Awei AT7 Stereo Wireless Bluetooth Headphone. Category: Bluetooth Headphone. Subcategory: Accessories. Price: 1,060৳1,390৳.

Product: Hoco W35 Wireless Bluetooth Headphone. Category: Bluetooth Headphone. Subcategory: Accessories. Price: 1,099৳1,450৳.
",261,779241,779502
3211,recursive,"
Product: Havit H626BT Wireless Foldable Bluetooth Kids Headphone. Category: Bluetooth Headphone. Subcategory: Accessories. Price: 1,450৳.

Product: Awei A997BL Stereo Wireless Bluetooth Headphone. Category: Bluetooth Headphone. Subcategory: Accessories. Price: 1,299৳1,500৳.
",276,779502,779778
3212,recursive,"
Product: Hoco W35 Pro Max Bluetooth Headphone. Category: Bluetooth Headphone. Subcategory: Accessories. Price: 1,450৳1,550৳.

Product: Havit i62 Bluetooth 90 Degree Ergonomic Design Headphone. Category: Bluetooth Headphone. Subcategory: Accessories. Price: 1,440৳1,590৳.
",272,779778,780050
3213,recursive,"
Product: Hoco W52 Bluetooth Headphone With AUX Mode. Category: Bluetooth Headphone. Subcategory: Accessories. Price: 1,470৳1,600৳.

Product: Joyroom JR-OH1 Bluetooth Wireless Headphone. Category: Bluetooth Headphone. Subcategory: Accessories. Price: 1,399৳1,650৳.
",265,780050,780315
3214,recursive,"
Product: Microlab HB21 Bluetooth Headphone. Category: Bluetooth Headphone. Subcategory: Accessories. Price: 1,690৳.

Product: Hoco W45 Bluetooth Wireless Headphone. Category: Bluetooth Headphone. Subcategory: Accessories. Price: 1,499৳1,700৳.
",244,780315,780559
3215,recursive,"
Product: Havit H612BT Wireless Bluetooth Headphone. Category: Bluetooth Headphone. Subcategory: Accessories. Price: 1,750৳.

Product: Fantech AGILE MP453 Anti-Slip Base Mouse pad. Category: Fantech. Subcategory: Mouse Pad. Price: 1,045৳.
",239,780559,780798
3216,recursive,"
Product: Fantech ZERO-G MPC450 Gaming Mouse Pad. Category: Fantech. Subcategory: Mouse Pad. Price: 1,299৳1,350৳.

Product: FANTECH MPR800s Firefly RGB Mousepad. Category: Fantech. Subcategory: Mouse Pad. Price: 1,750৳.
",220,780798,781018
3217,recursive,"
Product: Fantech ATO MP905 Mousepad. Category: Fantech. Subcategory: Mouse Pad. Price: 1,815৳.

Product: Fantech P31 Keyboard, Mouse & Mousepad Combo. Category: Fantech. Subcategory: Mouse Pad. Price: 1,849৳1,900৳.
",216,781018,781234
3218,recursive,"
Product: Fantech Strikepad MST901 Anti-Slip Rubber Gaming Mouse Pad. Category: Fantech. Subcategory: Mouse Pad. Price: 2,915৳.

Product: Fantech P51 Sakura Edition 5 In 1 Gaming Combo Pink. Category: Fantech. Subcategory: Mouse Pad. Price: 3,550৳4,000৳.
",255,781234,781489
3219,recursive,"
Product: Fantech Strikepad Pro MST491P Gaming Mouse pad. Category: Fantech. Subcategory: Mouse Pad. Price: 4,100৳.

Product: Fantech P51 5 In 1 Gaming Combo - Hitam. Category: Fantech. Subcategory: Mouse Pad. Price: 4,400৳4,850৳.
",231,781489,781720
3220,recursive,"
Product: Fantech ATO MP905 GE01 Gaming Mouse Pad. Category: Fantech. Subcategory: Mouse Pad. Price: Up Coming.

Product: FANTECH MPR351 RGB Mousepad. Category: Fantech. Subcategory: Mouse Pad. Price: Out Of Stock.
",215,781720,781935
3221,recursive,"
Product: Fantech Sven MP25 Gaming Mouse Pad. Category: Fantech. Subcategory: Mouse Pad. Price: Out Of Stock.

Product: Asus NC03 ROG Strix Edge Call of Duty Edition Gaming Mouse Pad. Category: Asus. Subcategory: Mouse Pad. Price: 2,650৳.
",239,781935,782174
3222,recursive,"
Product: Asus ROG Hone Ace Aim Lab Edition Gaming Mouse Pad. Category: Asus. Subcategory: Mouse Pad. Price: 3,699৳4,000৳.

Product: Asus ROG NC03 Strix Edge Vertical Gaming Mouse Pad. Category: Asus. Subcategory: Mouse Pad. Price: Out Of Stock.
",246,782174,782420
3223,recursive,"
Product: Asus Cerberus Mouse Pad. Category: Asus. Subcategory: Mouse Pad. Price: Out Of Stock.

Product: Asus ROG Scabbard II Medium Gaming Mouse Pad. Category: Asus. Subcategory: Mouse Pad. Price: Out Of Stock.
",213,782420,782633
3224,recursive,"
Product: Asus ROG Whetston Mouse Pad. Category: Asus. Subcategory: Mouse Pad. Price: Out Of Stock.

Product: Asus ROG NC02 SCABBARD Mouse Pad. Category: Asus. Subcategory: Mouse Pad. Price: Out Of Stock.
",205,782633,782838
3225,recursive,"
Product: Asus ROG Sheath Extended Gaming Mouse Pad. Category: Asus. Subcategory: Mouse Pad. Price: Out Of Stock.

Product: Asus NC07 ROG Sheath Electro Punk Gaming Mouse Pad. Category: Asus. Subcategory: Mouse Pad. Price: Out Of Stock.
",237,782838,783075
3226,recursive,"
Product: Asus ROG Sheath BLK LTD Gaming Mouse Pad. Category: Asus. Subcategory: Mouse Pad. Price: Out Of Stock.

Product: Asus ROG Scabbard II Extended Gaming Mouse Pad. Category: Asus. Subcategory: Mouse Pad. Price: Out Of Stock.
",232,783075,783307
3227,recursive,"
Product: Asus ROG Hone Ace XXL Gaming Mouse Pad. Category: Asus. Subcategory: Mouse Pad. Price: Out Of Stock.

Product: ASUS NH01 ROG Balteus Qi Wireless-Charging RGB Gaming Mouse Pad. Category: Asus. Subcategory: Mouse Pad. Price: Out Of Stock.
",247,783307,783554
3228,recursive,"
Product: SteelSeries QcK Low Profile Gaming Mouse Pad. Category: SteelSeries. Subcategory: Mouse Pad. Price: 1,600৳.

Product: SteelSeries QcK Medium Low Profile Gaming Mouse Pad. Category: SteelSeries. Subcategory: Mouse Pad. Price: 2,100৳.
",243,783554,783797
3229,recursive,"
Product: SteelSeries QcK Heavy Anti Slip Rubber Gaming Mouse Pad. Category: SteelSeries. Subcategory: Mouse Pad. Price: 2,399৳2,600৳.

Product: SteelSeries QcK Large Low Profile Gaming Mouse Pad. Category: SteelSeries. Subcategory: Mouse Pad. Price: 2,600৳.
",259,783797,784056
3230,recursive,"
Product: SteelSeries QcK XXL Micro Woven Cloth Gaming Mouse Pad. Category: SteelSeries. Subcategory: Mouse Pad. Price: 5,200৳.

Product: SteelSeries QcK Prism Medium Micro Woven Cloth Gaming Mouse Pad. Category: SteelSeries. Subcategory: Mouse Pad. Price: 6,600৳.
",265,784056,784321
3231,recursive,"
Product: SteelSeries QcK Prism XL Micro Woven Cloth Gaming Mouse Pad. Category: SteelSeries. Subcategory: Mouse Pad. Price: 9,700৳.

Product: SteelSeries QcK Edge Gaming Mouse Pad. Category: SteelSeries. Subcategory: Mouse Pad. Price: Out Of Stock.
",250,784321,784571
3232,recursive,"
Product: SteelSeries QcK Edge Large Gaming Mouse Pad. Category: SteelSeries. Subcategory: Mouse Pad. Price: Out Of Stock.

Product: SteelSeries QcK Heavy Large Anti Slip Rubber Gaming Mouse Pad. Category: SteelSeries. Subcategory: Mouse Pad. Price: Out Of Stock.
",264,784571,784835
3233,recursive,"
Product: Havit H.KRAKEN Stellarisforce-1 Gaming Mouse Pad. Category: Havit. Subcategory: Mouse Pad. Price: 1,950৳.

Product: Havit HV-KB501CM 4 in 1 Gaming Combo. Category: Havit. Subcategory: Mouse Pad. Price: 1,989৳2,200৳.
",226,784835,785061
3234,recursive,"
Product: Havit HV-MP850 Gaming Mouse Pad. Category: Havit. Subcategory: Mouse Pad. Price: Out Of Stock.

Product: Havit MP843 Gaming Mouse Pad. Category: Havit. Subcategory: Mouse Pad. Price: 150৳.
",199,785061,785260
3235,recursive,"
Product: Havit HV-MP860 Gaming Mouse Pad. Category: Havit. Subcategory: Mouse Pad. Price: Out Of Stock.

Product: Havit HV-MP861 Gaming Mousepad. Category: Havit. Subcategory: Mouse Pad. Price: 500৳.
",201,785260,785461
3236,recursive,"
Product: Havit MP901 RGB Gaming Mouse Pad. Category: Havit. Subcategory: Mouse Pad. Price: Out Of Stock.

Product: Havit MP901-Pro RGB Gaming Mouse Pad. Category: Havit. Subcategory: Mouse Pad. Price: Out Of Stock.
",216,785461,785677
3237,recursive,"
Product: Havit HV-MP905 RGB Gaming Mouse Pad. Category: Havit. Subcategory: Mouse Pad. Price: Out Of Stock.

Product: Havit KB868CM 4 in 1 Gamenote Wired Gaming Combo. Category: Havit. Subcategory: Mouse Pad. Price: Out Of Stock.
",231,785677,785908
3238,recursive,"
Product: Havit KB511L RGB Wired Mechanical Gaming Keyboard, Mouse & Mouse Pad 3-in-1 Combo. Category: Havit. Subcategory: Mouse Pad. Price: Out Of Stock.

Product: Rapoo V1000 E-sports Gaming Mouse Pad. Category: Rapoo. Subcategory: Mouse Pad. Price: Out Of Stock.
",266,785908,786174
3239,recursive,"
Product: Rapoo VPRO V1L Anti-Skid Large Gaming Mouse Pad. Category: Rapoo. Subcategory: Mouse Pad. Price: Out Of Stock.

Product: Rapoo V1XL Extra Large Mouse Pad. Category: Rapoo. Subcategory: Mouse Pad. Price: Out Of Stock.
",227,786174,786401
3240,recursive,"
Product: Logitech Desk Mat Studio Series Mouse Pad. Category: Logitech. Subcategory: Mouse Pad. Price: 2,000৳.

Product: Logitech G440 Hard Gaming Mouse Pad. Category: Logitech. Subcategory: Mouse Pad. Price: Out Of Stock.
",224,786401,786625
3241,recursive,"
Product: Logitech G240 Cloth Gaming Mouse Pad. Category: Logitech. Subcategory: Mouse Pad. Price: Out Of Stock.

Product: Logitech Studio Series Mouse Pad. Category: Logitech. Subcategory: Mouse Pad. Price: 900৳.
",214,786625,786839
3242,recursive,"
Product: MSI Agility GD22 GLEAM EDITION Gaming Mouse Pad. Category: MSI. Subcategory: Mouse Pad. Price: 1,400৳.

Product: MSI Agility GD60 Gaming RGB Mouse Pad. Category: MSI. Subcategory: Mouse Pad. Price: 2,800৳.
",216,786839,787055
3243,recursive,"
Product: MSI Agility GD72 GLEAM EDITION Gaming Mouse Pad. Category: MSI. Subcategory: Mouse Pad. Price: 3,900৳.

Product: MSI Agility GD21 Gaming Mouse Pad. Category: MSI. Subcategory: Mouse Pad. Price: Up Coming.
",215,787055,787270
3244,recursive,"
Product: Redragon P041 Xeon Large Premium XL Mouse Pad. Category: Redragon. Subcategory: Mouse Pad. Price: 1,250৳.

Product: Redragon P032 FLICK XL Mouse Pad. Category: Redragon. Subcategory: Mouse Pad. Price: 1,549৳1,600৳.
",225,787270,787495
3245,recursive,"
Product: Redragon P040 Flick 3XL Mouse Pad. Category: Redragon. Subcategory: Mouse Pad. Price: 2,799৳2,850৳.

Product: Redragon PISCES P016 Gaming Mouse Mat. Category: Redragon. Subcategory: Mouse Pad. Price: Out Of Stock.
",224,787495,787719
3246,recursive,"
Product: Redragon Capricorn P012 Gaming Mouse Pad. Category: Redragon. Subcategory: Mouse Pad. Price: Out Of Stock.

Product: Redragon P029 Flick S Gaming Mouse Pad. Category: Redragon. Subcategory: Mouse Pad. Price: Out Of Stock.
",232,787719,787951
3247,recursive,"
Product: Redragon Aquarius P015 Mouse Pad. Category: Redragon. Subcategory: Mouse Pad. Price: Out Of Stock.

Product: Redragon Suzaku P003 Gaming Mouse Pad. Category: Redragon. Subcategory: Mouse Pad. Price: Out Of Stock.
",223,787951,788174
3248,recursive,"
Product: Redragon TAURUS P018 Gaming Mouse Pad. Category: Redragon. Subcategory: Mouse Pad. Price: Out Of Stock.

Product: Redragon KUNLUN P006A Gaming Mouse Pad. Category: Redragon. Subcategory: Mouse Pad. Price: Out Of Stock.
",229,788174,788403
3249,recursive,"
Product: Redragon NEPTUNE P027 RGB Gaming Extended Mouse Pad. Category: Redragon. Subcategory: Mouse Pad. Price: Out Of Stock.

Product: Redragon P033 NEPTUNE X  RGB Gaming Mouse Pad. Category: Redragon. Subcategory: Mouse Pad. Price: Out Of Stock.
",250,788403,788653
3250,recursive,"
Product: Redragon S137 4 in 1 Gaming Combo. Category: Redragon. Subcategory: Mouse Pad. Price: Out Of Stock.

Product: Elgato Green Screen Mouse Mat. Category: Elgato. Subcategory: Mouse Pad. Price: 3,500৳.
",208,788653,788861
3251,recursive,"
Product: DeepCool GM800 Gaming Mouse Pad. Category: DeepCool. Subcategory: Mouse Pad. Price: Out Of Stock.

Product: Deepcool GM810 Gaming Mouse Pad. Category: DeepCool. Subcategory: Mouse Pad. Price: Out Of Stock.
",216,788861,789077
3252,recursive,"
Product: DeepCool GT930 CORDURA XXL Gaming Mouse Pad. Category: DeepCool. Subcategory: Mouse Pad. Price: Out Of Stock.

Product: Meetion MT-PD120 Rubber LED RGB Gaming Mouse Pad. Category: MeeTion. Subcategory: Mouse Pad. Price: 1,650৳1,790৳.
",244,789077,789321
3253,recursive,"
Product: MeeTion MT-C011 Wired Gaming Mouse and Mouse Pad Combo. Category: MeeTion. Subcategory: Mouse Pad. Price: 2,250৳.

Product: Meetion MT-PD015 Anti Slip Gaming Mouse Pad. Category: MeeTion. Subcategory: Mouse Pad. Price: Out Of Stock.
",243,789321,789564
3254,recursive,"
Product: Meetion MT-PD121 Large RGB Backlit Keyboard and Mouse Pad for Gaming. Category: MeeTion. Subcategory: Mouse Pad. Price: Out Of Stock.

Product: X-raypad Aqua Control Plus XL Gaming Mouse Pad. Category: X-Raypad. Subcategory: Mouse Pad. Price: 2,300৳.
",261,789564,789825
3255,recursive,"
Product: X-raypad ROB Aqua Control Plus XL Gaming Mouse Pad. Category: X-Raypad. Subcategory: Mouse Pad. Price: 2,300৳.

Product: X-raypad White Aqua Control plus XL Gaming Mouse Pad. Category: X-Raypad. Subcategory: Mouse Pad. Price: 2,099৳2,300৳.
",250,789825,790075
3256,recursive,"
Product: X-raypad Aqua Control II XL Gaming Mouse Pad White. Category: X-Raypad. Subcategory: Mouse Pad. Price: 2,600৳.

Product: X-raypad Aqua Control II Sakura Green Gaming Mouse Pad. Category: X-Raypad. Subcategory: Mouse Pad. Price: 2,600৳.
",246,790075,790321
3257,recursive,"
Product: X-raypad Aqua Control II Sakura Blue Gaming Mouse Pad. Category: X-Raypad. Subcategory: Mouse Pad. Price: 2,600৳.

Product: X-raypad Aqua Control Zero Orange Gaming Mouse Pad. Category: X-Raypad. Subcategory: Mouse Pad. Price: 2,900৳.
",245,790321,790566
3258,recursive,"
Product: X-raypad Aqua Control plus XXL Gaming Mouse Pad White. Category: X-Raypad. Subcategory: Mouse Pad. Price: 3,900৳.

Product: X-raypad Aqua Control Plus XL Gaming Mouse Pad (Grey-Black). Category: X-Raypad. Subcategory: Mouse Pad. Price: Out Of Stock.
",260,790566,790826
3259,recursive,"
Product: X-raypad Aqua Control II XL Gaming Mouse Pad. Category: X-Raypad. Subcategory: Mouse Pad. Price: Out Of Stock.

Product: X-raypad Aqua Control II Sakura Night Gaming Mouse Pad. Category: X-Raypad. Subcategory: Mouse Pad. Price: Out Of Stock.
",252,790826,791078
3260,recursive,"
Product: X-raypad Aqua Control II Sakura Pink Gaming Mouse Pad. Category: X-Raypad. Subcategory: Mouse Pad. Price: Out Of Stock.

Product: X-raypad Aqua Control Zero Black Gaming Mouse Pad. Category: X-Raypad. Subcategory: Mouse Pad. Price: Out Of Stock.
",256,791078,791334
3261,recursive,"
Product: X-raypad Aqua Control Plus XXL Gaming Mouse Pad (Grey-Black). Category: X-Raypad. Subcategory: Mouse Pad. Price: Out Of Stock.

Product: X-raypad ROB Aqua Control Plus XXL Gaming Mouse Pad. Category: X-Raypad. Subcategory: Mouse Pad. Price: Out Of Stock.
",265,791334,791599
3262,recursive,"
Product: X-raypad Aqua Control Plus XXL Gaming Mouse Pad. Category: X-Raypad. Subcategory: Mouse Pad. Price: Out Of Stock.

Product: T-WOLF TF950 5 In 1 Wired Gaming Combo. Category: T-Wolf. Subcategory: Mouse Pad. Price: 2,450৳.
",231,791599,791830
3263,recursive,"
Product: Onikuma MP006 RGB Gaming Mousepad. Category: Onikuma. Subcategory: Mouse Pad. Price: 1,350৳.

Product: Onikuma MP005 RGB Gaming Mousepad. Category: Onikuma. Subcategory: Mouse Pad. Price: 1,400৳.
",206,791830,792036
3264,recursive,"
Product: MSI VIGOR WR01 Keyboard Wrist Rest. Category: Wrist Rest. Subcategory: Accessories. Price: 1,600৳.

Product: Asus AC01 ROG Gaming Wrist Rest. Category: Wrist Rest. Subcategory: Accessories. Price: Up Coming.
",218,792036,792254
3265,recursive,"
Product: Fantech AC4101M PILO Ergonomic Black Keyboard Wristpad. Category: Wrist Rest. Subcategory: Accessories. Price: Out Of Stock.

Product: Fantech AC4101L Keyboard Wristpad Large Black. Category: Wrist Rest. Subcategory: Accessories. Price: Out Of Stock.
",261,792254,792515
3266,recursive,"
Product: Redragon P023 Wrist Rest Pad. Category: Wrist Rest. Subcategory: Accessories. Price: Out Of Stock.

Product: AULA MP-W Mouse Pad with Sewing Edge. Category: AULA. Subcategory: Mouse Pad. Price: Up Coming.
",215,792515,792730
3267,recursive,"
Product: AULA MP-WFFM Gaming Mouse Pad with Sewing Edge. Category: AULA. Subcategory: Mouse Pad. Price: Up Coming.

Product: AULA F-X5 RGB Backlight Gaming Mouse Pad. Category: AULA. Subcategory: Mouse Pad. Price: Up Coming.
",226,792730,792956
3268,recursive,"
Product: AULA MP-XL Speed Type Gaming Mouse Pad. Category: AULA. Subcategory: Mouse Pad. Price: Out Of Stock.

Product: Onikuma ST-1 Stable Anti-Slip ABS Gaming Headphone Stand. Category: Headphone Stand. Subcategory: Accessories. Price: 450৳.
",245,792956,793201
3269,recursive,"
Product: Fantech TOWER II AC304 Headphone Stand. Category: Headphone Stand. Subcategory: Accessories. Price: 850৳.

Product: Fantech AC3001S RGB Tower Headphone Stand. Category: Headphone Stand. Subcategory: Accessories. Price: 1,450৳.
",237,793201,793438
3270,recursive,"
Product: MSI HS01 Headset Stand. Category: Headphone Stand. Subcategory: Accessories. Price: 3,000৳.

Product: Asus ROG Throne with 7.1 Surround Sound RGB Headphone Stand. Category: Headphone Stand. Subcategory: Accessories. Price: 8,699৳9,000৳.
",247,793438,793685
3271,recursive,"
Product: Fantech AC3001 Tower Headphone Stand. Category: Headphone Stand. Subcategory: Accessories. Price: Out Of Stock.

Product: Fantech AC3004 Gaming Headset Stand. Category: Headphone Stand. Subcategory: Accessories. Price: Out Of Stock.
",243,793685,793928
3272,recursive,"
Product: Redragon HA300 Scepter Pro RGB Backlit Gaming Headphone Stand. Category: Headphone Stand. Subcategory: Accessories. Price: Out Of Stock.

Product: Redragon SCEPTER ELITE HA311 RGB Headphone Stand with Mouse Bungee. Category: Headphone Stand. Subcategory: Accessories. Price: Out Of Stock.
",299,793928,794227
3273,recursive,"
Product: Havit TH650 RGB Headphone Stand with Dual Hanger & 2 USB Ports. Category: Headphone Stand. Subcategory: Accessories. Price: Out Of Stock.

Product: Fantech TOWER II AC304 PRO RGB Headphone Stand. Category: Headphone Stand. Subcategory: Accessories. Price: Out Of Stock.
",280,794227,794507
3274,recursive,"
Product: Corsair ST100 RGB Premium Headset Stand. Category: Headphone Stand. Subcategory: Accessories. Price: Out Of Stock.

Product: Asus ROG Throne Qi with 7.1 Surround Sound RGB Wireless Charging Headphone Stand. Category: Headphone Stand. Subcategory: Accessories. Price: Out Of Stock.
",291,794507,794798
3275,recursive,"
Product: Jedel S-562 RGB 2-in-1 Wired Soundbar. Category: Soundbar. Subcategory: Accessories. Price: 1,450৳.

Product: Onikuma L1 RGB Bluetooth Portable Soundbar. Category: Soundbar. Subcategory: Accessories. Price: 1,750৳.
",225,794798,795023
3276,recursive,"
Product: Havit SK854BT Bluetooth Speaker. Category: Soundbar. Subcategory: Accessories. Price: 1,780৳.

Product: Xtrike Me SK-604 2.0 Soundbar. Category: Soundbar. Subcategory: Accessories. Price: 2,100৳.
",206,795023,795229
3277,recursive,"
Product: Microlab MS212 Portable Bluetooth Soundbar. Category: Soundbar. Subcategory: Accessories. Price: 2,200৳.

Product: Havit SK215 2.0 RGB Bluetooth Soundbar. Category: Soundbar. Subcategory: Accessories. Price: 2,350৳.
",226,795229,795455
3278,recursive,"
Product: Havit SF149BT Portable Bluetooth Bar Speaker. Category: Soundbar. Subcategory: Accessories. Price: 2,700৳.

Product: Xtrike Me SP-211BT RGB Bluetooth Sound Bar. Category: Soundbar. Subcategory: Accessories. Price: 2,299৳2,700৳.
",238,795455,795693
3279,recursive,"
Product: Redragon GS570 Darknets RGB Bluetooth Stereo Soundbar. Category: Soundbar. Subcategory: Accessories. Price: 2,799৳2,900৳.

Product: Xiaomi Redmi MDZ-34-DA TV Soundbar Bluetooth & Wired Speaker. Category: Soundbar. Subcategory: Accessories. Price: 4,050৳4,500৳.
",271,795693,795964
3280,recursive,"
Product: Xtreme Race 2:1 Bluetooth Multimedia Soundbar with Remote. Category: Soundbar. Subcategory: Accessories. Price: 5,200৳.

Product: Awei Y999 Home Theater Bluetooth Soundbar Speaker. Category: Soundbar. Subcategory: Accessories. Price: 5,300৳5,799৳.
",258,795964,796222
3281,recursive,"
Product: Xtreme Glory 2:1 Bluetooth Multimedia Soundbar. Category: Soundbar. Subcategory: Accessories. Price: 6,400৳.

Product: Xtreme Falcon 5:1 Multimedia Bluetooth Soundbar. Category: Soundbar. Subcategory: Accessories. Price: 7,500৳.
",239,796222,796461
3282,recursive,"
Product: Microlab ONEBAR04 Stereo Bluetooth Soundbar. Category: Soundbar. Subcategory: Accessories. Price: 6,999৳7,900৳.

Product: Thonet & Vander BALKEN Bluetooth Soundbar. Category: Soundbar. Subcategory: Accessories. Price: 8,800৳.
",236,796461,796697
3283,recursive,"
Product: F&D HT-230 Soundbar Bluetooth Speaker. Category: Soundbar. Subcategory: Accessories. Price: 9,000৳.

Product: Wiwu S1 Bluetooth Soundbar Speaker. Category: Soundbar. Subcategory: Accessories. Price: 7,740৳9,000৳.
",223,796697,796920
3284,recursive,"
Product: Xtreme Harmony 5:1 Multimedia Soundbar with Remote. Category: Soundbar. Subcategory: Accessories. Price: 9,200৳.

Product: Thonet & Vander GUT Bluetooth Soundbar. Category: Soundbar. Subcategory: Accessories. Price: 10,000৳.
",235,796920,797155
3285,recursive,"
Product: Havit HV-SK473 USB 2.0 Speaker. Category: Speaker & Home Theater. Subcategory: Accessories. Price: 499৳530৳.

Product: Havit HV-SK486 USB 2.0 Speaker. Category: Speaker & Home Theater. Subcategory: Accessories. Price: 530৳.
",234,797155,797389
3286,recursive,"
Product: T-WOLF S2 Dual Wired Speaker. Category: Speaker & Home Theater. Subcategory: Accessories. Price: 598৳.

Product: Havit SK704 2:0 USB Speaker. Category: Speaker & Home Theater. Subcategory: Accessories. Price: 549৳600৳.
",229,797389,797618
3287,recursive,"
Product: Havit SK717 USB Stereo Speaker with LED Backlit. Category: Speaker & Home Theater. Subcategory: Accessories. Price: 599৳650৳.

Product: Jedel S-511 USB Mini Speaker. Category: Speaker & Home Theater. Subcategory: Accessories. Price: 650৳.
",249,797618,797867
3288,recursive,"
Product: HAVIT SK764 USB Stereo Speaker. Category: Speaker & Home Theater. Subcategory: Accessories. Price: 690৳.

Product: Havit SK210 Mini Pro 2.0 RGB Gaming Speaker. Category: Speaker & Home Theater. Subcategory: Accessories. Price: 649৳690৳.
",247,797867,798114
3289,recursive,"
Product: T-Wolf S3 Portable Wired RGB Gaming Speaker. Category: Speaker & Home Theater. Subcategory: Accessories. Price: 700৳.

Product: Havit SK715 2.0 USB Stereo Speaker. Category: Speaker & Home Theater. Subcategory: Accessories. Price: 750৳.
",247,798114,798361
3290,recursive,"
Product: Havit SK706 Stereo LED Backlit USB Speaker. Category: Speaker & Home Theater. Subcategory: Accessories. Price: 800৳.

Product: Havit SK708 2:0 RGB USB Gaming Speaker. Category: Speaker & Home Theater. Subcategory: Accessories. Price: 779৳850৳.
",254,798361,798615
3291,recursive,"
Product: Havit SK709 LED USB Speaker. Category: Speaker & Home Theater. Subcategory: Accessories. Price: 850৳.

Product: Jedel S-554 RGB USB Speaker. Category: Speaker & Home Theater. Subcategory: Accessories. Price: 900৳.
",224,798615,798839
3292,recursive,"
Product: Jedel S-553 RGB USB Speaker. Category: Speaker & Home Theater. Subcategory: Accessories. Price: 900৳.

Product: Havit SK518 2.0 USB Speaker. Category: Speaker & Home Theater. Subcategory: Accessories. Price: 950৳.
",224,798839,799063
3293,recursive,"
Product: Havit SK599 2.0 USB Speaker. Category: Speaker & Home Theater. Subcategory: Accessories. Price: 960৳.

Product: Xtrike Me SK-405 2.0 Channel Stereo RGB Gaming Speaker. Category: Speaker & Home Theater. Subcategory: Accessories. Price: 799৳1,000৳.
",257,799063,799320
3294,recursive,"
Product: Jedel S-527 RGB Wired USB Speaker. Category: Speaker & Home Theater. Subcategory: Accessories. Price: 1,000৳.

Product: Jedel S-526 RGB USB Mini Speaker. Category: Speaker & Home Theater. Subcategory: Accessories. Price: 1,000৳.
",239,799320,799559
3295,recursive,"
Product: Logitech C270 HD Webcam. Category: Logitech. Subcategory: Webcam. Price: 2,300৳.

Product: Logitech Brio 100 Full HD Privacy Shutter Webcam. Category: Logitech. Subcategory: Webcam. Price: 3,900৳.
",207,799559,799766
3296,recursive,"
Product: Logitech BRIO 300 Full HD 1080p 2MP Webcam. Category: Logitech. Subcategory: Webcam. Price: 7,300৳.

Product: Logitech C920 HD PRO Full HD Webcam. Category: Logitech. Subcategory: Webcam. Price: 12,500৳.
",214,799766,799980
3297,recursive,"
Product: Logitech BRIO 500 Full HD 1080p 4MP Auto-framing Webcam. Category: Logitech. Subcategory: Webcam. Price: 12,500৳.

Product: Logitech C922 Pro Full HD Webcam. Category: Logitech. Subcategory: Webcam. Price: 12,499৳13,000৳.
",232,799980,800212
3298,recursive,"
Product: Logitech MX Brio Ultra HD 4K Webcam. Category: Logitech. Subcategory: Webcam. Price: 21,800৳.

Product: Logitech C930E Full HD Video Conferencing Webcam. Category: Logitech. Subcategory: Webcam. Price: Out Of Stock.
",226,800212,800438
3299,recursive,"
Product: A4tech PK-825P 720P HD Webcam. Category: A4TECH. Subcategory: Webcam. Price: 1,999৳2,150৳.

Product: A4TECH Pk-910H 1080p Full-HD Webcam. Category: A4TECH. Subcategory: Webcam. Price: 2,299৳2,500৳.
",208,800438,800646
3300,recursive,"
Product: A4Tech PK-935HL 1080p Full HD Webcam. Category: A4TECH. Subcategory: Webcam. Price: 3,199৳3,400৳.

Product: A4TECH PK-1000HA UHD 4K Pro Auto Focus Webcam. Category: A4TECH. Subcategory: Webcam. Price: 12,999৳13,500৳.
",227,800646,800873
3301,recursive,"
Product: A4Tech Pk-910P 720P High-HD Webcam. Category: A4TECH. Subcategory: Webcam. Price: Out Of Stock.

Product: A4tech PK-940HA FHD 1080P AF Webcam. Category: A4TECH. Subcategory: Webcam. Price: Out Of Stock.
",213,800873,801086
3302,recursive,"
Product: Xtreme Ikarao Waterproof Travel Bag for Break X2 Speaker. Category: Bluetooth Speakers. Subcategory: Accessories. Price: 2,300৳.

Product: Xtreme Ikarao Waterproof Travel Trolley Bag for Break X1 Speaker. Category: Bluetooth Speakers. Subcategory: Accessories. Price: 6,300৳.
",286,801086,801372
3303,recursive,"
Product: F&D F380 X 2.1 Channel Multimedia Bluetooth Speakers. Category: Bluetooth Speakers. Subcategory: Accessories. Price: 8,600৳.

Product: F&D W4 Wireless Portable Bluetooth Speaker. Category: Bluetooth Speakers. Subcategory: Accessories. Price: Up Coming.
",263,801372,801635
3304,recursive,"
Product: Awei Y385 Mini Portable Bluetooth Speaker. Category: Bluetooth Speakers. Subcategory: Accessories. Price: 891৳990৳.

Product: Hoco HC22 Stereo Bluetooth Wireless Speaker. Category: Bluetooth Speakers. Subcategory: Accessories. Price: 972৳1,080৳.
",256,801635,801891
3305,recursive,"
Product: Hoco BS60 Portable Bluetooth Speaker. Category: Bluetooth Speakers. Subcategory: Accessories. Price: 1,020৳1,102৳.

Product: Yison Celebrat SP-3 Portable Bluetooth Speaker. Category: Bluetooth Speakers. Subcategory: Accessories. Price: 900৳1,150৳.
",258,801891,802149
3306,recursive,"
Product: Hoco BS47 UNO Bluetooth Wireless Speaker. Category: Bluetooth Speakers. Subcategory: Accessories. Price: 1,050৳1,150৳.

Product: Yison Celebrat SP-8 Portable Bluetooth Speaker. Category: Bluetooth Speakers. Subcategory: Accessories. Price: 1,090৳1,160৳.
",264,802149,802413
3307,recursive,"
Product: Hoco HC1 True Wireless Waterproof Bluetooth Speaker. Category: Bluetooth Speakers. Subcategory: Accessories. Price: 1,080৳1,180৳.

Product: JOYROOM JR-ML03 Transparent RGB Bluetooth Wireless Speaker. Category: Bluetooth Speakers. Subcategory: Accessories. Price: 960৳1,200৳.
",285,802413,802698
3308,recursive,"
Product: Yison Celebrat SKY-3 Portable Bluetooth Speaker. Category: Bluetooth Speakers. Subcategory: Accessories. Price: 1,190৳1,290৳.

Product: Havit SK838BT Portable Bluetooth Speaker. Category: Bluetooth Speakers. Subcategory: Accessories. Price: 1,175৳1,350৳.
",265,802698,802963
3309,recursive,"
Product: Megastar Avengers Gaming G002 Wireless Neck Speaker. Category: Bluetooth Speakers. Subcategory: Accessories. Price: 1,250৳1,350৳.

Product: Yison Celebrat SP-19 Portable Bluetooth Speaker. Category: Bluetooth Speakers. Subcategory: Accessories. Price: 1,237৳1,390৳.
",276,802963,803239
3310,recursive,"
Product: Hoco HC16 True Wireless Bluetooth Speaker. Category: Bluetooth Speakers. Subcategory: Accessories. Price: 1,259৳1,399৳.

Product: Havit HV-M3 Portable Alarm Clock Bluetooth Speaker. Category: Bluetooth Speakers. Subcategory: Accessories. Price: 1,250৳1,450৳.
",269,803239,803508
3311,recursive,"
Product: Havit SK800BT Portable Bluetooth Speaker. Category: Bluetooth Speakers. Subcategory: Accessories. Price: 1,240৳1,450৳.

Product: Recci RSK-W09 Portable Bluetooth Speaker. Category: Bluetooth Speakers. Subcategory: Accessories. Price: 1,360৳1,450৳.
",258,803508,803766
3312,recursive,"
Product: Havit N5086 HD Webcam. Category: Havit. Subcategory: Webcam. Price: 1,150৳.

Product: Havit HN25G HD Webcam With Beauty Light. Category: Havit. Subcategory: Webcam. Price: 1,450৳.

Product: Havit HV-HN11P 1080P Webcam. Category: Havit. Subcategory: Webcam. Price: 1,900৳.
",282,803766,804048
3313,recursive,"
Product: ASUS C3 Full HD Streaming USB Webcam. Category: Asus. Subcategory: Webcam. Price: 6,499৳6,900৳.

Product: Asus ROG Eye S Full HD 60fps Webcam. Category: Asus. Subcategory: Webcam. Price: 9,599৳10,000৳.
",212,804048,804260
3314,recursive,"
Product: Rapoo C200 720P HD Webcam. Category: Webcam. Subcategory: Accessories. Price: 2,199৳2,500৳.

Product: Redragon GW600 FOBOS 720P Webcam. Category: Webcam. Subcategory: Accessories. Price: 2,850৳.
",205,804260,804465
3315,recursive,"
Product: Fantech Luminous C30 USB 2K Quad HD 4MP Webcam. Category: Webcam. Subcategory: Accessories. Price: 3,250৳3,500৳.

Product: Rapoo C280 2K Webcam. Category: Webcam. Subcategory: Accessories. Price: 4,400৳.
",214,804465,804679
3316,recursive,"
Product: Magpie MG-WC05NC3 5.0 MP Privacy Shutter Webcam. Category: Webcam. Subcategory: Accessories. Price: 4,199৳4,500৳.

Product: Redragon GW910 ONESHOT 1080P PC Webcam. Category: Webcam. Subcategory: Accessories. Price: 4,599৳4,900৳.
",239,804679,804918
3317,recursive,"
Product: Redragon GW900 APEX 1080P Webcam. Category: Webcam. Subcategory: Accessories. Price: 5,149৳5,300৳.

Product: Fantech Luminous C50 Webcam. Category: Webcam. Subcategory: Accessories. Price: 5,800৳.

Product: Elgato Facecam Neo. Category: Webcam. Subcategory: Accessories. Price: 10,000৳.
",297,804918,805215
3318,recursive,"
Product: Elgato Facecam Premium 1080p Webcam. Category: Elgato. Subcategory: Webcam. Price: 18,499৳19,500৳.

Product: Rapoo C260 USB Full HD Webcam. Category: Rapoo. Subcategory: Webcam. Price: Out Of Stock.
",209,805215,805424
3319,recursive,"
Product: Redragon GW800 HITMAN 1080P Webcam. Category: Redragon. Subcategory: Webcam. Price: Out Of Stock.

Product: Oraimo RobustLine 1M USB to Lightning Cable #OCD-114L. Category: USB Cable. Subcategory: Cable. Price: 155৳.
",227,805424,805651
3320,recursive,"
Product: Awei CL-115M 1 Meter USB to Micro USB 2.4A Fast Charging Cable. Category: USB Cable. Subcategory: Cable. Price: 170৳.

Product: FJGEAR 1.5 Meter USB Extension Cable. Category: USB Cable. Subcategory: Cable. Price: 195৳.
",230,805651,805881
3321,recursive,"
Product: Riversong CM85 Beta 09 Micro USB Data Cable. Category: USB Cable. Subcategory: Cable. Price: 140৳199৳.

Product: Foneng XS01 1 Meter USB to Type-C Cable. Category: USB Cable. Subcategory: Cable. Price: 199৳.
",218,805881,806099
3322,recursive,"
Product: Megastar FC-M001 2 Meter Micro USB Fast Charging Cable. Category: USB Cable. Subcategory: Cable. Price: 140৳250৳.

Product: Yuanxin YUX-003 USB Male to Micro USB 0.8 Meter Cable. Category: USB Cable. Subcategory: Cable. Price: 230৳250৳.
",247,806099,806346
3323,recursive,"
Product: Yuanxin YUX-003 USB Male to Male 1.5 Meter Cable. Category: USB Cable. Subcategory: Cable. Price: 250৳.

Product: Awei CL-10 0.3 Meter USB to Micro USB Fast Charging Cable. Category: USB Cable. Subcategory: Cable. Price: 199৳250৳.
",241,806346,806587
3324,recursive,"
Product: Megastar FC-C001 2 Meter USB to Type C Fast Charging Cable. Category: USB Cable. Subcategory: Cable. Price: 190৳299৳.

Product: Vention CCSBB USB 2.0 Type C Male to USB A Female OTG Cable 0.15M. Category: USB Cable. Subcategory: Cable. Price: 280৳325৳.
",263,806587,806850
3325,recursive,"
Product: Yuanxin X-KC801 USB Male to Type-C Male 1 Meter Data & Charging Cable. Category: USB Cable. Subcategory: Cable. Price: 290৳350৳.

Product: WiWU TITAN LINK Series Wi-C055 1 Meter USB A to Lightning Cable. Category: USB Cable. Subcategory: Cable. Price: 350৳.
",268,806850,807118
3326,recursive,"
Product: Vyvylabs VCSUC-02 Crystal Series USB to Type-C 1M Fast Charging Cable. Category: USB Cable. Subcategory: Cable. Price: 320৳357৳.

Product: Yuanxin YAX-006 1.5 Meter 3.5mm Male to Male Audio Cable. Category: Cable. Subcategory: Accessories. Price: 150৳.
",263,807118,807381
3327,recursive,"
Product: Yison Celebrat CB-31 A-C 1 Meter USB to USB Type-C Cable. Category: Cable. Subcategory: Accessories. Price: 158৳.

Product: Yison Celebrat CB-31 A-C-White 1 Meter USB to USB Type-C Cable. Category: Cable. Subcategory: Accessories. Price: 158৳.
",254,807381,807635
3328,recursive,"
Product: CHARG C3L 1 Meter USB to Lightning Cable. Category: Cable. Subcategory: Accessories. Price: 160৳.

Product: CHARG C3CC 1 Meter Type C Cable. Category: Cable. Subcategory: Accessories. Price: 175৳.
",207,807635,807842
3329,recursive,"
Product: Yuanxin YAX-008 1.5 Meter 3.5mm Male to Male Audio Cable. Category: Cable. Subcategory: Accessories. Price: 190৳.

Product: Havit 5 Meter VGA Male to Male Cable. Category: VGA Cable. Subcategory: Cable. Price: 400৳.
",226,807842,808068
3330,recursive,"
Product: Yuanxin YVX-001 VGA Male to Male 1.5 Meter Cable. Category: VGA Cable. Subcategory: Cable. Price: 400৳500৳.

Product: Yuanxin YVX-002 VGA Male to Male 3 Meter Cable. Category: VGA Cable. Subcategory: Cable. Price: 560৳580৳.
",234,808068,808302
3331,recursive,"
Product: Ugreen VG101 2 Meter VGA Male to Male Cable #11646. Category: VGA Cable. Subcategory: Cable. Price: 630৳.

Product: HAVIT Male to Male 10 Meter VGA Cable. Category: VGA Cable. Subcategory: Cable. Price: 680৳740৳.
",223,808302,808525
3332,recursive,"
Product: Yuanxin YVX-005 VGA Male to Male 5 Meter Cable. Category: VGA Cable. Subcategory: Cable. Price: 650৳750৳.

Product: UGREEN VG101 VGA Male to Male 5m Cable #11632. Category: VGA Cable. Subcategory: Cable. Price: 1,050৳.
",229,808525,808754
3333,recursive,"
Product: Ugreen DP105 1.5 Meter DisplayPort to VGA Cable #10247. Category: VGA Cable. Subcategory: Cable. Price: 1,050৳.

Product: HAVIT Male to Male 20 Meter VGA Cable. Category: VGA Cable. Subcategory: Cable. Price: 1,120৳.
",227,808754,808981
3334,recursive,"
Product: FJGEAR 15 Meter VGA Cable. Category: VGA Cable. Subcategory: Cable. Price: 890৳1,150৳.

Product: VENTION DAEBL VGA(3+6) Male to Male Cable with ferrite cores 10M. Category: VGA Cable. Subcategory: Cable. Price: 1,190৳1,400৳.
",235,808981,809216
3335,recursive,"
Product: Yuanxin YVX-010 VGA Male to Male 10 Meter Cable. Category: VGA Cable. Subcategory: Cable. Price: 1,400৳.

Product: HAVIT Male to Male 30 Meter VGA Cable. Category: VGA Cable. Subcategory: Cable. Price: 1,990৳.
",220,809216,809436
3336,recursive,"
Product: Yuanxin YVX-015 VGA Male to Male 15 Meter Cable. Category: VGA Cable. Subcategory: Cable. Price: 2,000৳.

Product: FJGEAR 30 Meter VGA Cable. Category: VGA Cable. Subcategory: Cable. Price: 2,200৳.
",208,809436,809644
3337,recursive,"
Product: UGREEN VG101 15m Male to Male VGA Cable #11634. Category: VGA Cable. Subcategory: Cable. Price: 2,520৳.

Product: Yuanxin YVX-020 VGA Male to Male 20 Meter Cable. Category: VGA Cable. Subcategory: Cable. Price: 2,700৳.
",229,809644,809873
3338,recursive,"
Product: FJGEAR 40 Meter VGA Cable. Category: VGA Cable. Subcategory: Cable. Price: 3,100৳.

Product: UGREEN VG101 20m Male to Male VGA Cable #11635. Category: VGA Cable. Subcategory: Cable. Price: 3,120৳.
",207,809873,810080
3339,recursive,"
Product: Dtech DT-V011 50 Meter VGA Cable. Category: VGA Cable. Subcategory: Cable. Price: Up Coming.

Product: VENTION VAB-B06-B150-M 1.5 Meter 3.5mm Audio Extension Cable. Category: Audio Cable. Subcategory: Cable. Price: 280৳.
",231,810080,810311
3340,recursive,"
Product: UGREEN AV141 3.5mm Male To Dual 3.5mm Female Headphone Splitter Cable. Category: Audio Cable. Subcategory: Cable. Price: 350৳.

Product: Vention BBVBY Dual 3.5mm Female to 3.5mm Male Stereo Splitter Audio Cable. Category: Audio Cable. Subcategory: Cable. Price: 350৳.
",278,810311,810589
3341,recursive,"
Product: Hoco UPA26 1 Meter Type-C to 3.5mm Aux Audio Cable. Category: Audio Cable. Subcategory: Cable. Price: 350৳.

Product: Hoco UPA26 1 Meter Lightning to 3.5mm Aux Audio Cable. Category: Audio Cable. Subcategory: Cable. Price: 350৳.
",239,810589,810828
3342,recursive,"
Product: Hoco UPA21 One Female to Dual Male 3.5mm Splitter Audio Cable. Category: Audio Cable. Subcategory: Cable. Price: 290৳350৳.

Product: Hoco UPA21 one Male to Dual Female 3.5mm Splitter Audio Cable. Category: Audio Cable. Subcategory: Cable. Price: 290৳350৳.
",266,810828,811094
3343,recursive,"
Product: UGREEN AV119 5M 3.5mm Audio Extension Cable #10729. Category: Audio Cable. Subcategory: Cable. Price: 430৳.

Product: UGREEN AV119 3M 3.5mm Audio Extension Cable #10728. Category: Audio Cable. Subcategory: Cable. Price: 390৳.
",236,811094,811330
3344,recursive,"
Product: UGREEN AV140 3.5mm Female To Dual 3.5mm Male Audio Splitter Cable #20897. Category: Audio Cable. Subcategory: Cable. Price: 350৳.

Product: Ugreen AV112 2M 3.5mm Audio Cable #10687. Category: Audio Cable. Subcategory: Cable. Price: 360৳.
",248,811330,811578
3345,recursive,"
Product: Ugreen AV118 3M 3.5mm Male to Female Audio Extension Cable #10595. Category: Audio Cable. Subcategory: Cable. Price: 380৳.

Product: Ugreen AV122 1.5 Meter Toslink Optical Audio Cable #70891. Category: Audio Cable. Subcategory: Cable. Price: 390৳.
",258,811578,811836
3346,recursive,"
Product: VENTION VAB-B06-B300-M 3 Meter 3.5mm Audio Extension Cable. Category: Audio Cable. Subcategory: Cable. Price: 400৳.

Product: UGREEN AV122 Toslink Optical Male To Male Audio Cable #70892. Category: Audio Cable. Subcategory: Cable. Price: 440৳.
",254,811836,812090
3347,recursive,"
Product: Ugreen AV112 3.5mm Male to Male 3 Meter Audio Cable #10688. Category: Audio Cable. Subcategory: Cable. Price: 450৳.

Product: UGREEN AV134 3.5mm Male to Dual Female Headphone Splitter Cable #20816. Category: Audio Cable. Subcategory: Cable. Price: 390৳450৳.
",268,812090,812358
3348,recursive,"
Product: Yuanxin YAX-003 3 Meter 3.5mm Male to Male Audio Cable. Category: Audio Cable. Subcategory: Cable. Price: 250৳450৳.

Product: Vention AACBF 1Meter High-Speed HDMI Cable. Category: HDMI Cable. Subcategory: Cable. Price: 240৳250৳.
",239,812358,812597
3349,recursive,"
Product: VENTION VAA-D02-B150 1.5 Meter Mini HDMI to HDMI Cable. Category: HDMI Cable. Subcategory: Cable. Price: 350৳.

Product: Vention AACBH 2Meter High-Speed HDMI Cable. Category: HDMI Cable. Subcategory: Cable. Price: 320৳375৳.
",234,812597,812831
3350,recursive,"
Product: Vention AACBG 1.5M Male to Male HDMI Cable. Category: HDMI Cable. Subcategory: Cable. Price: 290৳450৳.

Product: Yuanxin YHX-002 HDMI Male to Male 1.5 Meter Cable. Category: HDMI Cable. Subcategory: Cable. Price: 390৳450৳.
",233,812831,813064
3351,recursive,"
Product: Yuanxin YHD-001 HDMI Male to DVI Male 1.8 Meter Cable. Category: HDMI Cable. Subcategory: Cable. Price: 490৳.

Product: Vention AACBI 3Meter High-Speed HDMI Cable. Category: HDMI Cable. Subcategory: Cable. Price: 450৳499৳.
",233,813064,813297
3352,recursive,"
Product: Vention VAA-B06-B300 HDMI Male to Female 3M Extension Cable. Category: HDMI Cable. Subcategory: Cable. Price: 500৳.

Product: UGREEN HD107 HDMI Male to Female 2m Cable #10142. Category: HDMI Cable. Subcategory: Cable. Price: 490৳550৳.
",245,813297,813542
3353,recursive,"
Product: Yuanxin YHX-003 Male to Male 3 Meter HDMI Cable. Category: HDMI Cable. Subcategory: Cable. Price: 430৳550৳.

Product: UGREEN HD118 2M HDMI Cable #40410. Category: HDMI Cable. Subcategory: Cable. Price: 580৳650৳.
",222,813542,813764
3354,recursive,"
Product: UGREEN HD103 Right Angle 90° 2M HDMI Cable #10173. Category: HDMI Cable. Subcategory: Cable. Price: 520৳650৳.

Product: Ugreen HD163 2 Meter Mini HDMI to HDMI 8K Cable #15515. Category: HDMI Cable. Subcategory: Cable. Price: 780৳.
",241,813764,814005
3355,recursive,"
Product: FJGEAR 10 Meter 1.4 Version HDMI Cable. Category: HDMI Cable. Subcategory: Cable. Price: 800৳.

Product: Yuanxin YHX-020 HDMI Male to Male 5 Meter Cable. Category: HDMI Cable. Subcategory: Cable. Price: 740৳800৳.
",223,814005,814228
3356,recursive,"
Product: Belkin F3Y020bt1M High-Speed HDMI Cable with Ethernet. Category: HDMI Cable. Subcategory: Cable. Price: 600৳850৳.

Product: Yuanxin YHX-022 HDMI Male to Male 3 Meter Cable. Category: HDMI Cable. Subcategory: Cable. Price: 750৳850৳.
",242,814228,814470
3357,recursive,"
Product: Baseus High Definition Series HDMI To HDMI Graphene 4K Adapter Cable 2 Meter. Category: HDMI Cable. Subcategory: Cable. Price: 780৳899৳.

Product: Vention AACBK 8Meter High-Speed HDMI Cable. Category: HDMI Cable. Subcategory: Cable. Price: 850৳925৳.
",260,814470,814730
3358,recursive,"
Product: Belkin F3Y021bt1M HDMI Male to HDMI Male Cable. Category: HDMI Cable. Subcategory: Cable. Price: 880৳950৳.

Product: Riversong CT56 Alpha 03 Premium Nylon Braided Fast Charging Type-C Cable. Category: Type-C Cable. Subcategory: Cable. Price: 199৳.
",258,814730,814988
3359,recursive,"
Product: CHARG C3C 1 Meter USB to Type C Cable. Category: Type-C Cable. Subcategory: Cable. Price: 200৳.

Product: Awei CL-115T USB to Type-C Fast Charging Cable. Category: Type-C Cable. Subcategory: Cable. Price: 149৳300৳.
",225,814988,815213
3360,recursive,"
Product: Vention TRCSF 1M Type-C to Type-C Cable. Category: Type-C Cable. Subcategory: Cable. Price: 300৳.

Product: Vention TRDWF 1M Type-C to Type-C Cable. Category: Type-C Cable. Subcategory: Cable. Price: 300৳.
",216,815213,815429
3361,recursive,"
Product: Wiwu Titan Link Series Wi-C054 1 Meter USB A to Type C Cable. Category: Type-C Cable. Subcategory: Cable. Price: 350৳.

Product: WiWU Titan Link Series Wi-C057 1.2 Meter Type-C Cable. Category: Type-C Cable. Subcategory: Cable. Price: 350৳.
",251,815429,815680
3362,recursive,"
Product: Vention TRCSH 2M Type-C to Type-C Cable. Category: Type-C Cable. Subcategory: Cable. Price: 350৳.

Product: Yuanxin YDP-002 Mini DisplayPort Male to Male 1.8 Meter Cable. Category: DisplayPort Cable. Subcategory: Cable. Price: 490৳650৳.
",247,815680,815927
3363,recursive,"
Product: Yuanxin YDH-001 Mini DisplayPort Male to HDMI Male 1.8 Meter Cable. Category: DisplayPort Cable. Subcategory: Cable. Price: 590৳650৳.

Product: Vention HAABG 1.5 Meter Mini DisplayPort to DisplayPort Cable. Category: DisplayPort Cable. Subcategory: Cable. Price: 660৳.
",279,815927,816206
3364,recursive,"
Product: Dtech DT-CU0308 1.8M DP To DP Cable. Category: DisplayPort Cable. Subcategory: Cable. Price: 550৳.

Product: Dtech DT-CU0308 3M DP To DP Cable. Category: DisplayPort Cable. Subcategory: Cable. Price: 690৳.
",216,816206,816422
3365,recursive,"
Product: Yuanxin YDH-002 DisplayPort Male to HDMI Male 1.8 Meter Cable. Category: DisplayPort Cable. Subcategory: Cable. Price: 740৳800৳.

Product: Yuanxin YDP-003 3 Meter DisplayPort Cable. Category: DisplayPort Cable. Subcategory: Cable. Price: 800৳.
",254,816422,816676
3366,recursive,"
Product: Yuanxin YDP-001 DisplayPort Male to Male 1.8 Meter Cable. Category: DisplayPort Cable. Subcategory: Cable. Price: 600৳890৳.

Product: Yuanxin YDP-003 Mini DisplayPort Male to DisplayPort Male 1.8 Meter Cable. Category: DisplayPort Cable. Subcategory: Cable. Price: 790৳890৳.
",285,816676,816961
3367,recursive,"
Product: Vention HCDBI 3 Meter 8K DisplayPort 1.4 Cable. Category: DisplayPort Cable. Subcategory: Cable. Price: 800৳900৳.

Product: Yuanxin X-3214 DisplayPort Male to USB Type-C Male 1.8 Meter Cable. Category: DisplayPort Cable. Subcategory: Cable. Price: 950৳1,050৳.
",270,816961,817231
3368,recursive,"
Product: UGREEN DP103 2 Meter DP to DVI Cable #10221. Category: DisplayPort Cable. Subcategory: Cable. Price: 990৳1,200৳.

Product: UGREEN DP101 5 Meter DisplayPort to HDMI Cable #10204. Category: DisplayPort Cable. Subcategory: Cable. Price: 1,550৳.
",252,817231,817483
3369,recursive,"
Product: Vention HCELI 3 Meter 8K Male to Male DisplayPort Cable. Category: DisplayPort Cable. Subcategory: Cable. Price: 1,330৳1,600৳.

Product: Ugreen DP119 3 Meter 4K DisplayPort To HDMI Cable #25491. Category: DisplayPort Cable. Subcategory: Cable. Price: 1,800৳.
",269,817483,817752
3370,recursive,"
Product: UGREEN MM139 USB Type-C to DP Cable #50994. Category: DisplayPort Cable. Subcategory: Cable. Price: 1,690৳1,860৳.

Product: Ugreen DP114 1.5 Meter DisplayPort Cable #80391. Category: DisplayPort Cable. Subcategory: Cable. Price: Out Of Stock.
",253,817752,818005
3371,recursive,"
Product: Vention HCELG 1.5M 8K Male to Male DisplayPort Cable. Category: DisplayPort Cable. Subcategory: Cable. Price: Out Of Stock.

Product: Vention HBLBG DP to VGA Cable 1.5M. Category: DisplayPort Cable. Subcategory: Cable. Price: Out Of Stock.
",250,818005,818255
3372,recursive,"
Product: Awei CL-115L 1 Meter USB to Lightning 2.4A Fast Charging Cable. Category: Lightning Cable. Subcategory: Cable. Price: 149৳250৳.

Product: Yuanxin X-KC802 USB Male to Lightning Male 1 Meter Data & Charging Cable. Category: Lightning Cable. Subcategory: Cable. Price: 275৳350৳.
",286,818255,818541
3373,recursive,"
Product: Foneng XS02 1.2M 60W & PD 27W Type-C Cable. Category: Lightning Cable. Subcategory: Cable. Price: 399৳449৳.

Product: Baseus Rapid Series 3-in-1 Micro+Dual Lightning 3A Cable 1.2 Meter. Category: Lightning Cable. Subcategory: Cable. Price: 389৳450৳.
",260,818541,818801
3374,recursive,"
Product: Hoco U125 Benefit USB-A to Lightning 12W Data Cable With Display. Category: Lightning Cable. Subcategory: Cable. Price: 450৳.

Product: Awei CL-206L USB to Lightning Fast Charging Cable. Category: Lightning Cable. Subcategory: Cable. Price: 350৳450৳.
",261,818801,819062
3375,recursive,"
Product: Yison Celebrat CB-22 A-L 1.2 Meter USB to Lightning Cable. Category: Lightning Cable. Subcategory: Cable. Price: 429৳469৳.

Product: Yuanxin X-KC805 USB Type-C Male to Lightning Male Data & Charging Cable. Category: Lightning Cable. Subcategory: Cable. Price: 450৳500৳.
",280,819062,819342
3376,recursive,"
Product: Vyvylabs VCSCL-02 Fast Charging Type-C to Lightning Cable. Category: Lightning Cable. Subcategory: Cable. Price: 470৳508৳.

Product: ZOOOK Fastlink i Lightning Rapid Charge & Sync Cable. Category: Lightning Cable. Subcategory: Cable. Price: 390৳550৳.
",261,819342,819603
3377,recursive,"
Product: Foneng X92 60W 4-in-1 Fast Charging Cable. Category: Lightning Cable. Subcategory: Cable. Price: 499৳599৳.

Product: Vention H16BF 1M Type-C to Lightning Cable. Category: Lightning Cable. Subcategory: Cable. Price: 550৳600৳.
",235,819603,819838
3378,recursive,"
Product: Vention H17BAV 1.2M 2-in-1 Type-C to Lightning Cable. Category: Lightning Cable. Subcategory: Cable. Price: 550৳600৳.

Product: Riversong C58 Infinity 05 3 in 1 Data Cable. Category: Lightning Cable. Subcategory: Cable. Price: 390৳639৳.
",247,819838,820085
3379,recursive,"
Product: ZOOOK MagicLight i USB A to Lightning Smart LED Fast Charging Cable. Category: Lightning Cable. Subcategory: Cable. Price: 590৳700৳.

Product: Foneng X80 100W 3-in-1 USB Fast Charging Cable. Category: Lightning Cable. Subcategory: Cable. Price: 699৳749৳.
",265,820085,820350
3380,recursive,"
Product: VENTION AIOB0 HDMI 90 Degree Male to Female Adapter. Category: Converter. Subcategory: Accessories. Price: 120৳180৳.

Product: Hoco UA17 Type-C Male to USB 3.0 Female Adapter. Category: Converter. Subcategory: Accessories. Price: 240৳.
",246,820350,820596
3381,recursive,"
Product: UGREEN Mini HDMI Male to HDMI Female Adapter. Category: Converter. Subcategory: Accessories. Price: 250৳.

Product: UGREEN US157 USB Type-C to Micro USB Adapter #30391. Category: Converter. Subcategory: Accessories. Price: 190৳250৳.
",243,820596,820839
3382,recursive,"
Product: VENTION AIRB0 HDMI Female to Female Coupler Adapter. Category: Converter. Subcategory: Accessories. Price: 180৳250৳.

Product: UGREEN HD112 HDMI Male to Female Down HDMI Converter #20109. Category: Converter. Subcategory: Accessories. Price: 220৳250৳.
",262,820839,821101
3383,recursive,"
Product: UGREEN HD112 HDMI Male to Female UP HDMI Converter #20110. Category: Converter. Subcategory: Accessories. Price: 300৳.

Product: VENTION BDBW0 3.5mm Male to Dual Female Audio Converter. Category: Converter. Subcategory: Accessories. Price: 250৳300৳.
",260,821101,821361
3384,recursive,"
Product: Ugreen HD159 8K Female to Female HDMI Converter #90592. Category: Converter. Subcategory: Accessories. Price: 300৳.

Product: Vention AGFB0 2-in-1 Micro & Mini HDMI Male to HDMI Female Converter. Category: Converter. Subcategory: Accessories. Price: 280৳325৳.
",270,821361,821631
3385,recursive,"
Product: UGREEN US282 Type-C Female to Micro USB Male Adapter #50590. Category: Converter. Subcategory: Accessories. Price: 329৳.

Product: UGREEN US154 Type-C To USB Female Cable #30701. Category: Converter. Subcategory: Accessories. Price: 350৳.
",249,821631,821880
3386,recursive,"
Product: UGREEN US381 Female to Female USB 3.0 Converter #20119. Category: Converter. Subcategory: Accessories. Price: 350৳.

Product: WiWU Wi-C052 A-C USB to Type-C PD Fast Charging Converter. Category: Converter. Subcategory: Accessories. Price: 350৳.
",255,821880,822135
3387,recursive,"
Product: WiWU Wi-C052 C-L Type-C to Lightning PD Fast Charging Converter. Category: Converter. Subcategory: Accessories. Price: 350৳.

Product: VENTION CDIB0 OTG Adapter For Android. Category: Converter. Subcategory: Accessories. Price: 325৳380৳.
",248,822135,822383
3388,recursive,"
Product: UGREEN 30453 Micro USB+ USB-C to USB 3.0 Adapter. Category: Converter. Subcategory: Accessories. Price: 450৳.

Product: Yuanxin YDX-001 DVI Male to Male 1.5 Meter Cable. Category: DVI Cable. Subcategory: Cable. Price: 500৳550৳.
",238,822383,822621
3389,recursive,"
Product: Yuanxin YDX-015 DVI Male to Male 3 Meter Cable. Category: DVI Cable. Subcategory: Cable. Price: 700৳.

Product: Vention COQBG USB 2.0 Type-A To Type-B Printer Cable 1.5M. Category: Printer Cable. Subcategory: Cable. Price: 299৳.
",239,822621,822860
3390,recursive,"
Product: Yuanxin YUX-002 USB Type-A Male to Type-B Male 3 Meter Printer Cable. Category: Printer Cable. Subcategory: Cable. Price: 350৳390৳.

Product: Vention COQBJ 5M USB 2.0 Type-A To Type-B Printer Cable. Category: Printer Cable. Subcategory: Cable. Price: 400৳.
",267,822860,823127
3391,recursive,"
Product: Vention COOBG USB 3.0 Type-A To Type-B Printer Cable 1.5M. Category: Printer Cable. Subcategory: Cable. Price: 390৳440৳.

Product: Yuanxin YUX-002 USB Type-A Male to Type-B Male 1.5 Meter Printer Cable. Category: Printer Cable. Subcategory: Cable. Price: 200৳450৳.
",275,823127,823402
3392,recursive,"
Product: Yuanxin YUX-008 USB Type-A Male to Type-B Male Printer Cable. Category: Printer Cable. Subcategory: Cable. Price: 315৳450৳.

Product: Vention VAS-A16-B500 Flat USB2.0 A Male to B Male 5M Print Cable. Category: Printer Cable. Subcategory: Cable. Price: 440৳499৳.
",272,823402,823674
3393,recursive,"
Product: Ugreen US135 USB Type-B Male & USB 2.0 Male Printer Cable #10350. Category: Printer Cable. Subcategory: Cable. Price: 300৳500৳.

Product: Yuanxin YUX-012 5 Meter USB Type-A Male to Type-B Male Printer Cable. Category: Printer Cable. Subcategory: Cable. Price: 600৳700৳.
",280,823674,823954
3394,recursive,"
Product: Yuanxin YXB-13 1.5 Meter USB Male To Parallel Female Printer Cable. Category: Printer Cable. Subcategory: Cable. Price: 770৳900৳.

Product: Yuanxin YUX-025 10 Meter USB Type-A Male to Type-B Male Printer Cable. Category: Printer Cable. Subcategory: Cable. Price: 850৳1,000৳.
",285,823954,824239
3395,recursive,"
Product: UGREEN US122 15 Meter Type-A Male to Type-B Male Printer Cable #10362. Category: Printer Cable. Subcategory: Cable. Price: 1,800৳2,100৳.

Product: Vention VAS-A16-B150 1.5M USB Type-A to USB Type-B Printer Cable. Category: Printer Cable. Subcategory: Cable. Price: Out Of Stock.
",289,824239,824528
3396,recursive,"
Product: Vention COQBI USB 2.0 Type-A To Type-B Printer Cable 3M. Category: Printer Cable. Subcategory: Cable. Price: Out Of Stock.

Product: UGREEN US241 1.5M Type-C Male to Type-B Male Printer Cable #40417. Category: Printer Cable. Subcategory: Cable. Price: Out Of Stock.
",276,824528,824804
3397,recursive,"
Product: Vention COOBI USB 3.0 Type-A To Type-B Printer Cable 3M. Category: Printer Cable. Subcategory: Cable. Price: Out Of Stock.

Product: VENTION KAABH 2 Meter Cable Tie. Category: Cable Organizer. Subcategory: Cable. Price: 190৳.
",236,824804,825040
3398,recursive,"
Product: UGREEN LP121 25mm 3M Mask Cable Organizer #30819. Category: Cable Organizer. Subcategory: Cable. Price: 450৳.

Product: UGREEN LP114 Cable Organizer 2 Pack #30762. Category: Cable Organizer. Subcategory: Cable. Price: 390৳499৳.
",238,825040,825278
3399,recursive,"
Product: UGREEN LP121 25mm 5m Mask Cable Organizer #30820. Category: Cable Organizer. Subcategory: Cable. Price: 576৳.

Product: UGREEN 30398 Universal Cable Management Box White L Size. Category: Cable Organizer. Subcategory: Cable. Price: 2,250৳.
",250,825278,825528
3400,recursive,"
Product: Cable Management Tray. Category: Cable Organizer. Subcategory: Cable. Price: Up Coming.

Product: UGREEN Data Cable Tail Protection Sleeve 10pcs/bag #40705. Category: Cable Organizer. Subcategory: Cable. Price: Out Of Stock.
",235,825528,825763
3401,recursive,"
Product: UGREEN LP127 Charging Cable Protector #40705. Category: Cable Organizer. Subcategory: Cable. Price: Out Of Stock.

Product: Orico CBT-1S 1M Reusable & Dividable Hook and Loop Cable Ties. Category: Cable Organizer. Subcategory: Cable. Price: Out Of Stock.
",265,825763,826028
3402,recursive,"
Product: VENTION KAABJ 5 Meter Cable Tie. Category: Cable Organizer. Subcategory: Cable. Price: Out Of Stock.

Product: Orico CBT-5S 1M Reusable & Dividable Hook and Loop Cable Ties. Category: Cable Organizer. Subcategory: Cable. Price: Out Of Stock.
",252,826028,826280
3403,recursive,"
Product: Yuanxin YHV-011 HDMI Male to VGA Female Converter. Category: HDMI Converter. Subcategory: Converter. Price: 490৳.

Product: Yuanxin YHV-010 HDMI Male to VGA Female Converter with Audio. Category: HDMI Converter. Subcategory: Converter. Price: 450৳520৳.
",263,826280,826543
3404,recursive,"
Product: Yuanxin YHV-012 HDMI Male to VGA Female Converter with Audio. Category: HDMI Converter. Subcategory: Converter. Price: 550৳600৳.

Product: Ugreen HDMI to VGA Converter 40253. Category: HDMI Converter. Subcategory: Converter. Price: 750৳.
",248,826543,826791
3405,recursive,"
Product: VENTION ACPBB HDMI to VGA 0.15M Converter. Category: HDMI Converter. Subcategory: Converter. Price: 650৳750৳.

Product: VENTION 42154 HDMI to VGA 0.15M Converter. Category: HDMI Converter. Subcategory: Converter. Price: 700৳850৳.
",240,826791,827031
3406,recursive,"
Product: Orico DHTV-C20 HDMI A to VGA Adapter. Category: HDMI Converter. Subcategory: Converter. Price: 1,100৳.

Product: Ugreen CM513 VGA to HDMI Converter # 50945. Category: HDMI Converter. Subcategory: Converter. Price: 1,100৳1,200৳.
",238,827031,827269
3407,recursive,"
Product: Vention AKOB0 2-Port HDMI Bi-Direction 4K Switcher. Category: HDMI Converter. Subcategory: Converter. Price: 1,190৳1,299৳.

Product: VENTION CREBC Cotton Braided Type-C to HDMI Converter. Category: HDMI Converter. Subcategory: Converter. Price: 1,150৳1,340৳.
",269,827269,827538
3408,recursive,"
Product: VENTION AFUH0 2-Port HDMI Bi-Direction Switcher. Category: HDMI Converter. Subcategory: Converter. Price: 1,150৳1,400৳.

Product: Ugreen CM429 Female to Female HDMI Extension Adapter #10943. Category: HDMI Converter. Subcategory: Converter. Price: 1,440৳.
",266,827538,827804
3409,recursive,"
Product: Ugreen MM137 DisplayPort to HDMI Converter #70694. Category: HDMI Converter. Subcategory: Converter. Price: 1,440৳.

Product: Ugreen US320 Type-C to HDMI Adapter #70450. Category: HDMI Converter. Subcategory: Converter. Price: 1,590৳1,740৳.
",251,827804,828055
3410,recursive,"
Product: Vention AFVHB HDMI to HDMI and VGA Converter. Category: HDMI Converter. Subcategory: Converter. Price: 2,000৳.

Product: Boya BY-EA2L USB Sound Adapter. Category: Audio Converter. Subcategory: Converter. Price: 480৳580৳.
",231,828055,828286
3411,recursive,"
Product: Ugreen CM383 3.5mm Female to USB Male Audio Converter #80864. Category: Audio Converter. Subcategory: Converter. Price: 900৳.

Product: BOYA 35C-XLR Pro Mini-Jack to XLR Adapter with Power Converter. Category: Audio Converter. Subcategory: Converter. Price: 1,200৳1,300৳.
",282,828286,828568
3412,recursive,"
Product: Apple Lightning to 3.5mm Headphone Jack Adapter #MMX62ZM/A. Category: Audio Converter. Subcategory: Converter. Price: 1,400৳1,750৳.

Product: VENTION CDRBB USB 2.0 External Stereo Sound Adapter with Volume Control. Category: Audio Converter. Subcategory: Converter. Price: 1,290৳1,500৳.
",297,828568,828865
3413,recursive,"
Product: Ugreen US212 3.5mm to Lightning Audio Converter #30759. Category: Audio Converter. Subcategory: Converter. Price: 1,350৳1,500৳.

Product: BOYA BY-K3 TRS to Male Lightning Adapter. Category: Audio Converter. Subcategory: Converter. Price: 1,390৳1,650৳.
",262,828865,829127
3414,recursive,"
Product: UGREEN AV161 USB Type-C to 3.5mm Cable #80154. Category: Audio Converter. Subcategory: Converter. Price: 1,300৳1,650৳.

Product: GoPro Pro 3.5mm Mic Adapter For Hero10/9/8/7/6/5. Category: Audio Converter. Subcategory: Converter. Price: 7,400৳.
",255,829127,829382
3415,recursive,"
Product: Vention VAB-S01-L 3.5mm Female to 6.5mm Male Audio Converter. Category: Audio Converter. Subcategory: Converter. Price: Out Of Stock.

Product: Oraimo OAA-310 Type C to 3.5mm  Audio Converter. Category: Audio Converter. Subcategory: Converter. Price: Out Of Stock.
",275,829382,829657
3416,recursive,"
Product: QGeeM QG-UA15 Type-C Male to 3.5mm Female Converter. Category: Audio Converter. Subcategory: Converter. Price: Out Of Stock.

Product: VENTION BGWH0 Type-C Male to 3.5mm Female Audio Adapter. Category: Audio Converter. Subcategory: Converter. Price: Out Of Stock.
",274,829657,829931
3417,recursive,"
Product: UGREEN AV142 USB Type-C to 3.5mm Female Cable Converter 10CM #30632. Category: Audio Converter. Subcategory: Converter. Price: Out Of Stock.

Product: VENTION BDAW0 3.5mm Male to 2x3.5mm Female Audio Splitter. Category: Audio Converter. Subcategory: Converter. Price: Out Of Stock.
",292,829931,830223
3418,recursive,"
Product: Hoco LS31 Adapter Dual Lightning Audio Converter. Category: Audio Converter. Subcategory: Converter. Price: Out Of Stock.

Product: Baseus L54 Type-C Male to 3.5mm Female Adapter. Category: Audio Converter. Subcategory: Converter. Price: Out Of Stock.
",262,830223,830485
3419,recursive,"
Product: Yuanxin X-3562 USB Male to LAN Female Converter. Category: USB Converter. Subcategory: Converter. Price: 980৳1,050৳.

Product: Yuanxin X-3519 USB Male to Lan Female Converter. Category: USB Converter. Subcategory: Converter. Price: 1,100৳1,150৳.
",256,830485,830741
3420,recursive,"
Product: Yuanxin X-3518 USB Male to Lan Female Converter. Category: USB Converter. Subcategory: Converter. Price: 1,160৳1,250৳.

Product: Cudy UE10C Type-C to RJ45 Gigabit LAN Converter. Category: USB Converter. Subcategory: Converter. Price: 1,450৳.
",252,830741,830993
3421,recursive,"
Product: Redragon ERIS GA-200 Keyboard and Mouse Converter. Category: USB Converter. Subcategory: Converter. Price: 1,600৳.

Product: Vention CEWHB USB 3.0 Gigabit Ethernet Adapter. Category: USB Converter. Subcategory: Converter. Price: 1,530৳1,700৳.
",253,830993,831246
3422,recursive,"
Product: TRENDnet TU-S9 USB to Serial Converter. Category: USB Converter. Subcategory: Converter. Price: 2,000৳.

Product: Linksys USB3GIG USB 3.0 Gigabit Ethernet Adapter. Category: USB Converter. Subcategory: Converter. Price: Up Coming.
",241,831246,831487
3423,recursive,"
Product: Cudy UE10A USB to RJ45 Gigabit LAN Converter. Category: USB Converter. Subcategory: Converter. Price: Up Coming.

Product: UGREEN US280 USB Male to Type-C Female Converter #50568. Category: USB Converter. Subcategory: Converter. Price: Out Of Stock.
",260,831487,831747
3424,recursive,"
Product: Vention CDWB0 USB 2.0 Male to USB-Type C Female Adapter. Category: USB Converter. Subcategory: Converter. Price: Out Of Stock.

Product: UGREEN US701 USB Type-A to Type C Adapter #45275. Category: USB Converter. Subcategory: Converter. Price: Out Of Stock.
",267,831747,832014
3425,recursive,"
Product: VENTION CCVBB Type-C to USB Type-A 0.15M OTG Cable. Category: USB Converter. Subcategory: Converter. Price: Out Of Stock.

Product: Orico 20UTS 2.5 inch Hard Drive Adapter. Category: USB Converter. Subcategory: Converter. Price: Out Of Stock.
",253,832014,832267
3426,recursive,"
Product: VENTION CDQH0 USB Type-C Male to USB 3.0 Female OTG Adapter. Category: Type-C Converter. Subcategory: Converter. Price: 290৳450৳.

Product: Ugreen US382 Type-B Male to Type-C Female Converter #20120. Category: Type-C Converter. Subcategory: Converter. Price: 450৳.
",275,832267,832542
3427,recursive,"
Product: Hoco LS36 Type-C To 3.5mm Digital Audio Converter. Category: Type-C Converter. Subcategory: Converter. Price: 350৳450৳.

Product: Hoco UA17 Lightning Male to Type A Female Adapter. Category: Type-C Converter. Subcategory: Converter. Price: 499৳.
",256,832542,832798
3428,recursive,"
Product: QGeeM QG-UH02-2 Type C to PD Charger and 3.5mm Audio adapter. Category: Type-C Converter. Subcategory: Converter. Price: 500৳.

Product: Yuanxin X-3212 Type-C Male to VGA Female Converter. Category: Type-C Converter. Subcategory: Converter. Price: 600৳700৳.
",268,832798,833066
3429,recursive,"
Product: Hoco UA19 Easy flow 4K Type-C to HDMI Adapter Converter. Category: Type-C Converter. Subcategory: Converter. Price: 750৳.

Product: Yuanxin X-3130H Type-C Male to HDMI Female Converter. Category: Type-C Converter. Subcategory: Converter. Price: 850৳900৳.
",265,833066,833331
3430,recursive,"
Product: ORICO AXCP-02 Type-C to 3.5mm & Charge Adapter Converter. Category: Type-C Converter. Subcategory: Converter. Price: 900৳.

Product: Yuanxin X-3215 Type-C Male to HDMI USB PD Female Converter. Category: Type-C Converter. Subcategory: Converter. Price: 850৳920৳.
",272,833331,833603
3431,recursive,"
Product: Yuanxin X-3232 Type-C Male to Mini DisplayPort Male Converter. Category: Type-C Converter. Subcategory: Converter. Price: 950৳1,000৳.

Product: UGREEN MM137 DisplayPort Male to HDMI Female Converter #40363. Category: Type-C Converter. Subcategory: Converter. Price: 950৳1,040৳.
",288,833603,833891
3432,recursive,"
Product: UGREEN US372 1M USB Type-C Male to Female Extension Cable #30205. Category: Type-C Converter. Subcategory: Converter. Price: 1,050৳.

Product: Yuanxin X-3562T Type-C Male to Lan Female Converter. Category: Type-C Converter. Subcategory: Converter. Price: 1,099৳.
",273,833891,834164
3433,recursive,"
Product: Yuanxin YDP-010 Mini DisplayPort Male to HDMI Female Converter. Category: DisplayPort Converter. Subcategory: Converter. Price: 520৳.

Product: Yuanxin YDP-012 Mini DisplayPort Male to VGA Female Converter. Category: DisplayPort Converter. Subcategory: Converter. Price: 580৳.
",287,834164,834451
3434,recursive,"
Product: Yuanxin YDP-013 DisplayPort Male to VGA Female Converter. Category: DisplayPort Converter. Subcategory: Converter. Price: 600৳.

Product: Yuanxin YDP-011 Mini DisplayPort Male to DVI Female Converter. Category: DisplayPort Converter. Subcategory: Converter. Price: 490৳600৳.
",285,834451,834736
3435,recursive,"
Product: Yuanxin YDP-014 DisplayPort Male to HDMI Female Converter. Category: DisplayPort Converter. Subcategory: Converter. Price: 450৳700৳.

Product: Yuanxin YDP-015 DisplayPort Male to DVI Female Converter. Category: DisplayPort Converter. Subcategory: Converter. Price: 500৳750৳.
",285,834736,835021
3436,recursive,"
Product: Vention HBFBB DP to VGA Adapter Converter. Category: DisplayPort Converter. Subcategory: Converter. Price: 1,030৳1,100৳.

Product: Ugreen HDMI To VGA + HDMI + 3.5mm Converter #40744. Category: DisplayPort Converter. Subcategory: Converter. Price: 1,450৳.
",265,835021,835286
3437,recursive,"
Product: Belkin F2CD079BT Mini DisplayPort to HDMI Converter. Category: DisplayPort Converter. Subcategory: Converter. Price: 2,150৳2,400৳.

Product: Ugreen CM449 USB-A to HDMI/VGAConverter #20518. Category: DisplayPort Converter. Subcategory: Converter. Price: 3,050৳3,700৳.
",277,835286,835563
3438,recursive,"
Product: Dtech DT-6508 Mini Display Port To HDMI Adapter. Category: DisplayPort Converter. Subcategory: Converter. Price: Out Of Stock.

Product: Vention HBOB0 DisplayPort Male to HDMI Female Adapter Converter. Category: DisplayPort Converter. Subcategory: Converter. Price: Out Of Stock.
",290,835563,835853
3439,recursive,"
Product: Ugreen MD112 Mini DisplayPort to HDMI Converter #10461. Category: DisplayPort Converter. Subcategory: Converter. Price: Out Of Stock.

Product: Ugreen DP109 DP Male to VGA Female Converter #20415. Category: DisplayPort Converter. Subcategory: Converter. Price: Out Of Stock.
",285,835853,836138
3440,recursive,"
Product: Vention HBGBB DisplayPort Male to HDMI Female Converter. Category: DisplayPort Converter. Subcategory: Converter. Price: Out Of Stock.

Product: FJGEAR FJ-2004 4 Port VGA Splitter. Category: VGA Converter. Subcategory: Converter. Price: 670৳850৳.
",257,836138,836395
3441,recursive,"
Product: Yuanxin YVH-001 VGA Male to HDMI Female Converter with Audio. Category: VGA Converter. Subcategory: Converter. Price: 800৳1,000৳.

Product: Vention ACNBB VGA to HDMI Converter with Female Micro USB and Audio Port. Category: VGA Converter. Subcategory: Converter. Price: 1,250৳1,450৳.
",294,836395,836689
3442,recursive,"
Product: FJGEAR FJ-201AS 2 Port VGA Switch with Remote. Category: VGA Converter. Subcategory: Converter. Price: 3,250৳.

Product: FJGEAR FJ-2504A 250Mhz 1 to 4 Port VGA Splitter. Category: VGA Converter. Subcategory: Converter. Price: Out Of Stock.
",250,836689,836939
3443,recursive,"
Product: VGA SPLITTER 4 PORT. Category: VGA Converter. Subcategory: Converter. Price: Out Of Stock.

Product: Dtech DT-7254 1 to 4 Port VGA Splitter. Category: VGA Converter. Subcategory: Converter. Price: Out Of Stock.
",221,836939,837160
3444,recursive,"
Product: Ugreen MM102 HDMI Male to VGA Female Converter with Audio #40233. Category: VGA Converter. Subcategory: Converter. Price: Out Of Stock.

Product: Vention ACEB0 VGA Male to HDMI Female Converter. Category: VGA Converter. Subcategory: Converter. Price: Out Of Stock.
",275,837160,837435
3445,recursive,"
Product: Yuanxin X-3220 DVI Male to VGA Female Converter. Category: DVI Converter. Subcategory: Converter. Price: 600৳690৳.

Product: VENTION ECDB0 DVI Male to HDMI Female Converter. Category: DVI Converter. Subcategory: Converter. Price: Up Coming.
",251,837435,837686
3446,recursive,"
Product: Vention AIKB0 HDMI Male to DVI (24+5) Female Converter Adapter. Category: DVI Converter. Subcategory: Converter. Price: Out Of Stock.

Product: ORICO FL02 4 Port USB 2.0 HUB. Category: Hubs & Docks. Subcategory: Accessories. Price: 350৳.
",248,837686,837934
3447,recursive,"
Product: ORICO FL02 4 Port USB 2.0 HUB White. Category: Hubs & Docks. Subcategory: Accessories. Price: 350৳.

Product: Havit H18 4-Port USB 2.0 HUB. Category: Hubs & Docks. Subcategory: Accessories. Price: 380৳.
",213,837934,838147
3448,recursive,"
Product: Yuanxin X-2328 Multiport 4-in-1 USB Hub. Category: Hubs & Docks. Subcategory: Accessories. Price: 400৳.

Product: Yuanxin YXH-55 Multiport 4-in-1 USB Hub. Category: Hubs & Docks. Subcategory: Accessories. Price: 380৳400৳.
",232,838147,838379
3449,recursive,"
Product: ORICO MINI-U32 3-in-1 USB Hub. Category: Hubs & Docks. Subcategory: Accessories. Price: 450৳.

Product: HAVIT H91 4-PORT USB2.0 HUB. Category: Hubs & Docks. Subcategory: Accessories. Price: 500৳.
",206,838379,838585
3450,recursive,"
Product: Yuanxin X-2328T Multiport 4-in-1 USB Type-C Hub. Category: Hubs & Docks. Subcategory: Accessories. Price: 440৳500৳.

Product: Orico W5P-U2-030-BK-BP 4 Port USB 2.0 Hub Black. Category: Hubs & Docks. Subcategory: Accessories. Price: 550৳.
",248,838585,838833
3451,recursive,"
Product: ORICO AH-12F 4 Port USB 3.0 HUB. Category: Hubs & Docks. Subcategory: Accessories. Price: 550৳.

Product: ORICO PAPW4A-U3 PW SERIES 4-PORT USB 3.0 HUB. Category: Hubs & Docks. Subcategory: Accessories. Price: 550৳.
",225,838833,839058
3452,recursive,"
Product: Yuanxin YXH-52 Multiport 4-in-1 USB Hub. Category: Hubs & Docks. Subcategory: Accessories. Price: 500৳550৳.

Product: Havit H08 4-Port High-Speed USB 2.0 HUB. Category: Hubs & Docks. Subcategory: Accessories. Price: 600৳.
",232,839058,839290
3453,recursive,"
Product: Yuanxin X-3328L USB Male to Tri USB 2.0 & USB 3.0 Female Hub. Category: Hubs & Docks. Subcategory: Accessories. Price: 600৳.

Product: Orico AH-A13 USB A to USB 3.0 4 Port  Hub. Category: Hubs & Docks. Subcategory: Accessories. Price: 675৳.
",251,839290,839541
3454,recursive,"
Product: Yuanxin YXH-56 USB & Type-C Male to Quad USB Female Hub. Category: Hubs & Docks. Subcategory: Accessories. Price: 600৳690৳.

Product: Havit H40 4-Port High-Speed USB Hub. Category: Hubs & Docks. Subcategory: Accessories. Price: 699৳.
",244,839541,839785
3455,recursive,"
Product: Havit H94 4-Port High-Speed USB Hub. Category: Hubs & Docks. Subcategory: Accessories. Price: 700৳.

Product: Hoco HB45 Spirit Single Mode Type-C 2.0 Card Reader. Category: Card Reader. Subcategory: Accessories. Price: 300৳.
",235,839785,840020
3456,recursive,"
Product: Hoco HB45 Spirit 2-in-1 USB & Type-C 2.0 Card Reader. Category: Card Reader. Subcategory: Accessories. Price: 365৳450৳.

Product: Hoco HB45 Spirit USB Card Reader. Category: Card Reader. Subcategory: Accessories. Price: 437৳475৳.
",240,840020,840260
3457,recursive,"
Product: Hoco HB45 Spirit 2-in-1 USB & Type-C 3.0 Card Reader. Category: Card Reader. Subcategory: Accessories. Price: 430৳550৳.

Product: Transcend TS-RDF5R USB 3.1 Card Reader. Category: Card Reader. Subcategory: Accessories. Price: 875৳.
",242,840260,840502
3458,recursive,"
Product: Transcend TS-RDF8K2 USB 3.1 Gen1 All-In-One Multi Memory Card Reader. Category: Card Reader. Subcategory: Accessories. Price: 1,565৳1,799৳.

Product: Transcend TS-RDC8K2 USB-3.1 Card Reader. Category: Card Reader. Subcategory: Accessories. Price: 1,656৳1,800৳.
",271,840502,840773
3459,recursive,"
Product: Transcend TS-RDF9K2 USB-3.1 Multi Memory Card Reader. Category: Card Reader. Subcategory: Accessories. Price: 1,758৳1,850৳.

Product: Transcend TS-RDP9K USB 2.0 OTG Card Reader. Category: Card Reader. Subcategory: Accessories. Price: Up Coming.
",255,840773,841028
3460,recursive,"
Product: Hoco HB20 Mindful 2-in-1 USB 2.0 Card Reader. Category: Card Reader. Subcategory: Accessories. Price: Out Of Stock.

Product: Hoco HB20 Mindful 2-in-1 USB 3.0 Card Reader. Category: Card Reader. Subcategory: Accessories. Price: Out Of Stock.
",252,841028,841280
3461,recursive,"
Product: Transcend TS-RDF5K USB 3.1 Card Reader. Category: Card Reader. Subcategory: Accessories. Price: Out Of Stock.

Product: Hoco HB39 2-in-1 USB & Type-C 3.0 Card Reader. Category: Card Reader. Subcategory: Accessories. Price: Out Of Stock.
",247,841280,841527
3462,recursive,"
Product: Ugreen CR125 3-in-1 Type-A Male to SD-TF Card Reader #30333. Category: Card Reader. Subcategory: Accessories. Price: Out Of Stock.

Product: ORICO CL4T-A3 4-in-1 USB Type-C Multifunction Card Reader. Category: Card Reader. Subcategory: Accessories. Price: Out Of Stock.
",280,841527,841807
3463,recursive,"
Product: Sony ICD-PX470 4GB Digital Voice Recorder. Category: Sony. Subcategory: Digital Voice Recorder. Price: 8,300৳9,000৳.

Product: Sony UX570F 4GB Digital Voice Recorder. Category: Sony. Subcategory: Digital Voice Recorder. Price: 12,400৳15,500৳.
",253,841807,842060
3464,recursive,"
Product: Sony TX660 Digital Voice Recorder. Category: Sony. Subcategory: Digital Voice Recorder. Price: 14,500৳17,000৳.

Product: Sony PCM-A10 High-Resolution Portable Digital Voice Recorder. Category: Sony. Subcategory: Digital Voice Recorder. Price: 23,500৳27,000৳.
",269,842060,842329
3465,recursive,"
Product: Sony ICD-PX370 4GB Digital Voice Recorder. Category: Sony. Subcategory: Digital Voice Recorder. Price: Out Of Stock.

Product: Sony ICD-PX240 4GB Digital Voice Recorder. Category: Sony. Subcategory: Digital Voice Recorder. Price: Out Of Stock.
",254,842329,842583
3466,recursive,"
Product: Ugreen LP479 Wireless Presenter. Category: Presenter. Subcategory: Accessories. Price: 1,170৳.

Product: Rapoo XR100 Wireless Laser Presenter. Category: Presenter. Subcategory: Accessories. Price: 1,650৳.
",215,842583,842798
3467,recursive,"
Product: Baseus Orange Dot Red Laser Wireless Presenter. Category: Presenter. Subcategory: Accessories. Price: 1,860৳1,999৳.

Product: Rapoo XR200 Wireless Laser Presenter. Category: Presenter. Subcategory: Accessories. Price: 2,300৳.
",236,842798,843034
3468,recursive,"
Product: Baseus Orange Dot Green Laser Wireless Presenter. Category: Presenter. Subcategory: Accessories. Price: 3,000৳.

Product: Logitech R400 Wireless Presenter. Category: Presenter. Subcategory: Accessories. Price: 3,800৳4,200৳.
",234,843034,843268
3469,recursive,"
Product: Logitech R800 Wireless Professional Presenter. Category: Presenter. Subcategory: Accessories. Price: 9,500৳.

Product: Logitech Spotlight Wireless Presenter (910-004863). Category: Presenter. Subcategory: Accessories. Price: 15,000৳.
",244,843268,843512
3470,recursive,"
Product: Targus AMP16AP-53 Wireless Presenter with Laser Pointer. Category: Presenter. Subcategory: Accessories. Price: Up Coming.

Product: Targus AMP32 Dual Mode Presenter with Laser Pointer. Category: Presenter. Subcategory: Accessories. Price: Up Coming.
",260,843512,843772
3471,recursive,"
Product: TARGUS AMP17AP Wireless Presenter with Cursor Control (Black Rubberized). Category: Presenter. Subcategory: Accessories. Price: Out Of Stock.

Product: A4tech LP15 Wireless Laser Presenter. Category: Presenter. Subcategory: Accessories. Price: Out Of Stock.
",268,843772,844040
3472,recursive,"
Product: Micropack WPM-06 Black Pocket Wireless Red laser 100M Range Presenter. Category: Presenter. Subcategory: Accessories. Price: Out Of Stock.

Product: Targus AMP30GL-50 Wireless Presenter With Pointer (Black). Category: Presenter. Subcategory: Accessories. Price: Out Of Stock.
",286,844040,844326
3473,recursive,"
Product: Targus AMP16AP-60 Presenter with Laser Pointer (Black). Category: Presenter. Subcategory: Accessories. Price: Out Of Stock.

Product: Micropack WPM-03 Multimedia Wireless Red laser Presenter. Category: Presenter. Subcategory: Accessories. Price: Out Of Stock.
",270,844326,844596
3474,recursive,"
Product: PROLiNK PWP102G 2.4GHz Wireless Presenter with Air Mouse. Category: Presenter. Subcategory: Accessories. Price: Out Of Stock.

Product: PROLiNK PWP106G 2.4GHz Wireless Presenter with Green Laser. Category: Presenter. Subcategory: Accessories. Price: Out Of Stock.
",274,844596,844870
3475,recursive,"
Product: Targus AMP09 Wireless USB Presenter. Category: Presenter. Subcategory: Accessories. Price: Out Of Stock.

Product: Zoom H1 Essential 2-Track Handy Audio Recorder. Category: Digital Voice Recorder. Subcategory: Accessories. Price: 15,500৳20,000৳.
",256,844870,845126
3476,recursive,"
Product: Zoom H2n Handy Recorder. Category: Digital Voice Recorder. Subcategory: Accessories. Price: 21,500৳23,500৳.

Product: Zoom Q2N-4K Handy Video Recorder with X/Y Microphone. Category: Digital Voice Recorder. Subcategory: Accessories. Price: 27,700৳29,000৳.
",265,845126,845391
3477,recursive,"
Product: Zoom H4n Pro 4-Track Portable Audio Recorder. Category: Digital Voice Recorder. Subcategory: Accessories. Price: 28,800৳31,000৳.

Product: Zoom H5 4-Track Portable Recorder. Category: Digital Voice Recorder. Subcategory: Accessories. Price: 31,500৳32,000৳.
",267,845391,845658
3478,recursive,"
Product: Zoom H6 Handy Recorder. Category: Digital Voice Recorder. Subcategory: Accessories. Price: 36,100৳39,500৳.

Product: Zoom H4 Essential 4-Track Handy Audio Recorder. Category: Digital Voice Recorder. Subcategory: Accessories. Price: 31,500৳40,000৳.
",258,845658,845916
3479,recursive,"
Product: Zoom H8 8-Input, 12-Track Portable Handy Recorder. Category: Digital Voice Recorder. Subcategory: Accessories. Price: 44,000৳.

Product: Zoom H6 Essential 6-Track Handy Audio Recorder. Category: Digital Voice Recorder. Subcategory: Accessories. Price: 39,500৳45,000৳.
",278,845916,846194
3480,recursive,"
Product: ZOOM H1n Professional Audio Recorder. Category: Digital Voice Recorder. Subcategory: Accessories. Price: Out Of Stock.

Product: Boya BY-M1 Omnidirectional Lavalier Microphone (Original). Category: Microphone. Subcategory: Accessories. Price: 890৳1,150৳.
",265,846194,846459
3481,recursive,"
Product: Boya BY-MM1 Compact On Camera Video Microphone. Category: Microphone. Subcategory: Accessories. Price: 1,800৳2,050৳.

Product: Takstar CH-58 Microphone Clamp. Category: Microphone. Subcategory: Accessories. Price: 700৳750৳.
",234,846459,846693
3482,recursive,"
Product: Takstar W-10 Microphone Windscreen. Category: Microphone. Subcategory: Accessories. Price: 550৳900৳.

Product: Havit GK58B GAMENOTE RGB USB Microphone. Category: Microphone. Subcategory: Accessories. Price: 850৳950৳.
",227,846693,846920
3483,recursive,"
Product: Hoco L15 Lightning Lavalier Wireless Microphone For iPhone. Category: Microphone. Subcategory: Accessories. Price: 870৳1,050৳.

Product: Hoco L15 Type-C Crystal Lavalier Wireless Digital Microphone. Category: Microphone. Subcategory: Accessories. Price: 870৳1,050৳.
",276,846920,847196
3484,recursive,"
Product: Havit GK56B RGB USB Gaming Microphone. Category: Microphone. Subcategory: Accessories. Price: 900৳1,100৳.

Product: K&F Concept KF 10.010 M1 Lavalier Microphone. Category: Microphone. Subcategory: Accessories. Price: 1,100৳1,150৳.
",241,847196,847437
3485,recursive,"
Product: Xtrike Me XMC-03 Omnidirectional RGB Gaming Microphone. Category: Microphone. Subcategory: Accessories. Price: 1,250৳.

Product: BOYA BY-M1S Universal Lavalier Microphone. Category: Microphone. Subcategory: Accessories. Price: 1,120৳1,300৳.
",251,847437,847688
3486,recursive,"
Product: Redragon GM93 Athan Wireless Lavalier Microphone. Category: Microphone. Subcategory: Accessories. Price: 1,150৳1,400৳.

Product: Onikuma M830 USB Gaming Microphone. Category: Microphone. Subcategory: Accessories. Price: 1,400৳.
",238,847688,847926
3487,recursive,"
Product: Redragon GM99 STIX USB Microphone. Category: Microphone. Subcategory: Accessories. Price: 1,300৳1,500৳.

Product: Saramonic SmartMic Condenser Basic Microphone. Category: Microphone. Subcategory: Accessories. Price: 1,700৳1,750৳.
",240,847926,848166
3488,recursive,"
Product: Boya BY-M1DM Dual Omni Directional Lavalier Microphone. Category: Microphone. Subcategory: Accessories. Price: 1,640৳1,800৳.

Product: Boya BY-M1 Pro II 3.5mm Lavalier Microphone. Category: Microphone. Subcategory: Accessories. Price: 1,650৳1,900৳.
",259,848166,848425
3489,recursive,"
Product: MIRFAK MC1P Lavalier Microphone with Lightning Port. Category: Microphone. Subcategory: Accessories. Price: 1,900৳2,000৳.

Product: Panasonic EM-2800A Boom Microphone. Category: Microphone. Subcategory: Accessories. Price: 2,000৳2,100৳.
",247,848425,848672
3490,recursive,"
Product: Hoco L15 Type C & Lightning Dual Mic Lavalier Wireless Microphone Black. Category: Microphone. Subcategory: Accessories. Price: 1,690৳2,100৳.

Product: PNY Elite 64GB Class-10 UHS-I Micro SD Memory Card With SD Adapter. Category: PNY. Subcategory: Memory Card. Price: 650৳850৳.
",288,848672,848960
3491,recursive,"
Product: PNY Elite 128GB Class-10 Micro SD Memory Card With Adapter. Category: PNY. Subcategory: Memory Card. Price: 1,250৳.

Product: PNY Elite 256GB Class-10 Micro SD Memory Card. Category: PNY. Subcategory: Memory Card. Price: 2,800৳3,200৳.
",245,848960,849205
3492,recursive,"
Product: PNY 32 GB microSDHC Class-10 Flash Memory Card. Category: PNY. Subcategory: Memory Card. Price: Out Of Stock.

Product: PNY Elite 64GB Class-10 Micro SD Memory Card. Category: PNY. Subcategory: Memory Card. Price: Out Of Stock.
",238,849205,849443
3493,recursive,"
Product: PNY 64 GB microSDXC Class-10 Flash Memory Card. Category: PNY. Subcategory: Memory Card. Price: Out Of Stock.

Product: Dahua C100 64GB UHS-I Class 10 microSDXC Memory Card. Category: Memory Card. Subcategory: Accessories. Price: 600৳.
",246,849443,849689
3494,recursive,"
Product: Dahua ST2-64-S1 64GB MicroSD Memory Card. Category: Memory Card. Subcategory: Accessories. Price: 600৳.

Product: Hiksemi HS-TF-C1 NEO-AD 64GB UHS-I Class 10 microSDXC Memory Card. Category: Memory Card. Subcategory: Accessories. Price: 600৳.
",253,849689,849942
3495,recursive,"
Product: Apacer R100 MicroSDHC/SDXC UHS-1 U1 V10 A1 32GB Memory Card with Adapter. Category: Memory Card. Subcategory: Accessories. Price: 650৳.

Product: Smart Eagle Eye 64GB Micro SDXC UHS-I U3 Class10 Memory Card with Adapter. Category: Memory Card. Subcategory: Accessories. Price: 700৳.
",293,849942,850235
3496,recursive,"
Product: Transcend 64GB MicroSDXC/SDHC 300S Class 10 Memory Card (TS64GUSD300S). Category: Memory Card. Subcategory: Accessories. Price: 750৳.

Product: Apacer R100 MicroSDXC UHS-I U1 V10 A1 64GB Class-10 Memory Card with Adapter. Category: Memory Card. Subcategory: Accessories. Price: 750৳.
",294,850235,850529
3497,recursive,"
Product: SanDisk Ultra 32GB Class-10 100mbps Micro SDHC UHS-I Memory Card (SDSQUNR-032G-GN3MN). Category: Memory Card. Subcategory: Accessories. Price: 700৳1,000৳.
",165,850529,850694
3498,recursive,"
Product: Lexar High-Performance 633x 64GB MicroSDXC UHS-I Memory Card. Category: Memory Card. Subcategory: Accessories. Price: 800৳1,000৳.

Product: Smart Eagle Eye 128GB Micro SDXC UHS-I U3 Class10 Memory Card with Adapter. Category: Memory Card. Subcategory: Accessories. Price: 1,000৳.
",290,850694,850984
3499,recursive,"
Product: ADATA High-Endurance 64GB UHS-I Class 10 microSDXC Memory Card. Category: Memory Card. Subcategory: Accessories. Price: 1,100৳.

Product: Adata 128GB Micro SD Class-10 (SDXC-UHX-I) Memory Card With Adapter. Category: Memory Card. Subcategory: Accessories. Price: 1,150৳.
",281,850984,851265
3500,recursive,"
Product: Transcend 64GB 100Mbps SDXC/SDHC UHS-I SD 300S Memory Card (TS64GSDC300S). Category: Memory Card. Subcategory: Accessories. Price: 1,100৳1,200৳.
",155,851265,851420
3501,recursive,"
Product: SanDisk Extreme 32GB 100mbps SDHC UHS-I Memory Card (SDSDXVT-032G-GNCIN). Category: Memory Card. Subcategory: Accessories. Price: 1,250৳.
",148,851420,851568
3502,recursive,"
Product: SanDisk Ultra 64GB Class-10 100mbps Micro SDXC UHS-I Memory Card (SDSQUNR-064G-GN3MN). Category: Memory Card. Subcategory: Accessories. Price: 1,200৳1,300৳.
",167,851568,851735
3503,recursive,"
Product: SanDisk Ultra SQUAB 64GB MicroSDXC UHS-I Memory Card (SDSQUAB-064G-GN6MN). Category: Memory Card. Subcategory: Accessories. Price: 1,130৳1,300৳.

Product: Hiksemi HS-TF-C1 NEO-AD 128GB UHS-I Class 10 microSDXC Memory Card. Category: Memory Card. Subcategory: Accessories. Price: 1,300৳.
",297,851735,852032
3504,recursive,"
Product: Kingston Canvas Select Plus 128GB Memory Card. Category: Memory Card. Subcategory: Accessories. Price: 1,300৳.

Product: TEAM 32GB MicroSDHC/SDXC UHS-I U1 C10 Memory Card with Adapter. Category: TEAM. Subcategory: Memory Card. Price: Out Of Stock.
",258,852032,852290
3505,recursive,"
Product: TEAM 32GB MicroSDHC/SDXC UHS-I U1 Memory Card with Adapter. Category: TEAM. Subcategory: Memory Card. Price: Out Of Stock.

Product: TEAM 64GB MicroSDHC/SDXC UHS-I U1 C10 Memory Card with Adapter. Category: TEAM. Subcategory: Memory Card. Price: Out Of Stock.
",270,852290,852560
3506,recursive,"
Product: TEAM 128GB MicroSDHC/SDXC UHS-I U1 C10 Memory Card with Adapter. Category: TEAM. Subcategory: Memory Card. Price: Out Of Stock.

Product: TEAM A2 PRO+ 128GB MicroSDXC UHS-I U3 V30 Memory Card with Adapter. Category: TEAM. Subcategory: Memory Card. Price: Out Of Stock.
",279,852560,852839
3507,recursive,"
Product: TEAM PRO 128GB SDXC UHS-I U3 V30 4K Memory Card. Category: TEAM. Subcategory: Memory Card. Price: Out Of Stock.

Product: TEAM ELITE A1 256GB U3 Micro SDXC UHS-I V30 Memory Card with Adapter. Category: TEAM. Subcategory: Memory Card. Price: Out Of Stock.
",265,852839,853104
3508,recursive,"
Product: TEAM A2 PRO+ 256GB MicroSDXC UHS-I U3 V30 Memory Card with Adapter. Category: TEAM. Subcategory: Memory Card. Price: Out Of Stock.

Product: TEAM PRO 256GB SDXC UHS-I U3 V30 4K Memory Card. Category: TEAM. Subcategory: Memory Card. Price: Out Of Stock.
",263,853104,853367
3509,recursive,"
Product: TEAM A2 PRO+ 512GB MicroSDXC UHS-I U3 V30 Memory Card with Adapter. Category: TEAM. Subcategory: Memory Card. Price: Out Of Stock.

Product: TEAM A2 PRO+ 1TB MicroSDXC UHS-I U3 V30 Memory Card with Adapter. Category: TEAM. Subcategory: Memory Card. Price: Out Of Stock.
",280,853367,853647
3510,recursive,"
Product: Sandisk Ultra 64GB 140Mbps SDXC UHS-I Memory Card (SDSDUNB-064G-GN6IN). Category: SanDisk. Subcategory: Memory Card. Price: 1,300৳1,350৳.
",148,853647,853795
3511,recursive,"
Product: SanDisk Extreme PRO 64GB 200mbps microSDXC UHS-I Memory Card with Adapter (SDSQXCU-064G-GN6MA). Category: SanDisk. Subcategory: Memory Card. Price: 1,400৳1,600৳.
",172,853795,853967
3512,recursive,"
Product: SanDisk Ultra 128GB Class-10 100mbps Micro SDXC UHS-I Memory Card (SDSQUNR-128G-GN6MN). Category: SanDisk. Subcategory: Memory Card. Price: 1,600৳1,900৳.
",164,853967,854131
3513,recursive,"
Product: SanDisk Extreme PRO 64GB 200mbps SDXC UHS-I Memory Card ( SDSDXXU-064G-GN4IN ). Category: SanDisk. Subcategory: Memory Card. Price: 1,900৳2,200৳.
",156,854131,854287
3514,recursive,"
Product: Sandisk Extreme Pro 128GB 200mbps MicroSDXC UHS-1 Memory Card With Adapter (SDSQXCD-128G-GN6MA). Category: SanDisk. Subcategory: Memory Card. Price: 2,100৳2,400৳.
",173,854287,854460
3515,recursive,"
Product: SanDisk Extreme 128GB 190mbps microSDXC UHS-I Memory Card (SDSQXAA-128G-GN6MN). Category: SanDisk. Subcategory: Memory Card. Price: 2,400৳2,500৳.
",156,854460,854616
3516,recursive,"
Product: SanDisk Extreme PRO 128GB 200mbps SDXC UHS-I Memory Card (SDSDXXD-128G-GN4IN). Category: SanDisk. Subcategory: Memory Card. Price: 2,600৳3,000৳.
",155,854616,854771
3517,recursive,"
Product: SanDisk Ultra 256GB Class-10 100mbps Micro SDXC UHS-I Memory Card (SDSQUNR-256G-GN3MN). Category: SanDisk. Subcategory: Memory Card. Price: 3,000৳3,200৳.
",164,854771,854935
3518,recursive,"
Product: Sandisk Extreme PRO 256GB 200mbps MicroSDXC UHS-I Memory Card With Adapter (SDSQXCD-256G-GN6MA). Category: SanDisk. Subcategory: Memory Card. Price: 3,500৳4,100৳.
",173,854935,855108
3519,recursive,"
Product: SanDisk Extreme Pro 32GB Compact Flash Memory Card (SDCFXPS-032G-X46). Category: SanDisk. Subcategory: Memory Card. Price: 5,400৳5,600৳.

Product: SanDisk Ultra 512GB MicroSDXC UHS-I Memory Card (SDSQUAC-512G-GN6MN). Category: SanDisk. Subcategory: Memory Card. Price: 5,700৳.
",287,855108,855395
3520,recursive,"
Product: SanDisk Extreme PRO 256GB 200mbps SDHC And SDXC UHS-I Memory Card (SDSDXXD-256G-GN4IN). Category: SanDisk. Subcategory: Memory Card. Price: 5,400৳6,250৳.
",164,855395,855559
3521,recursive,"
Product: SanDisk Extreme 512GB 190mbps microSDXC UHS-I Memory Card (SDSQXAV-512G-GN6MN). Category: SanDisk. Subcategory: Memory Card. Price: 6,600৳7,000৳.
",156,855559,855715
3522,recursive,"
Product: Sandisk Extreme PRO 512GB 200mbps MicroSDXC UHS-1 Memory Card With Adapter (SDSQXCD-512G-GN6MA). Category: SanDisk. Subcategory: Memory Card. Price: 7,000৳7,400৳.
",173,855715,855888
3523,recursive,"
Product: SanDisk Extreme PRO 64GB 300mbps SDXC UHS-II Memory Card (SDSDXDK-064G-GN4IN). Category: SanDisk. Subcategory: Memory Card. Price: 13,500৳16,500৳.

Product: SanDisk Extreme PRO CFexpress Type B 128GB Memory Card. Category: SanDisk. Subcategory: Memory Card. Price: 21,800৳25,000৳.
",291,855888,856179
3524,recursive,"
Product: Apacer 128GB Micro SD Class-10 Memory Card with Adapter. Category: Apacer. Subcategory: Memory Card. Price: 1,350৳1,450৳.

Product: Apacer R100 MicroSDXC UHS-I U1 V10 128GB Class-10 Memory Card with Adapter. Category: Apacer. Subcategory: Memory Card. Price: 1,350৳1,500৳.
",283,856179,856462
3525,recursive,"
Product: Apacer R100 SDXC/SDHC UHS-I U1 V10 256GB A1 Class 10 Memory Card with Adapter. Category: Apacer. Subcategory: Memory Card. Price: 3,400৳.
",148,856462,856610
3526,recursive,"
Product: Apacer R100 MicroSDXC UHS-I U3 V30 A2 512GB Class-10 Memory Card with Adapter. Category: Apacer. Subcategory: Memory Card. Price: 5,550৳6,200৳.
",154,856610,856764
3527,recursive,"
Product: Apacer R100 MicroSDXC UHS-I U3 V30 A1 32GB Class-10 Memory Card with Adapter. Category: Apacer. Subcategory: Memory Card. Price: Out Of Stock.
",153,856764,856917
3528,recursive,"
Product: Apacer R100 SDXC/SDHC UHS-I U3 V30 256GB A2 Class 10 Memory Card with Adapter. Category: Apacer. Subcategory: Memory Card. Price: Out Of Stock.
",154,856917,857071
3529,recursive,"
Product: Apacer 256GB MicroSDXC UHS-I U3 V30 R100 A1 Class-10 Memory Card with Adapter. Category: Apacer. Subcategory: Memory Card. Price: Out Of Stock.

Product: Nikon XQD 64GB Memory Card. Category: Nikon. Subcategory: Memory Card. Price: 15,000৳18,000৳.
",258,857071,857329
3530,recursive,"
Product: Dahua Imou ST2-128-S1 128GB MicroSD Memory Card. Category: Dahua. Subcategory: Memory Card. Price: 1,450৳.

Product: Dahua C100 256GB UHS-I Class 10 microSDXC Memory Card. Category: Dahua. Subcategory: Memory Card. Price: 2,650৳.
",240,857329,857569
3531,recursive,"
Product: Dahua Imou ST2-256-S1 256GB MicroSD Memory Card. Category: Dahua. Subcategory: Memory Card. Price: 3,000৳.

Product: Dahua C100 512GB UHS-I Class 10 microSDXC Memory Card. Category: Dahua. Subcategory: Memory Card. Price: 5,400৳.
",240,857569,857809
3532,recursive,"
Product: Dahua C100 128GB UHS-I Class 10 microSDXC Memory Card. Category: Dahua. Subcategory: Memory Card. Price: Out Of Stock.

Product: Samsung EVO Select 256GB microSDXC Memory Card with Adapter. Category: Samsung. Subcategory: Memory Card. Price: Out Of Stock.
",266,857809,858075
3533,recursive,"
Product: Transcend 128GB 100Mbps UHS-I SD 300S Memory Card. Category: Transcend. Subcategory: Memory Card. Price: 1,400৳.

Product: Transcend 128GB Micro SD Class 10 With Adapter. Category: Transcend. Subcategory: Memory Card. Price: 1,400৳1,500৳.
",249,858075,858324
3534,recursive,"
Product: Transcend 128GB MicroSDXC/SDHC 300S Class 10 Memory Card (TS128GUSD300S). Category: Transcend. Subcategory: Memory Card. Price: 1,500৳.
",146,858324,858470
3535,recursive,"
Product: Transcend 32GB Micro SD UHS-I U1-Class-10-Memory Card with Adapter (TS32GUSD300S-A). Category: Transcend. Subcategory: Memory Card. Price: Out Of Stock.
",163,858470,858633
3536,recursive,"
Product: Transcend 64GB Micro SD UHS-I U1 Memory Card with Adapter (TS64GUSD300S-A). Category: Transcend. Subcategory: Memory Card. Price: Out Of Stock.
",154,858633,858787
3537,recursive,"
Product: Transcend USD350V U1 64GB High Endurance MicroSD Memory Card with Adapter. Category: Transcend. Subcategory: Memory Card. Price: Out Of Stock.
",153,858787,858940
3538,recursive,"
Product: Transcend 256GB Micro SD UHS-I U3 Memory Card with Adapter (TS256GUSD300S-A). Category: Transcend. Subcategory: Memory Card. Price: Out Of Stock.
",156,858940,859096
3539,recursive,"
Product: Transcend 512GB 300S UHS-I microSDXC U3A1 Memory Card with Adapter. Category: Transcend. Subcategory: Memory Card. Price: Out Of Stock.

Product: Lexar High-Endurance 64GB MicroSD UHS-I Memory Card. Category: Lexar. Subcategory: Memory Card. Price: 1,300৳1,650৳.
",273,859096,859369
3540,recursive,"
Product: Lexar High-Performance 633x 128GB MicroSDXC UHS-I Memory Card with Adapter. Category: Lexar. Subcategory: Memory Card. Price: 1,600৳1,850৳.

Product: Lexar High-Endurance 128GB MicroSD UHS-I Memory Card. Category: Lexar. Subcategory: Memory Card. Price: 1,700৳2,000৳.
",278,859369,859647
3541,recursive,"
Product: Lexar High-Performance 633x 256GB MicroSDXC UHS-I Memory Card with Adapter. Category: Lexar. Subcategory: Memory Card. Price: 2,800৳3,300৳.

Product: Lexar Professional CFexpress Type B 512GB Memory Card. Category: Lexar. Subcategory: Memory Card. Price: 37,900৳39,000৳.
",281,859647,859928
3542,recursive,"
Product: Lexar High-Performance 633x 512GB MicroSDXC UHS-I Memory Card with Adapter. Category: Lexar. Subcategory: Memory Card. Price: Out Of Stock.

Product: TwinMOS 32GB MicroSDXC Class-10 UHS-I Memory Card. Category: TwinMOS. Subcategory: Memory Card. Price: Out Of Stock.
",277,859928,860205
3543,recursive,"
Product: TwinMOS 64GB MicroSDXC Class-10 UHS-I Memory Card. Category: TwinMOS. Subcategory: Memory Card. Price: Out Of Stock.

Product: TwinMOS 128GB MicroSDXC Class-10 Memory Card. Category: TwinMOS. Subcategory: Memory Card. Price: Out Of Stock.
",249,860205,860454
3544,recursive,"
Product: ADATA High-Endurance 128GB UHS-I Class 10 microSDXC Memory Card. Category: Adata. Subcategory: Memory Card. Price: 1,650৳.

Product: Adata Premier 256GB MicroSDXC UHS-I Memory Card. Category: Adata. Subcategory: Memory Card. Price: 2,600৳.
",250,860454,860704
3545,recursive,"
Product: ADATA High-Endurance 256GB UHS-I Class 10 microSDXC Memory Card. Category: Adata. Subcategory: Memory Card. Price: 3,150৳3,300৳.

Product: ADATA High-Endurance 512GB UHS-I Class 10 microSDXC Memory Card. Category: Adata. Subcategory: Memory Card. Price: 5,650৳5,800৳.
",278,860704,860982
3546,recursive,"
Product: Adata 32GB Micro SD Class-10 (SDHC-UHS-I) Memory Card With Adapter. Category: Adata. Subcategory: Memory Card. Price: Out Of Stock.

Product: Adata 64GB Micro SD Class-10 (SDXC-UHX-I) Memory Card With Adapter. Category: Adata. Subcategory: Memory Card. Price: Out Of Stock.
",284,860982,861266
3547,recursive,"
Product: Sony SF-E Series UHS-II SDXC 64GB Memory Card. Category: Sony. Subcategory: Memory Card. Price: 3,000৳3,500৳.

Product: Sony SF-M Tough Series UHS-II SDXC 64GB Memory Card. Category: Sony. Subcategory: Memory Card. Price: 5,400৳6,500৳.
",246,861266,861512
3548,recursive,"
Product: Sony SF-M Tough Series UHS-II SDXC 128GB Memory Card. Category: Sony. Subcategory: Memory Card. Price: 13,400৳15,000৳.

Product: Sony SF-G Tough Series UHS-II SDXC 64GB Memory Card. Category: Sony. Subcategory: Memory Card. Price: 15,400৳17,000৳.
",257,861512,861769
3549,recursive,"
Product: Sony G Series XQD 64GB Memory Card. Category: Sony. Subcategory: Memory Card. Price: 15,500৳18,000৳.

Product: Sony SF-G Tough Series UHS-II SDXC 128GB Memory Card. Category: Sony. Subcategory: Memory Card. Price: 26,700৳28,500৳.
",240,861769,862009
3550,recursive,"
Product: Sony CFexpress Type A TOUGH 80GB Memory Card. Category: Sony. Subcategory: Memory Card. Price: 25,900৳29,000৳.

Product: Sony CFexpress Type A TOUGH 160GB Memory Card. Category: Sony. Subcategory: Memory Card. Price: 43,900৳47,000৳.
",243,862009,862252
3551,recursive,"
Product: Sony CFexpress Type A TOUGH 640GB Memory Card. Category: Sony. Subcategory: Memory Card. Price: 149,000৳155,000৳.

Product: Sony SF-M Tough Series UHS-II SDXC 256GB Memory Card. Category: Sony. Subcategory: Memory Card. Price: Out Of Stock.
",251,862252,862503
3552,recursive,"
Product: Sony CFexpress Type A TOUGH 320GB Memory Card. Category: Sony. Subcategory: Memory Card. Price: Out Of Stock.

Product: Asus XONAR DGX PCI Express Sound Card. Category: Sound Card. Subcategory: Accessories. Price: Out Of Stock.
",238,862503,862741
3553,recursive,"
Product: Orico SC2 USB 2.0 External Sound Card. Category: Sound Card. Subcategory: Accessories. Price: 1,050৳.

Product: UGREEN CM129 USB External Sound Card #40964. Category: Sound Card. Subcategory: Accessories. Price: Up Coming.
",233,862741,862974
3554,recursive,"
Product: Orico SKT2 USB 2.0 External Sound Card. Category: Sound Card. Subcategory: Accessories. Price: Out Of Stock.

Product: Fantech Tunnel AC3002 7.1 Surround Sound Audio Sound Card. Category: Sound Card. Subcategory: Accessories. Price: Out Of Stock.
",257,862974,863231
3555,recursive,"
Product: HyperX AMP Virtual 7.1 Surround USB Sound Card. Category: Sound Card. Subcategory: Accessories. Price: Out Of Stock.

Product: Asus Xonar SE 5.1 PCIe 192kHz Gaming Sound Card. Category: Sound Card. Subcategory: Accessories. Price: Out Of Stock.
",255,863231,863486
3556,recursive,"
Product: Orico SKT3 USB 2.0 External Sound Card. Category: Sound Card. Subcategory: Accessories. Price: Out Of Stock.

Product: Asus XONAR AE PCI Express Gaming Sound Card. Category: Sound Card. Subcategory: Accessories. Price: Out Of Stock.
",243,863486,863729
3557,recursive,"
Product: Avermedia GC311 Micro USB Full HD Live Gamer Mini Game Capture Card (Black). Category: AVerMedia. Subcategory: Capture Card. Price: 10,250৳10,400৳.
",158,863729,863887
3558,recursive,"
Product: Avermedia GC551 Type C Live Gamer Extreme 2 Full HD Game Capture Card (Black). Category: AVerMedia. Subcategory: Capture Card. Price: 12,400৳.
",153,863887,864040
3559,recursive,"
Product: AVerMedia Live Gamer Duo GC570D PCI-Express Internal Game Capture Card. Category: AVerMedia. Subcategory: Capture Card. Price: 18,700৳19,000৳.

Product: AVerMedia BU110 USB ExtremeCap UVC Video Capture Card. Category: AVerMedia. Subcategory: Capture Card. Price: Out Of Stock.
",287,864040,864327
3560,recursive,"
Product: AVerMedia Live Gamer HD 2 GC570 PCI-Express Internal Game Capture Card. Category: AVerMedia. Subcategory: Capture Card. Price: Out Of Stock.
",151,864327,864478
3561,recursive,"
Product: Avermedia GC513 Micro USB Full HD Live Gamer Mini Game Capture Card (Black). Category: AVerMedia. Subcategory: Capture Card. Price: Out Of Stock.

Product: Elgato Cam Link 4K USB Compact HDMI Capture Card. Category: Capture Card. Subcategory: Accessories. Price: 11,900৳13,000৳.
",289,864478,864767
3562,recursive,"
Product: Elgato Game Capture Neo Game Capture Card White. Category: Capture Card. Subcategory: Accessories. Price: 12,200৳14,500৳.

Product: Elgato HD60 X External Capture Card. Category: Capture Card. Subcategory: Accessories. Price: 19,000৳.
",245,864767,865012
3563,recursive,"
Product: Elgato Cam Link Pro Capture Card. Category: Capture Card. Subcategory: Accessories. Price: 35,100৳36,000৳.

Product: Ugreen CM489 Type-C & USB Male to HDMI Female 4K Video Capture Card #40189. Category: Capture Card. Subcategory: Accessories. Price: Out Of Stock.
",274,865012,865286
3564,recursive,"
Product: Vention ACWHA Type-C & USB Male to HDMI Female Video Capture Card. Category: Capture Card. Subcategory: Accessories. Price: Out Of Stock.

Product: ORICO HVC-1080 HDMI to USB3.0 Video Capture Card. Category: Capture Card. Subcategory: Accessories. Price: Out Of Stock.
",279,865286,865565
3565,recursive,"
Product: ORICO 2.5 to 3.5 inch Hard Drive Caddy (1125SS). Category: HDD-SSD Enclosure. Subcategory: Accessories. Price: 600৳.

Product: ORICO 25PW1-U3 2.5 inch USB3.0 Micro-B Hard Drive Enclosure. Category: HDD-SSD Enclosure. Subcategory: Accessories. Price: 650৳690৳.
",270,865565,865835
3566,recursive,"
Product: ORICO-2020U3 2.5 Inch SATA USB 3.0 HDD Enclosure. Category: HDD-SSD Enclosure. Subcategory: Accessories. Price: 650৳700৳.

Product: Orico 2520U3 2.5 inch USB 3.0 SATA HDD & SSD Enclosure. Category: HDD-SSD Enclosure. Subcategory: Accessories. Price: 750৳.
",266,865835,866101
3567,recursive,"
Product: Yuanxin YPH-023 2.5 Inch SATA HDD SSD Enclosure. Category: HDD-SSD Enclosure. Subcategory: Accessories. Price: 799৳850৳.

Product: Yuanxin YPH-024 2.5 inch USB HDD Enclosure. Category: HDD-SSD Enclosure. Subcategory: Accessories. Price: 950৳.
",253,866101,866354
3568,recursive,"
Product: Yuanxin YPH-025 2.5 Inch SATA HDD Enclosure. Category: HDD-SSD Enclosure. Subcategory: Accessories. Price: 800৳990৳.

Product: Yuanxin YPH-027 2.5 inch SATA HDD Enclosure. Category: HDD-SSD Enclosure. Subcategory: Accessories. Price: 800৳1,000৳.
",256,866354,866610
3569,recursive,"
Product: Ugreen 2.5"" SATA USB 3.0 Hard Disk Enclosure #60353. Category: HDD-SSD Enclosure. Subcategory: Accessories. Price: 1,300৳.

Product: Vention KPAB0 2.5 Inch USB 3.0 SATA Hard Drive Enclosure. Category: HDD-SSD Enclosure. Subcategory: Accessories. Price: 1,090৳1,500৳.
",277,866610,866887
3570,recursive,"
Product: Yuanxin YPH-037 M.2 NVMe SSD Enclosure. Category: HDD-SSD Enclosure. Subcategory: Accessories. Price: 1,700৳1,800৳.

Product: Yuanxin YPH-038 M.2 NVMe/SATA SSD Enclosure. Category: HDD-SSD Enclosure. Subcategory: Accessories. Price: 1,800৳.
",251,866887,867138
3571,recursive,"
Product: Yuanxin YPH-050 3.5 Inch SATA HDD Enclosure with Power Adapter. Category: HDD-SSD Enclosure. Subcategory: Accessories. Price: 1,800৳.

Product: Yuanxin YPH-033 3.5 Inch SATA HDD Enclosure with Power Adapter. Category: HDD-SSD Enclosure. Subcategory: Accessories. Price: 1,750৳1,850৳.
",294,867138,867432
3572,recursive,"
Product: UGREEN CM400 USB-C to M.2 NGFF 5Gbps SATA SSD Enclosure #10903. Category: HDD-SSD Enclosure. Subcategory: Accessories. Price: 1,700৳1,900৳.

Product: Vention KPBB0 2.5 Inch USB 3.0 SATA Hard Drive Enclosure. Category: HDD-SSD Enclosure. Subcategory: Accessories. Price: 1,680৳2,000৳.
",294,867432,867726
3573,recursive,"
Product: UGREEN CM300 Type-C to 2.5"" SATA Hard Drive Enclosure #70499. Category: HDD-SSD Enclosure. Subcategory: Accessories. Price: 2,150৳.

Product: UGREEN CM300 Type-C to 2.5"" SATA Hard Drive Enclosure #70498. Category: HDD-SSD Enclosure. Subcategory: Accessories. Price: 2,180৳.
",284,867726,868010
3574,recursive,"
Product: Ugreen CM642 M.2 NVMe SSD Enclosure #15976. Category: HDD-SSD Enclosure. Subcategory: Accessories. Price: 9,500৳.

Product: Orico M2PV-C3 M.2 Type-C NVMe SSD Enclosure. Category: HDD-SSD Enclosure. Subcategory: Accessories. Price: 2,250৳.
",249,868010,868259
3575,recursive,"
Product: DeepCool EK720-L-1.0 High Performance Thermal Pad. Category: Thermal Paste. Subcategory: Accessories. Price: 750৳.

Product: DeepCool EK720-L-1.5 High Performance Thermal Pad. Category: Thermal Paste. Subcategory: Accessories. Price: 850৳.
",250,868259,868509
3576,recursive,"
Product: Gamdias XC5 4g High-Performance Thermal Paste. Category: Thermal Paste. Subcategory: Accessories. Price: 900৳.

Product: DeepCool EK720-XL-0.5 High Performance Thermal Pad. Category: Thermal Paste. Subcategory: Accessories. Price: 1,000৳.
",249,868509,868758
3577,recursive,"
Product: DeepCool EK720-L-2.0 High Performance Thermal Pad. Category: Thermal Paste. Subcategory: Accessories. Price: 1,100৳.

Product: DeepCool DM9 4g Professional Grade Thermal Paste. Category: Thermal Paste. Subcategory: Accessories. Price: 1,100৳.
",253,868758,869011
3578,recursive,"
Product: DeepCool EK720-XL-1.0 High Performance Thermal Pad. Category: Thermal Paste. Subcategory: Accessories. Price: 1,400৳.

Product: DeepCool EK720-XL-1.5 High Performance Thermal Pad. Category: Thermal Paste. Subcategory: Accessories. Price: 1,800৳.
",256,869011,869267
3579,recursive,"
Product: Cryorig CP5 CRYO-PASTE. Category: Thermal Paste. Subcategory: Accessories. Price: Up Coming.

Product: Thermal Grizzly Kryonaut 1g Thermal Paste. Category: Thermal Paste. Subcategory: Accessories. Price: Up Coming.
",225,869267,869492
3580,recursive,"
Product: Thermal Grizzly Hydronaut 1g Thermal Paste. Category: Thermal Paste. Subcategory: Accessories. Price: Up Coming.

Product: Thermal Grizzly Duronaut 2g Thermal Paste. Category: Thermal Paste. Subcategory: Accessories. Price: Up Coming.
",245,869492,869737
3581,recursive,"
Product: Thermal Grizzly Aeronaut 1g Thermal Paste. Category: Thermal Paste. Subcategory: Accessories. Price: Up Coming.

Product: Arctic MX-4 4G Premium Performance Thermal Paste with Spatula. Category: Thermal Paste. Subcategory: Accessories. Price: Up Coming.
",264,869737,870001
3582,recursive,"
Product: DeepCool EX750 5g High-Performance Thermal Paste. Category: Thermal Paste. Subcategory: Accessories. Price: Up Coming.

Product: Thermal Grease (30gm) Paste Compound Silicone Syringe Gray. Category: Thermal Paste. Subcategory: Accessories. Price: Out Of Stock.
",271,870001,870272
3583,recursive,"
Product: Deepcool G15 Thermal Paste. Category: Thermal Paste. Subcategory: Accessories. Price: Out Of Stock.

Product: DeepCool Z3 Thermal Paste. Category: Thermal Paste. Subcategory: Accessories. Price: Out Of Stock.
",219,870272,870491
3584,recursive,"
Product: Deepcool Z5 Thermal Paste. Category: Thermal Paste. Subcategory: Accessories. Price: Out Of Stock.

Product: DeepCool Z10 Thermal Paste. Category: Thermal Paste. Subcategory: Accessories. Price: Out Of Stock.
",219,870491,870710
3585,recursive,"
Product: Hiksemi Pully HS-USB-M210S 32GB USB 3.2 Pen Drive. Category: Pen Drive. Subcategory: Accessories. Price: 450৳500৳.

Product: Hiksemi Cap HS-USB-M220P 32GB USB 3.2 Pen Drive. Category: Pen Drive. Subcategory: Accessories. Price: 525৳.
",244,870710,870954
3586,recursive,"
Product: Apacer AH25C 32GB USB 3.2 Gen 1 Flash Drive. Category: Pen Drive. Subcategory: Accessories. Price: 590৳.

Product: Apacer AH355 32GB USB 3.1 Flash Drive. Category: Pen Drive. Subcategory: Accessories. Price: 550৳600৳.
",228,870954,871182
3587,recursive,"
Product: Apacer AH353 32GB USB 3.2 Flash Drive. Category: Pen Drive. Subcategory: Accessories. Price: 650৳.

Product: Adata UV150 64GB USB 3.2 Gen 1 Pen Drive. Category: Pen Drive. Subcategory: Accessories. Price: 610৳650৳.
",225,871182,871407
3588,recursive,"
Product: Apacer AH357 32GB USB 3.2 Gen 1 Flash Drive. Category: Pen Drive. Subcategory: Accessories. Price: 550৳650৳.

Product: Kingston DataTraveler Exodia 64GB USB 3.2 Gen 1 Pen Drive. Category: Pen Drive. Subcategory: Accessories. Price: 553৳650৳.
",252,871407,871659
3589,recursive,"
Product: Hiksemi HS-USB-E307C 32GB USB 3.2 Pen Drive. Category: Pen Drive. Subcategory: Accessories. Price: 650৳.

Product: Hiksemi Sync HS-USB-E327C 32GB USB 3.2 Pen Drive. Category: Pen Drive. Subcategory: Accessories. Price: 650৳.
",235,871659,871894
3590,recursive,"
Product: Hiksemi Blade HS-USB-E301 64GB USB 3.2 Pen Drive. Category: Pen Drive. Subcategory: Accessories. Price: 553৳650৳.

Product: Hiksemi Pully HS-USB-M210S 64GB USB 3.2 Pen Drive. Category: Pen Drive. Subcategory: Accessories. Price: 650৳.
",245,871894,872139
3591,recursive,"
Product: Hiksemi Cap HS-USB-M220P 64GB USB 3.2 Pen Drive. Category: Pen Drive. Subcategory: Accessories. Price: 553৳650৳.

Product: Eaget ET-X1 32GB USB 3.2 Gen1 Pen Drive. Category: Pen Drive. Subcategory: Accessories. Price: 650৳.
",234,872139,872373
3592,recursive,"
Product: Apacer AH355 64GB USB 3.2 Gen 1 Flash Drive. Category: Pen Drive. Subcategory: Accessories. Price: 700৳.

Product: Apacer AH356 64GB USB 3.2 Gen 1 Flash Drive. Category: Pen Drive. Subcategory: Accessories. Price: 665৳700৳.
",234,872373,872607
3593,recursive,"
Product: Dahua U156 64GB USB 3.2 Pen Drive. Category: Pen Drive. Subcategory: Accessories. Price: 650৳700৳.

Product: ADATA UC310 ECO 64GB USB 3.2 Pen Drive. Category: Pen Drive. Subcategory: Accessories. Price: 600৳700৳.
",223,872607,872830
3594,recursive,"
Product: ADATA UC320 64GB USB 3.2 Pen Drive. Category: Pen Drive. Subcategory: Accessories. Price: 650৳700৳.

Product: Orico AXM2S-G2-GY M.2 Type-C SSD Enclosure. Category: Orico. Subcategory: HDD-SSD Enclosure. Price: 2,500৳.
",228,872830,873058
3595,recursive,"
Product: ORICO PVM2F-C3 NGFF M.2 Type-C Hard Drive Enclosure. Category: Orico. Subcategory: HDD-SSD Enclosure. Price: 2,200৳2,600৳.

Product: Orico 6829C3 2.5 3.5 inch SATA HDD SSD Offline Clone Dual Bay Dock. Category: Orico. Subcategory: HDD-SSD Enclosure. Price: 3,850৳4,100৳.
",281,873058,873339
3596,recursive,"
Product: Orico 2577U3-BK 2.5"" USB3.0 to SATA III Hard Drive Enclosure. Category: Orico. Subcategory: HDD-SSD Enclosure. Price: Out Of Stock.

Product: ORICO 2189U3 2.5 inch USB3.0 Hard Drive Enclosure. Category: Orico. Subcategory: HDD-SSD Enclosure. Price: Out Of Stock.
",273,873339,873612
3597,recursive,"
Product: ORICO 2139U3 2.5 inch Transparent USB 3.0 Hard Drive Enclosure. Category: Orico. Subcategory: HDD-SSD Enclosure. Price: Out Of Stock.

Product: ORICO 2577C3-V1 USB 3.0 to Type-C 2.5 inch HDD Enclosure. Category: Orico. Subcategory: HDD-SSD Enclosure. Price: Out Of Stock.
",282,873612,873894
3598,recursive,"
Product: ORICO TX25C3-GY 2.5 inch Type-C Transparent Enclosure. Category: Orico. Subcategory: HDD-SSD Enclosure. Price: Out Of Stock.

Product: Orico 2129U3 2.5"" SATA HDD/SSD USB 3.0 Transparent Enclosure. Category: Orico. Subcategory: HDD-SSD Enclosure. Price: Out Of Stock.
",277,873894,874171
3599,recursive,"
Product: Orico NGFF M.2 Hard Drive Enclosure. Category: Orico. Subcategory: HDD-SSD Enclosure. Price: Out Of Stock.

Product: Orico 1106SS 3.5 inch 5.25 Bay Stainless Internal Hard Drive Mounting Bracket Adapter. Category: Orico. Subcategory: HDD-SSD Enclosure. Price: Out Of Stock.
",284,874171,874455
3600,recursive,"
Product: Orico PDM2 M.2 NVME to PCI-E3.0 X4 Expansion Card. Category: Orico. Subcategory: HDD-SSD Enclosure. Price: Out Of Stock.

Product: Orico M2PF-C3 M.2 Type-C SSD Enclosure. Category: Orico. Subcategory: HDD-SSD Enclosure. Price: Out Of Stock.
",251,874455,874706
3601,recursive,"
Product: Orico PWM2 Type-C 5Gbps M.2 NGFF SATA SSD Enclosure. Category: Orico. Subcategory: HDD-SSD Enclosure. Price: Out Of Stock.

Product: Orico TCM2-C3 M.2 Sata SSD Enclosure. Category: Orico. Subcategory: HDD-SSD Enclosure. Price: Out Of Stock.
",251,874706,874957
3602,recursive,"
Product: Ugreen 30848 2.5 Inch Hard Drive Box Enclosure. Category: UGREEN. Subcategory: HDD-SSD Enclosure. Price: Out Of Stock.

Product: UGREEN CM471 2.5 Inch USB Hard Drive Enclosure #30719. Category: UGREEN. Subcategory: HDD-SSD Enclosure. Price: Out Of Stock.
",265,874957,875222
3603,recursive,"
Product: Ugreen USB Type-C 2.5 Inch SATA III Hard Drive Enclosure (Case Only) #50743. Category: UGREEN. Subcategory: HDD-SSD Enclosure. Price: Out Of Stock.

Product: UGREEN US221 2.5 inch USB 3.1 Hard Drive Enclosure #60735. Category: UGREEN. Subcategory: HDD-SSD Enclosure. Price: Out Of Stock.
",298,875222,875520
3604,recursive,"
Product: UGREEN US222 USB 3.0 SATA Hard Drive Enclosure #50422. Category: UGREEN. Subcategory: HDD-SSD Enclosure. Price: Out Of Stock.

Product: UGREEN CM578 M.2 NVMe SSD Enclosure #15512. Category: UGREEN. Subcategory: HDD-SSD Enclosure. Price: Out Of Stock.
",261,875520,875781
3605,recursive,"
Product: UGREEN CM400 M.2 SATA and NVMe SSD Enclosure #90264. Category: UGREEN. Subcategory: HDD-SSD Enclosure. Price: Out Of Stock.

Product: Ugreen M2 Sata SSD Case Enclosure USB Type A to Type C 3.1. Category: UGREEN. Subcategory: HDD-SSD Enclosure. Price: Out Of Stock.
",275,875781,876056
3606,recursive,"
Product: VENTION KPKH0 M.2 NVMe SSD Enclosure. Category: Vention. Subcategory: HDD-SSD Enclosure. Price: 2,700৳.

Product: Cooler Master Oracle Air M.2 NVMe SSD Enclosure. Category: Cooler Master. Subcategory: HDD-SSD Enclosure. Price: Out Of Stock.
",251,876056,876307
3607,recursive,"
Product: Deli CT703 2 Pin 4 Port 3 Meter Power Strip. Category: Deli. Subcategory: Power Strip. Price: 650৳750৳.

Product: Deli CT704 2 Pin 4 Port 5 Meter Power Strip. Category: Deli. Subcategory: Power Strip. Price: 850৳950৳.
",228,876307,876535
3608,recursive,"
Product: Deli CT705 2 Pin 6 Port 3 Meter Power Strip. Category: Deli. Subcategory: Power Strip. Price: 850৳950৳.

Product: Deli CT703ES 3 Pin 4 Port 3 Meter Power Strip With Surge Protection. Category: Deli. Subcategory: Power Strip. Price: 1,050৳1,200৳.
",256,876535,876791
3609,recursive,"
Product: Deli CT705ES 3 Pin 6 Port 3 Meter Power Strip With Surge Protection. Category: Deli. Subcategory: Power Strip. Price: 1,199৳1,300৳.

Product: Deli ET410 2 Pin 3 Port 2 Meter Power Strip. Category: Deli. Subcategory: Power Strip. Price: 1,650৳1,700৳.
",260,876791,877051
3610,recursive,"
Product: Deli CT711 4 Port 2 Meter Power Strip. Category: Deli. Subcategory: Power Strip. Price: 1,699৳1,800৳.

Product: Deli ET404 Universal Hole Extension Cord 2 Pin 4 Port 5 Meter Power Strip. Category: Deli. Subcategory: Power Strip. Price: Out Of Stock.
",260,877051,877311
3611,recursive,"
Product: Deli ET403 Universal Hole Extension Cord 2 Pin 4 Port 3 Meter Power Strip. Category: Deli. Subcategory: Power Strip. Price: Out Of Stock.

Product: Deli ET405 2 Pin 6 Port 3 Meter Power Strip. Category: Deli. Subcategory: Power Strip. Price: Out Of Stock.
",266,877311,877577
3612,recursive,"
Product: Deli CT411 2 Pin 4 Port 2 Meter Power Strip. Category: Deli. Subcategory: Power Strip. Price: Out Of Stock.

Product: Deli ET411 2 Pin 4 Port 2 Meter Power Strip. Category: Deli. Subcategory: Power Strip. Price: Out Of Stock.
",236,877577,877813
3613,recursive,"
Product: Nano NPS 205 5-Port 2-Pin White Power Strip. Category: Power Strip. Subcategory: Accessories. Price: 399৳650৳.

Product: Havit HV-SP8813 3AC Slot+3 USB Switch Power Strip. Category: Power Strip. Subcategory: Accessories. Price: 749৳800৳.
",248,877813,878061
3614,recursive,"
Product: Huntkey SZM401 4 Port Socket 2Core Cable Power Strip. Category: Power Strip. Subcategory: Accessories. Price: 680৳850৳.

Product: Nano MBS 405 5-Port Power Strip White (3 Pin Power Plug). Category: Power Strip. Subcategory: Accessories. Price: 550৳1,000৳.
",266,878061,878327
3615,recursive,"
Product: Nano MBS 405 5-Port Power Strip White (2 Pin Power Plug). Category: Power Strip. Subcategory: Accessories. Price: 600৳1,000৳.

Product: Nano NPS 709 8-Port Power Strip White (3 Pin Power Plug). Category: Power Strip. Subcategory: Accessories. Price: 700৳1,000৳.
",272,878327,878599
3616,recursive,"
Product: Huntkey SZM604 6 Ports Power Strip With Surge Protection. Category: Power Strip. Subcategory: Accessories. Price: 930৳1,550৳.

Product: Hoco AC12A Reise 6-Ports Multifunctional Power Strip. Category: Power Strip. Subcategory: Accessories. Price: 1,350৳1,650৳.
",270,878599,878869
3617,recursive,"
Product: Belkin Economy Series 3-Socket Surge Protector 1.5 Meter Power Strip (F9E300ZB). Category: Power Strip. Subcategory: Accessories. Price: 1,550৳1,700৳.

Product: Huntkey SZM804 Eight Port Surge Protection Power Strip. Category: Power Strip. Subcategory: Accessories. Price: 1,599৳1,800৳.
",297,878869,879166
3618,recursive,"
Product: LDNIO SC3412 3 AC Outlets Universal Power Strip. Category: Power Strip. Subcategory: Accessories. Price: 1,690৳2,000৳.

Product: Huntkey SZN601 6 Port 3 Pin Power Strip with Surge Protection. Category: Power Strip. Subcategory: Accessories. Price: 1,899৳2,100৳.
",272,879166,879438
3619,recursive,"
Product: Belkin Economy Series 4-Socket Surge Protector 1.5 Meter Power Strip (F9E400ZB). Category: Power Strip. Subcategory: Accessories. Price: 1,850৳2,200৳.

Product: Huntkey PZC504 FivePorts 3 Line Surge Protection PowerStrip. Category: Huntkey. Subcategory: Power Strip. Price: 2,080৳2,700৳.
",298,879438,879736
3620,recursive,"
Product: Huntkey SZN507 Power Strip. Category: Huntkey. Subcategory: Power Strip. Price: 2,099৳2,800৳.

Product: Huntkey PZA402 4 AC Ports with 4 Switch Surge Protection PowerStrip. Category: Huntkey. Subcategory: Power Strip. Price: Out Of Stock.
",249,879736,879985
3621,recursive,"
Product: Huntkey SZN501 5 Port 3 Pin Power Strip with Surge protection. Category: Huntkey. Subcategory: Power Strip. Price: Out Of Stock.

Product: Maxline ML Q455 2 Pin 4 Port Multiplug Power Strip with 10 Meter Cable. Category: Maxline. Subcategory: Power Strip. Price: Up Coming.
",284,879985,880269
3622,recursive,"
Product: Maxline ML Q455 2 Pin 4 Port Multiplug Power Strip with 2 Meter Cable. Category: Maxline. Subcategory: Power Strip. Price: Out Of Stock.

Product: Maxline ML Q455 2 Pin 4 Port Multiplug Power Strip with 5 Meter Cable. Category: Maxline. Subcategory: Power Strip. Price: Out Of Stock.
",294,880269,880563
3623,recursive,"
Product: Maxline ML-254-3M 2 Pin Plug 4 Gang Multi Extension Socket Power Strip. Category: Maxline. Subcategory: Power Strip. Price: Out Of Stock.

Product: Maxline ML-255-5M 2 Pin Plug 5 Gang Multi Extension Socket Power-Strip. Category: Maxline. Subcategory: Power Strip. Price: Out Of Stock.
",296,880563,880859
3624,recursive,"
Product: Maxline ML-804 USB Fast Charging Multiplug Power Strip. Category: Maxline. Subcategory: Power Strip. Price: Out Of Stock.

Product: Maxline Ml-604 4 USB Fast Charging Multiplug Power Strip. Category: Maxline. Subcategory: Power Strip. Price: Out Of Stock.
",266,880859,881125
3625,recursive,"
Product: MaxLine ML-704 4 USB Port 3 Socket Multiplug Power Strip. Category: Maxline. Subcategory: Power Strip. Price: Out Of Stock.

Product: Maxline ML-825-5M 10 Port Multi Extension Socket Power-Strip. Category: Maxline. Subcategory: Power Strip. Price: Out Of Stock.
",272,881125,881397
3626,recursive,"
Product: Maxline ML-254-5M 2 Pin Plug 4 Gang Multi Extension Socket Power-Strip. Category: Maxline. Subcategory: Power Strip. Price: Out Of Stock.

Product: Maxline ML-358-3M Wire 5 Gang Multiplug Power Strip. Category: Maxline. Subcategory: Power Strip. Price: Out Of Stock.
",277,881397,881674
3627,recursive,"
Product: ORICO HPC-4A5U-V1-EU 4 AC Outlet Surge Protector with 5 USB Charging Port Smart Power Strip. Category: ORICO. Subcategory: Power Strip. Price: 2,650৳3,100৳.

Product: Baseus PowerCombo Lite 6 Ports Power Strip. Category: Baseus. Subcategory: Power Strip. Price: 3,890৳4,270৳.
",286,881674,881960
3628,recursive,"
Product: Anker 615 USB Power Strip (GaNPrime 65W). Category: Anker. Subcategory: Power Strip. Price: Up Coming.

Product: Anker PowerExtend 3 Plug USB Type-C Power Strip. Category: Anker. Subcategory: Power Strip. Price: Out Of Stock.
",236,881960,882196
3629,recursive,"
Product: Belkin Economy Series 6-Socket Surge Protector 2 Meter Power Strip (F9E600ZB2M). Category: Belkin. Subcategory: Power Strip. Price: 2,150৳2,400৳.
",156,882196,882352
3630,recursive,"
Product: Belkin Economy Series 8-Socket Surge Protector 2 Meter Power Strip (F9E800ZB). Category: Belkin. Subcategory: Power Strip. Price: 2,699৳3,000৳.

Product: Hoco UA18 Bluetooth 5.0 USB Adapter Black. Category: Bluetooth Adapter. Subcategory: Accessories. Price: 340৳370৳.
",279,882352,882631
3631,recursive,"
Product: Hoco UA28 Bluetooth 5.1 USB Adapter. Category: Bluetooth Adapter. Subcategory: Accessories. Price: 350৳380৳.

Product: Baseus BA04 5.0 Bluetooth Receiver Adapter. Category: Bluetooth Adapter. Subcategory: Accessories. Price: 460৳500৳.
",245,882631,882876
3632,recursive,"
Product: Orico BTA-508 USB Bluetooth 5.0 Adapter. Category: Bluetooth Adapter. Subcategory: Accessories. Price: 500৳540৳.

Product: Vention NAFB0 USB Apt-X Bluetooth 5.1 Adapter. Category: Bluetooth Adapter. Subcategory: Accessories. Price: 650৳710৳.
",252,882876,883128
3633,recursive,"
Product: UGREEN CM591 USB Bluetooth 5.3 Adapter. Category: Bluetooth Adapter. Subcategory: Accessories. Price: 720৳.

Product: Yuanxin YLY-021 USB Bluetooth 5.4 Adapter. Category: Bluetooth Adapter. Subcategory: Accessories. Price: 680৳730৳.
",243,883128,883371
3634,recursive,"
Product: UGREEN CM748 USB Bluetooth v5.4 Adapter #35058. Category: Bluetooth Adapter. Subcategory: Accessories. Price: 730৳800৳.

Product: TP-Link UB400 Bluetooth 4.0 Nano USB Adapter. Category: Bluetooth Adapter. Subcategory: Accessories. Price: 740৳810৳.
",258,883371,883629
3635,recursive,"
Product: TP-Link UB500 Bluetooth 5.0 Nano USB Adapter. Category: Bluetooth Adapter. Subcategory: Accessories. Price: 790৳850৳.

Product: Ugreen BT301 USB Bluetooth Adapter #35994. Category: Bluetooth Adapter. Subcategory: Accessories. Price: 840৳910৳.
",253,883629,883882
3636,recursive,"
Product: Vention NAHB0 USB Bluetooth 5.3 Adapter. Category: Bluetooth Adapter. Subcategory: Accessories. Price: 890৳960৳.

Product: Baseus BA07 5.3 Bluetooth Receiver Adapter. Category: Bluetooth Adapter. Subcategory: Accessories. Price: 950৳1,040৳.
",251,883882,884133
3637,recursive,"
Product: TRENDnet TBW-107UB Micro Bluetooth USB Adapter. Category: Bluetooth Adapter. Subcategory: Accessories. Price: 1,140৳1,250৳.

Product: TRENDnet TBW-110UB USB Bluetooth 5.0 Adapter. Category: Bluetooth Adapter. Subcategory: Accessories. Price: 1,450৳1,550৳.
",266,884133,884399
3638,recursive,"
Product: UGREEN CM276 Bluetooth Audio Receiver #70303. Category: Bluetooth Adapter. Subcategory: Accessories. Price: 1,720৳1,850৳.
",132,884399,884531
3639,recursive,"
Product: Ugreen CM106 Wireless Bluetooth Audio Receiver 5.0 with 3.5mm and 2RCA Adapter #40759. Category: Bluetooth Adapter. Subcategory: Accessories. Price: 2,050৳2,199৳.
",173,884531,884704
3640,recursive,"
Product: Ugreen CM123 Wireless Bluetooth Audio Receiver 5.0 with 3.5mm and 2RCA Adapter with SRRC #30445. Category: Bluetooth Adapter. Subcategory: Accessories. Price: 2,090৳2,199৳.
",183,884704,884887
3641,recursive,"
Product: UGREEN CM123 Wireless Bluetooth Audio Receiver #30445. Category: Bluetooth Adapter. Subcategory: Accessories. Price: 2,200৳.

Product: Ugreen CM279 3.5mm Bluetooth Audio Receiver #70304. Category: Bluetooth Adapter. Subcategory: Accessories. Price: 2,340৳2,550৳.
",273,884887,885160
3642,recursive,"
Product: Hoco AC7A Storm 7-Ports Power Strip. Category: Hoco. Subcategory: Power Strip. Price: Up Coming.

Product: Hoco AC11A Voyage 6-Ports Expansion Power Strip. Category: Hoco. Subcategory: Power Strip. Price: Out Of Stock.
",229,885160,885389
3643,recursive,"
Product: Hoco AC8A Storm 7-Ports PD30W Power Strip. Category: Hoco. Subcategory: Power Strip. Price: Out Of Stock.

Product: Xiaomi Mi Smart LED Bulb Essential (White and Color). Category: Gadget. Price: 1,400৳1,499৳.
",219,885389,885608
3644,recursive,"
Product: Xiaomi Portable Electric Air Compressor 2. Category: Gadget. Price: 4,950৳5,199৳.

Product: Yison Celebrat G35 3.5mm Wired Earphone. Category: Gadget. Price: 130৳.

Product: Yison Celebrat G3 3.5mm Wired Earphone. Category: Gadget. Price: 140৳.
",255,885608,885863
3645,recursive,"
Product: CHARG DME63 3.5MM Wired Earphone. Category: Gadget. Price: 140৳.

Product: CHARG DME62 3.5MM Wired Earphone. Category: Gadget. Price: 160৳.

Product: Yison Celebrat G13 3.5mm Wired Earphone. Category: Gadget. Price: 170৳.
",232,885863,886095
3646,recursive,"
Product: FONENG T15 Half-In-Ear 3.5mm Heavy Bass Earphone. Category: Gadget. Price: 170৳.

Product: Yison Celebrat G28 3.5mm Wired Earphone. Category: Gadget. Price: 172৳.

Product: Yison Celebrat FLY-1 In-Ear Wired Earphone. Category: Gadget. Price: 190৳.
",258,886095,886353
3647,recursive,"
Product: FONENG EP200 3.5mm In-Ear Wired Earphone. Category: Gadget. Price: 190৳.

Product: Yison Celebrat D2 3.5mm Wired Premium Earphone. Category: Gadget. Price: 195৳.

Product: Oraimo OEP-320S In-Ear Wired Earphone. Category: Gadget. Price: 200৳.
",252,886353,886605
3648,recursive,"
Product: Oraimo Halo Lite In-Ear Wired Earphone. Category: Gadget. Price: 215৳.

Product: Hoco M97 Enjoy 3.5mm Wired Earphone. Category: Gadget. Price: 230৳.

Product: Riversong SEED+ EA64 Wired Earphone. Category: Gadget. Price: 180৳235৳.
",241,886605,886846
3649,recursive,"
Product: Yison Celebrat G9 Wired 3.5mm Earphone. Category: Gadget. Price: 240৳.

Product: Yison CX620 In-Ear Wired Earphone. Category: Gadget. Price: 240৳.

Product: FONENG T52 3.5mm In-Ear Wired Earphone. Category: Gadget. Price: 190৳249৳.
",242,886846,887088
3650,recursive,"
Product: Recci REP-L15 3.5mm Wired Earphone. Category: Gadget. Price: 250৳.

Product: COLMI P81 Smart Watch. Category: Smart Watch. Subcategory: Gadget. Price: 1,426৳1,550৳.

Product: Yison Celebrat SW2Pro Smart Watch. Category: Smart Watch. Subcategory: Gadget. Price: 1,520৳1,650৳.
",285,887088,887373
3651,recursive,"
Product: COLMI P71 Smart Watch. Category: Smart Watch. Subcategory: Gadget. Price: 1,518৳1,650৳.

Product: Oraimo Watch 5 Max Bluetooth Calling Smart Watch (Tahilalats Edition). Category: Smart Watch. Subcategory: Gadget. Price: 1,590৳1,699৳.
",244,887373,887617
3652,recursive,"
Product: Zeblaze GTS 3. Category: Smart Watch. Subcategory: Gadget. Price: 1,590৳1,699৳.

Product: Oraimo Watch 5 Lite Smart Watch. Category: Smart Watch. Subcategory: Gadget. Price: 1,565৳1,799৳.
",198,887617,887815
3653,recursive,"
Product: Yison Celebrat SW6Pro Smart Watch. Category: Smart Watch. Subcategory: Gadget. Price: 1,690৳1,820৳.

Product: COLMI P76 Smart Watch. Category: Smart Watch. Subcategory: Gadget. Price: 1,701৳1,890৳.
",208,887815,888023
3654,recursive,"
Product: Zeblaze Btalk 3 Plus. Category: Smart Watch. Subcategory: Gadget. Price: 1,760৳1,899৳.

Product: COLMI P73 Smart Watch. Category: Smart Watch. Subcategory: Gadget. Price: 1,791৳1,990৳.
",195,888023,888218
3655,recursive,"
Product: Riversong Motive 6 Pro Smart Watch. Category: Smart Watch. Subcategory: Gadget. Price: 1,779৳1,999৳.

Product: Haylou Watch S6 Smart Watch. Category: Smart Watch. Subcategory: Gadget. Price: 1,800৳1,999৳.
",215,888218,888433
3656,recursive,"
Product: Riversong Motive 3C SW31 Smart Watch. Category: Smart Watch. Subcategory: Gadget. Price: 1,868৳2,099৳.

Product: XTRA Active S5 Pro+ Smart Watch. Category: Smart Watch. Subcategory: Gadget. Price: 1,920৳2,099৳.
",221,888433,888654
3657,recursive,"
Product: Havit M9035 Smart Watch. Category: Smart Watch. Subcategory: Gadget. Price: 1,978৳2,150৳.

Product: Awei H21 Smart Watch. Category: Smart Watch. Subcategory: Gadget. Price: 2,050৳2,190৳.
",197,888654,888851
3658,recursive,"
Product: Riversong Motive 3 SW30 Smart Watch. Category: Smart Watch. Subcategory: Gadget. Price: 2,090৳2,199৳.

Product: QCY Watch GS Bluetooth Calling Smart Watch. Category: Smart Watch. Subcategory: Gadget. Price: 2,138৳2,299৳.
",231,888851,889082
3659,recursive,"
Product: Imilab IMIKI Frame 2 Lite Smart Watch. Category: Smart Watch. Subcategory: Gadget. Price: 1,931৳2,299৳.

Product: COLMI V73 Smart Watch. Category: Smart Watch. Subcategory: Gadget. Price: 2,090৳2,322৳.
",212,889082,889294
3660,recursive,"
Product: Fantech PAC1 Portable Handheld Charger Fan. Category: Mini Fan. Subcategory: Gadget. Price: 510৳560৳.

Product: Yison Celebrat F6 Portable Fan. Category: Mini Fan. Subcategory: Gadget. Price: 590৳645৳.
",212,889294,889506
3661,recursive,"
Product: Vyvylabs VKL01 Babbit Handheld Fan. Category: Mini Fan. Subcategory: Gadget. Price: 720৳790৳.

Product: Yison Celebrat F4 Clip-on Portable Fan. Category: Mini Fan. Subcategory: Gadget. Price: 890৳960৳.
",212,889506,889718
3662,recursive,"
Product: Xiaomi Qualitell Y2 Portable Fan. Category: Mini Fan. Subcategory: Gadget. Price: 920৳999৳.

Product: Awei F32 Portable Rechargeable Mini Fan. Category: Mini Fan. Subcategory: Gadget. Price: 990৳1,080৳.
",213,889718,889931
3663,recursive,"
Product: Fantech PAC2 Portable Handheld Charger Fan. Category: Mini Fan. Subcategory: Gadget. Price: 1,180৳1,280৳.

Product: Vyvylabs D02 Handheld Foldable Clip Fan. Category: Mini Fan. Subcategory: Gadget. Price: 1,350৳1,450৳.
",229,889931,890160
3664,recursive,"
Product: Vyvylabs VKH01 Babbit High Speed Handheld Fan. Category: Mini Fan. Subcategory: Gadget. Price: 1,840৳1,990৳.

Product: Remax F23 Bladeless Rechargeable Neck Fan. Category: Mini Fan. Subcategory: Gadget. Price: 1,900৳2,050৳.
",234,890160,890394
3665,recursive,"
Product: Jisulife Neck Fan Pro1. Category: Mini Fan. Subcategory: Gadget. Price: 5,400৳5,899৳.

Product: Oraimo SmartHandheldfan 2 Rechargeable Fan. Category: Mini Fan. Subcategory: Gadget. Price: Up Coming.
",209,890394,890603
3666,recursive,"
Product: Hoco HX60 Nimble Portable Handheld Rechargeable Mini Fan. Category: Mini Fan. Subcategory: Gadget. Price: Up Coming.

Product: Hoco HX61 Handheld Rechargeable Mini Fan. Category: Mini Fan. Subcategory: Gadget. Price: Up Coming.
",238,890603,890841
3667,recursive,"
Product: Hoco HX63 Handheld Mini Fan With Display. Category: Mini Fan. Subcategory: Gadget. Price: Up Coming.

Product: Hoco HX62 Handheld Mini Fan With Display. Category: Mini Fan. Subcategory: Gadget. Price: Up Coming.
",222,890841,891063
3668,recursive,"
Product: Hoco HX64 Handheld Mini Fan With Display. Category: Mini Fan. Subcategory: Gadget. Price: Up Coming.

Product: Yison Celebrat F1 Rechargeable Fan. Category: Mini Fan. Subcategory: Gadget. Price: Out Of Stock.
",219,891063,891282
3669,recursive,"
Product: Plextone F2 Portable Handheld Charger Fan. Category: Mini Fan. Subcategory: Gadget. Price: Out Of Stock.

Product: Xiaomi Solove N9P Mini 2000mAh Portable Fan. Category: Mini Fan. Subcategory: Gadget. Price: Out Of Stock.
",232,891282,891514
3670,recursive,"
Product: Lenovo HT18 True Wireless Earbuds. Category: Earbuds. Subcategory: Gadget. Price: 650৳750৳.

Product: Awei T71 True Wireless Earbuds. Category: Earbuds. Subcategory: Gadget. Price: 837৳910৳.

Product: FONENG BL135 Wireless Earbuds. Category: Earbuds. Subcategory: Gadget. Price: 900৳980৳.
",299,891514,891813
3671,recursive,"
Product: Hoco EQ24 Estrella Wireless Earbuds. Category: Earbuds. Subcategory: Gadget. Price: 950৳1,030৳.

Product: FONENG BL138 True Wireless Earbuds. Category: Earbuds. Subcategory: Gadget. Price: 965৳1,049৳.
",211,891813,892024
3672,recursive,"
Product: Onikuma T308 Bluetooth Earbuds. Category: Earbuds. Subcategory: Gadget. Price: 1,040৳1,140৳.

Product: Awei T13 Pro TWS Waterproof Touch Sports Earbuds. Category: Earbuds. Subcategory: Gadget. Price: 972৳1,080৳.
",222,892024,892246
3673,recursive,"
Product: HOCO EQ2 Plus True Wireless Earbuds. Category: Earbuds. Subcategory: Gadget. Price: 990৳1,080৳.

Product: Hoco EW25 TWS Wireless Bluetooth Earbuds. Category: Earbuds. Subcategory: Gadget. Price: 934৳1,099৳.
",217,892246,892463
3674,recursive,"
Product: XTRA Buds T2 Wireless Bluetooth Earbuds. Category: Earbuds. Subcategory: Gadget. Price: 999৳1,099৳.

Product: Hoco EW201 True Wireless Earbuds. Category: Earbuds. Subcategory: Gadget. Price: 1,009৳1,134৳.
",215,892463,892678
3675,recursive,"
Product: Hoco EQ2 True Wireless Earbuds. Category: Earbuds. Subcategory: Gadget. Price: 1,050৳1,149৳.

Product: FONENG BL151 Half-In-Ear TWS Earbuds. Category: Earbuds. Subcategory: Gadget. Price: 1,050৳1,150৳.
",212,892678,892890
3676,recursive,"
Product: Yison Celebrat W52 True Wireless Earbuds. Category: Earbuds. Subcategory: Gadget. Price: 1,090৳1,190৳.

Product: Havit TW976 True Wireless Stereo Earbuds. Category: Earbuds. Subcategory: Gadget. Price: 1,062৳1,180৳.
",226,892890,893116
3677,recursive,"
Product: Awei T29 Pro Gaming Earbuds. Category: Earbuds. Subcategory: Gadget. Price: 1,083৳1,190৳.

Product: Hoco EQ3 True Wireless Earbuds. Category: Earbuds. Subcategory: Gadget. Price: 1,120৳1,200৳.
",203,893116,893319
3678,recursive,"
Product: Choetech BH-T24 TWS Wireless Earbuds. Category: Earbuds. Subcategory: Gadget. Price: 1,150৳1,235৳.

Product: Awei T29P True Wireless Earbuds. Category: Earbuds. Subcategory: Gadget. Price: 1,130৳1,240৳.
",213,893319,893532
3679,recursive,"
Product: Awei T28 Pro TWS Gaming Earbuds. Category: Earbuds. Subcategory: Gadget. Price: 1,140৳1,250৳.

Product: Xiaomi Mi Band 8 Smart Bracelet. Category: Smart Band. Subcategory: Gadget. Price: 3,902৳4,590৳.
",211,893532,893743
3680,recursive,"
Product: Huawei Band 10 (Global Variant). Category: Smart Band. Subcategory: Gadget. Price: 4,999৳.

Product: Huawei Band 6 All-Day SpO2 Monitoring with FullView Display. Category: Smart Band. Subcategory: Gadget. Price: 5,190৳5,999৳.
",236,893743,893979
3681,recursive,"
Product: Xiaomi Smart Band 8 Pro. Category: Smart Band. Subcategory: Gadget. Price: 7,109৳7,899৳.

Product: Xiaomi Smart Band 9 Active. Category: Smart Band. Subcategory: Gadget. Price: Out Of Stock.
",201,893979,894180
3682,recursive,"
Product: Xiaomi Smart Band 9 Pro. Category: Smart Band. Subcategory: Gadget. Price: Out Of Stock.

Product: Amazfit Band 7. Category: Smart Band. Subcategory: Gadget. Price: Out Of Stock.
",189,894180,894369
3683,recursive,"
Product: Xiaomi Smart Band 7 AMOLED Display Fitness Tracker (CN Variant). Category: Smart Band. Subcategory: Gadget. Price: Out Of Stock.

Product: Honor CHOICE MOECEN Band AMOLED Bluetooth Calling Smart band. Category: Smart Band. Subcategory: Gadget. Price: Out Of Stock.
",275,894369,894644
3684,recursive,"
Product: Xiaomi Mi Smart Band 9 AMOLED Fitness Tracker (CN Variant). Category: Smart Band. Subcategory: Gadget. Price: Out Of Stock.

Product: HUAWEI Band 8 AMOLED Display Fitness Tracker Smart Band. Category: Smart Band. Subcategory: Gadget. Price: Out Of Stock.
",265,894644,894909
3685,recursive,"
Product: Huawei Band 9. Category: Smart Band. Subcategory: Gadget. Price: Out Of Stock.

Product: Honor Band 9 AMOLED Fitness Tracker Smart Band (CN Variant). Category: Smart Band. Subcategory: Gadget. Price: Out Of Stock.
",224,894909,895133
3686,recursive,"
Product: Xiaomi Mi Band 7 Pro (CN Edition). Category: Smart Band. Subcategory: Gadget. Price: Out Of Stock.

Product: Ray-Ban Meta Wayfarer Smart Glasses. Category: Smart Glasses. Subcategory: Gadget. Price: Pre Order.
",220,895133,895353
3687,recursive,"
Product: Ray-Ban Meta Skyler Smart Glasses. Category: Smart Glasses. Subcategory: Gadget. Price: Pre Order.

Product: Ray-Ban Meta Headliner Smart Glasses. Category: Smart Glasses. Subcategory: Gadget. Price: Pre Order.
",221,895353,895574
3688,recursive,"
Product: COLMI G06 Smart Glasses. Category: Smart Glasses. Subcategory: Gadget. Price: Out Of Stock.

Product: Lenovo HE05X Bluetooth Neckband Earphone Black. Category: Neckband. Subcategory: Gadget. Price: 450৳490৳.
",218,895574,895792
3689,recursive,"
Product: Lenovo HE05 Bluetooth Neckband Earphone Black. Category: Neckband. Subcategory: Gadget. Price: 450৳490৳.

Product: XTRA N25 In-Ear Stereo Wireless Neckband. Category: Neckband. Subcategory: Gadget. Price: 540৳590৳.
",225,895792,896017
3690,recursive,"
Product: Hoco ES64 Ultra Sports Bluetooth Wireless Neckband Earphone. Category: Neckband. Subcategory: Gadget. Price: 650৳699৳.

Product: Lenovo HE05X II (New Edition) Bluetooth Neckband Earphone Black. Category: Neckband. Subcategory: Gadget. Price: 640৳699৳.
",262,896017,896279
3691,recursive,"
Product: Hoco ES64 Sports Bluetooth Wireless Neckband Earphone. Category: Neckband. Subcategory: Gadget. Price: 640৳699৳.

Product: FONENG BL40 Bluetooth Neckband. Category: Neckband. Subcategory: Gadget. Price: 850৳930৳.
",223,896279,896502
3692,recursive,"
Product: FONENG BL34 Wireless Bluetooth Neckband Earphone. Category: Neckband. Subcategory: Gadget. Price: 699৳750৳.

Product: Hoco ES67 Bluetooth Wireless Neckband. Category: Neckband. Subcategory: Gadget. Price: 585৳640৳.
",225,896502,896727
3693,recursive,"
Product: Hoco ES61 Manner Wireless Earphones with Mic. Category: Neckband. Subcategory: Gadget. Price: 750৳820৳.

Product: Hoco ES69 In-ear Bluetooth Neckband. Category: Neckband. Subcategory: Gadget. Price: 750৳820৳.
",219,896727,896946
3694,recursive,"
Product: Hoco ES70 Armour Bluetooth Wireless Neckband Earphone. Category: Neckband. Subcategory: Gadget. Price: 749৳820৳.

Product: Hoco ES65 Crystal Sports Bluetooth Wireless Neckband. Category: Neckband. Subcategory: Gadget. Price: 783৳880৳.
",245,896946,897191
3695,recursive,"
Product: XTRA N40 Wireless Bluetooth Neckband. Category: Neckband. Subcategory: Gadget. Price: 790৳850৳.

Product: CHARG CL8 Type C Neckband. Category: Neckband. Subcategory: Gadget. Price: 610৳660৳.
",201,897191,897392
3696,recursive,"
Product: Riversong EA65 Stream N+ Bluetooth Neckband. Category: Neckband. Subcategory: Gadget. Price: 790৳850৳.

Product: Hoco ES63 Graceful Air Conduction Wireless Neckband. Category: Neckband. Subcategory: Gadget. Price: 1,050৳1,150৳.
",238,897392,897630
3697,recursive,"
Product: WiWU GB01 Wireless Neckband. Category: Neckband. Subcategory: Gadget. Price: 916৳1,030৳.

Product: Yison E17 Waterproof Wireless In Ear Neckband. Category: Neckband. Subcategory: Gadget. Price: 890৳950৳.
",214,897630,897844
3698,recursive,"
Product: Hoco ES72 Bluetooth Neckband. Category: Neckband. Subcategory: Gadget. Price: 1,050৳1,134৳.

Product: Ximax R02 Smart Ring. Category: Smart Ring. Subcategory: Gadget. Price: 2,549৳2,990৳.

Product: COLMI R02 Smart Ring. Category: Smart Ring. Subcategory: Gadget. Price: 2,850৳3,099৳.
",294,897844,898138
3699,recursive,"
Product: COLMI R12 Smart Ring. Category: Smart Ring. Subcategory: Gadget. Price: 3,650৳3,942৳.

Product: Amazfit Helio Smart Ring. Category: Smart Ring. Subcategory: Gadget. Price: Out Of Stock.
",196,898138,898334
3700,recursive,"
Product: Oraimo Halo 2S OEP-E21P in-ear Earphone. Category: Earphone. Subcategory: Gadget. Price: 255৳.

Product: CHARG DME61 Type C Wired Earphone. Category: Earphone. Subcategory: Gadget. Price: 260৳.
",204,898334,898538
3701,recursive,"
Product: TX10 Pro 4K Android TV Box with Voice Control Remote. Category: TV Box. Subcategory: Gadget. Price: 2,450৳2,650৳.

Product: Xiaomi TV Box S (2nd Gen) with Google TV. Category: TV Box. Subcategory: Gadget. Price: Out Of Stock.
",236,898538,898774
3702,recursive,"
Product: Xiaomi TV Box S 3rd Gen Android TV Box. Category: TV Box. Subcategory: Gadget. Price: 6,999৳8,000৳.

Product: Apple TV 4K 128GB 3rd Generation TV Box. Category: TV Box. Subcategory: Gadget. Price: 25,000৳30,000৳.
",223,898774,898997
3703,recursive,"
Product: TX3 Mini-A Android 7.1 2GB RAM 16GB ROM TV Box. Category: TV Box. Subcategory: Gadget. Price: Out Of Stock.

Product: TX60 Pro 14K Ultra HD Smart Android TV Box with Voice Control Remote. Category: TV Box. Subcategory: Gadget. Price: Out Of Stock.
",258,898997,899255
3704,recursive,"
Product: Xiaomi Mi MDZ-27-EU HDMI Android 4K TV Stick. Category: TV Box. Subcategory: Gadget. Price: 4,999৳6,000৳.

Product: Google Chromecast with Google TV 4K. Category: TV Box. Subcategory: Gadget. Price: Out Of Stock.
",223,899255,899478
3705,recursive,"
Product: Apple TV HD A1625 32GB 4th Generation TV Box (MHY93ZP/A). Category: TV Box. Subcategory: Gadget. Price: Out Of Stock.

Product: Apple TV 4K 32GB 6th Generation TV Box 2021 (MXGY2). Category: TV Box. Subcategory: Gadget. Price: Out Of Stock.
",251,899478,899729
3706,recursive,"
Product: Apple TV 4K 64GB 6th Generation TV Box 2021 (MXH02). Category: TV Box. Subcategory: Gadget. Price: Out Of Stock.

Product: Lewitt LCT 440 PURE Large-Diaphragm Cardioid Condenser Microphone. Category: Studio Microphones. Subcategory: Studio Equipment. Price: 50,000৳55,000৳.
",284,899729,900013
3707,recursive,"
Product: Maono AU-A03 Professional Condenser Studio Microphone Kit. Category: Studio Microphones. Subcategory: Studio Equipment. Price: 3,800৳4,500৳.
",151,900013,900164
3708,recursive,"
Product: RODE SM6 Studio Microphone Shock Mount With Detachable Pop Filter. Category: Studio Microphones. Subcategory: Studio Equipment. Price: 9,300৳.
",153,900164,900317
3709,recursive,"
Product: RODE VideoMicro II Ultracompact Camera-Mount Shotgun Microphone for Cameras and Smartphones. Category: Studio Microphones. Subcategory: Studio Equipment. Price: 12,500৳15,000৳.
",187,900317,900504
3710,recursive,"
Product: RODE Lavalier II Omnidirectional Lavalier Microphone. Category: Studio Microphones. Subcategory: Studio Equipment. Price: 13,500৳16,000৳.
",148,900504,900652
3711,recursive,"
Product: RODE VideoMic GO II Ultracompact Analog/USB Camera-Mount Shotgun Microphone. Category: Studio Microphones. Subcategory: Studio Equipment. Price: 15,500৳17,000৳.
",171,900652,900823
3712,recursive,"
Product: Audio Technica AT2020 Cardioid Condenser Microphone. Category: Studio Microphones. Subcategory: Studio Equipment. Price: 17,000৳20,000৳.
",147,900823,900970
3713,recursive,"
Product: Audio Technica AT2040 Hypercardioid Dynamic Podcast Microphone. Category: Studio Microphones. Subcategory: Studio Equipment. Price: 19,000৳23,000৳.

Product: Lewitt LCT-240 Pro Condenser Microphone. Category: Studio Microphones. Subcategory: Studio Equipment. Price: 20,500৳25,000৳.
",293,900970,901263
3714,recursive,"
Product: RODE PSA1+ Professional Studio Arm. Category: Studio Microphones. Subcategory: Studio Equipment. Price: 23,000৳26,000৳.

Product: RODE M3 Versatile End-Address Condenser Microphone. Category: Studio Microphones. Subcategory: Studio Equipment. Price: 22,000৳27,000৳.
",276,901263,901539
3715,recursive,"
Product: RODE X XCM-50 Compact USB-C Condenser Microphone. Category: Studio Microphones. Subcategory: Studio Equipment. Price: 25,000৳28,000৳.

Product: Audio Technica AT2050 Multi-pattern Condenser Microphone. Category: Studio Microphones. Subcategory: Studio Equipment. Price: 25,000৳29,000৳.
",296,901539,901835
3716,recursive,"
Product: RODE X XDM-100 Dynamic USB-C Microphone. Category: Studio Microphones. Subcategory: Studio Equipment. Price: 33,000৳37,000৳.

Product: RODE Wireless PRO Clip-On Wireless Microphone. Category: Studio Microphones. Subcategory: Studio Equipment. Price: 43,500৳47,000৳.
",276,901835,902111
3717,recursive,"
Product: Audio Technica AT4040 Cardioid Condenser Microphone. Category: Studio Microphones. Subcategory: Studio Equipment. Price: 49,500৳57,000৳.

Product: Shure SM7B Cardioid Dynamic Vocal Microphone. Category: Studio Microphones. Subcategory: Studio Equipment. Price: 67,000৳75,000৳.
",287,902111,902398
3718,recursive,"
Product: Lewitt RAY Large-Diaphragm Condenser Microphone. Category: Studio Microphones. Subcategory: Studio Equipment. Price: 67,000৳75,000৳.

Product: Shure SM7dB Vocal Microphone with Built-In Preamp. Category: Studio Microphones. Subcategory: Studio Equipment. Price: 77,000৳85,000৳.
",288,902398,902686
3719,recursive,"
Product: Audio Technica AT4050 Multi-pattern Condenser Microphone. Category: Studio Microphones. Subcategory: Studio Equipment. Price: 86,000৳95,000৳.

Product: M-Audio BX4 BT 4.5"" Bluetooth Studio Monitor Speaker. Category: Studio Monitors. Subcategory: Studio Equipment. Price: 26,500৳33,000৳.
",297,902686,902983
3720,recursive,"
Product: M-Audio BX5 D3 5"" Studio Monitor Speaker. Category: Studio Monitors. Subcategory: Studio Equipment. Price: 39,000৳44,000৳.

Product: JBL 305P MKII Studio Monitor Speaker. Category: Studio Monitors. Subcategory: Studio Equipment. Price: 41,000৳47,000৳.
",262,902983,903245
3721,recursive,"
Product: JBL 306P MKII Studio Monitor Speaker. Category: Studio Monitors. Subcategory: Studio Equipment. Price: 52,000৳60,000৳.

Product: Yamaha HS5 5"" Powered Studio Monitor Speaker. Category: Studio Monitors. Subcategory: Studio Equipment. Price: 56,000৳62,000৳.
",266,903245,903511
3722,recursive,"
Product: KRK ROKIT 5 G5 5"" 2-Way Active Studio Monitor. Category: Studio Monitors. Subcategory: Studio Equipment. Price: 58,000৳66,000৳.

Product: JBL 308P MKII Studio Monitor Speaker. Category: Studio Monitors. Subcategory: Studio Equipment. Price: 63,000৳72,000৳.
",267,903511,903778
3723,recursive,"
Product: Yamaha HS7 6.5"" Powered Studio Monitor Speaker. Category: Studio Monitors. Subcategory: Studio Equipment. Price: 82,000৳90,000৳.

Product: Focal Alpha 50 EVO Active 2-way Studio Monitor Speaker. Category: Studio Monitors. Subcategory: Studio Equipment. Price: 115,000৳127,000৳.
",288,903778,904066
3724,recursive,"
Product: Genelec 8030C 5"" 2-Way 100W Active Studio Monitor Speaker. Category: Studio Monitors. Subcategory: Studio Equipment. Price: 157,000৳173,000৳.

Product: Focal Alpha 65 EVO Studio Monitor Speaker. Category: Studio Monitors. Subcategory: Studio Equipment. Price: 165,000৳180,000৳.
",288,904066,904354
3725,recursive,"
Product: Genelec 8040B 6.5"" 2-Way 180W Active Studio Monitor Speaker. Category: Studio Monitors. Subcategory: Studio Equipment. Price: 253,000৳273,000৳.

Product: M-Audio BX4 4.5"" Studio Monitor Speaker. Category: Studio Monitors. Subcategory: Studio Equipment. Price: Out Of Stock.
",284,904354,904638
3726,recursive,"
Product: Edifier R2750DB Active 2.0 Tri-Amp Bluetooth Bookshelf Speaker. Category: Studio Monitors. Subcategory: Studio Equipment. Price: 24,999৳25,500৳.
",155,904638,904793
3727,recursive,"
Product: Microlab SOLO 16 2.0 Two-Way Stereo Bluetooth Monitor Speaker. Category: Studio Monitors. Subcategory: Studio Equipment. Price: 26,999৳.

Product: Microlab SOLO 29 2.0 Bluetooth Hi-Fi Monitor Speaker. Category: Studio Monitors. Subcategory: Studio Equipment. Price: 31,500৳32,500৳.
",292,904793,905085
3728,recursive,"
Product: Neumann NDH 30 Open-Back Professsional Studio Headphone. Category: Studio Headphones. Subcategory: Studio Equipment. Price: 90,000৳95,000৳.

Product: JTS HP-535 Professional Studio Monitor Headphones. Category: Studio Headphones. Subcategory: Studio Equipment. Price: Out Of Stock.
",292,905085,905377
3729,recursive,"
Product: AKG Pro Audio K72 Closed-Back Studio Headphone. Category: Studio Headphones. Subcategory: Studio Equipment. Price: 7,800৳8,900৳.

Product: Audio Technica ATH-M20x Professional Studio Monitor Headphone. Category: Studio Headphones. Subcategory: Studio Equipment. Price: 9,000৳11,000৳.
",294,905377,905671
3730,recursive,"
Product: Audio-Technica ATH-M20xBT Over-Ear Bluetooth Headphone. Category: Studio Headphones. Subcategory: Studio Equipment. Price: 11,000৳13,000৳.
",149,905671,905820
3731,recursive,"
Product: Audio Technica ATH-M30x Professional Studio Monitor Headphone. Category: Studio Headphones. Subcategory: Studio Equipment. Price: 10,500৳14,000৳.

Product: Sennheiser HD 200 PRO Wireless Studio Headphone. Category: Studio Headphones. Subcategory: Studio Equipment. Price: 10,500৳14,000৳.
",298,905820,906118
3732,recursive,"
Product: AKG K240 STUDIO Professional Headphone. Category: Studio Headphones. Subcategory: Studio Equipment. Price: 13,500৳15,000৳.

Product: Audio technica ATH-M40x Professional Studio Monitor Headphone. Category: Studio Headphones. Subcategory: Studio Equipment. Price: 15,000৳18,000৳.
",289,906118,906407
3733,recursive,"
Product: AKG K240 MKII Professional Studio Headphone. Category: Studio Headphones. Subcategory: Studio Equipment. Price: 15,500৳18,000৳.

Product: Sennheiser HD 25 Wired Studio Headphone. Category: Studio Headphones. Subcategory: Studio Equipment. Price: 16,000৳19,500৳.
",272,906407,906679
3734,recursive,"
Product: Audio technica ATH-M50x Professional Studio Monitor Headphone. Category: Studio Headphones. Subcategory: Studio Equipment. Price: 19,200৳22,000৳.
",156,906679,906835
3735,recursive,"
Product: Audio Technica ATH-M50xSTS USB StreamSet Streaming Headset. Category: Studio Headphones. Subcategory: Studio Equipment. Price: 28,000৳33,000৳.
",153,906835,906988
3736,recursive,"
Product: Audio Technica ATH-M70x Professional Studio Monitor Headphone. Category: Studio Headphones. Subcategory: Studio Equipment. Price: 33,000৳36,000৳.
",156,906988,907144
3737,recursive,"
Product: Beyerdynamic DT 770 PRO 250 Ohm Over-Ear Studio Headphone. Category: Studio Headphones. Subcategory: Studio Equipment. Price: 33,000৳38,000৳.

Product: Beyerdynamic DT 990 Pro Open-back Studio Headphone. Category: Studio Headphones. Subcategory: Studio Equipment. Price: 35,500৳38,500৳.
",297,907144,907441
3738,recursive,"
Product: AKG K52 Professional Closed Back Studio Monitor Headphone. Category: Studio Headphones. Subcategory: Studio Equipment. Price: Out Of Stock.

Product: Sennheiser HD280 Pro Studio Monitoring Headphone. Category: Studio Headphones. Subcategory: Studio Equipment. Price: Out Of Stock.
",291,907441,907732
3739,recursive,"
Product: Takstar MX1 Mini Portable Webcast Sound Card. Category: Studio Equipment. Subcategory: Gadget. Price: 4,200৳4,500৳.

Product: Maono Maonocaster AMC2 NEO One-Stop Streaming Audio Mixer & Sound Card. Category: Studio Equipment. Subcategory: Gadget. Price: 5,700৳5,900৳.
",278,907732,908010
3740,recursive,"
Product: M-Audio SP-2 Professional Piano Style Pedal. Category: Studio Equipment. Subcategory: Gadget. Price: 4,500৳6,000৳.

Product: Takstar SC-M1 Portable Live Broadcast Sound Card. Category: Studio Equipment. Subcategory: Gadget. Price: 9,700৳10,500৳.
",256,908010,908266
3741,recursive,"
Product: BOYA BY-AM4 Dual-Channel Type-C Audio Interface. Category: Studio Equipment. Subcategory: Gadget. Price: 9,000৳11,000৳.

Product: Takstar MX1 Set Live Broadcast Sound Card Set with Earphone & Microphone. Category: Studio Equipment. Subcategory: Gadget. Price: 18,990৳20,990৳.
",286,908266,908552
3742,recursive,"
Product: Focusrite Scarlett 2i2 3rd Generation PC Audio Interface. Category: Studio Equipment. Subcategory: Gadget. Price: 19,000৳23,000৳.

Product: Focusrite Scarlett 4i4 3rd Gen USB Recording Interface. Category: Studio Equipment. Subcategory: Gadget. Price: 25,000৳25,500৳.
",278,908552,908830
3743,recursive,"
Product: Focusrite Scarlett Solo 4th Gen Type-C Audio Interface. Category: Studio Equipment. Subcategory: Gadget. Price: 20,500৳26,000৳.
",138,908830,908968
3744,recursive,"
Product: Focusrite Scarlett Solo Studio 3rd Gen USB Audio Interface and Recording Bundle. Category: Studio Equipment. Subcategory: Gadget. Price: 26,000৳30,000৳.

Product: Universal Audio Volt 2 USB-C Audio Interface. Category: Studio Equipment. Subcategory: Gadget. Price: 27,000৳30,000৳.
",291,908968,909259
3745,recursive,"
Product: Focusrite Scarlett 2i2 4th Gen Type-C Audio Interface. Category: Studio Equipment. Subcategory: Gadget. Price: 26,500৳30,000৳.

Product: M-Audio AIR 192|6 USB Audio Interface. Category: Studio Equipment. Subcategory: Gadget. Price: 27,000৳30,500৳.
",258,909259,909517
3746,recursive,"
Product: Focusrite Vocaster One Studio 1-Person Podcasting Kit. Category: Studio Equipment. Subcategory: Gadget. Price: 29,000৳32,000৳.

Product: M-Audio 4 Vocal Studio Pro air 192| Audio Interface. Category: Studio Equipment. Subcategory: Gadget. Price: 28,000৳33,000৳.
",272,909517,909789
3747,recursive,"
Product: Apogee One Audio Interface for MAC and PC. Category: Studio Equipment. Subcategory: Gadget. Price: 29,000৳34,500৳.

Product: Focusrite Scarlett 2i2 Studio 3rd Gen USB Audio Interface and Recording Bundle. Category: Studio Equipment. Subcategory: Gadget. Price: 30,000৳35,000৳.
",287,909789,910076
3748,recursive,"
Product: Focusrite Scarlett 8i6 3rd Gen USB Audio Interface. Category: Studio Equipment. Subcategory: Gadget. Price: 33,000৳36,000৳.

Product: RODE X Streamer X Audio and Video Streaming Console. Category: Studio Equipment. Subcategory: Gadget. Price: 35,000৳38,000৳.
",269,910076,910345
3749,recursive,"
Product: Yison Celebrat PB-11 10000mAh Portable Power Bank. Category: Power Bank. Subcategory: Gadget. Price: 990৳1,049৳.

Product: Awei P20K 10000mah Power Bank. Category: Power Bank. Subcategory: Gadget. Price: 890৳1,090৳.
",226,910345,910571
3750,recursive,"
Product: Awei P37K 10000mAh Fast Charging Power Bank. Category: Power Bank. Subcategory: Gadget. Price: 830৳1,150৳.

Product: Hoco J101 Astute 10000mAh 22.5W Fast Charging Power Bank. Category: Power Bank. Subcategory: Gadget. Price: 1,050৳1,200৳.
",249,910571,910820
3751,recursive,"
Product: Joyroom JR-PBF12 10000mAh 12W 2.4A LED Power Bank. Category: Power Bank. Subcategory: Gadget. Price: 800৳1,200৳.

Product: Fantech S2 10000mAh Power Bank. Category: Power Bank. Subcategory: Gadget. Price: 890৳1,200৳.
",227,910820,911047
3752,recursive,"
Product: Awei P5K 10000mAh Fast Charging Power Bank. Category: Power Bank. Subcategory: Gadget. Price: 800৳1,250৳.

Product: Hoco J89 10000mAh 20W Fast Charging Digital Display Power Bank. Category: Power Bank. Subcategory: Gadget. Price: 1,070৳1,250৳.
",254,911047,911301
3753,recursive,"
Product: Foneng PX101 10000mAh 22.5W Power Bank. Category: Power Bank. Subcategory: Gadget. Price: 1,180৳1,349৳.

Product: Remax RPP-296 20000mah Fast Charging Power Bank. Category: Power Bank. Subcategory: Gadget. Price: 1,250৳1,350৳.
",237,911301,911538
3754,recursive,"
Product: Awei P10K 10000mah 22.5W Fast Charging Digital Display Power Bank. Category: Power Bank. Subcategory: Gadget. Price: 940৳1,350৳.

Product: Oraimo Toast 15 Flash OPB-1100 10000mAh 15W Type C Power Bank. Category: Power Bank. Subcategory: Gadget. Price: 1,160৳1,380৳.
",276,911538,911814
3755,recursive,"
Product: Remax RPP-26 Lango 2 Series 20000mah Fast Charging Power Bank. Category: Power Bank. Subcategory: Gadget. Price: 1,400৳.

Product: Fantech S3 10000mAh Portable Power Bank. Category: Power Bank. Subcategory: Gadget. Price: 1,150৳1,400৳.
",246,911814,912060
3756,recursive,"
Product: MKB PK10 10000mAh Fast Charging Power Bank. Category: Power Bank. Subcategory: Gadget. Price: 1,400৳.

Product: Remax RPP-626 20000mAh 2.1A Power Bank. Category: Power Bank. Subcategory: Gadget. Price: 1,250৳1,450৳.
",226,912060,912286
3757,recursive,"
Product: Hoco J105 10000mAh 22.5W Fast Charging Digital Display Power Bank. Category: Power Bank. Subcategory: Gadget. Price: 1,399৳1,450৳.

Product: CHARG CP03 10000mAh 10W Power Bank. Category: Power Bank. Subcategory: Gadget. Price: 999৳1,470৳.
",249,912286,912535
3758,recursive,"
Product: Foneng PX106 10000mAh 22.5W Power Bank With Built-in Type-C and IP Cables. Category: Power Bank. Subcategory: Gadget. Price: 1,299৳1,499৳.

Product: Awei P6K 20000mAh Double USB Power Bank. Category: Power Bank. Subcategory: Gadget. Price: 1,199৳1,500৳.
",264,912535,912799
3759,recursive,"
Product: Blackmagic Design ATEM Mini Pro HDMI Live Stream Switcher. Category: Switcher. Subcategory: Studio Equipment. Price: 53,000৳58,000৳.

Product: Casio EMI External AC Power Adaptor +9.0v /2amp (LP). Category: Musical Keyboard. Subcategory: Studio Equipment. Price: 600৳900৳.
",283,912799,913082
3760,recursive,"
Product: Casio SA-50 32-Keys Portable Musical Mini Keyboard Without Adapter. Category: Musical Keyboard. Subcategory: Studio Equipment. Price: 6,700৳8,000৳.
",158,913082,913240
3761,recursive,"
Product: Casio SA-51 32-Keys Portable Musical Mini Keyboard Without Adapter. Category: Musical Keyboard. Subcategory: Studio Equipment. Price: 6,700৳8,000৳.
",158,913240,913398
3762,recursive,"
Product: Casio SA-80 44-Keys Portable Musical Mini Keyboard Without Adapter. Category: Musical Keyboard. Subcategory: Studio Equipment. Price: 7,700৳9,000৳.
",158,913398,913556
3763,recursive,"
Product: Casio SA-81 44-Keys Portable Musical Mini Keyboard Without Adapter. Category: Musical Keyboard. Subcategory: Studio Equipment. Price: 8,500৳10,000৳.
",159,913556,913715
3764,recursive,"
Product: Casio CT-S100 Portable Musical Keyboard Piano Without Adapter. Category: Musical Keyboard. Subcategory: Studio Equipment. Price: 14,000৳17,000৳.
",155,913715,913870
3765,recursive,"
Product: CASIO CTK-2550 61-key Standard Musical Keyboard Without Adapter. Category: Musical Keyboard. Subcategory: Studio Equipment. Price: 15,500৳17,000৳.
",157,913870,914027
3766,recursive,"
Product: Casio CT-S200WE 61-Key Portable Musical Keyboard Piano Without Adapter. Category: Musical Keyboard. Subcategory: Studio Equipment. Price: 16,000৳18,000৳.
",164,914027,914191
3767,recursive,"
Product: Casio CT-S200BK 61-Key Portable Musical Keyboard Piano without Adapter. Category: Musical Keyboard. Subcategory: Studio Equipment. Price: 16,200৳19,000৳.
",164,914191,914355
3768,recursive,"
Product: CASIO CTK-3500 61-key Standard Musical Keyboard Without Adapter. Category: Musical Keyboard. Subcategory: Studio Equipment. Price: 21,000৳26,000৳.

Product: M-Audio Oxygen 49 49-Key MIDI Keyboard. Category: Musical Keyboard. Subcategory: Studio Equipment. Price: 25,500৳28,500৳.
",289,914355,914644
3769,recursive,"
Product: CASIO CT-X870IN 61-key Portable Musical Keyboard Without Adapter. Category: Musical Keyboard. Subcategory: Studio Equipment. Price: 26,500৳29,000৳.
",158,914644,914802
3770,recursive,"
Product: CASIO CT-X8000IN 61-key Portable Musical Keyboard With Adapter. Category: Musical Keyboard. Subcategory: Studio Equipment. Price: 33,000৳37,000৳.
",156,914802,914958
3771,recursive,"
Product: Novation Impulse 49 49-key MIDI Keyboard Controller. Category: Musical Keyboard. Subcategory: Studio Equipment. Price: 40,000৳43,500৳.
",145,914958,915103
3772,recursive,"
Product: Casio CT-S400 61-Keys Portable Musical Keyboard Without Adapter. Category: Musical Keyboard. Subcategory: Studio Equipment. Price: 38,000৳44,000৳.
",157,915103,915260
3773,recursive,"
Product: Casio CT-S1RD 61-Key Portable Musical Keyboard Piano Without Adapter. Category: Musical Keyboard. Subcategory: Studio Equipment. Price: 39,000৳44,000৳.
",162,915260,915422
3774,recursive,"
Product: Casio CT-S1WE 61-Key Portable Musical Keyboard Piano Without Adapter. Category: Musical Keyboard. Subcategory: Studio Equipment. Price: 39,000৳44,000৳.
",162,915422,915584
3775,recursive,"
Product: Casio CT-S1BK 61-Key Portable Musical Keyboard Piano Without Adapter. Category: Musical Keyboard. Subcategory: Studio Equipment. Price: 39,000৳44,000৳.
",162,915584,915746
3776,recursive,"
Product: Casio CT-X9000IN 61-key Standard Musical Keyboard With Adapter. Category: Musical Keyboard. Subcategory: Studio Equipment. Price: 57,000৳63,000৳.
",156,915746,915902
3777,recursive,"
Product: Casio CT-S500 61-Keys Portable Musical Keyboard With Adapter. Category: Musical Keyboard. Subcategory: Studio Equipment. Price: 60,500৳66,000৳.

Product: DJI Neo Standard. Category: DJI. Subcategory: Drones. Price: 26,000৳29,500৳.
",241,915902,916143
3778,recursive,"
Product: DJI Neo Fly More Combo Drone. Category: DJI. Subcategory: Drones. Price: 39,900৳48,000৳.

Product: DJI Mini 4K Stardard. Category: DJI. Subcategory: Drones. Price: 43,500৳44,000৳.
",190,916143,916333
3779,recursive,"
Product: DJI Mini 4K Fly More Combo Drone (Global Version). Category: DJI. Subcategory: Drones. Price: 54,000৳55,400৳.

Product: DJI Flip N3 Drone. Category: DJI. Subcategory: Drones. Price: 50,600৳55,000৳.
",208,916333,916541
3780,recursive,"
Product: DJI Neo Motion Fly More Combo Drone. Category: DJI. Subcategory: Drones. Price: 55,900৳58,000৳.

Product: DJI Flip Standard With RC2 Controller. Category: DJI. Subcategory: Drones. Price: 66,000৳72,000৳.
",214,916541,916755
3781,recursive,"
Product: DJI Mini 3 Drone Fly More Combo with DJI RC Remote Controller. Category: DJI. Subcategory: Drones. Price: 73,800৳79,000৳.

Product: DJI Flip Drone Fly More Combo. Category: DJI. Subcategory: Drones. Price: 79,999৳91,400৳.
",232,916755,916987
3782,recursive,"
Product: DJI MINI 4 PRO Fly More Combo + DJI RC2. Category: DJI. Subcategory: Drones. Price: 111,800৳120,000৳.

Product: DJI MINI 4 PRO Fly More Combo Plus + DJI RC2 (Global Version). Category: DJI. Subcategory: Drones. Price: Up Coming.
",239,916987,917226
3783,recursive,"
Product: DJI Avata 2 Fly More Combo Drone with Goggles 3 & RC Motion 3 Controller. Category: DJI. Subcategory: Drones. Price: 124,499৳134,000৳.

Product: DJI Air 3S Fly More Combo With DJI RC 2 Remote Controller. Category: DJI. Subcategory: Drones. Price: 157,999৳170,000৳.
",275,917226,917501
3784,recursive,"
Product: DJI Mavic 4 Pro Fly More Combo. Category: DJI. Subcategory: Drones. Price: 279,900৳315,000৳.

Product: DJI Mavic 3 Pro Fly More Combo 4K Drone with Remote Controller. Category: DJI. Subcategory: Drones. Price: 316,000৳385,000৳.
",238,917501,917739
3785,recursive,"
Product: DJI Mavic 4 Pro Creator Combo With RC Pro 2. Category: DJI. Subcategory: Drones. Price: 379,900৳409,000৳.

Product: DJI Matrice 350 RTK Drone. Category: DJI. Subcategory: Drones. Price: Call for Price.
",212,917739,917951
3786,recursive,"
Product: DJI P4 Multispectral Drone. Category: DJI. Subcategory: Drones. Price: Call for Price.

Product: DJI Mavic 2 Enterprise Dual Edition Drone. Category: DJI. Subcategory: Drones. Price: Call for Price.
",209,917951,918160
3787,recursive,"
Product: DJI Mavic 2 Enterprise Zoom Edition Drone. Category: DJI. Subcategory: Drones. Price: Call for Price.

Product: Focusrite Scarlett 2i2 Studio 4th Gen USB Audio Interface Combo. Category: Audio Interfaces. Subcategory: Studio Equipment. Price: 39,000৳43,000৳.
",269,918160,918429
3788,recursive,"
Product: Focusrite Scarlett 18i8 3rd Gen USB Audio Interface. Category: Audio Interfaces. Subcategory: Studio Equipment. Price: 40,500৳45,000৳.

Product: Focusrite Vocaster Two Studio 2-Person Podcasting Kit. Category: Audio Interfaces. Subcategory: Studio Equipment. Price: 41,000৳45,000৳.
",292,918429,918721
3789,recursive,"
Product: Universal Audio Volt 276 USB-C Audio Interface. Category: Audio Interfaces. Subcategory: Studio Equipment. Price: 42,000৳48,000৳.

Product: Yamaha MG10XU 10-Input Mixer with Built-In FX and USB. Category: Audio Interfaces. Subcategory: Studio Equipment. Price: 44,000৳50,000৳.
",287,918721,919008
3790,recursive,"
Product: Solid State Logic SSL 2+ USB Audio Interface. Category: Audio Interfaces. Subcategory: Studio Equipment. Price: 45,000৳50,000৳.

Product: Yamaha MG12XU 12-channel Mixer with USB and Effects. Category: Audio Interfaces. Subcategory: Studio Equipment. Price: 58,000৳61,000৳.
",283,919008,919291
3791,recursive,"
Product: DK W1 Pro Folding 4K Toy Drone. Category: Mini Toy Drone. Subcategory: Drones. Price: 7,490৳11,000৳.

Product: DK W1 ProS 4K Toy Drone. Category: Mini Toy Drone. Subcategory: Drones. Price: 7,990৳11,500৳.
",215,919291,919506
3792,recursive,"
Product: DK S6 Mini Dual Camera 6K Toy Drone With Wi-Fi & GPS. Category: Mini Toy Drone. Subcategory: Drones. Price: 9,500৳17,000৳.

Product: DK W7 GPS 4K Toy Drone With RC Toy Remote. Category: Mini Toy Drone. Subcategory: Drones. Price: 16,500৳23,000৳.
",256,919506,919762
3793,recursive,"
Product: DK W7 GPS 4K Toy Drone Without RC. Category: Mini Toy Drone. Subcategory: Drones. Price: 12,800৳18,000৳.

Product: DK U2 ProS 4K Toy Drone. Category: Mini Toy Drone. Subcategory: Drones. Price: 4,900৳7,500৳.
",218,919762,919980
3794,recursive,"
Product: DJI Inspire 3 Drone. Category: Enterprise Drone. Subcategory: Drones. Price: Out Of Stock.

Product: DJI Matrice 4E Enterprise Drone. Category: Enterprise Drone. Subcategory: Drones. Price: 860,000৳1,000,000৳.
",220,919980,920200
3795,recursive,"
Product: Zhiyun SMOOTH-X2 Smartphone Gimbal. Category: Zhiyun. Subcategory: Gimbal. Price: 7,600৳9,100৳.

Product: Zhiyun Smooth-Q3 3-Axis Gimbal Stabilizer. Category: Zhiyun. Subcategory: Gimbal. Price: 8,999৳9,600৳.
",219,920200,920419
3796,recursive,"
Product: Zhiyun Smooth-Q3 Combo 3-Axis Gimbal Stabilizer. Category: Zhiyun. Subcategory: Gimbal. Price: 10,500৳11,000৳.

Product: Zhiyun Smooth Q4 Handheld Gimbal Stabilizer. Category: Zhiyun. Subcategory: Gimbal. Price: 9,900৳10,600৳.
",237,920419,920656
3797,recursive,"
Product: Zhiyun Smooth-X2 COMBO Smartphone Gimbal. Category: Zhiyun. Subcategory: Gimbal. Price: 10,400৳11,500৳.

Product: Zhiyun SMOOTH 5 Smartphone Gimbal. Category: Zhiyun. Subcategory: Gimbal. Price: 13,690৳14,700৳.
",221,920656,920877
3798,recursive,"
Product: Zhiyun Smooth 5S 3-Axis Smartphone Handheld Gimbal Combo. Category: Zhiyun. Subcategory: Gimbal. Price: 20,500৳22,100৳.

Product: Zhiyun Crane-M2S Smartphone and Camera Handheld Stabilizer Gimbal. Category: Zhiyun. Subcategory: Gimbal. Price: 18,500৳21,400৳.
",269,920877,921146
3799,recursive,"
Product: Zhiyun CRANE-M3 3-Axis Handheld Gimbal Stabilizer. Category: Zhiyun. Subcategory: Gimbal. Price: 23,999৳25,900৳.

Product: Zhiyun CRANE-M3 COMBO 3-Axis Handheld Gimbal Stabilizer. Category: Zhiyun. Subcategory: Gimbal. Price: 28,800৳31,000৳.
",252,921146,921398
3800,recursive,"
Product: Zhiyun Smooth-XS 2-Axis Gimbal for Smartphone. Category: Zhiyun. Subcategory: Gimbal. Price: Out Of Stock.

Product: Zhiyun Smooth X Foldable Smartphone Gimbal. Category: Zhiyun. Subcategory: Gimbal. Price: Out Of Stock.
",231,921398,921629
3801,recursive,"
Product: Zhiyun Smooth Q4 Combo Gimbal Stabilizer. Category: Zhiyun. Subcategory: Gimbal. Price: Out Of Stock.

Product: Zhiyun Smooth 5S 3-Axis Smartphone Handheld Gimbal. Category: Zhiyun. Subcategory: Gimbal. Price: Out Of Stock.
",234,921629,921863
3802,recursive,"
Product: Zhiyun Weebill S 3-Axis Gimbal Stabilizer for Cameras. Category: Zhiyun. Subcategory: Gimbal. Price: Out Of Stock.

Product: Zhiyun Crane 2S 3-Axis Handheld Gimbal Stabilizer. Category: Zhiyun. Subcategory: Gimbal. Price: Out Of Stock.
",246,921863,922109
3803,recursive,"
Product: Zhiyun WEEBILL-2 handheld 3-Axis Gimbal Stabilizer. Category: Zhiyun. Subcategory: Gimbal. Price: Out Of Stock.

Product: Zhiyun Weebill 2S 3-Axis Handheld Gimbal Stabilizer. Category: Zhiyun. Subcategory: Gimbal. Price: Out Of Stock.
",245,922109,922354
3804,recursive,"
Product: Zhiyun WEEBILL 3 Handheld Gimbal Stabilizer. Category: Zhiyun. Subcategory: Gimbal. Price: Out Of Stock.

Product: Zhiyun Crane 3S 3-Axis Handheld Gimbal Stabilizer. Category: Zhiyun. Subcategory: Gimbal. Price: Out Of Stock.
",236,922354,922590
3805,recursive,"
Product: DJI Osmo Pocket Waterproof Case. Category: DJI. Subcategory: Gimbal. Price: 7,000৳.

Product: DJI Osmo Mobile SE Smartphone Gimbal with 3-Axis Stabilization. Category: DJI. Subcategory: Gimbal. Price: 7,500৳9,500৳.
",225,922590,922815
3806,recursive,"
Product: DJI Osmo Mobile 7 Smartphone Gimbal. Category: DJI. Subcategory: Gimbal. Price: 10,900৳11,700৳.

Product: DJI Osmo Mobile 6 Foldable Smartphone Gimbal. Category: DJI. Subcategory: Gimbal. Price: 13,999৳15,000৳.
",221,922815,923036
3807,recursive,"
Product: DJI Osmo Mobile 7P Smartphone Gimbal. Category: DJI. Subcategory: Gimbal. Price: 15,490৳16,700৳.

Product: DJI RS 4 Mini Handheld Camera Gimbal Stabilizer. Category: DJI. Subcategory: Gimbal. Price: 31,990৳34,500৳.
",225,923036,923261
3808,recursive,"
Product: DJI RS 3 Mini Gimbal Stabilizer. Category: DJI. Subcategory: Gimbal. Price: 26,900৳28,000৳.

Product: DJI RS 4 Mini Handheld Camera Gimbal Stabilizer Combo. Category: DJI. Subcategory: Gimbal. Price: 39,900৳43,000৳.
",226,923261,923487
3809,recursive,"
Product: DJI RS 4 Handheld Camera Gimbal Stabilizer. Category: DJI. Subcategory: Gimbal. Price: 48,990৳52,900৳.

Product: DJI RS 3 Gimbal Stabilizer Combo. Category: DJI. Subcategory: Gimbal. Price: 48,900৳53,800৳.
",216,923487,923703
3810,recursive,"
Product: DJI OM 5 3 Axis Stable Gimbal. Category: DJI. Subcategory: Gimbal. Price: Out Of Stock.

Product: DJI Ronin-SC Handheld 3-Axis Camera Gimbal Stabilizer. Category: DJI. Subcategory: Gimbal. Price: Out Of Stock.
",220,923703,923923
3811,recursive,"
Product: DJI RSC 2 3-Axis Gimbal Stabilizer. Category: DJI. Subcategory: Gimbal. Price: Out Of Stock.

Product: DJI RS 3 Gimbal Stabilizer. Category: DJI. Subcategory: Gimbal. Price: Out Of Stock.
",198,923923,924121
3812,recursive,"
Product: DJI RSC 2 Pro Combo Gimbal Stabilizer. Category: DJI. Subcategory: Gimbal. Price: Out Of Stock.

Product: DJI RS 4 Handheld Camera Gimbal Stabilizer Combo. Category: DJI. Subcategory: Gimbal. Price: Out Of Stock.
",223,924121,924344
3813,recursive,"
Product: K&F Concept DJI Drone Mini 3 Pro & Mini 3 Drone Filter Set (CPL+ND8+ND16) With a Set of Propellers. Category: Drone Accessories. Subcategory: Drones. Price: 3,500৳4,000৳.
",181,924344,924525
3814,recursive,"
Product: K&F Concept DJI Avata Drone HD Filter Set (CPL+ND8+ND16). Category: Drone Accessories. Subcategory: Drones. Price: 4,000৳4,200৳.

Product: K&F Concept DJI Osmo Action3 HD Filter Set(CPL+ND8+ND16). Category: Drone Accessories. Subcategory: Drones. Price: 4,000৳4,500৳.
",278,924525,924803
3815,recursive,"
Product: K&F Concept DJI Mavic 3 Classic HD Filter Set (CPL+ND8+ND16). Category: Drone Accessories. Subcategory: Drones. Price: 5,000৳5,300৳.
",143,924803,924946
3816,recursive,"
Product: K&F Concept DJI Drone AIR 2S HD Filter Set (ND8/PL+ND16/PL+ND32/PL+ND64/PL) with a Set of Propellers. Category: Drone Accessories. Subcategory: Drones. Price: 6,500৳6,800৳.
",183,924946,925129
3817,recursive,"
Product: K&F Concept DJI Mavic 3 PRO Drone (CPL+ND8+ND16) Filter Set. Category: Drone Accessories. Subcategory: Drones. Price: 6,500৳7,000৳.

Product: DJI Mini 3 Pro Fly More Kit. Category: Drone Accessories. Subcategory: Drones. Price: 30,000৳.
",247,925129,925376
3818,recursive,"
Product: DJI D-RTK 2 High-Precision GNSS Mobile Station Tripod. Category: Drone Accessories. Subcategory: Drones. Price: 30,000৳.

Product: DJI Mini 3 Pro Fly More Kit Plus. Category: Drone Accessories. Subcategory: Drones. Price: 29,000৳35,000৳.
",248,925376,925624
3819,recursive,"
Product: DJI RC Drone Remote Controller. Category: Drone Accessories. Subcategory: Drones. Price: 34,500৳35,000৳.

Product: DJI Zenmuse H20 Triple-Sensor Drone Camera. Category: Drone Accessories. Subcategory: Drones. Price: Call for Price.
",242,925624,925866
3820,recursive,"
Product: DJI Matrice 300 TB60 Intelligent Flight Battery. Category: Drone Accessories. Subcategory: Drones. Price: Out Of Stock.

Product: DJI RC Pro Drone Remote Controller. Category: Drone Accessories. Subcategory: Drones. Price: Call for Price.
",249,925866,926115
3821,recursive,"
Product: DJI ZENMUSE P1 Drone Camera. Category: Drone Accessories. Subcategory: Drones. Price: Call for Price.

Product: DJI Zenmuse H20N UAV Load Gimbal Camera. Category: Drone Accessories. Subcategory: Drones. Price: Call for Price.
",236,926115,926351
3822,recursive,"
Product: DJI Zenmuse H20T Quad-Sensor Drone Camera. Category: Drone Accessories. Subcategory: Drones. Price: Call for Price.

Product: DJI Zenmuse L1 Drone Camera. Category: Drone Accessories. Subcategory: Drones. Price: Call for Price.
",238,926351,926589
3823,recursive,"
Product: DJI Mavic Air 2 Intelligent Flight Battery. Category: Drone Accessories. Subcategory: Drones. Price: Out Of Stock.

Product: DJI Avata Fly More Kit. Category: Drone Accessories. Subcategory: Drones. Price: Out Of Stock.
",230,926589,926819
3824,recursive,"
Product: DJI D-RTK 2 High Precision GNSS Mobile Station. Category: Drone Accessories. Subcategory: Drones. Price: Out Of Stock.

Product: Hohem iSteady XE Kit Smartphone Gimbal Stabilizer. Category: Gimbal. Subcategory: Gadget. Price: 6,900৳7,500৳.
",250,926819,927069
3825,recursive,"
Product: Hohem iSteady X3 SE Foldable Gimbal Stabilizer. Category: Gimbal. Subcategory: Gadget. Price: 7,900৳8,800৳.

Product: Baseus SUYT-D0G Control Smartphone Handheld Folding Gimbal Stabilizer. Category: Gimbal. Subcategory: Gadget. Price: 7,800৳9,100৳.
",259,927069,927328
3826,recursive,"
Product: Hohem iSteady Pro4 3-Axis Action Camera Gimbal Stabilizer. Category: Gimbal. Subcategory: Gadget. Price: 10,900৳11,800৳.

Product: Hohem iSteady V3 Foldable AI Gimbal Stabilizer. Category: Gimbal. Subcategory: Gadget. Price: 12,400৳13,600৳.
",251,927328,927579
3827,recursive,"
Product: FEIYU Vimble 3 Handheld Stabilizer. Category: Gimbal. Subcategory: Gadget. Price: 11,750৳12,600৳.

Product: FEIYU VB4 Handheld Stabilizer. Category: Gimbal. Subcategory: Gadget. Price: 13,900৳15,000৳.
",211,927579,927790
3828,recursive,"
Product: Hohem iSteady M6 Kit AI Gimbal Stabilizer. Category: Gimbal. Subcategory: Gadget. Price: 19,600৳21,200৳.

Product: Insta360 Flow Pro AI Tracking Smartphone Gimbal Stabilizer. Category: Gimbal. Subcategory: Gadget. Price: 18,490৳19,900৳.
",247,927790,928037
3829,recursive,"
Product: FEIYU SCORP-Mini P Handheld Stabilizer. Category: Gimbal. Subcategory: Gadget. Price: 18,900৳20,400৳.

Product: DJI Matrice 300 RTK Commercial Drone. Category: Professional Drone. Subcategory: Drones. Price: Call for Price.
",234,928037,928271
3830,recursive,"
Product: DJI Mavic 4 Pro Standard With RC 2 Controller. Category: Professional Drone. Subcategory: Drones. Price: Up Coming.

Product: DJI Mini 2 SE Fly More Combo Drone. Category: Professional Drone. Subcategory: Drones. Price: Up Coming.
",241,928271,928512
3831,recursive,"
Product: Insta360 Flow Standalone AI Tracking Smartphone Gimbal Stabilizer. Category: Insta360. Subcategory: Gimbal. Price: Out Of Stock.

Product: Insta360 Flow 2 Pro Smartphone Gimbal Stabilizer. Category: Insta360. Subcategory: Gimbal. Price: Out Of Stock.
",261,928512,928773
3832,recursive,"
Product: Hohem iSteady M7 AI Gimbal Stabilizer. Category: Hohem. Subcategory: Gimbal. Price: 24,990৳27,000৳.

Product: Hohem iSteady MT2 Kit Camera Gimbal. Category: Hohem. Subcategory: Gimbal. Price: 32,500৳35,000৳.
",218,928773,928991
3833,recursive,"
Product: Hohem iSteady Mobile+ Kit Gimbal Stabilizer. Category: Hohem. Subcategory: Gimbal. Price: Up Coming.

Product: DJI Mini 3 Drone Fly More Combo. Category: 4K Drone. Subcategory: Drones. Price: Out Of Stock.
",216,928991,929207
3834,recursive,"
Product: DJI Mini 3 Pro Drone with RC Controller (Standard Version). Category: 4K Drone. Subcategory: Drones. Price: Out Of Stock.

Product: DJI Mini 3 Drone Fly More Combo with DJI RC Remote Controller (Global Version). Category: 4K Drone. Subcategory: Drones. Price: Out Of Stock.
",284,929207,929491
3835,recursive,"
Product: DJI Avata Fly Smart Drone Combo with FPV Goggles V2. Category: 4K Drone. Subcategory: Drones. Price: Out Of Stock.

Product: UGREEN LP252 Car Mount Hook #80199. Category: Daily Lifestyle. Subcategory: Gadget. Price: 240৳340৳.
",236,929491,929727
3836,recursive,"
Product: VENTION KBJB0 Storage Case. Category: Daily Lifestyle. Subcategory: Gadget. Price: 420৳475৳.

Product: RBC DMT-4333 Flex Tip Digital Thermometer. Category: Daily Lifestyle. Subcategory: Gadget. Price: 490৳.
",217,929727,929944
3837,recursive,"
Product: Mosalogic Sticky Glue Cards Refills-5 Pack. Category: Daily Lifestyle. Subcategory: Gadget. Price: 490৳530৳.

Product: Philips HD2582/00 800 Watt Pop Up Toaster. Category: Daily Lifestyle. Subcategory: Gadget. Price: 6,290৳8,390৳.
",241,929944,930185
3838,recursive,"
Product: Baseus Rainproof Film for Car Rear-View Mirror. Category: Daily Lifestyle. Subcategory: Gadget. Price: 570৳634৳.

Product: Mosalogic Sticky Glue Cards Refills-10 Pack. Category: Daily Lifestyle. Subcategory: Gadget. Price: 690৳750৳.
",243,930185,930428
3839,recursive,"
Product: Hoco GM231 Hidden Spy Camera Detector. Category: Daily Lifestyle. Subcategory: Gadget. Price: 750৳810৳.

Product: Xiaomi Qualitell C1 Lite Powerful Electric Mosquito Swatter Bat. Category: Daily Lifestyle. Subcategory: Gadget. Price: 770৳840৳.
",254,930428,930682
3840,recursive,"
Product: Xiaomi K1405 Kaco Lemo Stapler Machine. Category: Daily Lifestyle. Subcategory: Gadget. Price: 830৳910৳.

Product: Xiaomi Mijia Mi Gel Ink Pen 10pcs. Category: Daily Lifestyle. Subcategory: Gadget. Price: 830৳910৳.
",225,930682,930907
3841,recursive,"
Product: VivaChek Bree Blood Glucose Test Strips (50 Pcs). Category: Daily Lifestyle. Subcategory: Gadget. Price: 1,000৳.

Product: Hoco E91 Smart GPS Tracker. Category: Daily Lifestyle. Subcategory: Gadget. Price: 950৳1,040৳.
",228,930907,931135
3842,recursive,"
Product: Baseus T2 Intelligent Rope Type Anti-loss Device. Category: Daily Lifestyle. Subcategory: Gadget. Price: 950৳1,050৳.

Product: ENCHEN N3 Mini Electric Ear and Nose Hair Trimmer. Category: Daily Lifestyle. Subcategory: Gadget. Price: 990৳1,080৳.
",255,931135,931390
3843,recursive,"
Product: Baseus Heyo hidden camera detector. Category: Daily Lifestyle. Subcategory: Gadget. Price: 1,030৳1,096৳.

Product: Baseus Quick to take cycling Holder for bicycle and Motorcycle. Category: Daily Lifestyle. Subcategory: Gadget. Price: 1,000৳1,099৳.
",258,931390,931648
3844,recursive,"
Product: FEIYU SCORP-Mini P Handheld Stabilizer Kit. Category: Feiyu. Subcategory: Gimbal. Price: 23,900৳25,800৳.

Product: Superpower 2000W Electric Blower. Category: Blower Machine. Subcategory: Gadget. Price: 1,013৳1,350৳.
",227,931648,931875
3845,recursive,"
Product: Orin EB005 1600W Electric Blower. Category: Blower Machine. Subcategory: Gadget. Price: Out Of Stock.

Product: Super 0023 1000W Blower Machine. Category: Blower Machine. Subcategory: Gadget. Price: 1,105৳1,700৳.
",223,931875,932098
3846,recursive,"
Product: WELLOO EBW32400 400W Electric Blower. Category: Blower Machine. Subcategory: Gadget. Price: 1,900৳.

Product: Prescott PT2240001 400W Electric Blower Machine. Category: Blower Machine. Subcategory: Gadget. Price: 1,500৳2,000৳.
",237,932098,932335
3847,recursive,"
Product: Maxtol PB600 600W Electric Blower. Category: Blower Machine. Subcategory: Gadget. Price: 2,100৳2,400৳.

Product: INGCO AB4018 650W Aspirator Blower Machine. Category: Blower Machine. Subcategory: Gadget. Price: 2,795৳2,800৳.
",235,932335,932570
3848,recursive,"
Product: DCK KQF3 680W Electric Blower. Category: Blower Machine. Subcategory: Gadget. Price: 2,706৳3,300৳.

Product: INGCO AB8008 800W Aspirator Blower. Category: Blower Machine. Subcategory: Gadget. Price: 5,400৳.
",217,932570,932787
3849,recursive,"
Product: INGCO AB6008 600W Aspirator Blower. Category: Blower Machine. Subcategory: Gadget. Price: Up Coming.

Product: ONI EB005 1600W Electric Blower. Category: Blower Machine. Subcategory: Gadget. Price: Out Of Stock.
",222,932787,933009
3850,recursive,"
Product: AK EB005 1600W Power Dust Electric Blower Machine. Category: Blower Machine. Subcategory: Gadget. Price: Out Of Stock.

Product: Orin 1200W Blower Machine. Category: Blower Machine. Subcategory: Gadget. Price: Out Of Stock.
",234,933009,933243
3851,recursive,"
Product: Cromnn 1200W Blower Machine. Category: Blower Machine. Subcategory: Gadget. Price: Out Of Stock.

Product: Mexico 600W Electric Blower. Category: Blower Machine. Subcategory: Gadget. Price: Out Of Stock.
",214,933243,933457
3852,recursive,"
Product: Maxwell MAX 600W Electric Blower. Category: Blower Machine. Subcategory: Gadget. Price: Out Of Stock.

Product: Boss 1250W Electric Blower Machine. Category: Blower Machine. Subcategory: Gadget. Price: Out Of Stock.
",226,933457,933683
3853,recursive,"
Product: Boss BOSS0022 1250W Electric Blower Machine. Category: Blower Machine. Subcategory: Gadget. Price: Out Of Stock.

Product: XCORT 650W Electric Blower. Category: Blower Machine. Subcategory: Gadget. Price: Out Of Stock.
",229,933683,933912
3854,recursive,"
Product: INGCO AB4018 400W Aspirator Blower. Category: Blower Machine. Subcategory: Gadget. Price: Out Of Stock.

Product: Casio HL-4A Portable Basic Calculator. Category: Casio. Subcategory: Calculator. Price: 300৳.
",218,933912,934130
3855,recursive,"
Product: Casio LC-160LV Portable Basic Calculator. Category: Casio. Subcategory: Calculator. Price: 310৳.

Product: Casio MZ-12Sa Basic Calculator. Category: Casio. Subcategory: Calculator. Price: 583৳.
",204,934130,934334
3856,recursive,"
Product: Casio MJ-12DA Check & Correct Basic Calculator. Category: Casio. Subcategory: Calculator. Price: 730৳.

Product: Casio MJ-120D Calculator. Category: Casio. Subcategory: Calculator. Price: 849৳900৳.
",208,934334,934542
3857,recursive,"
Product: Casio SX-220-W Portable Basic Calculator. Category: Casio. Subcategory: Calculator. Price: 935৳.

Product: Casio MJ-100D Plus Check & Recheck Basic Calculator. Category: Casio. Subcategory: Calculator. Price: 990৳.
",225,934542,934767
3858,recursive,"
Product: Casio FX-82MS 2nd Edition Non Programmable Scientific Calculator. Category: Casio. Subcategory: Calculator. Price: 1,100৳.

Product: Casio Fx-100MS-2 Non-programmable Scientific Calculator. Category: Casio. Subcategory: Calculator. Price: 1,678৳.
",257,934767,935024
3859,recursive,"
Product: CASIO GX-16B Basic Calculator. Category: Casio. Subcategory: Calculator. Price: 1,870৳.

Product: Casio FX-570ES PLUS 2nd Edition Non Programmable Scientific Calculator. Category: Casio. Subcategory: Calculator. Price: 1,949৳2,024৳.
",243,935024,935267
3860,recursive,"
Product: Casio FX-991MS-2 Scientific Calculator. Category: Casio. Subcategory: Calculator. Price: 2,049৳2,100৳.

Product: Casio FX-991ES Plus 2nd Edition Non-Programmable Scientific Calculator. Category: Casio. Subcategory: Calculator. Price: 1,999৳2,200৳.
",258,935267,935525
3861,recursive,"
Product: Casio HL-820LV Portable Basic Calculator. Category: Casio. Subcategory: Calculator. Price: Out Of Stock.

Product: Casio HL-815L Portable Basic Calculator. Category: Casio. Subcategory: Calculator. Price: Out Of Stock.
",229,935525,935754
3862,recursive,"
Product: Casio HL-100LB Portable Basic Calculator. Category: Casio. Subcategory: Calculator. Price: Out Of Stock.

Product: Casio SX-300-W Portable Basic Calculator. Category: Casio. Subcategory: Calculator. Price: Out Of Stock.
",230,935754,935984
3863,recursive,"
Product: Casio SX-300P-W Portable Basic Calculator. Category: Casio. Subcategory: Calculator. Price: Out Of Stock.

Product: CASIO MW-8V Basic Calculator. Category: Casio. Subcategory: Calculator. Price: Out Of Stock.
",219,935984,936203
3864,recursive,"
Product: Casio SX-320P-W Portable Basic Calculator. Category: Casio. Subcategory: Calculator. Price: Out Of Stock.

Product: Elgato Stream Deck Neo. Category: Stream Deck. Subcategory: Gadget. Price: 11,400৳12,500৳.
",217,936203,936420
3865,recursive,"
Product: Elgato Stream Deck MK2. Category: Stream Deck. Subcategory: Gadget. Price: 16,300৳.

Product: Elgato Stream Deck Live Content Creation Controller. Category: Stream Deck. Subcategory: Gadget. Price: Out Of Stock.
",222,936420,936642
3866,recursive,"
Product: Loupedeck+ The Photo and Video Editing Console. Category: Stream Deck. Subcategory: Gadget. Price: Out Of Stock.

Product: Loupedeck Live Console for Content Creators & Streamers. Category: Stream Deck. Subcategory: Gadget. Price: Out Of Stock.
",255,936642,936897
3867,recursive,"
Product: Loupedeck CT Custom Editing Console for Photo Video Music and Design. Category: Stream Deck. Subcategory: Gadget. Price: Out Of Stock.
",145,936897,937042
3868,recursive,"
Product: Casio FX-570MS-2 2nd Edition Non Programmable Scientific Calculator. Category: Scientific Calculator. Subcategory: Calculator. Price: 1,600৳1,750৳.
",158,937042,937200
3869,recursive,"
Product: Casio FX-82ES Plus 2nd Edition Non Programmable Scientific Calculator. Category: Scientific Calculator. Subcategory: Calculator. Price: Out Of Stock.
",160,937200,937360
3870,recursive,"
Product: Casio FX-82EX Non Programmable Scientific Calculator. Category: Scientific Calculator. Subcategory: Calculator. Price: Out Of Stock.

Product: Casio FX-991ES PLUS Non Programmable Scientific Calculator. Category: Scientific Calculator. Subcategory: Calculator. Price: Out Of Stock.
",292,937360,937652
3871,recursive,"
Product: Casio FX-100MS Scientific Calculator. Category: Scientific Calculator. Subcategory: Calculator. Price: Out Of Stock.

Product: Casio FX-570EX Non Programmable Scientific Calculator. Category: Scientific Calculator. Subcategory: Calculator. Price: Out Of Stock.
",271,937652,937923
3872,recursive,"
Product: Casio FX-991CW Scientific Calculator. Category: Scientific Calculator. Subcategory: Calculator. Price: Out Of Stock.

Product: Casio Fx-9860GII Graphical & Scientific Calculator. Category: Scientific Calculator. Subcategory: Calculator. Price: Out Of Stock.
",268,937923,938191
3873,recursive,"
Product: Casio FX-9860GIII Graphical & Scientific Calculator. Category: Scientific Calculator. Subcategory: Calculator. Price: Out Of Stock.

Product: Xiaomi Kaco Lemo Desktop Electronic Calculator. Category: Calculator. Subcategory: Gadget. Price: 1,150৳1,250৳.
",264,938191,938455
3874,recursive,"
Product: Phantom Edge Vortex CH25BB Gaming Chair. Category: Phantom Edge. Subcategory: Gaming Chair. Price: 17,999৳19,000৳.

Product: Phantom Edge Vortex CH25BR Gaming Chair. Category: Phantom Edge. Subcategory: Gaming Chair. Price: 17,670৳19,000৳.
",250,938455,938705
3875,recursive,"
Product: Phantom Edge Vortex CH25BG Gaming Chair. Category: Phantom Edge. Subcategory: Gaming Chair. Price: 17,999৳19,000৳.

Product: Aolion ALXB201901 Xbox Gamepad Stand. Category: Gaming. Price: 750৳.

Product: Aolion ALXB201902 Xbox Gamepad Stand. Category: Gaming. Price: 750৳.
",283,938705,938988
3876,recursive,"
Product: Aolion ALXB201907 Xbox Gamepad Stand. Category: Gaming. Price: 750৳.

Product: Fantech ACGP02 Gamepad Accessories. Category: Gaming. Price: 820৳.

Product: Fantech ACGP01 Gamepad Holder Smartphone Gaming Grip. Category: Gaming. Price: 850৳.
",251,938988,939239
3877,recursive,"
Product: HAVIT HV-G92 Gamepad. Category: Gaming. Price: 799৳900৳.

Product: Fantech ACGP04 Grip Tape For Gamepad. Category: Gaming. Price: 999৳1,045৳.

Product: Fantech ACGP03 EOS Gamepad Charging Dock for EOS PRO WGP15. Category: Gaming. Price: 1,320৳.
",255,939239,939494
3878,recursive,"
Product: Fantech GP12 Revolver Gaming Controller. Category: Gaming. Price: 1,699৳1,740৳.

Product: Onikuma C1 Dual-Mode Wireless Gaming Controller. Category: Gaming. Price: 1,899৳1,999৳.

Product: A4TECH Bloody GP30 USB Gaming Controller. Category: Gaming. Price: 1,799৳2,000৳.
",279,939494,939773
3879,recursive,"
Product: Aolion AL-NS2258-B Wireless Gaming Controller. Category: Gaming. Price: 2,099৳2,300৳.

Product: Havit G180BT Transparent RGB Bluetooth Vibration Gamepad. Category: Gaming. Price: 2,199৳2,400৳.

Product: Logitech F310 USB Gamepad. Category: Gaming. Price: 2,500৳.
",273,939773,940046
3880,recursive,"
Product: Aolion AL-NS2258-T Wireless Gaming Controller. Category: Gaming. Price: 2,299৳2,550৳.

Product: A4Tech Bloody GPW50 Dual Mode Wireless Gaming Controller. Category: Gaming. Price: 2,399৳2,600৳.
",203,940046,940249
3881,recursive,"
Product: Rapoo V600 Ergonomic Vibration Shock Controller Gamepad. Category: Gaming. Price: 2,650৳.

Product: Havit G158BT Pro Transparent RGB Bluetooth Vibration Gamepad. Category: Gaming. Price: 2,499৳2,650৳.
",211,940249,940460
3882,recursive,"
Product: Aolion AL-NS2288PRO-WH Wireless Gaming Controller. Category: Gaming. Price: 2,399৳2,650৳.

Product: Gamemax GCR07 Gaming Chair Blue. Category: GameMax. Subcategory: Gaming Chair. Price: 11,200৳14,000৳.
",212,940460,940672
3883,recursive,"
Product: Gamemax GCR07 Gaming Chair Green. Category: GameMax. Subcategory: Gaming Chair. Price: 11,200৳14,000৳.

Product: Gamemax GCR07 Gaming Chair Red. Category: GameMax. Subcategory: Gaming Chair. Price: 12,500৳16,000৳.
",224,940672,940896
3884,recursive,"
Product: Gamemax GCR07 Gaming Chair Black. Category: GameMax. Subcategory: Gaming Chair. Price: Out Of Stock.

Product: MeeTion MT-CHR16 Cute Pink Racing E-Sport Gaming Chair. Category: MeeTion. Subcategory: Gaming Chair. Price: Out Of Stock.
",244,940896,941140
3885,recursive,"
Product: Cougar ARMOR EVO M Gaming Chair ORANGE. Category: Cougar. Subcategory: Gaming Chair. Price: 44,650৳47,000৳.

Product: Cougar Terminator Elite Gaming Chair Gold. Category: Cougar. Subcategory: Gaming Chair. Price: 92,000৳95,000৳.
",239,941140,941379
3886,recursive,"
Product: Cougar Fusion S Gaming Chair. Category: Cougar. Subcategory: Gaming Chair. Price: Out Of Stock.

Product: Cougar DEFENSOR S JET GRAY F Gaming Chair. Category: Cougar. Subcategory: Gaming Chair. Price: Up Coming.
",222,941379,941601
3887,recursive,"
Product: Cougar DEFENSOR S NAVY BLUE F Gaming Chair. Category: Cougar. Subcategory: Gaming Chair. Price: Up Coming.

Product: Cougar DEFENSOR S ARMY GREEN F Gaming Chair. Category: Cougar. Subcategory: Gaming Chair. Price: Up Coming.
",235,941601,941836
3888,recursive,"
Product: Cougar Explore Jet Gray F Gaming Chair. Category: Cougar. Subcategory: Gaming Chair. Price: Up Coming.

Product: Cougar ARMOR ONE V2 BLACK F Gaming Chair. Category: Cougar. Subcategory: Gaming Chair. Price: Up Coming.
",228,941836,942064
3889,recursive,"
Product: Cougar ARMOR ONE V2 GRAY F Gaming Chair. Category: Cougar. Subcategory: Gaming Chair. Price: Up Coming.

Product: Cougar Stryder Gaming Chair Black. Category: Cougar. Subcategory: Gaming Chair. Price: Up Coming.
",222,942064,942286
3890,recursive,"
Product: Cougar Stryder Gaming Chair Grey. Category: Cougar. Subcategory: Gaming Chair. Price: Up Coming.

Product: Cougar Stryder Gaming Chair White. Category: Cougar. Subcategory: Gaming Chair. Price: Up Coming.
",215,942286,942501
3891,recursive,"
Product: Cougar Fusion SF Gaming Chair. Category: Cougar. Subcategory: Gaming Chair. Price: Out Of Stock.

Product: Cougar SPEEDER ONE Ergonomic Gaming Chair. Category: Cougar. Subcategory: Gaming Chair. Price: Out Of Stock.
",226,942501,942727
3892,recursive,"
Product: Cougar SPEEDER Ergonomic Gaming Chair. Category: Cougar. Subcategory: Gaming Chair. Price: Out Of Stock.

Product: Cougar Terminator Elite Gaming Chair Silver. Category: Cougar. Subcategory: Gaming Chair. Price: Out Of Stock.
",236,942727,942963
3893,recursive,"
Product: Cougar ARMOR EVO M Gaming Chair GOLD. Category: Cougar. Subcategory: Gaming Chair. Price: Out Of Stock.

Product: Corsair T3 RUSH Gaming Chair Grey Charcol. Category: Corsair. Subcategory: Gaming Chair. Price: 29,000৳30,000৳.
",236,942963,943199
3894,recursive,"
Product: Corsair T3 RUSH Gaming Chair Charcol. Category: Corsair. Subcategory: Gaming Chair. Price: 28,999৳30,000৳.

Product: Corsair TC100 RELAXED Fabric Gaming Chair Grey. Category: Corsair. Subcategory: Gaming Chair. Price: 27,500৳.
",237,943199,943436
3895,recursive,"
Product: Corsair TC500 LUXE Gaming Chair Shadow. Category: Corsair. Subcategory: Gaming Chair. Price: 58,000৳60,000৳.

Product: Corsair TC500 LUXE Gaming Chair Frost. Category: Corsair. Subcategory: Gaming Chair. Price: 58,000৳.
",230,943436,943666
3896,recursive,"
Product: Corsair TC100 RELAXED Leatherette Gaming Chair. Category: Corsair. Subcategory: Gaming Chair. Price: Out Of Stock.

Product: Corsair TC100 RELAXED Fabric Gaming Chair. Category: Corsair. Subcategory: Gaming Chair. Price: 27,500৳.
",240,943666,943906
3897,recursive,"
Product: Corsair TC500 LUXE Gaming Chair Sherwood. Category: Corsair. Subcategory: Gaming Chair. Price: Out Of Stock.

Product: Fantech TIGRIS GD210 RGB Gaming Desk Table. Category: Gaming Desk. Subcategory: Gaming. Price: 22,000৳23,000৳.
",240,943906,944146
3898,recursive,"
Product: Xtrike Me DK-02 Gaming Desk Table. Category: Gaming Desk. Subcategory: Gaming. Price: Out Of Stock.

Product: Xtrike Me DK-05 RGB Gaming Desk Table. Category: Gaming Desk. Subcategory: Gaming. Price: Out Of Stock.
",224,944146,944370
3899,recursive,"
Product: Xtrike Me DK-04 L-shape Gaming Desk Table. Category: Gaming Desk. Subcategory: Gaming. Price: Out Of Stock.

Product: Cougar E-STAR 140 Gaming Desk. Category: Gaming Desk. Subcategory: Gaming. Price: Up Coming.
",221,944370,944591
3900,recursive,"
Product: FURGLE ET Series Gaming Desk Table. Category: Gaming Desk. Subcategory: Gaming. Price: Out Of Stock.

Product: Fantech TIGRIS GD214 RGB Gaming Desk Table. Category: Gaming Desk. Subcategory: Gaming. Price: Out Of Stock.
",230,944591,944821
3901,recursive,"
Product: Fantech WS414 Height Adjustable Rising Gaming Desk Table. Category: Gaming Desk. Subcategory: Gaming. Price: Out Of Stock.

Product: Fantech GD914 Height Adjustable Rising Gaming Desk Table. Category: Gaming Desk. Subcategory: Gaming. Price: Out Of Stock.
",266,944821,945087
3902,recursive,"
Product: Fantech GD914 Height Adjustable Rising White Gaming Desk Table. Category: Gaming Desk. Subcategory: Gaming. Price: Out Of Stock.

Product: GIGABYTE AORUS AGC310 Gaming Chair. Category: Gaming Chair. Subcategory: Gaming. Price: 27,550৳29,000৳.
",253,945087,945340
3903,recursive,"
Product: Thermaltake U Fit Black-Red Gaming Chair. Category: Gaming Chair. Subcategory: Gaming. Price: 32,800৳.

Product: Fantech Korsi GC-191 Red Gaming Chair. Category: Gaming Chair. Subcategory: Gaming. Price: 29,800৳35,000৳.
",230,945340,945570
3904,recursive,"
Product: Thermaltake V Comfort Black-Red Gaming Chair. Category: Gaming Chair. Subcategory: Gaming. Price: 37,000৳.

Product: Thermaltake V Comfort Blue-White Gaming Chair. Category: Gaming Chair. Subcategory: Gaming. Price: 37,000৳.
",235,945570,945805
3905,recursive,"
Product: Thermaltake CyberChair E500 White Edition Gaming Chair. Category: Gaming Chair. Subcategory: Gaming. Price: 90,000৳.

Product: Thermaltake CyberChair E500 Black Gaming Chair. Category: Gaming Chair. Subcategory: Gaming. Price: 90,000৳.
",246,945805,946051
3906,recursive,"
Product: Thermaltake ARGENT E700 Real Leather Space Gray Gaming Chair. Category: Gaming Chair. Subcategory: Gaming. Price: 115,000৳.

Product: Thermaltake ARGENT E700 Real Leather Glacier White Gaming Chair. Category: Gaming Chair. Subcategory: Gaming. Price: 115,000৳.
",271,946051,946322
3907,recursive,"
Product: Havit HV-MS1027 USB Gaming Mouse. Category: Mouse. Subcategory: Gaming. Price: 399৳500৳.

Product: Havit HV-MS1010 RGB Backlit Gaming Mouse. Category: Mouse. Subcategory: Gaming. Price: 550৳.

Product: Hoco GM37 USB Gaming Mouse. Category: Mouse. Subcategory: Gaming. Price: 450৳550৳.
",295,946322,946617
3908,recursive,"
Product: Xtrike Me GM-217 RGB Gaming Mouse. Category: Mouse. Subcategory: Gaming. Price: 549৳650৳.

Product: Xtrike Me GM-227 Wired Gaming Mouse. Category: Mouse. Subcategory: Gaming. Price: 499৳650৳.

Product: Onikuma CW917 Wired Gaming Mouse. Category: Mouse. Subcategory: Gaming. Price: 699৳.
",297,946617,946914
3909,recursive,"
Product: Xtrfy M4 Lizard Skins Dsp Mouse Grip Tape Black. Category: Mouse. Subcategory: Gaming. Price: 250৳700৳.

Product: Xtrfy M42 Lizard Skins Dsp Mouse Grip Tape Black. Category: Mouse. Subcategory: Gaming. Price: 250৳700৳.
",229,946914,947143
3910,recursive,"
Product: Xtrfy MZ1 Lizard Skins Dsp Mouse Grip Tape Black. Category: Mouse. Subcategory: Gaming. Price: 250৳700৳.

Product: Fantech Kanata VX9 Gaming Mouse. Category: Mouse. Subcategory: Gaming. Price: 715৳.
",209,947143,947352
3911,recursive,"
Product: Xtrike Me GM-226 RGB Gaming Mouse. Category: Mouse. Subcategory: Gaming. Price: 670৳770৳.

Product: AULA F805 Wired Programmable Gaming Mouse. Category: Mouse. Subcategory: Gaming. Price: 850৳.
",204,947352,947556
3912,recursive,"
Product: Fantech Raigor III WG12 Gaming Mouse. Category: Mouse. Subcategory: Gaming. Price: 750৳850৳.

Product: Fantech WG10 Raigor II Wirless Gaming Mouse. Category: Mouse. Subcategory: Gaming. Price: 790৳870৳.
",213,947556,947769
3913,recursive,"
Product: Havit Gamenote HV-MS1001S RGB Backlit Programmable Gaming Mouse. Category: Mouse. Subcategory: Gaming. Price: 799৳900৳.

Product: PC Power PGC801A105 RGB Wired Gaming Keyboard Mouse Combo with Bangla. Category: Mouse. Subcategory: Gaming. Price: 950৳.
",262,947769,948031
3914,recursive,"
Product: PC Power PGC801TA01 RGB Wired Gaming Keyboard Mouse Combo with Bangla. Category: Mouse. Subcategory: Gaming. Price: 950৳.

Product: PC Power PGC801BG13 RGB Wired Gaming Keyboard Mouse Combo with Bangla. Category: Mouse. Subcategory: Gaming. Price: 850৳950৳.
",268,948031,948299
3915,recursive,"
Product: Havit MS1014 Wired RGB Gaming Mouse. Category: Mouse. Subcategory: Gaming. Price: 850৳950৳.

Product: Havit HV-KB275L USB Gaming Keyboard with Bangla. Category: Keyboard. Subcategory: Gaming. Price: 799৳900৳.
",219,948299,948518
3916,recursive,"
Product: Havit KB866L Multi-function Backlit Membrane Gaming Keyboard. Category: Keyboard. Subcategory: Gaming. Price: 850৳950৳.

Product: Fantech KM100 USB Keyboard Mouse Combo Black. Category: Keyboard. Subcategory: Gaming. Price: 970৳.
",240,948518,948758
3917,recursive,"
Product: Fantech Shikari K515 Gaming Keyboard. Category: Keyboard. Subcategory: Gaming. Price: 945৳1,045৳.

Product: T-Wolf TF600 RGB Gaming Keyboard Mouse Combo. Category: Keyboard. Subcategory: Gaming. Price: 950৳1,050৳.
",224,948758,948982
3918,recursive,"
Product: Fantech K511 Hunter PRO Backlit Gaming Keyboard. Category: Keyboard. Subcategory: Gaming. Price: 1,050৳1,150৳.

Product: Havit KB488L Multi-Function Backlit Gaming Keyboard. Category: Keyboard. Subcategory: Gaming. Price: 1,030৳1,150৳.
",246,948982,949228
3919,recursive,"
Product: PC Power Silent-98 Gaming Keyboard with Bangla. Category: Keyboard. Subcategory: Gaming. Price: 1,200৳.

Product: T-Wolf TF770 Wireless Keyboard Mouse Combo. Category: Keyboard. Subcategory: Gaming. Price: 1,099৳1,250৳.
",230,949228,949458
3920,recursive,"
Product: Redragon K521-Rainbow Netherbane RGB Gaming Keyboard. Category: Keyboard. Subcategory: Gaming. Price: 1,275৳.

Product: Havit KB487L Multi-Function USB Backlit Gaming Keyboard. Category: Keyboard. Subcategory: Gaming. Price: 1,150৳1,300৳.
",249,949458,949707
3921,recursive,"
Product: Havit KB838L Multi-function RGB Backlit Gaming Keyboard. Category: Keyboard. Subcategory: Gaming. Price: 1,199৳1,300৳.

Product: Redragon K521-RGB Netherbane Gaming Keyboard. Category: Keyboard. Subcategory: Gaming. Price: 1,475৳.
",241,949707,949948
3922,recursive,"
Product: Fantech K614L Fighter III RGB Gaming Keyboard. Category: Keyboard. Subcategory: Gaming. Price: 1,380৳1,500৳.

Product: T-Wolf TF350 Wireless Keyboard Mouse Combo. Category: Keyboard. Subcategory: Gaming. Price: 1,299৳1,550৳.
",235,949948,950183
3923,recursive,"
Product: T-Wolf TF610 RGB Gaming Keyboard Mouse Combo. Category: Keyboard. Subcategory: Gaming. Price: 1,499৳1,650৳.

Product: T-WOLF TF100 Wired Keyboard Mouse Gaming Combo. Category: Keyboard. Subcategory: Gaming. Price: 1,650৳.
",232,950183,950415
3924,recursive,"
Product: Hoco W106 Tiger Gaming Headphone. Category: Headphone. Subcategory: Gaming. Price: 940৳1,190৳.

Product: Redragon H130 Pelias Wired Gaming Headset. Category: Headphone. Subcategory: Gaming. Price: 1,150৳1,250৳.
",221,950415,950636
3925,recursive,"
Product: Onikuma X7 Pro Wired RGB Gaming Headphone. Category: Headphone. Subcategory: Gaming. Price: 1,250৳.

Product: Havit H2230d 3.5mm Wired Gaming Headphone. Category: Headphone. Subcategory: Gaming. Price: 1,280৳.
",220,950636,950856
3926,recursive,"
Product: Fantech FLASH HQ53 Lightweight Gaming Headset. Category: Headphone. Subcategory: Gaming. Price: 1,180৳1,300৳.

Product: Havit H2040D Wired Gaming Headphone. Category: Headphone. Subcategory: Gaming. Price: 1,300৳.
",224,950856,951080
3927,recursive,"
Product: HAVIT HV-H2232d RGB Gaming Headphone. Category: Headphone. Subcategory: Gaming. Price: 1,350৳.

Product: Xtrike Me GH-510 RGB Stereo Gaming Headset. Category: Headphone. Subcategory: Gaming. Price: 1,150৳1,350৳.
",222,951080,951302
3928,recursive,"
Product: Onikuma X29 RGB Gaming Headphone. Category: Headphone. Subcategory: Gaming. Price: 1,350৳.

Product: Xtrike Me GH-509 RGB Stereo Gaming Headphone. Category: Headphone. Subcategory: Gaming. Price: 1,199৳1,400৳.
",220,951302,951522
3929,recursive,"
Product: Xtrike Me GH-511 RGB Translucent Gaming Headphone. Category: Headphone. Subcategory: Gaming. Price: 1,250৳1,450৳.

Product: Havit Gamenote H2042d RGB Wired Gaming Headphone. Category: Headphone. Subcategory: Gaming. Price: 1,299৳1,500৳.
",247,951522,951769
3930,recursive,"
Product: Razer Kishi V2 Mobile Gaming Controller for iPhone. Category: Razer. Subcategory: Gamepad. Price: 9,999৳15,000৳.

Product: Razer Kishi Universal Gaming Controller for Android. Category: Razer. Subcategory: Gamepad. Price: Out Of Stock.
",246,951769,952015
3931,recursive,"
Product: Razer Wolverine Tournament Edition Chroma - Customizable Gamepad Controller (Global). Category: Razer. Subcategory: Gamepad. Price: Out Of Stock.

Product: Razer Kishi V2 Universal Gaming Controller for Android. Category: Razer. Subcategory: Gamepad. Price: Out Of Stock.
",282,952015,952297
3932,recursive,"
Product: Logitech F710 Wireless Gamepad. Category: Logitech. Subcategory: Gamepad. Price: 4,800৳5,000৳.

Product: Logitech Joystick Extreme 3D PRO (942-000008). Category: Logitech. Subcategory: Gamepad. Price: 5,500৳.
",219,952297,952516
3933,recursive,"
Product: Logitech Driving Force Shifter. Category: Logitech. Subcategory: Gamepad. Price: 7,000৳.

Product: Logitech Driving Force G29 Racing Gaming Wheel for PlayStation and PC. Category: Logitech. Subcategory: Gamepad. Price: 40,000৳.
",238,952516,952754
3934,recursive,"
Product: Logitech G923 TRUEFORCE Gaming Racing Wheel for PlayStation and PC. Category: Logitech. Subcategory: Gamepad. Price: 48,500৳.

Product: Nintendo Switch Pro Controller Splatoon 2 Edition. Category: Nintendo. Subcategory: Gamepad. Price: 6,500৳.
",254,952754,953008
3935,recursive,"
Product: Nintendo Switch Pro Controller Xenoblade Chronicles 2 Edition. Category: Nintendo. Subcategory: Gamepad. Price: 6,500৳.

Product: Nintendo Switch Pro Controller. Category: Nintendo. Subcategory: Gamepad. Price: 5,999৳6,700৳.
",235,953008,953243
3936,recursive,"
Product: Aolion AL-NS2288PRO-PI Wireless Gaming Controller. Category: Gamepad. Subcategory: Gaming. Price: 2,399৳2,650৳.

Product: SteelSeries Stratus Duo Tri-Mode Gaming Controller. Category: SteelSeries. Subcategory: Gamepad. Price: 5,999৳6,300৳.
",250,953243,953493
3937,recursive,"
Product: SteelSeries Nimbus Plus Wireless Gamepad. Category: SteelSeries. Subcategory: Gamepad. Price: 8,299৳9,000৳.

Product: SteelSeries Stratus Plus Wireless Gamepad. Category: SteelSeries. Subcategory: Gamepad. Price: 11,999৳13,000৳.
",239,953493,953732
3938,recursive,"
Product: Xbox Wireless Controller 1914. Category: Xbox. Subcategory: Gamepad. Price: 6,900৳8,500৳.

Product: Xbox Wireless Controller Shock Blue. Category: Xbox. Subcategory: Gamepad. Price: 6,900৳8,500৳.
",206,953732,953938
3939,recursive,"
Product: Microsoft Xbox Wireless Controller - Electric Volt. Category: Xbox. Subcategory: Gamepad. Price: 6,999৳8,100৳.

Product: Microsoft Xbox Wireless Controller - Daystrike Camo Special Edition. Category: Xbox. Subcategory: Gamepad. Price: 8,800৳.
",253,953938,954191
3940,recursive,"
Product: Xbox Wireless Controller 1914 White. Category: Xbox. Subcategory: Gamepad. Price: 6,799৳8,800৳.

Product: Xbox Wireless Controller Arctic Camo Special Edition. Category: Xbox. Subcategory: Gamepad. Price: 8,800৳.
",223,954191,954414
3941,recursive,"
Product: Microsoft Xbox Wireless Controller - Stormcloud Vapor Special Edition. Category: Xbox. Subcategory: Gamepad. Price: 8,800৳.

Product: Xbox Wireless Controller Red. Category: Xbox. Subcategory: Gamepad. Price: 7,449৳8,040৳.
",233,954414,954647
3942,recursive,"
Product: Microsoft Xbox Wireless Controller - Velocity Green. Category: Xbox. Subcategory: Gamepad. Price: 7,700৳9,000৳.

Product: Microsoft Xbox Wireless Controller - Mineral Camo Special Edition. Category: Xbox. Subcategory: Gamepad. Price: 8,800৳9,200৳.
",258,954647,954905
3943,recursive,"
Product: Xbox Wireless Controller Nocturnal Vapor Special Edition. Category: Xbox. Subcategory: Gamepad. Price: 8,500৳9,800৳.

Product: Xbox Elite Series 2 Wireless Controller. Category: Xbox. Subcategory: Gamepad. Price: 19,900৳25,000৳.
",239,954905,955144
3944,recursive,"
Product: Xbox Wireless Controller Dream Vapor Special Edition. Category: Xbox. Subcategory: Gamepad. Price: Up Coming.

Product: Xbox Wireless Controller Astral Purple. Category: Xbox. Subcategory: Gamepad. Price: Up Coming.
",226,955144,955370
3945,recursive,"
Product: Xbox One Wireless Controller (Without Wireless & Bluetooth Dongle ). Category: Xbox. Subcategory: Gamepad. Price: Up Coming.

Product: Xbox Night Ops Camo Special Edition Wireless Controller. Category: Xbox. Subcategory: Gamepad. Price: Out Of Stock.
",261,955370,955631
3946,recursive,"
Product: Microsoft Xbox One Armed Forces Camo Controller. Category: Xbox. Subcategory: Gamepad. Price: Out Of Stock.

Product: Xbox Midnight Forces II Special Edition Wireless Controller. Category: Xbox. Subcategory: Gamepad. Price: Out Of Stock.
",248,955631,955879
3947,recursive,"
Product: Microsoft Xbox Wireless Controller - Lunar Shift Special Edition. Category: Xbox. Subcategory: Gamepad. Price: Out Of Stock.

Product: Microsoft Xbox Wireless Controller - Aqua Shift Special Edition. Category: Xbox. Subcategory: Gamepad. Price: Out Of Stock.
",269,955879,956148
3948,recursive,"
Product: Xtrike Me GP-51 Wireless Gamepad. Category: Xtrike Me. Subcategory: Gamepad. Price: 1,899৳2,700৳.

Product: Xtrike Me GP-52 RGB Wireless Gamepad. Category: Xtrike Me. Subcategory: Gamepad. Price: 1,999৳2,800৳.
",220,956148,956368
3949,recursive,"
Product: Xtrike Me GP-50 Wireless Gamepad. Category: Xtrike Me. Subcategory: Gamepad. Price: Out Of Stock.

Product: Xtrike Me GP-43 Wireless Gamepad. Category: Xtrike Me. Subcategory: Gamepad. Price: Out Of Stock.
",216,956368,956584
3950,recursive,"
Product: Xtrike Me GP-903 Gaming Racing Wheel. Category: Xtrike Me. Subcategory: Gamepad. Price: Out Of Stock.

Product: Redragon G815 Blue Dual-Mode Wireless Gamepad. Category: Redragon. Subcategory: Gamepad. Price: 4,449৳4,800৳.
",232,956584,956816
3951,recursive,"
Product: Redragon G815 Pink Dual-Mode Wireless Gamepad. Category: Redragon. Subcategory: Gamepad. Price: 4,399৳4,800৳.

Product: Redragon Saturn G807 Wired Gamepad. Category: Redragon. Subcategory: Gamepad. Price: 1,650৳1,750৳.
",229,956816,957045
3952,recursive,"
Product: Redragon RIFT G710 Wired Gamepad. Category: Redragon. Subcategory: Gamepad. Price: 1,850৳.

Product: Redragon G711 Wireless Gamepad. Category: Redragon. Subcategory: Gamepad. Price: 2,899৳3,050৳.
",206,957045,957251
3953,recursive,"
Product: Redragon HARROW G808 Wireless Gamepad. Category: Redragon. Subcategory: Gamepad. Price: Out Of Stock.

Product: Redragon G808-PR0 HARROW Gamepad. Category: Redragon. Subcategory: Gamepad. Price: Out Of Stock.
",219,957251,957470
3954,recursive,"
Product: Redragon Ceres G812 Wireless Gamepad. Category: Redragon. Subcategory: Gamepad. Price: Out Of Stock.

Product: Sony PlayStation 5 DualSense Charging Station. Category: PlayStation. Subcategory: Gamepad. Price: 2,750৳5,000৳.
",234,957470,957704
3955,recursive,"
Product: PlayStation 5 DualSense Wireless Controller - Galactic Purple. Category: PlayStation. Subcategory: Gamepad. Price: 8,500৳.

Product: PlayStation 5 DualSense Wireless Controller - Grey Camouflage. Category: PlayStation. Subcategory: Gamepad. Price: 8,500৳.
",266,957704,957970
3956,recursive,"
Product: PlayStation 5 DualSense Wireless Controller. Category: PlayStation. Subcategory: Gamepad. Price: 8,400৳9,000৳.

Product: PlayStation 5 DualSense Wireless Controller - Starlight Blue. Category: PlayStation. Subcategory: Gamepad. Price: 8,500৳9,000৳.
",259,957970,958229
3957,recursive,"
Product: PlayStation 5 DualSense Wireless Controller Cosmic Red. Category: PlayStation. Subcategory: Gamepad. Price: 8,400৳9,200৳.

Product: PlayStation 5 DualSense Wireless Controller - Midnight Black. Category: PlayStation. Subcategory: Gamepad. Price: 8,350৳9,800৳.
",270,958229,958499
3958,recursive,"
Product: PlayStation 5 DualSense Wireless Controller Cobalt Blue. Category: PlayStation. Subcategory: Gamepad. Price: 8,800৳9,800৳.

Product: PlayStation 5 DualSense Wireless Controller Chroma Teal. Category: PlayStation. Subcategory: Gamepad. Price: 9,500৳10,700৳.
",267,958499,958766
3959,recursive,"
Product: PlayStation 5 DualSense Wireless Controller Chroma Indigo. Category: PlayStation. Subcategory: Gamepad. Price: 9,500৳10,800৳.

Product: PlayStation 5 DualSense Wireless Controller Spider-Man 2 Edition. Category: PlayStation. Subcategory: Gamepad. Price: 17,500৳.
",273,958766,959039
3960,recursive,"
Product: PlayStation 5 DualSense Wireless Controller DEATH STRANDING 2 ON THE BEACH Edition. Category: PlayStation. Subcategory: Gamepad. Price: 18,500৳.

Product: PlayStation 5 DualSense Wireless Controller Hogwarts Legacy Edition. Category: PlayStation. Subcategory: Gamepad. Price: 19,900৳.
",295,959039,959334
3961,recursive,"
Product: PXN V9 Racing Wheel With Shifter and Pedal. Category: PlayStation. Subcategory: Gamepad. Price: 23,990৳27,000৳.

Product: PS4 Dualshock 4 Wireless Controller Green Camouflage (Original). Category: PlayStation. Subcategory: Gamepad. Price: Out Of Stock.
",263,959334,959597
3962,recursive,"
Product: PS4 DualShock 4 Wireless Controller Magma Red (Original). Category: PlayStation. Subcategory: Gamepad. Price: Out Of Stock.

Product: PS4 Dualshock 4 Wireless Controller Steel Glacier White (Original). Category: PlayStation. Subcategory: Gamepad. Price: Out Of Stock.
",278,959597,959875
3963,recursive,"
Product: PS4 DualShock 4 Wireless Controller Black (Original). Category: PlayStation. Subcategory: Gamepad. Price: Out Of Stock.

Product: HAVIT HV-G83 Gamepad. Category: Havit. Subcategory: Gamepad. Price: Out Of Stock.
",222,959875,960097
3964,recursive,"
Product: Havit G85 USB Gaming Pad. Category: Havit. Subcategory: Gamepad. Price: Out Of Stock.

Product: Havit HV-G69 USB with Vibration Gamepad. Category: Havit. Subcategory: Gamepad. Price: Out Of Stock.
",207,960097,960304
3965,recursive,"
Product: Havit G61 USB Vibration Double Gamepad. Category: Havit. Subcategory: Gamepad. Price: Out Of Stock.

Product: Havit G171 Wired Gamepad With Vibration. Category: Havit. Subcategory: Gamepad. Price: Out Of Stock.
",221,960304,960525
3966,recursive,"
Product: Havit G145BT Bluetooth Vibration Android Gamepad. Category: Havit. Subcategory: Gamepad. Price: Out Of Stock.

Product: Havit G176 Wired Gamepad With Vibration. Category: Havit. Subcategory: Gamepad. Price: Out Of Stock.
",231,960525,960756
3967,recursive,"
Product: Havit G89W 2.4GHZ Wireless Vibration GamePad. Category: Havit. Subcategory: Gamepad. Price: Out Of Stock.

Product: Havit G158BT Bluetooth Vibration Android Gamepad. Category: Havit. Subcategory: Gamepad. Price: Out Of Stock.
",236,960756,960992
3968,recursive,"
Product: Rapoo V600S Wired & Wireless Dual Vibration Motors Gamepad With Nano USB Receiver. Category: Rapoo. Subcategory: Gamepad. Price: 3,250৳.

Product: Rapoo V600SE Dual Mode Wireless Gamepad. Category: Rapoo. Subcategory: Gamepad. Price: 3,199৳3,350৳.
",258,960992,961250
3969,recursive,"
Product: Corsair SCUF ENVISION Gamepad. Category: Corsair. Subcategory: Gamepad. Price: 7,499৳7,700৳.

Product: Corsair SCUF NOMAD Mobile Gaming Controller for iPhone. Category: Corsair. Subcategory: Gamepad. Price: 8,599৳8,800৳.
",231,961250,961481
3970,recursive,"
Product: Corsair SCUF ENVISION PRO Wireless Gamepad. Category: Corsair. Subcategory: Gamepad. Price: 14,500৳.

Product: Fantech EOS LITE GP15L Wired Gamepad. Category: Fantech. Subcategory: Gamepad. Price: 2,599৳2,750৳.
",221,961481,961702
3971,recursive,"
Product: Fantech GP15 EOS Vega Multiplatform Wired Gamepad. Category: Fantech. Subcategory: Gamepad. Price: 2,899৳3,050৳.

Product: Fantech Revolver WGP12 Wireless Gaming Controller. Category: Fantech. Subcategory: Gamepad. Price: 2,999৳3,200৳.
",246,961702,961948
3972,recursive,"
Product: Fantech Revolver III WGP12S Wireless Controller. Category: Fantech. Subcategory: Gamepad. Price: 3,675৳.

Product: Fantech NOVA PRO WGP14V2 Multiplatform Wireless Gamepad. Category: Fantech. Subcategory: Gamepad. Price: 4,049৳4,250৳.
",244,961948,962192
3973,recursive,"
Product: Fantech EOS PRO WGP15 Multiplatform Tri-Mode Wireless Gamepad. Category: Fantech. Subcategory: Gamepad. Price: 4,199৳4,250৳.

Product: Fantech NOVA WGP14 Wireless Gaming Controller. Category: Fantech. Subcategory: Gamepad. Price: 3,999৳4,345৳.
",254,962192,962446
3974,recursive,"
Product: Fantech Nova II WGP16 Wireless Controller Black. Category: Fantech. Subcategory: Gamepad. Price: 4,450৳.

Product: Fantech Nova II WGP16 Wireless Controller. Category: Fantech. Subcategory: Gamepad. Price: 4,500৳.
",224,962446,962670
3975,recursive,"
Product: Fantech Nova II WGP16 Wireless Controller White. Category: Fantech. Subcategory: Gamepad. Price: 4,500৳.

Product: Fantech GP11 Shooter USB Gamepad. Category: Fantech. Subcategory: Gamepad. Price: Out Of Stock.
",221,962670,962891
3976,recursive,"
Product: Fantech GP13 Shooter II Gaming Controller. Category: Fantech. Subcategory: Gamepad. Price: 1,799৳1,925৳.

Product: Fantech WGP13 Shooter II Wireless Gaming Controller. Category: Fantech. Subcategory: Gamepad. Price: Out Of Stock.
",240,962891,963131
3977,recursive,"
Product: Fantech WGP13S Shooter III Wireless Gamepad. Category: Fantech. Subcategory: Gamepad. Price: 2,985৳3,135৳.

Product: Pico Neo 3 Link Standalone 6GB RAM 128GB Storage All-in-One VR Headset. Category: VR. Subcategory: Gaming. Price: 41,500৳45,000৳.
",257,963131,963388
3978,recursive,"
Product: Meta Quest 3s VR Headset with Batman Arkham Shadow (3 month trail). Category: VR. Subcategory: Gaming. Price: 47,400৳55,000৳.

Product: Pico Neo 3 Link Standalone 6GB RAM 256GB Storage All-in-One VR Headset. Category: VR. Subcategory: Gaming. Price: 51,500৳58,000৳.
",276,963388,963664
3979,recursive,"
Product: Meta Quest 2 256 GB All-in-One VR System. Category: VR. Subcategory: Gaming. Price: 59,900৳64,000৳.

Product: PICO 4 All-in-One 128GB VR Headset. Category: VR. Subcategory: Gaming. Price: 57,400৳64,000৳.
",214,963664,963878
3980,recursive,"
Product: PICO 4 All-in-One 256GB VR Headset. Category: VR. Subcategory: Gaming. Price: 59,500৳65,000৳.

Product: Meta Quest 3s 128GB All-in-One VR Headset. Category: VR. Subcategory: Gaming. Price: 44,900৳65,000৳.
",215,963878,964093
3981,recursive,"
Product: Sony PlayStation VR2. Category: VR. Subcategory: Gaming. Price: 58,500৳65,500৳.

Product: Meta Quest 3s 256GB All-in-One VR Headset. Category: VR. Subcategory: Gaming. Price: 58,500৳67,500৳.
",201,964093,964294
3982,recursive,"
Product: Meta Quest 3 512GB All-in-One VR Headset. Category: VR. Subcategory: Gaming. Price: 74,900৳83,500৳.

Product: Apple Vision Pro 256GB Storage Spatial Computer VR Headset. Category: VR. Subcategory: Gaming. Price: 445,000৳.
",232,964294,964526
3983,recursive,"
Product: Apple Vision Pro 1TB Storage Spatial Computer VR Headset. Category: VR. Subcategory: Gaming. Price: 529,000৳545,000৳.

Product: Sony Playstation Move Virtual Reality Motion Controller. Category: VR. Subcategory: Gaming. Price: Up Coming.
",248,964526,964774
3984,recursive,"
Product: Meta Quest Pro 256 GB All-in-One VR Headset. Category: VR. Subcategory: Gaming. Price: Up Coming.

Product: Pico Neo 3 8GB RAM 128GB ROM 3D Advanced All-In-One VR Headset. Category: VR. Subcategory: Gaming. Price: Out Of Stock.
",238,964774,965012
3985,recursive,"
Product: Meta Quest 2 128 GB All-in-One VR System. Category: VR. Subcategory: Gaming. Price: Out Of Stock.

Product: Pico Neo 3 8GB RAM 256GB ROM 3D Advanced All-In-One VR Headset. Category: VR. Subcategory: Gaming. Price: Out Of Stock.
",238,965012,965250
3986,recursive,"
Product: Meta Quest 2 128GB All-in-One VR System with Resident Evil 4 Game Bundle. Category: VR. Subcategory: Gaming. Price: Out Of Stock.

Product: Sony PlayStation VR2 Horizon Call of the Mountain Bundle. Category: VR. Subcategory: Gaming. Price: Out Of Stock.
",264,965250,965514
3987,recursive,"
Product: Meta Quest 3 128GB All-in-One VR Headset. Category: VR. Subcategory: Gaming. Price: Out Of Stock.

Product: Sony Vertical Console Stand for PS5. Category: PlayStation. Subcategory: Gaming Console. Price: 2,800৳4,200৳.
",228,965514,965742
3988,recursive,"
Product: PlayStation 5 Console Cover. Category: PlayStation. Subcategory: Gaming Console. Price: 4,990৳6,900৳.

Product: PlayStation 5 Console Cover God of War Edition. Category: PlayStation. Subcategory: Gaming Console. Price: 7,500৳.
",237,965742,965979
3989,recursive,"
Product: Sony PlayStation HD Camera for PS5. Category: PlayStation. Subcategory: Gaming Console. Price: 7,000৳7,500৳.

Product: Sony Console Disc Drive for PS5 Digital Edition Slim. Category: PlayStation. Subcategory: Gaming Console. Price: 21,500৳29,000৳.
",258,965979,966237
3990,recursive,"
Product: Sony PlayStation 5 Media Remote. Category: PlayStation. Subcategory: Gaming Console. Price: Out Of Stock.

Product: PlayStation 5 Console Cover Marvel’s Spider-Man 2 Limited Edition. Category: PlayStation. Subcategory: Gaming Console. Price: Out Of Stock.
",266,966237,966503
3991,recursive,"
Product: Valve Steam Deck OLED Handheld Gaming Console. Category: Steam Deck. Subcategory: Gaming Console. Price: 79,500৳90,000৳.

Product: Valve Steam Deck OLED 1TB Handheld Gaming Console. Category: Steam Deck. Subcategory: Gaming Console. Price: 93,500৳115,000৳.
",267,966503,966770
3992,recursive,"
Product: ASUS ROG Ally X Gaming Console. Category: Asus. Subcategory: Gaming Console. Price: 122,900৳144,000৳.

Product: Asus ROG Ally Gaming Console. Category: Asus. Subcategory: Gaming Console. Price: Out Of Stock.
",218,966770,966988
3993,recursive,"
Product: Lenovo Legion Go Handheld PC Gaming Console. Category: Lenovo. Subcategory: Gaming Console. Price: 96,700৳119,000৳.

Product: Uncharted 4 A Thief's End for PlayStation 4. Category: Games. Subcategory: Gaming. Price: 2,700৳.
",234,966988,967222
3994,recursive,"
Product: The Witcher 3: Wild Hunt for PS4 and PS5. Category: Games. Subcategory: Gaming. Price: 2,800৳.

Product: Gran Turismo Sport for PS4 and PS5. Category: Games. Subcategory: Gaming. Price: 2,800৳.
",204,967222,967426
3995,recursive,"
Product: Tom Clancy's The Division 2 for PS4 and PS5. Category: Games. Subcategory: Gaming. Price: 2,800৳.

Product: Gran Turismo Sport for PlayStation 4 VR. Category: Games. Subcategory: Gaming. Price: 2,890৳.
",212,967426,967638
3996,recursive,"
Product: WWE 2K20 for PS4 and PS5. Category: Games. Subcategory: Gaming. Price: 3,000৳.

Product: Need for Speed Payback for PS4 and PS5. Category: Games. Subcategory: Gaming. Price: 3,000৳.

Product: Mortal Kombat XL for PS4 and PS5. Category: Games. Subcategory: Gaming. Price: 3,000৳.
",289,967638,967927
3997,recursive,"
Product: Watch Dogs: Legion for PS4 and PS5. Category: Games. Subcategory: Gaming. Price: 3,100৳.

Product: Red Dead Redemption 2 Sony PS4 Game. Category: Games. Subcategory: Gaming. Price: 3,200৳.
",199,967927,968126
3998,recursive,"
Product: Battlefield V Year 2 Edition for PS4 and PS5. Category: Games. Subcategory: Gaming. Price: 3,200৳.

Product: Need for Speed Heat for PS4 and PS5. Category: Games. Subcategory: Gaming. Price: 3,200৳.
",209,968126,968335
3999,recursive,"
Product: God of War for PS4 and PS5. Category: Games. Subcategory: Gaming. Price: 2,990৳3,300৳.

Product: Call of Duty: Infinite Warfare for PS4 and PS5. Category: Games. Subcategory: Gaming. Price: 3,500৳.
",208,968335,968543
4000,recursive,"
Product: Assassin's Creed Valhalla for PS4 and PS5. Category: Games. Subcategory: Gaming. Price: 3,700৳.

Product: Mafia: Definitive Edition for PlayStation 4. Category: Games. Subcategory: Gaming. Price: 4,200৳.
",214,968543,968757
4001,recursive,"
Product: FAR CRY 6 Game for PS4 and PS5. Category: Games. Subcategory: Gaming. Price: 4,500৳.

Product: Grand Theft Auto V (GTA 5) for PS4 and PS5. Category: Games. Subcategory: Gaming. Price: 4,500৳.
",202,968757,968959
4002,recursive,"
Product: The Last of Us Part II for PS4 and PS5. Category: Games. Subcategory: Gaming. Price: 4,500৳.

Product: Resident Evil Village Game for PS4 and PS5. Category: Games. Subcategory: Gaming. Price: 4,500৳.
",210,968959,969169
4003,recursive,"
Product: Nintendo Switch Lite Gaming Console. Category: Nintendo. Subcategory: Gaming Console. Price: 21,900৳25,500৳.

Product: Nintendo Switch OLED Gaming Console. Category: Nintendo. Subcategory: Gaming Console. Price: 36,500৳38,000৳.
",238,969169,969407
4004,recursive,"
Product: Nintendo Switch OLED Model Neon Blue/Neon Red set Gaming Console. Category: Nintendo. Subcategory: Gaming Console. Price: 36,500৳38,000৳.
",148,969407,969555
4005,recursive,"
Product: Nintendo Switch OLED Model The Legend of Zelda Tears of the Kingdom Edition Gaming Console. Category: Nintendo. Subcategory: Gaming Console. Price: 41,000৳.

Product: Nintendo Switch 2 Gaming Console. Category: Nintendo. Subcategory: Gaming Console. Price: 75,000৳82,000৳.
",283,969555,969838
4006,recursive,"
Product: Nintendo Switch 2 With Mario Kart World Bundle. Category: Nintendo. Subcategory: Gaming Console. Price: 87,000৳95,000৳.

Product: Nintendo Switch OLED Model Pokemon Scarlet & Violet Edition Gaming Console. Category: Nintendo. Subcategory: Gaming Console. Price: Up Coming.
",283,969838,970121
4007,recursive,"
Product: Nintendo Switch OLED Model Splatoon 3 Edition Gaming Console. Category: Nintendo. Subcategory: Gaming Console. Price: Up Coming.

Product: Nintendo Switch OLED Model Mario Red Edition Gaming Console. Category: Nintendo. Subcategory: Gaming Console. Price: Out Of Stock.
",280,970121,970401
4008,recursive,"
Product: Nintendo Switch Fortnite Wildcat Bundle Gaming Console. Category: Nintendo. Subcategory: Gaming Console. Price: Out Of Stock.

Product: Microsoft Xbox Series S Gaming Console. Category: Xbox. Subcategory: Gaming Console. Price: 42,500৳46,300৳.
",254,970401,970655
4009,recursive,"
Product: Microsoft Xbox One X Gaming Console. Category: Xbox. Subcategory: Gaming Console. Price: 65,000৳.

Product: Microsoft Xbox Series X Gaming Console White. Category: Xbox. Subcategory: Gaming Console. Price: 81,000৳92,000৳.
",232,970655,970887
4010,recursive,"
Product: Microsoft Xbox One S Gaming Console. Category: Xbox. Subcategory: Gaming Console. Price: Up Coming.

Product: Haier H32D2M 32 Inch Miracast HD LED TV. Category: Haier. Subcategory: All TV. Price: 16,500৳20,900৳.
",222,970887,971109
4011,recursive,"
Product: Haier H32K85FX 32"" DLED HD Google TV. Category: Haier. Subcategory: All TV. Price: 22,300৳26,900৳.

Product: Haier H32S80EFX 32"" QLED FHD Android Google TV. Category: Haier. Subcategory: All TV. Price: 22,990৳29,900৳.
",228,971109,971337
4012,recursive,"
Product: Haier Candy C40K6FG 40"" DLED FHD Smart Android TV. Category: Haier. Subcategory: All TV. Price: 27,900৳30,900৳.

Product: Haier H43K85FFX 43"" DLED FHD Google TV. Category: Haier. Subcategory: All TV. Price: 30,990৳39,900৳.
",233,971337,971570
4013,recursive,"
Product: Haier H43S80EUX 43"" QLED 4K Android Google TV. Category: Haier. Subcategory: All TV. Price: 35,990৳46,900৳.

Product: Haier H43P7UX 43 Inch Voice Control HQLED 4K Smart Google TV. Category: Haier. Subcategory: All TV. Price: 38,300৳49,900৳.
",251,971570,971821
4014,recursive,"
Product: Haier H50P7UX 50 Inch Voice Control HQLED 4K Smart Google TV. Category: Haier. Subcategory: All TV. Price: 49,990৳64,900৳.

Product: Haier H55P7UX 55 Inch Voice Control HQLED 4K Smart Google TV. Category: Haier. Subcategory: All TV. Price: 57,684৳75,900৳.
",266,971821,972087
4015,recursive,"
Product: Haier H65P7UX 65 Inch Voice Control HQLED 4K Smart Google TV. Category: Haier. Subcategory: All TV. Price: 76,400৳99,900৳.

Product: Haier H75P7UX 75 Inch Voice Control HQLED 4K Smart Google TV. Category: Haier. Subcategory: All TV. Price: 121,900৳159,900৳.
",268,972087,972355
4016,recursive,"
Product: Haier Candy C32K7G 32"" DLED HD Smart Android TV. Category: Haier. Subcategory: All TV. Price: Out Of Stock.

Product: Haier H32K800X 32 Inch Bezel Less HD Google TV. Category: Haier. Subcategory: All TV. Price: Out Of Stock.
",235,972355,972590
4017,recursive,"
Product: Haier H43K800FX 43 Inch Bezel Less Full HD Google Smart TV. Category: Haier. Subcategory: All TV. Price: Out Of Stock.

Product: Haier H43K800UX 43 Inch Bezel Less 4K Google TV. Category: Haier. Subcategory: All TV. Price: Out Of Stock.
",247,972590,972837
4018,recursive,"
Product: Smart SEL-32B24K 32"" HD Basic LED TV. Category: TV. Price: 13,800৳18,500৳.

Product: Rangs RG32HX 32"" HD LED Android Google TV. Category: TV. Price: 22,705৳23,900৳.

Product: Smart SEL-32S22KS 32"" HD LED Android TV. Category: TV. Price: 25,500৳.
",256,972837,973093
4019,recursive,"
Product: SINGER S32 SLE32E3AGOTV 32 Inch HD Android Google TV. Category: TV. Price: 23,900৳23,990৳.

Product: Samsung 32H5000F 32"" HD LED Smart TV. Category: TV. Price: 23,800৳29,500৳.

Product: Daewoo 32DE54HLB 32 Inch HD Android Google Smart TV. Category: TV. Price: 22,900৳30,900৳.
",286,973093,973379
4020,recursive,"
Product: Samsung 32T4450 32"" HD LED Smart TV. Category: TV. Price: 22,900৳30,900৳.

Product: Rangs RG43HX 43"" HD LED Android Google TV. Category: TV. Price: 34,105৳35,900৳.

Product: LG LQ63 32 Inch HD Smart LED TV. Category: TV. Price: 33,900৳38,900৳.
",254,973379,973633
4021,recursive,"
Product: Hisense 43A4F4 43"" Bezelless Smart Android FHD TV. Category: TV. Price: 31,990৳39,900৳.

Product: ROWA 43S52 43 Inch Full HD Android Smart TV. Category: TV. Price: 30,500৳40,900৳.

Product: Smart SEL-43V24K 43"" Voice Control Android LED Smart TV. Category: TV. Price: 31,900৳41,900৳.
",294,973633,973927
4022,recursive,"
Product: Rangs RG43ZX 43"" 4K Android Google TV. Category: TV. Price: 39,805৳41,900৳.

Product: Samsung 43F6000F 43"" FHD LED Smart TV. Category: TV. Price: 34,900৳41,900৳.

Product: Daewoo 43DM54UAB 43"" 4K Android Google Smart TV. Category: TV. Price: 35,990৳43,900৳.
",268,973927,974195
4023,recursive,"
Product: Hisense 43A6F3 43"" Bezelless Smart Android 4K UHD Google TV. Category: Hisense. Subcategory: All TV. Price: 34,900৳47,900৳.

Product: Hisense 50A6F3 50"" Bezelless Smart Android 4K UHD Google TV. Category: Hisense. Subcategory: All TV. Price: 47,663৳61,900৳.
",268,974195,974463
4024,recursive,"
Product: Hisense 65A6N 65"" 4K UHD Smart Android Google TV. Category: Hisense. Subcategory: All TV. Price: 78,990৳99,900৳.

Product: Hisense 65Q6N 65"" 4K QLED Voice Control Smart Google TV. Category: Hisense. Subcategory: All TV. Price: 101,000৳124,900৳.
",255,974463,974718
4025,recursive,"
Product: Hisense 75A6N 75"" 4K UHD Smart Android Google TV. Category: Hisense. Subcategory: All TV. Price: 124,000৳149,900৳.

Product: Hisense 75Q6N 75"" 4K QLED Voice Control Smart Google TV. Category: Hisense. Subcategory: All TV. Price: 146,000৳179,900৳.
",257,974718,974975
4026,recursive,"
Product: Hisense 85Q6N 85"" 4K QLED Voice Control Smart Google TV. Category: Hisense. Subcategory: All TV. Price: 245,000৳299,900৳.

Product: Hisense 43U6F3 43"" Bezelless Smart Android 4K ULED Google TV. Category: Hisense. Subcategory: All TV. Price: Out Of Stock.
",265,974975,975240
4027,recursive,"
Product: Hisense 55A6F3 55"" Bezelless Smart Android 4K UHD Google TV. Category: Hisense. Subcategory: All TV. Price: Out Of Stock.

Product: Hisense 65A6F3 65"" Bezelless Smart Android 4K UHD Google TV. Category: Hisense. Subcategory: All TV. Price: Out Of Stock.
",264,975240,975504
4028,recursive,"
Product: Hisense 100Q7N 100"" QLED 4K Smart Android Google TV. Category: Hisense. Subcategory: All TV. Price: Out Of Stock.

Product: Hisense 32A4F4 32"" Bezelless Smart Android HD TV. Category: Hisense. Subcategory: All TV. Price: Out Of Stock.
",245,975504,975749
4029,recursive,"
Product: Hisense 75A6F3 75"" Bezelless Smart Android 4K UHD Google TV. Category: Hisense. Subcategory: All TV. Price: Out Of Stock.

Product: SINGER Primax S55-SLE55GU5000TV 55"" 4K Android Google TV. Category: SINGER. Subcategory: All TV. Price: 75,000৳86,900৳.
",262,975749,976011
4030,recursive,"
Product: SINGER Primax S50-SLE50GU5000TV 50"" 4K Android Google TV. Category: SINGER. Subcategory: All TV. Price: 59,000৳68,990৳.

Product: SINGER Primax S43-SLE43GU5000TV 43"" 4K Android Google TV. Category: SINGER. Subcategory: All TV. Price: 42,400৳51,990৳.
",260,976011,976271
4031,recursive,"
Product: SINGER Frameless S43-SLE43G22GOTV 43"" 4K Android Google TV. Category: SINGER. Subcategory: All TV. Price: 41,500৳42,990৳.

Product: SINGER SLE43GP5000TV 43"" FHD Android Google TV. Category: SINGER. Subcategory: All TV. Price: 36,000৳36,990৳.
",252,976271,976523
4032,recursive,"
Product: SINGER Frameless E43-SLE43GA5000TV 43"" FHD Android Google TV. Category: SINGER. Subcategory: All TV. Price: Out Of Stock.

Product: SINGER SLE32GP6100TV 32"" HD Android Google TV. Category: SINGER. Subcategory: All TV. Price: 25,500৳25,990৳.
",251,976523,976774
4033,recursive,"
Product: Xiaomi A Pro 55 Inch QLED 4K UHD Smart Android Google TV (Global Version). Category: XIAOMI. Subcategory: All TV. Price: 67,000৳90,990৳.

Product: Xiaomi A 65 2025 65"" 4K UHD Smart Android Google TV (Global Version). Category: XIAOMI. Subcategory: All TV. Price: 80,000৳109,990৳.
",290,976774,977064
4034,recursive,"
Product: Xiaomi A Pro 65 Inch QLED 4K UHD Smart Android Google TV (Global Version). Category: XIAOMI. Subcategory: All TV. Price: 86,990৳129,990৳.

Product: Xiaomi A Pro 32 Inch HD Smart Android Google TV (Global Version). Category: XIAOMI. Subcategory: All TV. Price: Out Of Stock.
",284,977064,977348
4035,recursive,"
Product: Xiaomi A Pro 43 Inch 4K UHD Smart Android Google TV (Global Version). Category: XIAOMI. Subcategory: All TV. Price: Out Of Stock.

Product: Xiaomi A Pro 43 Inch QLED 4K UHD Smart Android Google TV (Global Version). Category: XIAOMI. Subcategory: All TV. Price: Out Of Stock.
",285,977348,977633
4036,recursive,"
Product: Xiaomi A Pro 55 Inch 4K UHD Smart Android Google TV (Global Version). Category: XIAOMI. Subcategory: All TV. Price: Out Of Stock.

Product: Xiaomi A 55 2025  55"" 4K UHD Smart Android Google TV (Global Version). Category: XIAOMI. Subcategory: All TV. Price: Out Of Stock.
",281,977633,977914
4037,recursive,"
Product: Xiaomi A Pro 65 Inch 4K UHD Smart Android Google TV (Global Version). Category: XIAOMI. Subcategory: All TV. Price: Out Of Stock.

Product: Xiaomi A Pro 75 Inch QLED 4K UHD Smart Android Google TV (Global Version). Category: XIAOMI. Subcategory: All TV. Price: Out Of Stock.
",285,977914,978199
4038,recursive,"
Product: Samsung 50U8000F 50"" Crystal 4K UHD LED Smart TV. Category: Samsung. Subcategory: All TV. Price: 59,990৳79,900৳.

Product: Samsung 43U8000F 43"" 4K UHD LED Smart TV. Category: Samsung. Subcategory: All TV. Price: 43,900৳51,900৳.
",238,978199,978437
4039,recursive,"
Product: Samsung 43U8510F 43"" 4K UHD LED Smart TV. Category: Samsung. Subcategory: All TV. Price: 44,900৳59,900৳.

Product: Samsung 43DU8000 43"" Crystal 4K UHD HDR Smart TV. Category: Samsung. Subcategory: All TV. Price: 57,000৳69,900৳.
",238,978437,978675
4040,recursive,"
Product: Samsung 55DU7700 55 Inch Crystal 4K UHD Smart TV (Unofficial). Category: Samsung. Subcategory: All TV. Price: 68,800৳75,000৳.

Product: Samsung 50DU7700 50 Inch Crystal 4K UHD Smart TV. Category: Samsung. Subcategory: All TV. Price: 59,334৳89,900৳.
",259,978675,978934
4041,recursive,"
Product: Samsung 55AU9000 55 Inch Crystal 4K UHD HDR Smart TV. Category: Samsung. Subcategory: All TV. Price: 88,800৳94,000৳.

Product: Samsung 55U8500F 55"" 4K UHD LED Smart TV. Category: Samsung. Subcategory: All TV. Price: 72,000৳95,900৳.
",242,978934,979176
4042,recursive,"
Product: Samsung 55Q70C 55 Inch QLED 4K UHD Smart TV. Category: Samsung. Subcategory: All TV. Price: 90,900৳97,000৳.

Product: Samsung 65Q65D 65"" QLED 4K UHD Smart TV (Unofficial). Category: Samsung. Subcategory: All TV. Price: 120,000৳130,000৳.
",247,979176,979423
4043,recursive,"
Product: Samsung 65Q70C 65 Inch QLED 4K UHD Smart TV. Category: Samsung. Subcategory: All TV. Price: 125,500৳140,000৳.

Product: Samsung 65Q70D 65"" QLED 4K UHD Smart TV. Category: Samsung. Subcategory: All TV. Price: 135,000৳145,000৳.
",236,979423,979659
4044,recursive,"
Product: Samsung 98DU9000 98"" 4K Smart LED TV. Category: Samsung. Subcategory: All TV. Price: 870,000৳1,199,000৳.

Product: Samsung 75Q7F 75"" QLED 4K UHD Vision AI Smart TV. Category: Samsung. Subcategory: All TV. Price: 195,000৳249,900৳.
",240,979659,979899
4045,recursive,"
Product: Samsung 65S85F 65"" OLED 4K UHD Vision AI Smart TV. Category: Samsung. Subcategory: All TV. Price: 285,000৳359,900৳.

Product: Samsung 55QN85D 55"" Neo QLED UHD 4K Smart TV (Unofficial). Category: Samsung. Subcategory: All TV. Price: 130,000৳145,000৳.
",260,979899,980159
4046,recursive,"
Product: Samsung 65DU7700 65 Inch Crystal 4K UHD Smart TV. Category: Samsung. Subcategory: All TV. Price: 95,936৳149,900৳.

Product: Sony Bravia KD-43X75K 43 Inch 4K Ultra HD Smart Android LED TV (Unofficial). Category: Sony. Subcategory: All TV. Price: 53,800৳57,000৳.
",271,980159,980430
4047,recursive,"
Product: Sony Bravia KD-50X75 50 Inch 4K Ultra HD Smart Android LED TV. Category: Sony. Subcategory: All TV. Price: 66,900৳72,000৳.

Product: Sony Bravia KD-43X75K 43 Inch 4K Ultra HD Smart Android LED TV. Category: Sony. Subcategory: All TV. Price: 59,430৳84,900৳.
",267,980430,980697
4048,recursive,"
Product: Sony Bravia KD-55X75K 55 Inch 4K Ultra HD Smart Android TV (Unofficial). Category: Sony. Subcategory: All TV. Price: 77,500৳82,000৳.

Product: Sony Bravia KD-50X75K 50 Inch 4K Ultra HD Smart TV. Category: Sony. Subcategory: All TV. Price: 70,902৳99,900৳.
",265,980697,980962
4049,recursive,"
Product: Sony Bravia KD-55X77L 55 Inch 4K Ultra HD Smart LED Google TV. Category: Sony. Subcategory: All TV. Price: 93,000৳97,000৳.

Product: Sony Bravia 3 K-55S30 55"" 4K UHD Google Smart TV (Unofficial). Category: Sony. Subcategory: All TV. Price: 107,900৳112,000৳.
",268,980962,981230
4050,recursive,"
Product: Sony Bravia KD-55X75K 55 Inch 4K Ultra HD Smart Android TV. Category: Sony. Subcategory: All TV. Price: 89,530৳127,900৳.

Product: Sony Bravia KD-43X80L 43 Inch 4K Ultra HD Smart TV. Category: Sony. Subcategory: All TV. Price: 83,900৳133,900৳.
",254,981230,981484
4051,recursive,"
Product: Sony Bravia 3 K-43S30 43 Inch 4K UHD Google TV. Category: Sony. Subcategory: All TV. Price: 84,630৳120,900৳.

Product: Sony Bravia 3 K-65S30 65"" 4K UHD Google Smart TV (Unofficial). Category: Sony. Subcategory: All TV. Price: 127,000৳135,000৳.
",254,981484,981738
4052,recursive,"
Product: Sony Bravia XR-55X90L 55 Inch 4K UHD Smart TV (Unofficial). Category: Sony. Subcategory: All TV. Price: 159,900৳167,000৳.

Product: Sony Bravia KD-65X75K 65 Inch 4K Ultra HD Smart LED Android TV. Category: Sony. Subcategory: All TV. Price: 123,469৳173,900৳.
",268,981738,982006
4053,recursive,"
Product: Sony Bravia 3 K-50S30 50 Inch 4K UHD Google TV. Category: Sony. Subcategory: All TV. Price: 101,430৳144,900৳.

Product: Sony Bravia KD-75X77L 75 Inch 4K Ultra HD Smart LED Google TV (Unofficial). Category: Sony. Subcategory: All TV. Price: 190,500৳205,000৳.
",268,982006,982274
4054,recursive,"
Product: Sony Bravia KD-75X80L 75 Inch 4K Ultra HD Smart LED Android TV (Unofficial). Category: Sony. Subcategory: All TV. Price: 207,900৳215,000৳.

Product: Sony Bravia 3 K-55S30 55 Inch 4K UHD Google TV. Category: Sony. Subcategory: All TV. Price: 116,254৳164,900৳.
",269,982274,982543
4055,recursive,"
Product: Sony Bravia 3 K-75S30 75"" 4K UHD Google Smart TV (Unofficial). Category: Sony. Subcategory: All TV. Price: 210,000৳220,000৳.

Product: Sony Bravia XR-65X90L 65-inch 4K Ultra HD Smart TV (Unofficial). Category: Sony. Subcategory: All TV. Price: 219,900৳230,000৳.
",272,982543,982815
4056,recursive,"
Product: Sony Bravia XR 55A80L 55"" 4K Ultra HD OLED Android Smart TV (Unofficial). Category: Sony. Subcategory: All TV. Price: 231,900৳240,000৳.

Product: ROWA 50U62 50 Inch 4K Android Smart Voice Control Google TV. Category: ROWA. Subcategory: All TV. Price: Up Coming.
",272,982815,983087
4057,recursive,"
Product: ROWA 65U62 65 Inch 4K Android Smart Voice Control Google TV. Category: ROWA. Subcategory: All TV. Price: Up Coming.

Product: ROWA 32S52 32 Inch HD Android Smart TV. Category: ROWA. Subcategory: All TV. Price: Out Of Stock.
",234,983087,983321
4058,recursive,"
Product: ROWA 43U62 43 Inch 4K Android Smart Google TV. Category: ROWA. Subcategory: All TV. Price: Out Of Stock.

Product: ROWA 55U62 55 Inch 4K Android Smart Voice Control Google TV. Category: ROWA. Subcategory: All TV. Price: Out Of Stock.
",244,983321,983565
4059,recursive,"
Product: LG UR75 43 Inch 4K UHD Smart LED TV. Category: LG. Subcategory: All TV. Price: 54,900৳59,900৳.

Product: LG UP7550 43 Inch 4K UHD Smart LED TV. Category: LG. Subcategory: All TV. Price: 62,000৳65,500৳.
",212,983565,983777
4060,recursive,"
Product: LG Nano75 43 Inch NanoCell 4K UHD Smart LED TV. Category: LG. Subcategory: All TV. Price: 61,900৳77,900৳.

Product: LG UP7750 50 Inch 4K UHD Smart LED TV. Category: LG. Subcategory: All TV. Price: 78,900৳82,900৳.
",223,983777,984000
4061,recursive,"
Product: LG UR80 50 Inch 4K UHD Smart LED TV. Category: LG. Subcategory: All TV. Price: 76,900৳95,900৳.

Product: LG NANO75 50 Inch NanoCell 4K UHD Smart LED TV. Category: LG. Subcategory: All TV. Price: 74,900৳105,900৳.
",222,984000,984222
4062,recursive,"
Product: LG UR80 55 Inch 4K UHD Smart LED TV. Category: LG. Subcategory: All TV. Price: 89,900৳109,900৳.

Product: LG UR80 65 Inch 4K UHD Smart TV. Category: LG. Subcategory: All TV. Price: 120,000৳125,000৳.
",209,984222,984431
4063,recursive,"
Product: LG Nano75 55 Inch NanoCell 4K UHD Smart LED TV. Category: LG. Subcategory: All TV. Price: 109,900৳132,900৳.

Product: LG UP77 70 Inch 4K UHD Smart LED TV. Category: LG. Subcategory: All TV. Price: 150,000৳160,000৳.
",225,984431,984656
4064,recursive,"
Product: LG QNED86 65 Inch MiniLED 4K UHD Smart TV. Category: LG. Subcategory: All TV. Price: 166,900৳175,000৳.

Product: LG NANO86 65 Inch NanoCell 4K UHD Smart LED TV. Category: LG. Subcategory: All TV. Price: 167,000৳175,900৳.
",231,984656,984887
4065,recursive,"
Product: LG evo C3 55 Inch OLED 4K Smart TV. Category: LG. Subcategory: All TV. Price: 170,000৳190,000৳.

Product: LG NANO81 65 Inch NanoCell 4K UHD Smart LED TV. Category: LG. Subcategory: All TV. Price: 172,900৳182,900৳.
",224,984887,985111
4066,recursive,"
Product: LG evo C4 55"" 4K UHD OLED AI Smart TV (Unofficial). Category: LG. Subcategory: All TV. Price: 173,000৳185,000৳.

Product: LG Nano75 65 Inch NanoCell 4K UHD Smart LED TV. Category: LG. Subcategory: All TV. Price: 159,900৳185,900৳.
",240,985111,985351
4067,recursive,"
Product: LG QNED80 55'' 4K UHD Smart LED TV. Category: LG. Subcategory: All TV. Price: 119,900৳220,900৳.

Product: LG evo C4 55 Inch 4K OLED AI Smart TV. Category: LG. Subcategory: All TV. Price: 210,000৳229,900৳.
",215,985351,985566
4068,recursive,"
Product: LG evo C3 55 Inch 4K OLED Smart TV. Category: LG. Subcategory: All TV. Price: 220,305৳231,900৳.

Product: Daewoo 50DM54UAB 50"" 4K Android Google Smart TV. Category: Daewoo. Subcategory: All TV. Price: 49,900৳59,900৳.
",227,985566,985793
4069,recursive,"
Product: Daewoo 55DM55UQB 55"" 4K QLED Android Google Smart TV. Category: Daewoo. Subcategory: All TV. Price: 67,900৳82,900৳.

Product: Daewoo 65DM55UQB 65"" 4K QLED Android Google Smart TV. Category: Daewoo. Subcategory: All TV. Price: 95,900৳109,900৳.
",253,985793,986046
4070,recursive,"
Product: Daewoo 75DM55UQB 75"" 4K QLED Android Google Smart TV. Category: Daewoo. Subcategory: All TV. Price: 134,900৳152,900৳.

Product: Smart SEL-43G25F 43"" 4K Voice Control Android Google TV. Category: SMART. Subcategory: All TV. Price: 44,000৳56,900৳.
",256,986046,986302
4071,recursive,"
Product: Smart SEL-50G25F 50"" 4K Voice Control Android Google TV. Category: SMART. Subcategory: All TV. Price: 54,000৳68,900৳.

Product: Smart SEL-50V24K 50"" 4K Voice Control Android LED Smart TV. Category: SMART. Subcategory: All TV. Price: 51,900৳69,900৳.
",259,986302,986561
4072,recursive,"
Product: Smart SEL-55G25F 55"" 4K Voice Control Android Google TV. Category: SMART. Subcategory: All TV. Price: 64,000৳81,900৳.

Product: Smart SEL-55V24K 55"" 4K Voice Control Android LED Smart TV. Category: SMART. Subcategory: All TV. Price: 61,900৳82,900৳.
",259,986561,986820
4073,recursive,"
Product: Smart SEL-65S224KKS 65"" 4K Voice Control Android TV. Category: SMART. Subcategory: All TV. Price: 76,000৳104,900৳.

Product: Smart SEL-65G25F 65"" 4K Voice Control Android Google TV. Category: SMART. Subcategory: All TV. Price: 84,000৳109,900৳.
",254,986820,987074
4074,recursive,"
Product: Smart SEL-75G25F 75"" 4K Voice Control Android Google TV. Category: SMART. Subcategory: All TV. Price: 136,000৳182,900৳.

Product: Smart SEL-85G25F 85"" 4K Voice Control Android Google TV. Category: SMART. Subcategory: All TV. Price: 185,000৳265,900৳.
",260,987074,987334
4075,recursive,"
Product: Smart SEL-100G25F 100"" 4K Voice Control Android Google TV. Category: SMART. Subcategory: All TV. Price: 490,000৳669,900৳.

Product: Rangs RG50ZX 50"" 4K Android Google TV. Category: 4K TV. Subcategory: TV. Price: 52,155৳54,900৳.
",238,987334,987572
4076,recursive,"
Product: Rangs RG55QX 55"" 4K QLED Android Google TV. Category: Rangs. Subcategory: All TV. Price: 74,955৳78,900৳.

Product: Rangs RG65ZX 65"" 4K Android Google TV. Category: Rangs. Subcategory: All TV. Price: 80,655৳84,900৳.
",225,987572,987797
4077,recursive,"
Product: Rangs RG75QX 75"" 4K QLED Android Google TV. Category: Rangs. Subcategory: All TV. Price: 131,900৳149,900৳.

Product: Rangs RG86QX 86"" 4K QLED Android Google TV. Category: Rangs. Subcategory: All TV. Price: 274,900৳314,900৳.
",234,987797,988031
4078,recursive,"
Product: Rangs RG100WX 100"" 4K webOS Smart TV. Category: Rangs. Subcategory: All TV. Price: 449,900৳549,900৳.

Product: Rangs RL-65ASS750L 65"" 4K Android Google TV. Category: Rangs. Subcategory: All TV. Price: Out Of Stock.
",225,988031,988256
4079,recursive,"
Product: Beko Crystal 9 OLED 120Hz 65"" 4K Android Google TV. Category: beko. Subcategory: All TV. Price: Up Coming.

Product: Beko Crystal 9 120Hz 75"" 4K Android Google TV. Category: beko. Subcategory: All TV. Price: Up Coming.
",229,988256,988485
4080,recursive,"
Product: TV Wall Mount Bracket For 24-32 Inch Support. Category: TV Stand & Wall Mount. Subcategory: TV. Price: 500৳.

Product: TV Wall Mount Bracket For 40-55 Inch Support. Category: TV Stand & Wall Mount. Subcategory: TV. Price: 800৳1,000৳.
",244,988485,988729
4081,recursive,"
Product: TV Wall Mount Bracket For 55-75 Inch Support. Category: TV Stand & Wall Mount. Subcategory: TV. Price: 1,600৳1,800৳.

Product: TV Wall Mount Bracket For 75-85 Inch Support. Category: TV Stand & Wall Mount. Subcategory: TV. Price: 3,000৳.
",248,988729,988977
4082,recursive,"
Product: TV Wall Mount Bracket For 75-100 Inch Support. Category: TV Stand & Wall Mount. Subcategory: TV. Price: 3,800৳.

Product: Universal TV Stand For 32-70 Inch Television. Category: TV Stand & Wall Mount. Subcategory: TV. Price: 14,500৳15,000৳.
",251,988977,989228
4083,recursive,"
Product: Universal TV Stand For 43-100 Inch Television. Category: TV Stand & Wall Mount. Subcategory: TV. Price: 22,000৳23,000৳.

Product: ZENO T750 Ceiling Mount Kit 3 Feet for 32-80"" Television. Category: TV Stand & Wall Mount. Subcategory: TV. Price: Out Of Stock.
",269,989228,989497
4084,recursive,"
Product: AKASH DTH Full Setup (Basic) with 130+ Live TV Channel and 60+ Full HD Channel. Category: AKASH Digital TV. Subcategory: TV. Price: Out Of Stock.

Product: Midea 1 Ton Portable AC. Category: Midea. Subcategory: AC. Price: 40,000৳47,000৳.
",248,989497,989745
4085,recursive,"
Product: Midea 1 Ton Non-Inverter AC. Category: Midea. Subcategory: AC. Price: 36,472৳47,990৳.

Product: Midea 1 Ton Inverter AC. Category: Midea. Subcategory: AC. Price: 41,433৳55,990৳.

Product: Midea 1.5 Ton Non-Inverter AC. Category: Midea. Subcategory: AC. Price: 47,112৳61,990৳.
",286,989745,990031
4086,recursive,"
Product: Midea 1.5 Ton Inverter AC. Category: Midea. Subcategory: AC. Price: 54,686৳73,900৳.

Product: Midea 2 Ton Non-Inverter AC. Category: Midea. Subcategory: AC. Price: 57,752৳75,990৳.

Product: Midea 2 Ton Inverter AC. Category: Midea. Subcategory: AC. Price: 64,793৳89,990৳.
",282,990031,990313
4087,recursive,"
Product: Hisense 1 Ton Non-Inverter AC. Category: Hisense. Subcategory: AC. Price: 37,990৳49,900৳.

Product: Hisense 1 Ton Inverter AC. Category: Hisense. Subcategory: AC. Price: 43,390৳57,900৳.

Product: Hisense 1.5 Ton Non-Inverter AC. Category: Hisense. Subcategory: AC. Price: 49,500৳63,900৳.
",298,990313,990611
4088,recursive,"
Product: Hisense 2 Ton Non-Inverter AC. Category: Hisense. Subcategory: AC. Price: 59,990৳77,900৳.

Product: Hisense 1.5 Ton Inverter AC. Category: Hisense. Subcategory: AC. Price: 55,900৳79,900৳.
",198,990611,990809
4089,recursive,"
Product: Hisense 1.5 Ton WiFi Full DC Inverter AC. Category: Hisense. Subcategory: AC. Price: 64,701৳81,900৳.

Product: Hisense 2 Ton Inverter AC. Category: Hisense. Subcategory: AC. Price: 69,084৳90,900৳.
",207,990809,991016
4090,recursive,"
Product: Hisense 2 Ton WiFi Full DC Inverter AC. Category: Hisense. Subcategory: AC. Price: 83,000৳99,900৳.

Product: Hisense 2 Ton Cassette Inverter AC. Category: Hisense. Subcategory: AC. Price: 128,000৳139,900৳.
",216,991016,991232
4091,recursive,"
Product: Hisense 3 Ton Cassette Inverter AC. Category: Hisense. Subcategory: AC. Price: 152,000৳167,900৳.

Product: Hisense 4 Ton Cassette Inverter AC. Category: Hisense. Subcategory: AC. Price: 202,000৳223,900৳.
",214,991232,991446
4092,recursive,"
Product: Hisense 5 Ton Cassette Inverter AC. Category: Hisense. Subcategory: AC. Price: 215,000৳239,900৳.

Product: Hisense 1.5 Ton Smart Compact Inverter AC. Category: Hisense. Subcategory: AC. Price: Out Of Stock.
",217,991446,991663
4093,recursive,"
Product: Haier 1 Ton Non-Inverter AC. Category: AC. Subcategory: Appliance. Price: 38,900৳45,990৳.

Product: Xiaomi Viomi A2 1 Ton Non-Inverter AC. Category: AC. Subcategory: Appliance. Price: 37,493৳49,990৳.
",210,991663,991873
4094,recursive,"
Product: Haier 1 Ton AquaCool Non-Inverter AC. Category: AC. Subcategory: Appliance. Price: 39,500৳49,990৳.

Product: Walton 1 Ton Frost Clean Inverter AC. Category: AC. Subcategory: Appliance. Price: 44,500৳51,990৳.
",218,991873,992091
4095,recursive,"
Product: Gree 1 Ton Muse-Split Non-Inverter AC. Category: AC. Subcategory: Appliance. Price: 42,640৳52,000৳.

Product: Gree 1 Ton Cosmo-Split Non-Inverter AC. Category: AC. Subcategory: Appliance. Price: 43,500৳52,000৳.
",221,992091,992312
4096,recursive,"
Product: Gree 1 Ton Portable AC. Category: AC. Subcategory: Appliance. Price: 46,000৳52,500৳.

Product: Smart 1 Ton Non-Inverter AC. Category: AC. Subcategory: Appliance. Price: 41,262৳52,900৳.
",195,992312,992507
4097,recursive,"
Product: KELVINATOR 1 Ton Non Inverter AC. Category: AC. Subcategory: Appliance. Price: 48,668৳52,900৳.

Product: Haier 1 Ton EnergyCool Inverter AC. Category: AC. Subcategory: Appliance. Price: 43,990৳56,990৳.
",212,992507,992719
4098,recursive,"
Product: Haier 1 Ton CleanCool Inverter AC. Category: AC. Subcategory: Appliance. Price: 43,900৳56,990৳.

Product: Walton 1 Ton Inverter AC. Category: AC. Subcategory: Appliance. Price: 46,900৳57,900৳.
",203,992719,992922
4099,recursive,"
Product: Gree 1 Ton Fairy-Split Inverter AC. Category: AC. Subcategory: Appliance. Price: 50,000৳59,290৳.

Product: Gree 1 Ton Lomo Split Inverter AC. Category: AC. Subcategory: Appliance. Price: 49,294৳59,390৳.
",213,992922,993135
4100,recursive,"
Product: Hyundai 1 Ton Inverter AC. Category: AC. Subcategory: Appliance. Price: 52,000৳59,900৳.

Product: Gree 1 Ton Zeno-Split Inverter AC. Category: Gree. Subcategory: AC. Price: 52,000৳61,290৳.
",199,993135,993334
4101,recursive,"
Product: Gree 1 Ton Shimo-Split Inverter AC. Category: Gree. Subcategory: AC. Price: 52,000৳61,290৳.

Product: Gree 1 Ton Cosmo-Split Inverter AC. Category: Gree. Subcategory: AC. Price: 52,500৳61,790৳.
",204,993334,993538
4102,recursive,"
Product: Gree 1.5 Ton Non-Inverter AC. Category: Gree. Subcategory: AC. Price: 55,072৳67,990৳.

Product: Gree 1.5 Ton Cosmo-Split Non-Inverter AC. Category: Gree. Subcategory: AC. Price: 56,000৳67,990৳.

Product: Gree 1.5 Ton Inverter AC. Category: Gree. Subcategory: AC. Price: 65,100৳79,390৳.
",296,993538,993834
4103,recursive,"
Product: Gree 1.5 Ton Fairy-Split Inverter AC. Category: Gree. Subcategory: AC. Price: 65,100৳79,390৳.

Product: Gree 1.5 Ton Zeno-Split Inverter AC. Category: Gree. Subcategory: AC. Price: 67,000৳81,390৳.
",207,993834,994041
4104,recursive,"
Product: Gree 1.5 Ton Shimo-Split Inverter AC. Category: Gree. Subcategory: AC. Price: 67,000৳81,390৳.

Product: Gree 1.5 Ton Cosmo-Split Inverter AC. Category: Gree. Subcategory: AC. Price: 67,500৳81,890৳.
",208,994041,994249
4105,recursive,"
Product: Gree 2 Ton Non-Inverter AC. Category: Gree. Subcategory: AC. Price: 70,000৳83,190৳.

Product: Gree 2 Ton Lomo Split Non-Inverter AC. Category: Gree. Subcategory: AC. Price: 70,000৳83,190৳.
",199,994249,994448
4106,recursive,"
Product: Gree 2 Ton Muse-Split Non-Inverter AC. Category: Gree. Subcategory: AC. Price: 70,000৳83,190৳.

Product: Gree 2 Ton Fairy-Split Non-Inverter AC. Category: Gree. Subcategory: AC. Price: 70,000৳83,190৳.
",211,994448,994659
4107,recursive,"
Product: Gree 2 Ton Cosmo-Split Non-Inverter AC. Category: Gree. Subcategory: AC. Price: 70,500৳83,190৳.

Product: Awei F33 1800mAh Desktop Ultra Slim Fan. Category: Appliance. Price: 930৳1,030৳.

Product: Smart SEK-S18ES 1.8 Liter Electric Kettle. Category: Appliance. Price: 990৳1,290৳.
",290,994659,994949
4108,recursive,"
Product: Baseus Serenity Series Desktop Fan. Category: Appliance. Price: 1,090৳1,299৳.

Product: Vyvylabs D04 Mini Portable Desktop Fan with LED light. Category: Appliance. Price: 1,350৳1,450৳.

Product: Vyvylabs D11 Mini Foldable Desktop Fan. Category: Appliance. Price: 1,350৳1,450৳.
",287,994949,995236
4109,recursive,"
Product: WiWU FS03 2 in 1 Table Clip Fan. Category: Appliance. Price: 1,450৳1,550৳.

Product: Smart SEK-P18ES 1.8 Ltr Electric Kettle. Category: Appliance. Price: 1,390৳1,790৳.

Product: Smart SEK-P20ES 1 Liter Black Electric Kettle. Category: Appliance. Price: 1,190৳1,790৳.
",277,995236,995513
4110,recursive,"
Product: Smart SEK-P23ES 2.3L Electric Kettle. Category: Appliance. Price: 1,490৳1,990৳.

Product: Xundd M321 Portable Charger Fan. Category: Appliance. Price: 1,890৳1,999৳.

Product: XIAOMI SOLOVE F5 Pro Desktop Fan. Category: Appliance. Price: 1,950৳2,099৳.
",261,995513,995774
4111,recursive,"
Product: Walton WRH-PTC007 Mini Room Heater. Category: Appliance. Price: 2,200৳2,290৳.

Product: XIAOMI SOLOVE F5 Desktop Charger Fan. Category: Appliance. Price: 1,750৳2,299৳.

Product: Awei F34 Air Circulation Wide Angle Fan. Category: Appliance. Price: 2,140৳2,340৳.
",271,995774,996045
4112,recursive,"
Product: Walton WRH-FH003 Room Heater. Category: Appliance. Price: 2,270৳2,370৳.

Product: Baseus SUXUN-WF0S Breeze Fan Air Freshener For Vehicles. Category: Appliance. Price: 2,350৳2,900৳.

Product: Walton WRH-PTC0X Mini Room Heater. Category: Appliance. Price: 2,900৳2,990৳.
",278,996045,996323
4113,recursive,"
Product: Xiaomi Solove F5P 4000mAh Desktop Stand Fan. Category: Appliance. Price: 2,490৳2,999৳.

Product: Xundd XDOT-024 Type-C Rechargeable Oscillating Fan. Category: Appliance. Price: 2,800৳3,050৳.
",201,996323,996524
4114,recursive,"
Product: Xiaomi Solove F5 Pro Max 10000mAh Rechargeable Fan. Category: Appliance. Price: 2,850৳3,099৳.

Product: Smart 1 Ton Inverter AC. Category: SMART. Subcategory: AC. Price: 46,546৳62,900৳.

Product: Smart 1.5 Ton Non-Inverter AC. Category: SMART. Subcategory: AC. Price: 52,000৳66,900৳.
",294,996524,996818
4115,recursive,"
Product: Smart 1.5 Ton Inverter AC. Category: SMART. Subcategory: AC. Price: 59,126৳79,900৳.

Product: Smart 2 Ton Non-Inverter AC. Category: SMART. Subcategory: AC. Price: 62,086৳83,900৳.

Product: Smart 2 Ton Inverter AC. Category: SMART. Subcategory: AC. Price: 69,486৳93,900৳.
",282,996818,997100
4116,recursive,"
Product: General 1.5 Ton Constant Speed Non-Inverter AC. Category: General. Subcategory: AC. Price: 114,000৳129,900৳.

Product: General 2 Ton Constant Speed Non-Inverter AC. Category: General. Subcategory: AC. Price: 124,000৳137,900৳.
",236,997100,997336
4117,recursive,"
Product: General 1.5 Ton Coanda Airflow Non-Inverter AC. Category: General. Subcategory: AC. Price: Up Coming.

Product: General 2.5 Ton Non-Inverter AC. Category: General. Subcategory: AC. Price: Up Coming.
",209,997336,997545
4118,recursive,"
Product: General 1 Ton Non-Inverter AC. Category: General. Subcategory: AC. Price: Out Of Stock.

Product: General 1.5 Ton Non-Inverter AC. Category: General. Subcategory: AC. Price: Out Of Stock.

Product: General 1.5 Ton Inverter AC. Category: General. Subcategory: AC. Price: Out Of Stock.
",294,997545,997839
4119,recursive,"
Product: General 2 Ton Inverter AC. Category: General. Subcategory: AC. Price: Out Of Stock.

Product: General 2 Ton Non-Inverter AC. Category: General. Subcategory: AC. Price: Out Of Stock.

Product: General 2.5 Ton Inverter AC. Category: General. Subcategory: AC. Price: Out Of Stock.
",288,997839,998127
4120,recursive,"
Product: Sharp 1 Ton AC. Category: Sharp. Subcategory: AC. Price: 61,977৳84,900৳.

Product: Sharp 1.5 Ton AC. Category: Sharp. Subcategory: AC. Price: 80,568৳111,900৳.

Product: Sharp 2 Ton AC. Category: Sharp. Subcategory: AC. Price: 101,448৳140,900৳.
",254,998127,998381
4121,recursive,"
Product: Haier 1 Ton UVCool WiFi Inverter AC. Category: Haier. Subcategory: AC. Price: 50,000৳59,990৳.

Product: Haier 1.5 Ton Non-Inverter AC. Category: Haier. Subcategory: AC. Price: 48,000৳61,990৳.
",202,998381,998583
4122,recursive,"
Product: Haier 1.5 Ton AquaCool Non-Inverter AC. Category: Haier. Subcategory: AC. Price: 49,000৳63,990৳.

Product: Haier 1.6 Ton CleanCool Inverter AC. Category: Haier. Subcategory: AC. Price: 55,493৳74,990৳.
",211,998583,998794
4123,recursive,"
Product: Haier 1.6 Ton EnergyCool Inverter AC. Category: Haier. Subcategory: AC. Price: 54,990৳74,990৳.

Product: Haier 2 Ton Non-Inverter AC. Category: Haier. Subcategory: AC. Price: 60,000৳75,990৳.
",201,998794,998995
4124,recursive,"
Product: Haier 1.6 Ton UVCool WiFi Inverter AC. Category: Haier. Subcategory: AC. Price: 62,990৳77,990৳.

Product: Haier 2 Ton AquaCool Non-Inverter AC. Category: Haier. Subcategory: AC. Price: 60,000৳77,990৳.
",211,998995,999206
4125,recursive,"
Product: Haier 1.5 Ton Wi-Fi Hot & Cool Inverter AC. Category: Haier. Subcategory: AC. Price: 64,772৳78,990৳.

Product: Haier 1.6 Ton UltimateCool Inverter AC. Category: Haier. Subcategory: AC. Price: 70,461৳80,990৳.
",218,999206,999424
4126,recursive,"
Product: Haier 2 Ton CleanCool Inverter AC. Category: Haier. Subcategory: AC. Price: 70,512৳85,990৳.

Product: Haier 1.5 Ton EnergyCool Inverter AC. Category: Haier. Subcategory: AC. Price: Out Of Stock.
",205,999424,999629
4127,recursive,"
Product: Haier 1.5 Ton CleanCool Inverter AC. Category: Haier. Subcategory: AC. Price: Out Of Stock.

Product: Haier 1.5 Ton WiFi Inverter AC. Category: Haier. Subcategory: AC. Price: Out Of Stock.
",199,999629,999828
4128,recursive,"
Product: Haier 2 Ton EnergyCool Inverter AC. Category: Haier. Subcategory: AC. Price: Out Of Stock.

Product: Samsung 1 Ton Inverter AC. Category: Samsung. Subcategory: AC. Price: Up Coming.

Product: Samsung 1.5 Ton Digital Inverter AC. Category: Samsung. Subcategory: AC. Price: Up Coming.
",293,999828,1000121
4129,recursive,"
Product: Samsung 2 Ton Digital Inverter AC. Category: Samsung. Subcategory: AC. Price: Up Coming.

Product: Samsung 1 Ton Digital Inverter AC. Category: Samsung. Subcategory: AC. Price: Up Coming.

Product: Samsung 2 Ton Inverter AC. Category: Samsung. Subcategory: AC. Price: Up Coming.
",289,1000121,1000410
4130,recursive,"
Product: Samsung 1.5 Ton Inverter AC. Category: Samsung. Subcategory: AC. Price: Up Coming.

Product: Panasonic 1.5 Ton Inverter AC. Category: Panasonic. Subcategory: AC. Price: 115,526৳122,900৳.
",197,1000410,1000607
4131,recursive,"
Product: Panasonic 1.5 Ton WiFi Inverter AC. Category: Panasonic. Subcategory: AC. Price: 119,587৳127,900৳.

Product: Panasonic 2 Ton Inverter AC. Category: Panasonic. Subcategory: AC. Price: 127,481৳134,900৳.
",211,1000607,1000818
4132,recursive,"
Product: Xiaomi Viomi A2 1.5 Ton Non-Inverter AC. Category: Xiaomi. Subcategory: AC. Price: 47,392৳59,990৳.

Product: Xiaomi Viomi A2 2 Ton Non-Inverter AC. Category: Xiaomi. Subcategory: AC. Price: 59,415৳69,900৳.
",216,1000818,1001034
4133,recursive,"
Product: SINGER 1 Ton Inverter AC. Category: SINGER. Subcategory: AC. Price: 55,683৳61,870৳.

Product: SINGER 1.5 Ton Inverter AC. Category: SINGER. Subcategory: AC. Price: 74,565৳82,850৳.

Product: SINGER 1.8 Ton Inverter AC. Category: SINGER. Subcategory: AC. Price: 88,542৳98,380৳.
",286,1001034,1001320
4134,recursive,"
Product: Walton 1.25 Ton Inverter AC. Category: Walton. Subcategory: AC. Price: 49,900৳59,990৳.

Product: Walton 1.5 Ton Frost Clean Inverter AC. Category: Walton. Subcategory: AC. Price: 55,400৳66,990৳.
",205,1001320,1001525
4135,recursive,"
Product: Walton 1.5 Ton Inverter AC. Category: Walton. Subcategory: AC. Price: 62,000৳76,990৳.

Product: Walton 2 Ton Frost Clean Inverter AC. Category: Walton. Subcategory: AC. Price: 66,500৳80,990৳.

Product: Walton 2 Ton Inverter AC. Category: Walton. Subcategory: AC. Price: 75,000৳92,600৳.
",296,1001525,1001821
4136,recursive,"
Product: LG 1.5 Ton Dual Inverter AC. Category: LG. Subcategory: AC. Price: 117,087৳125,900৳.

Product: LG 2 Ton Dual Inverter AC. Category: LG. Subcategory: AC. Price: 135,687৳145,900৳.

Product: ELITE 2 Ton AC. Category: Elite. Subcategory: AC. Price: 57,500৳65,000৳.
",271,1001821,1002092
4137,recursive,"
Product: ELITE 1 Ton AC. Category: Elite. Subcategory: AC. Price: Up Coming.

Product: ELITE 1.5 Ton AC. Category: Elite. Subcategory: AC. Price: Up Coming.

Product: Beko 1.5 Ton Inverter AC. Category: beko. Subcategory: AC. Price: 75,186৳83,540৳.
",250,1002092,1002342
4138,recursive,"
Product: Beko 2 Ton Inverter AC. Category: beko. Subcategory: AC. Price: 89,280৳99,200৳.

Product: Hyundai 1.5 Ton Inverter AC. Category: Hyundai. Subcategory: AC. Price: 57,990৳78,900৳.

Product: Hyundai 2 Ton Inverter AC. Category: Hyundai. Subcategory: AC. Price: 71,990৳94,900৳.
",284,1002342,1002626
4139,recursive,"
Product: LG GT-T5107BM 506 Liters Refrigerator. Category: LG. Subcategory: Fridge. Price: 156,000৳164,900৳.

Product: LG GS-Q6472NS 647L Side By Side In Door Refrigerator. Category: LG. Subcategory: Fridge. Price: 288,000৳303,900৳.
",233,1002626,1002859
4140,recursive,"
Product: Daewoo 1 Ton Inverter AC. Category: Daewoo. Subcategory: AC. Price: 47,900৳67,900৳.

Product: Daewoo 1.5 Ton Inverter AC. Category: Daewoo. Subcategory: AC. Price: 56,900৳82,900৳.

Product: Daewoo 2 Ton Inverter AC. Category: Daewoo. Subcategory: AC. Price: 74,900৳104,900৳.
",285,1002859,1003144
4141,recursive,"
Product: Kelvinator KCCF-168DF 168 Litre Deep Freezer. Category: Fridge. Subcategory: Appliance. Price: 28,500৳33,500৳.

Product: Rangs RCF-175GD 175L Glass Door Deep Freezer. Category: Fridge. Subcategory: Appliance. Price: 33,535৳35,300৳.
",242,1003144,1003386
4142,recursive,"
Product: Rangs RCF-175GD 175L Glass Door Deep Freezer Yellow. Category: Fridge. Subcategory: Appliance. Price: 33,535৳35,300৳.

Product: Rangs RCF-175GD 175L Glass Door Deep Freezer Blue. Category: Fridge. Subcategory: Appliance. Price: 33,535৳35,300৳.
",254,1003386,1003640
4143,recursive,"
Product: SMART SER-150TS 150 Ltr Top Mount Refrigerator. Category: Fridge. Subcategory: Appliance. Price: 27,900৳36,900৳.

Product: Kelvinator KCCF-230DFV 230 Litre Deep Freezer. Category: Fridge. Subcategory: Appliance. Price: 32,900৳38,500৳.
",245,1003640,1003885
4144,recursive,"
Product: Kelvinator KCCF-225DFG 225 Litre Glass Door Deep Freezer White. Category: Fridge. Subcategory: Appliance. Price: 37,905৳39,900৳.

Product: Kelvinator KCCF-225DFG 225 Litre Glass Door Deep Freezer Black. Category: Fridge. Subcategory: Appliance. Price: 37,905৳39,900৳.
",278,1003885,1004163
4145,recursive,"
Product: Kelvinator KCCF-225DFG 225 Litre Glass Door Deep Freezer Dark Gray. Category: Fridge. Subcategory: Appliance. Price: 37,905৳39,900৳.

Product: Haier HCF-175SG 142L Deep Freezer. Category: Fridge. Subcategory: Appliance. Price: 33,500৳40,400৳.
",253,1004163,1004416
4146,recursive,"
Product: Rangs RCF-223GD 223L Glass Door Deep Freezer. Category: Fridge. Subcategory: Appliance. Price: 38,570৳40,600৳.

Product: Rangs RCF-223GD 223L Glass Door Deep Freezer Blue. Category: Fridge. Subcategory: Appliance. Price: 38,570৳40,600৳.
",247,1004416,1004663
4147,recursive,"
Product: Whirlpool Fresh Magic Pro 236L Chromium Steel Refrigerator. Category: Fridge. Subcategory: Appliance. Price: 39,000৳41,490৳.

Product: Hisense RTDG236NASR/BD3 238L Glass Door Refrigerator. Category: Fridge. Subcategory: Appliance. Price: 38,000৳41,900৳.
",264,1004663,1004927
4148,recursive,"
Product: Hisense RTDG236NADP/BD3 238L Glass Door Refrigerator. Category: Fridge. Subcategory: Appliance. Price: 38,000৳41,900৳.

Product: Hisense RTDG236NAAB/BD3 238L Glass Door Refrigerator. Category: Fridge. Subcategory: Appliance. Price: 38,000৳41,900৳.
",258,1004927,1005185
4149,recursive,"
Product: Hisense RTDG236NAMB/BD3 238L Glass Door Refrigerator. Category: Fridge. Subcategory: Appliance. Price: 38,000৳41,900৳.

Product: Hisense RT1G236NAB/BD3 238L Glass Door Refrigerator. Category: Fridge. Subcategory: Appliance. Price: 38,000৳41,900৳.
",257,1005185,1005442
4150,recursive,"
Product: Hisense BD189BLK 189L Deep Freezer. Category: Fridge. Subcategory: Appliance. Price: 38,000৳43,900৳.

Product: Hisense BD189BLU 189L Deep Freezer. Category: Fridge. Subcategory: Appliance. Price: 38,000৳43,900৳.
",222,1005442,1005664
4151,recursive,"
Product: KELVINATOR 1 Ton Inverter AC Golden. Category: Kelvinator. Subcategory: AC. Price: 57,868৳62,900৳.

Product: KELVINATOR 1 Ton Inverter AC. Category: Kelvinator. Subcategory: AC. Price: 59,708৳64,900৳.
",211,1005664,1005875
4152,recursive,"
Product: KELVINATOR 1.5 Ton Non Inverter AC. Category: Kelvinator. Subcategory: AC. Price: 61,548৳66,900৳.

Product: KELVINATOR 1.5 Ton WIFI Inverter AC. Category: Kelvinator. Subcategory: AC. Price: 75,900৳.
",210,1005875,1006085
4153,recursive,"
Product: KELVINATOR 1 Ton Heat & Cool WIFI Inverter AC. Category: Kelvinator. Subcategory: AC. Price: 47,900৳78,900৳.

Product: KELVINATOR 1.5 Ton Inverter AC. Category: Kelvinator. Subcategory: AC. Price: 72,588৳78,900৳.
",223,1006085,1006308
4154,recursive,"
Product: KELVINATOR 1.5 Ton Heat & Cool WIFI Inverter AC. Category: Kelvinator. Subcategory: AC. Price: 79,900৳.

Product: KELVINATOR 2 Ton Non Inverter AC. Category: Kelvinator. Subcategory: AC. Price: 74,428৳80,900৳.
",220,1006308,1006528
4155,recursive,"
Product: KELVINATOR 1.5 Ton Inverter AC Golden. Category: Kelvinator. Subcategory: AC. Price: 64,900৳85,900৳.

Product: KELVINATOR 2 Ton WIFI Inverter AC. Category: Kelvinator. Subcategory: AC. Price: 90,900৳.
",211,1006528,1006739
4156,recursive,"
Product: KELVINATOR 2 Ton Inverter AC Golden. Category: Kelvinator. Subcategory: AC. Price: 85,468৳92,900৳.

Product: KELVINATOR 2 Ton Inverter AC. Category: Kelvinator. Subcategory: AC. Price: 87,308৳94,900৳.
",211,1006739,1006950
4157,recursive,"
Product: KELVINATOR 2 Ton Heat & Cool WIFI Inverter AC. Category: Kelvinator. Subcategory: AC. Price: 95,900৳.

Product: KELVINATOR 1 Ton WIFI Inverter AC. Category: Kelvinator. Subcategory: AC. Price: 46,900৳105,900৳.
",220,1006950,1007170
4158,recursive,"
Product: KELVINATOR 1.5 Ton Split Non Inverter AC. Category: Kelvinator. Subcategory: AC. Price: Up Coming.

Product: KELVINATOR 2 Ton Split Non Inverter AC. Category: Kelvinator. Subcategory: AC. Price: Up Coming.
",216,1007170,1007386
4159,recursive,"
Product: Sharp SJC-118-WH 110 Liters Deep Freezer. Category: Sharp. Subcategory: Fridge. Price: 36,900৳48,900৳.

Product: Sharp SJC-118-GY 110 Liters Deep Freezer. Category: Sharp. Subcategory: Fridge. Price: 36,900৳48,900৳.
",226,1007386,1007612
4160,recursive,"
Product: Sharp SJC-168-WH 160 Liters Deep Freezer. Category: Sharp. Subcategory: Fridge. Price: 49,900৳65,900৳.

Product: Sharp SJC-178-GY 160 Liters Deep Freezer. Category: Sharp. Subcategory: Fridge. Price: 51,900৳68,900৳.
",226,1007612,1007838
4161,recursive,"
Product: Sharp SJC-228-GY 220 Liters Deep Freezer. Category: Sharp. Subcategory: Fridge. Price: 63,900৳84,900৳.

Product: Sharp SJ-EX455P-BR 397 Liters Inverter Refrigerator. Category: Sharp. Subcategory: Fridge. Price: 121,900৳162,500৳.
",239,1007838,1008077
4162,recursive,"
Product: Sharp SJ-EX585P-BK 508 Liters Inverter Refrigerator. Category: Sharp. Subcategory: Fridge. Price: 151,900৳202,500৳.

Product: Sharp SJ-EFD589X-BK 473 Liters 4-Door Inverter Refrigerator. Category: Sharp. Subcategory: Fridge. Price: 152,900৳203,800৳.
",260,1008077,1008337
4163,recursive,"
Product: Sharp SJ-EX655-BK 570 Liters Inverter Refrigerator. Category: Sharp. Subcategory: Fridge. Price: 188,900৳251,900৳.

Product: Sharp SJ-EX735-BK 656 Liters Inverter Refrigerator. Category: Sharp. Subcategory: Fridge. Price: 214,900৳286,500৳.
",250,1008337,1008587
4164,recursive,"
Product: Sharp SJ-EX315E-SL 253 Liters Inverter Refrigerator. Category: Sharp. Subcategory: Fridge. Price: Out Of Stock.

Product: SHARP SJ-ESB631XN 521 Liters 2-Door Inverter Refrigerator. Category: Sharp. Subcategory: Fridge. Price: Out Of Stock.
",250,1008587,1008837
4165,recursive,"
Product: SHARP SJ-ESB691X-DX 599 Liters 2 Door Refrigerator. Category: Sharp. Subcategory: Fridge. Price: Out Of Stock.

Product: Hisense RTDG276NARG/BD3 277L Glass Door Refrigerator. Category: Hisense. Subcategory: Fridge. Price: 39,000৳43,900৳.
",248,1008837,1009085
4166,recursive,"
Product: Hisense RTDG276NAGS/BD3 277L Top Mount Door Refrigerator. Category: Hisense. Subcategory: Fridge. Price: 39,000৳43,900৳.

Product: Hisense RTDG276NAFB/BD3 277L Glass Door Refrigerator. Category: Hisense. Subcategory: Fridge. Price: 39,000৳43,900৳.
",258,1009085,1009343
4167,recursive,"
Product: Hisense RBDG266NARG/BD3 270L Glass Door Refrigerator. Category: Hisense. Subcategory: Fridge. Price: 43,000৳45,900৳.

Product: Hisense RBDG266NAFB/BD3 270L Glass Door Refrigerator. Category: Hisense. Subcategory: Fridge. Price: 43,000৳45,900৳.
",254,1009343,1009597
4168,recursive,"
Product: Hisense RBDG266NAAR/BD3 270L Glass Door Refrigerator. Category: Hisense. Subcategory: Fridge. Price: 43,000৳45,900৳.

Product: Hisense RB1G266NAB/BD3 270L Bottom Mount Inverter Refrigerator. Category: Hisense. Subcategory: Fridge. Price: 43,000৳47,900৳.
",264,1009597,1009861
4169,recursive,"
Product: Hisense BD240 240 L Deep Freezer. Category: Hisense. Subcategory: Fridge. Price: 43,500৳48,900৳.

Product: Hisense RD31DC4SHA 259 L Inverter Refrigerator. Category: Hisense. Subcategory: Fridge. Price: 47,500৳49,900৳.
",228,1009861,1010089
4170,recursive,"
Product: Hisense RT1G276NAB/BD3 277L Top Mount Inverter Refrigerator. Category: Hisense. Subcategory: Fridge. Price: 41,000৳49,900৳.

Product: Hisense RT42W4AK 346 L Refrigerator. Category: Hisense. Subcategory: Fridge. Price: 64,000৳72,900৳.
",244,1010089,1010333
4171,recursive,"
Product: Hisense RS67W4NV 566 L Inverter Refrigerator. Category: Hisense. Subcategory: Fridge. Price: 102,000৳119,900৳.

Product: Hisense RS3G558NAB/BD3 580 L Refrigerator. Category: Hisense. Subcategory: Fridge. Price: 102,000৳119,900৳.
",239,1010333,1010572
4172,recursive,"
Product: Beko BOREF-B5RCNS37HUG 375 Liter Refrigerator. Category: beko. Subcategory: Fridge. Price: Up Coming.

Product: Beko BOREF-B3RGNS46HGBI 466L Refrigerator. Category: beko. Subcategory: Fridge. Price: Up Coming.
",220,1010572,1010792
4173,recursive,"
Product: Beko BOREF-B3RCNS37HXB 375 Liter Refrigerator. Category: beko. Subcategory: Fridge. Price: Up Coming.

Product: Beko BOREF-B5RCNS34HUG 340 Liter Refrigerator. Category: beko. Subcategory: Fridge. Price: Up Coming.
",224,1010792,1011016
4174,recursive,"
Product: Beko BOREF-B3RCNS34HXB 340 Liter Refrigerator. Category: beko. Subcategory: Fridge. Price: Up Coming.

Product: Beko BOREF-B3RGNS46HXPI 466 Liters 4-Door Inverter Refrigerator. Category: beko. Subcategory: Fridge. Price: Up Coming.
",242,1011016,1011258
4175,recursive,"
Product: Beko BOREF-RDNE295DSE 275 Liter Refrigerator. Category: beko. Subcategory: Fridge. Price: Up Coming.

Product: Beko BOREF-RDNE295DWBE-EX 275 Liter Refrigerator. Category: beko. Subcategory: Fridge. Price: Up Coming.
",226,1011258,1011484
4176,recursive,"
Product: Haier HCF-175GE 142L Deep Freezer. Category: Haier. Subcategory: Fridge. Price: 38,000৳43,900৳.

Product: Haier HCF-230SG 200L Deep Freezer. Category: Haier. Subcategory: Fridge. Price: 39,000৳47,400৳.
",212,1011484,1011696
4177,recursive,"
Product: Haier HCF-230GE 200L Deep Freezer. Category: Haier. Subcategory: Fridge. Price: 45,000৳51,400৳.

Product: Haier HCF-290N 251L Deep Freezer. Category: Haier. Subcategory: Fridge. Price: 45,500৳52,400৳.
",211,1011696,1011907
4178,recursive,"
Product: Haier HRF-362TBG 342L Refrigerator. Category: Haier. Subcategory: Fridge. Price: 68,500৳75,900৳.

Product: Haier HRF-386TBG 366L Refrigerator. Category: Haier. Subcategory: Fridge. Price: 70,500৳79,900৳.
",214,1011907,1012121
4179,recursive,"
Product: Haier HRF-395PBG 375L Refrigerator. Category: Haier. Subcategory: Fridge. Price: 76,900৳85,900৳.

Product: Haier HRF-578TBG 522L French T-Door Refrigerator. Category: Haier. Subcategory: Fridge. Price: 132,905৳139,900৳.
",230,1012121,1012351
4180,recursive,"
Product: Haier HRF-622ICG 600L Side-by-Side Refrigerator. Category: Haier. Subcategory: Fridge. Price: 135,999৳144,900৳.

Product: Haier HRF-622IBG 600L Side-by-Side Refrigerator. Category: Haier. Subcategory: Fridge. Price: 136,999৳145,900৳.
",244,1012351,1012595
4181,recursive,"
Product: Haier HRF-680BG 630L Side-by-Side Refrigerator. Category: Haier. Subcategory: Fridge. Price: 140,000৳155,900৳.

Product: Haier HRF-680MG 630L Side-by-Side Refrigerator. Category: Haier. Subcategory: Fridge. Price: 134,900৳155,900৳.
",242,1012595,1012837
4182,recursive,"
Product: Haier HRF-266EPMC 246L Refrigerator. Category: Haier. Subcategory: Fridge. Price: Up Coming.

Product: Haier HRF-234EPPW 214L Refrigerator. Category: Haier. Subcategory: Fridge. Price: Up Coming.
",206,1012837,1013043
4183,recursive,"
Product: Haier HRF-234EPDA 214L Refrigerator. Category: Haier. Subcategory: Fridge. Price: Up Coming.

Product: Haier HRF-200EPMB 180L Refrigerator. Category: Haier. Subcategory: Fridge. Price: Up Coming.
",206,1013043,1013249
4184,recursive,"
Product: Haier HRF-200EPGL 180L Refrigerator. Category: Haier. Subcategory: Fridge. Price: Up Coming.

Product: Haier HCF-175 146L Deep Freezer. Category: Haier. Subcategory: Fridge. Price: Out Of Stock.
",205,1013249,1013454
4185,recursive,"
Product: Haier HCF-230 203L Deep Freezer. Category: Haier. Subcategory: Fridge. Price: Out Of Stock.

Product: Rangs RCF-275GD 275L Glass Door Deep Freezer Blue. Category: Rangs. Subcategory: Fridge. Price: 43,985৳46,300৳.
",224,1013454,1013678
4186,recursive,"
Product: Rangs RCF-275GD 275L Glass Door Deep Freezer. Category: Rangs. Subcategory: Fridge. Price: 43,985৳46,300৳.

Product: Rangs RCF-335DFV 335L Deep Freezer. Category: Rangs. Subcategory: Fridge. Price: 46,170৳48,600৳.
",224,1013678,1013902
4187,recursive,"
Product: Whirlpool Fresh Magic Pro 236L GD Florina Red Refrigerator. Category: Whirlpool. Subcategory: Fridge. Price: 35,000৳44,990৳.

Product: Whirlpool Fresh Magic Pro 236L GD Florina Blue Refrigerator. Category: Whirlpool. Subcategory: Fridge. Price: 35,000৳44,990৳.
",271,1013902,1014173
4188,recursive,"
Product: Whirlpool Fresh Magic Pro 236L Crystal Black Refrigerator. Category: Whirlpool. Subcategory: Fridge. Price: 42,000৳45,490৳.

Product: Whirlpool Fresh Magic Pro 257L GD Florina Red Refrigerator. Category: Whirlpool. Subcategory: Fridge. Price: 37,000৳47,490৳.
",269,1014173,1014442
4189,recursive,"
Product: Whirlpool Fresh Magic Pro 257L GD Florina Purple Refrigerator. Category: Whirlpool. Subcategory: Fridge. Price: 37,000৳47,490৳.

Product: Whirlpool Fresh Magic Pro 257L Crystal Black Refrigerator. Category: Whirlpool. Subcategory: Fridge. Price: 45,000৳47,990৳.
",272,1014442,1014714
4190,recursive,"
Product: Whirlpool Fresh Magic Pro 236L GD Inv Mirror Refrigerator. Category: Whirlpool. Subcategory: Fridge. Price: 47,000৳48,690৳.

Product: Whirlpool Fresh Magic Pro 278L GD Florina Red Refrigerator. Category: Whirlpool. Subcategory: Fridge. Price: 38,500৳49,490৳.
",269,1014714,1014983
4191,recursive,"
Product: Whirlpool Fresh Magic Pro 278L GD Florina Blue Refrigerator. Category: Whirlpool. Subcategory: Fridge. Price: 38,500৳49,490৳.

Product: Whirlpool Fresh Magic Pro 278L Crystal Black Refrigerator. Category: Whirlpool. Subcategory: Fridge. Price: 46,900৳49,690৳.
",270,1014983,1015253
4192,recursive,"
Product: Whirlpool Fresh Magic Pro 278L GD Inv Mirror Refrigerator. Category: Whirlpool. Subcategory: Fridge. Price: 49,500৳52,990৳.

Product: Whirlpool Neo Fresh Inverter 257L Crystal Black Refrigerator. Category: Whirlpool. Subcategory: Fridge. Price: 57,000৳59,890৳.
",271,1015253,1015524
4193,recursive,"
Product: Whirlpool Intellifresh Inverter 278L Steel Onyx Refrigerator. Category: Whirlpool. Subcategory: Fridge. Price: 58,000৳61,990৳.

Product: Whirlpool Neo Inv 278GD PRM Crystal Black BD Refrigerator. Category: Whirlpool. Subcategory: Fridge. Price: 60,500৳64,890৳.
",271,1015524,1015795
4194,recursive,"
Product: Kelvinator KRF-230T0G1AX 230 Liter Top Mount Refrigerator. Category: Kelvinator. Subcategory: Fridge. Price: 45,490৳.

Product: Kelvinator KRF-268T0G1AX 268 Liter Top Mount Refrigerator. Category: Kelvinator. Subcategory: Fridge. Price: 48,900৳.
",256,1015795,1016051
4195,recursive,"
Product: Kelvinator KHV-333FF 333L Refrigerator. Category: Kelvinator. Subcategory: Fridge. Price: 49,350৳.

Product: Kelvinator KRF-265B0G1AX 265 Litre Glass Door Refrigerator. Category: Kelvinator. Subcategory: Fridge. Price: 49,490৳.
",238,1016051,1016289
4196,recursive,"
Product: Kelvinator KHV-365FF 365 Litre Defrost Refrigerator. Category: Kelvinator. Subcategory: Fridge. Price: 50,600৳.

Product: Kelvinator KHV-279GDF 279L Glass Door Refrigerator. Category: Kelvinator. Subcategory: Fridge. Price: 39,900৳58,000৳.
",250,1016289,1016539
4197,recursive,"
Product: Kelvinator KHV-590NFSBS2DBG 590 Liters Inverter Refrigerator. Category: Kelvinator. Subcategory: Fridge. Price: 104,405৳109,900৳.

Product: Kelvinator KRS-537SBX 537 Liter Inverter Double Door Refrigerator. Category: Kelvinator. Subcategory: Fridge. Price: 120,000৳141,500৳.
",285,1016539,1016824
4198,recursive,"
Product: Kelvinator KRS-537SGX 537 Liter Inverter Double Door Refrigerator. Category: Kelvinator. Subcategory: Fridge. Price: 120,000৳141,500৳.
",145,1016824,1016969
4199,recursive,"
Product: Kelvinator KRS-537SBW 537 Liter Inverter Double Door Refrigerator with Water Dispenser. Category: Kelvinator. Subcategory: Fridge. Price: 124,500৳146,500৳.
",166,1016969,1017135
4200,recursive,"
Product: Kelvinator KRS-537SGW 537 Liter Inverter Double Door Refrigerator with Water Dispenser. Category: Kelvinator. Subcategory: Fridge. Price: 124,500৳146,500৳.
",166,1017135,1017301
4201,recursive,"
Product: Kelvinator KRS-663TBX 663 Liter Twin Eco-Inverter Double Door Refrigerator. Category: Kelvinator. Subcategory: Fridge. Price: 158,900৳.

Product: Hisense WTJA8012US/BD3 8KG Top Load Washing Machine. Category: Hisense. Subcategory: Washing Machine. Price: 26,990৳31,900৳.
",281,1017301,1017582
4202,recursive,"
Product: Hisense WTJA8012UT/BD3 8KG Top Load Washing Machine. Category: Hisense. Subcategory: Washing Machine. Price: 27,490৳33,900৳.

Product: Hisense WT5J1013DT 10.5 kg Top Load Washing Machine. Category: Hisense. Subcategory: Washing Machine. Price: 36,990৳43,900৳.
",270,1017582,1017852
4203,recursive,"
Product: Hisense WT5J9513DS/BD3 9.5 kg Top Load Washing Machine. Category: Hisense. Subcategory: Washing Machine. Price: 36,700৳41,900৳.

Product: Hisense WTJA801T 8 kg Top Load Washing Machine. Category: Hisense. Subcategory: Washing Machine. Price: Out Of Stock.
",266,1017852,1018118
4204,recursive,"
Product: Hisense WF3S9043BT 9KG Front Load Washing Machine. Category: Hisense. Subcategory: Washing Machine. Price: Out Of Stock.

Product: Hisense WT5J9513DT/BD3 9.5 kg Top Load Washing Machine. Category: Hisense. Subcategory: Washing Machine. Price: Out Of Stock.
",267,1018118,1018385
4205,recursive,"
Product: Hisense WF3S8043BW 8kg Inverter Front Load Washing Machine. Category: Hisense. Subcategory: Washing Machine. Price: Out Of Stock.

Product: Hisense WF3S1043BT 10.5 kg Front Load Washing Machine. Category: Hisense. Subcategory: Washing Machine. Price: Out Of Stock.
",275,1018385,1018660
4206,recursive,"
Product: SMART SER-196BS 196 Ltr Glass Door Refrigerator. Category: Smart. Subcategory: Fridge. Price: 34,900৳46,900৳.

Product: SMART SER-217TS 217 Ltr Top Mount Refrigerator. Category: Smart. Subcategory: Fridge. Price: 35,900৳47,900৳.
",239,1018660,1018899
4207,recursive,"
Product: SMART SER-240TS 240 Ltr Top Mount Refrigerator. Category: Smart. Subcategory: Fridge. Price: 37,900৳50,900৳.

Product: SMART SER-238BS 238 Ltr Bottom Mount Refrigerator. Category: Smart. Subcategory: Fridge. Price: 37,900৳50,900৳.
",241,1018899,1019140
4208,recursive,"
Product: SMART SER-250CS 250 Ltr Glass Door Deep Freezer. Category: Smart. Subcategory: Fridge. Price: 37,900৳50,900৳.

Product: SMART SER-305TS 305 Ltr Top Mount Refrigerator. Category: Smart. Subcategory: Fridge. Price: 44,900৳59,900৳.
",239,1019140,1019379
4209,recursive,"
Product: SMART SER-330BS 330 Liter Refrigerator. Category: Smart. Subcategory: Fridge. Price: 48,900৳64,900৳.

Product: SMART SER-356TS 356 Liter Refrigerator. Category: Smart. Subcategory: Fridge. Price: 49,900৳66,900৳.
",222,1019379,1019601
4210,recursive,"
Product: SMART SER-150CS 150 Ltr Glass Door Deep Freezer. Category: Smart. Subcategory: Fridge. Price: Up Coming.

Product: SMART SER-216BS 216 Ltr Bottom Mount Refrigerator. Category: Smart. Subcategory: Fridge. Price: Up Coming.
",232,1019601,1019833
4211,recursive,"
Product: Singer S300ATL70ISMJG1 7KG Top Loading Washing Machine. Category: Singer. Subcategory: Washing Machine. Price: 31,490৳33,490৳.

Product: Singer SRWM-S300ATL90ISMJG1 9 KG Top Loading Washing Machine. Category: Singer. Subcategory: Washing Machine. Price: 35,990৳38,990৳.
",280,1019833,1020113
4212,recursive,"
Product: Singer S300ATL100ISMJG1 10 KG Top Load Washing Machine. Category: Singer. Subcategory: Washing Machine. Price: 43,900৳44,990৳.

Product: Whirlpool SW Royal Plus 7.5 KG Top Load Washing Machine. Category: Whirlpool. Subcategory: Washing Machine. Price: 39,000৳40,490৳.
",278,1020113,1020391
4213,recursive,"
Product: Whirlpool SW PRO 8.0 KG Top Load Washing Machine. Category: Whirlpool. Subcategory: Washing Machine. Price: 40,000৳41,990৳.

Product: Whirlpool PRO H 9.5 KG Top Load Washing Machine. Category: Whirlpool. Subcategory: Washing Machine. Price: 41,990৳50,490৳.
",267,1020391,1020658
4214,recursive,"
Product: Whirlpool WFC90604RT-D 9 KG Front Load Washing Machine. Category: Whirlpool. Subcategory: Washing Machine. Price: 57,690৳67,990৳.

Product: Whirlpool WFC105604RT-D 10.5 KG Front Load Washing Machine. Category: Whirlpool. Subcategory: Washing Machine. Price: 58,990৳73,990৳.
",284,1020658,1020942
4215,recursive,"
Product: Walton WWM-ATP70 7 KG Top Load Fully Automatic Washing Machine. Category: Walton. Subcategory: Washing Machine. Price: 20,900৳23,900৳.

Product: Beko BOWM-WTL80IH12PB 8 KG Top Loading Washing Machine. Category: beko. Subcategory: Washing Machine. Price: 37,990৳41,990৳.
",280,1020942,1021222
4216,recursive,"
Product: Beko BOWM-WCV8636XB0M 8 KG Front Loading Washing Machine. Category: beko. Subcategory: Washing Machine. Price: 57,990৳67,990৳.

Product: Beko BOWM-WCV9736XB0M 9 KG Front Loading Washing Machine. Category: beko. Subcategory: Washing Machine. Price: 60,990৳70,990৳.
",274,1021222,1021496
4217,recursive,"
Product: Beko BOWM-WCV10746XC0M 10 KG Front Loading Washing Machine. Category: beko. Subcategory: Washing Machine. Price: 66,990৳76,990৳.

Product: Sharp ES-X858 8.0 KG Full Auto Washing Machine. Category: Sharp. Subcategory: Washing Machine. Price: 41,690৳58,500৳.
",267,1021496,1021763
4218,recursive,"
Product: Sharp ES-W80EW-H 8 KG Full Auto Washing Machine. Category: Sharp. Subcategory: Washing Machine. Price: 47,900৳63,900৳.

Product: Sharp ES-W85TWXT-SA 8.5 KG Full Auto J-Tech Inverter Washing Machine. Category: Sharp. Subcategory: Washing Machine. Price: 52,900৳70,500৳.
",279,1021763,1022042
4219,recursive,"
Product: Sharp ES-F120G 12 KG Full Auto Inverter Washing Machine. Category: Sharp. Subcategory: Washing Machine. Price: 61,900৳82,500৳.

Product: Sharp ES-FW85SG 8.5 KG  Full Auto Front Loading Inverter Washing Machine. Category: Sharp. Subcategory: Washing Machine. Price: 76,900৳106,900৳.
",292,1022042,1022334
4220,recursive,"
Product: Sharp ES-718X 7.0 KG Full Auto Washing Machine. Category: Sharp. Subcategory: Washing Machine. Price: Out Of Stock.

Product: Sharp ES-W95TWXT-SA 9.5 KG Full Auto J-Tech Inverter Washing Machine. Category: Sharp. Subcategory: Washing Machine. Price: Out Of Stock.
",274,1022334,1022608
4221,recursive,"
Product: Haier HWM70-1269S5 7 KG Top Load Fully Automatic Washing Machine. Category: Washing Machine. Subcategory: Appliance. Price: 23,990৳29,900৳.

Product: Haier HWM80-316S6 8 KG Top Load Washing Machine. Category: Washing Machine. Subcategory: Appliance. Price: 28,990৳34,900৳.
",283,1022608,1022891
4222,recursive,"
Product: Haier HWM90-316S6 9 KG Top Load Washing Machine. Category: Washing Machine. Subcategory: Appliance. Price: 32,590৳39,400৳.

Product: Haier HWM100-316S6 10 KG Top Load Washing Machine. Category: Washing Machine. Subcategory: Appliance. Price: 36,690৳43,900৳.
",268,1022891,1023159
4223,recursive,"
Product: Haier HWM120-316S6 12 KG Top Load Washing Machine. Category: Washing Machine. Subcategory: Appliance. Price: 41,990৳49,900৳.

Product: Haier HW80-BP12929S6 8 KG Front Load Washing Machine. Category: Washing Machine. Subcategory: Appliance. Price: 52,990৳62,900৳.
",273,1023159,1023432
4224,recursive,"
Product: Haier HW90-BP14959S8 9 KG Front Load Washing Machine. Category: Washing Machine. Subcategory: Appliance. Price: 57,690৳68,900৳.

Product: LG T2108VSAB 8KG Top Load Inverter Washing Machine. Category: LG. Subcategory: Washing Machine. Price: 51,990৳56,900৳.
",267,1023432,1023699
4225,recursive,"
Product: LG T2310VSAB 10KG Top Load Inverter Washing Machine. Category: LG. Subcategory: Washing Machine. Price: 63,690৳68,900৳.

Product: LG FB1209S6M 9.0KG Front Load Inverter Washing Machine. Category: LG. Subcategory: Washing Machine. Price: 91,000৳95,900৳.
",263,1023699,1023962
4226,recursive,"
Product: LG FV1411S2B 11KG Front Load Inverter Washing Machine. Category: LG. Subcategory: Washing Machine. Price: 109,590৳121,900৳.

Product: LG FV1410H3BA 10KG Front Load Inverter Washing Machine. Category: LG. Subcategory: Washing Machine. Price: 124,000৳130,900৳.
",269,1023962,1024231
4227,recursive,"
Product: Haier HW105-B14959S8U1 10.5 KG AI Front Load Washing Machine. Category: Haier. Subcategory: Washing Machine. Price: 69,900৳79,900৳.

Product: Haier HW120-BP14959S8 12 KG Front Load Washing Machine. Category: Haier. Subcategory: Washing Machine. Price: 74,900৳84,900৳.
",278,1024231,1024509
4228,recursive,"
Product: Haier HWD105-B14959S8U1 10.5 KG AI Front Load Washing Machine. Category: Haier. Subcategory: Washing Machine. Price: 84,999৳98,900৳.

Product: Samsung WW90TA047AX 9KG Inverter Front Loading Washing Machine. Category: Samsung. Subcategory: Washing Machine. Price: Up Coming.
",284,1024509,1024793
4229,recursive,"
Product: Samsung WA75H4200SY 7.5KG Top Load Fully Automatic Washing Machine. Category: Samsung. Subcategory: Washing Machine. Price: Out Of Stock.

Product: Samsung WA90T5260BY 9KG Top Load Fully Automatic Washing Machine. Category: Samsung. Subcategory: Washing Machine. Price: Out Of Stock.
",294,1024793,1025087
4230,recursive,"
Product: Samsung WW80T534DAX 8KG Front Load Inverter Washing Machine. Category: Samsung. Subcategory: Washing Machine. Price: Out Of Stock.

Product: Havells Enticer 56"" Ceiling Fan. Category: Ceiling Fan. Subcategory: Fan. Price: 8,300৳10,500৳.
",247,1025087,1025334
4231,recursive,"
Product: Havells ENTICER WOOD 56"" Ceiling Fan. Category: Ceiling Fan. Subcategory: Fan. Price: 8,500৳11,500৳.

Product: Havells Enticer Hues 56"" Ceiling Fan. Category: Ceiling Fan. Subcategory: Fan. Price: 8,500৳11,500৳.
",222,1025334,1025556
4232,recursive,"
Product: Usha Bloom Daffodil 50"" Decorative Ceiling Fan. Category: Ceiling Fan. Subcategory: Fan. Price: 6,999৳11,550৳.

Product: Havells Crew Deco 56'' Ceiling Fan. Category: Ceiling Fan. Subcategory: Fan. Price: 7,200৳12,000৳.
",230,1025556,1025786
4233,recursive,"
Product: Hindware Magnum 56"" Ceiling Fan. Category: Ceiling Fan. Subcategory: Fan. Price: 6,300৳12,000৳.

Product: Atomberg Studio+ 48"" Ceiling Fan With Remote. Category: Ceiling Fan. Subcategory: Fan. Price: 10,000৳12,500৳.
",226,1025786,1026012
4234,recursive,"
Product: Atomberg Renesa+ 56"" Ceiling Fan With Remote. Category: Ceiling Fan. Subcategory: Fan. Price: 10,000৳12,500৳.

Product: Hindware Magnum Art 56"" Ceiling Fan. Category: Ceiling Fan. Subcategory: Fan. Price: 6,500৳12,500৳.
",230,1026012,1026242
4235,recursive,"
Product: Hindware Eleganza 48"" Ceiling Fan. Category: Ceiling Fan. Subcategory: Fan. Price: 7,499৳13,500৳.

Product: Orient AeroQuite 48"" Ceiling Fan. Category: Ceiling Fan. Subcategory: Fan. Price: 15,500৳17,500৳.
",216,1026242,1026458
4236,recursive,"
Product: Atomberg Studio Smart+ 48"" Ceiling Fan With Remote. Category: Ceiling Fan. Subcategory: Fan. Price: 12,000৳19,000৳.

Product: Havells YORKER 53"" Ceiling Fan. Category: Ceiling Fan. Subcategory: Fan. Price: 16,499৳20,800৳.
",232,1026458,1026690
4237,recursive,"
Product: Orient AeroStorm 53"" Ceiling Fan. Category: Ceiling Fan. Subcategory: Fan. Price: 15,999৳22,400৳.

Product: Hindware Royal 48"" Ceiling Fan. Category: Ceiling Fan. Subcategory: Fan. Price: 10,900৳22,750৳.
",214,1026690,1026904
4238,recursive,"
Product: Atomberg Aris 48"" Ceiling Fan With Remote. Category: Ceiling Fan. Subcategory: Fan. Price: 17,500৳22,800৳.

Product: Atomberg Aris Starlight 48"" Ceiling Fan With Light and Remote. Category: Ceiling Fan. Subcategory: Fan. Price: 18,500৳23,800৳.
",254,1026904,1027158
4239,recursive,"
Product: Havells Elio Prime UL 56"" Ceiling Fan With Remote. Category: Ceiling Fan. Subcategory: Fan. Price: 17,499৳24,499৳.

Product: Havells Inox UL 48"" Ceiling Fan With Light and Remote. Category: Ceiling Fan. Subcategory: Fan. Price: 21,499৳25,499৳.
",254,1027158,1027412
4240,recursive,"
Product: Luminous Jaipur Mahal 52"" Decorative Engergy Saving Ceiling Fan. Category: Ceiling Fan. Subcategory: Fan. Price: 14,500৳25,900৳.

Product: Baseus Refreshing Monitor Clip On and Stand-Up Bladeless Air Desk Fan. Category: Fan. Subcategory: Appliance. Price: 2,890৳3,348৳.
",280,1027412,1027692
4241,recursive,"
Product: WIWU FS05 Carter Circulating Foldable Rechargeable Table Fan. Category: Fan. Subcategory: Appliance. Price: 3,190৳3,490৳.

Product: Arctic Summair Plus Portable Rechargeable Fan. Category: Fan. Subcategory: Appliance. Price: 3,400৳3,699৳.
",249,1027692,1027941
4242,recursive,"
Product: Remax F21 Water Cooling Oscillating Fan with Display. Category: Fan. Subcategory: Appliance. Price: 3,500৳3,790৳.

Product: SMART SEH-RT12 12” LED Rechargeable Table Fan. Category: Fan. Subcategory: Appliance. Price: 3,900৳5,190৳.
",241,1027941,1028182
4243,recursive,"
Product: Xiaomi Mi Smart Standing Fan 1C Lite. Category: Fan. Subcategory: Appliance. Price: 5,690৳6,199৳.

Product: Orient Super Deluxe Supreme 16"" Table Fan. Category: Fan. Subcategory: Appliance. Price: 4,999৳6,500৳.
",221,1028182,1028403
4244,recursive,"
Product: SMART SEH-RS86 16” LED Rechargeable Table Fan. Category: Charger Fan. Subcategory: Fan. Price: 5,900৳7,900৳.

Product: Awei F23 Rechargeable Desk Fan. Category: Charger Fan. Subcategory: Fan. Price: Up Coming.
",220,1028403,1028623
4245,recursive,"
Product: ZOJE ZJ9513 Direct Drive Industrial Sewing Machine. Category: ZOJE. Subcategory: Sewing Machine. Price: 33,455৳34,490৳.

Product: ZOJE A6000R Industrial Sewing Machine. Category: ZOJE. Subcategory: Sewing Machine. Price: 34,425৳35,490৳.
",247,1028623,1028870
4246,recursive,"
Product: ZOJE A6000-D-G Industrial Sewing Machine. Category: ZOJE. Subcategory: Sewing Machine. Price: 38,870৳40,490৳.

Product: ZOJE B9000-13 Industrial Sewing Machine. Category: ZOJE. Subcategory: Sewing Machine. Price: 46,541৳48,990৳.
",239,1028870,1029109
4247,recursive,"
Product: Vision Evaporative Super Cool 35L Air Cooler. Category: Air Cooler. Subcategory: Appliance. Price: 13,000৳13,400৳.

Product: Vision Evaporative Super Cool 45L Air Cooler. Category: Air Cooler. Subcategory: Appliance. Price: 14,000৳14,400৳.
",250,1029109,1029359
4248,recursive,"
Product: Gree KSWK-04S66RDG Hot & Cool Portable Air Cooler. Category: Air Cooler. Subcategory: Appliance. Price: 14,000৳14,490৳.

Product: Gree KSWK06S61DG 3-in-1 Tower Portable Air Cooler. Category: Air Cooler. Subcategory: Appliance. Price: 15,500৳15,990৳.
",260,1029359,1029619
4249,recursive,"
Product: Gree KSWK-2001DGL 20L Portable Air Cooler. Category: Air Cooler. Subcategory: Appliance. Price: 17,500৳17,990৳.

Product: Gree KSWK-4001DGL 40L Air Cooler. Category: Air Cooler. Subcategory: Appliance. Price: 19,500৳19,990৳.
",235,1029619,1029854
4250,recursive,"
Product: Gree KSWK-6001DGL 60L Air Cooler. Category: Air Cooler. Subcategory: Appliance. Price: 21,000৳21,990৳.

Product: Pakhtun PK-127 16"" High Speed Ceiling Mount Fan. Category: Stand Fan. Subcategory: Fan. Price: 6,500৳7,500৳.
",232,1029854,1030086
4251,recursive,"
Product: Pakhtun Zefiro 18"" High Speed Stand Fan. Category: Stand Fan. Subcategory: Fan. Price: 8,500৳11,500৳.

Product: Gree FXDZ-2305BG5 Remote Control Turbo Speed Stand Fan. Category: Stand Fan. Subcategory: Fan. Price: 12,000৳12,500৳.
",240,1030086,1030326
4252,recursive,"
Product: Pakhtun Zefiro 20"" High Speed Stand Fan. Category: Stand Fan. Subcategory: Fan. Price: 9,500৳12,500৳.

Product: Pakhtun Zefiro 18"" Stand Fan With Remote. Category: Stand Fan. Subcategory: Fan. Price: 9,500৳12,500৳.
",225,1030326,1030551
4253,recursive,"
Product: Pakhtun Tezra 18"" High Speed Stand Fan. Category: Stand Fan. Subcategory: Fan. Price: 8,000৳12,500৳.

Product: Pakhtun Tezra 18"" High Speed Stand Fan With Remote Control. Category: Stand Fan. Subcategory: Fan. Price: 9,000৳12,500৳.
",242,1030551,1030793
4254,recursive,"
Product: Orient Floor Supreme 16"" Stand Fan. Category: Stand Fan. Subcategory: Fan. Price: Out Of Stock.

Product: Orient Stand 38 18"" Stand Fan. Category: Stand Fan. Subcategory: Fan. Price: Out Of Stock.
",207,1030793,1031000
4255,recursive,"
Product: Orient Stand 39 16"" Stand Fan. Category: Stand Fan. Subcategory: Fan. Price: Out Of Stock.

Product: Orient Tornado Pedestal 18"" Stand Fan. Category: Stand Fan. Subcategory: Fan. Price: Out Of Stock.
",210,1031000,1031210
4256,recursive,"
Product: Pakhtun Zefiro 20"" Stand Fan With Remote. Category: Stand Fan. Subcategory: Fan. Price: Out Of Stock.

Product: Jack F5 Single Needle Direct Drive Lockstitch Industrial Sewing Machine. Category: JACK. Subcategory: Sewing Machine. Price: 31,500৳35,000৳.
",263,1031210,1031473
4257,recursive,"
Product: Jack A2B-C Auto Trimmer Direct Drive Single Needle Lock Sewing Machine. Category: JACK. Subcategory: Sewing Machine. Price: 36,800৳40,000৳.
",150,1031473,1031623
4258,recursive,"
Product: Jack A4B-A-C Computerized Lockstitch Sewing Machine With Auto Foot Lifter. Category: JACK. Subcategory: Sewing Machine. Price: 47,000৳50,000৳.

Product: Jack E4S-M03/333 Direct Drive 4 Thread Overlock Machine. Category: JACK. Subcategory: Sewing Machine. Price: 47,500৳50,000৳.
",288,1031623,1031911
4259,recursive,"
Product: SINGER PK-SM-15CH1-WT-ST-NEW Sewing Machine Without Cover. Category: SINGER. Subcategory: Sewing Machine. Price: 12,000৳12,910৳.

Product: SINGER PK-SM-15CH1-WT-ST-NEW Sewing Machine With Cover. Category: SINGER. Subcategory: Sewing Machine. Price: 12,700৳13,660৳.
",275,1031911,1032186
4260,recursive,"
Product: SINGER SRSM-SM1412 Electric Sewing Machine. Category: SINGER. Subcategory: Sewing Machine. Price: 14,990৳15,990৳.

Product: SINGER SRSM-SM024 Electric Sewing Machine. Category: SINGER. Subcategory: Sewing Machine. Price: 16,990৳17,490৳.
",247,1032186,1032433
4261,recursive,"
Product: SINGER SRSM-SME-1408 Electric Sewing Machine. Category: SINGER. Subcategory: Sewing Machine. Price: Out Of Stock.

Product: Whirlpool Magicook 20L Classic Knob Solo Microwave Oven. Category: Whirlpool. Subcategory: Oven. Price: 10,990৳11,990৳.
",254,1032433,1032687
4262,recursive,"
Product: Whirlpool MWO Pro 20 SE 20L Solo Microwave Oven. Category: Whirlpool. Subcategory: Oven. Price: 11,999৳12,990৳.

Product: Whirlpool Supreme Chef 35L Microwave Oven. Category: Whirlpool. Subcategory: Oven. Price: 47,990৳54,990৳.
",238,1032687,1032925
4263,recursive,"
Product: Whirlpool Magicook Pro 30 GE Grill 30 Litre Microwave Oven. Category: Whirlpool. Subcategory: Oven. Price: 17,890৳19,990৳.

Product: Whirlpool Magicook Convection 30L Microwave Oven. Category: Whirlpool. Subcategory: Oven. Price: 22,990৳26,990৳.
",256,1032925,1033181
4264,recursive,"
Product: Walton WAF-KB04L 4L Air Fryer. Category: Air Fryer. Subcategory: Appliance. Price: 7,000৳7,550৳.

Product: Singer 2447-BB Air Fryer. Category: Air Fryer. Subcategory: Appliance. Price: 8,490৳9,900৳.
",209,1033181,1033390
4265,recursive,"
Product: Walton WAF-AN06L 6L Air Fryer. Category: Air Fryer. Subcategory: Appliance. Price: 11,000৳11,990৳.

Product: Mi 3.5L Smart Air Fryer. Category: Air Fryer. Subcategory: Appliance. Price: 9,499৳13,490৳.
",211,1033390,1033601
4266,recursive,"
Product: Sharp KF-AF50 5L Air Fryer. Category: Air Fryer. Subcategory: Appliance. Price: 13,000৳16,000৳.

Product: Tefal EY2018 Air Fryer. Category: Air Fryer. Subcategory: Appliance. Price: 15,500৳18,000৳.
",208,1033601,1033809
4267,recursive,"
Product: Sharp KF-AF70RT-S3 7L Air Fryer. Category: Air Fryer. Subcategory: Appliance. Price: 14,500৳18,000৳.

Product: Xiaomi 4L Smart Air Fryer Pro. Category: Air Fryer. Subcategory: Appliance. Price: Out Of Stock.
",218,1033809,1034027
4268,recursive,"
Product: Xiaomi 6L Air Fryer. Category: Air Fryer. Subcategory: Appliance. Price: Out Of Stock.

Product: Panasonic MC-CL601 Bagless Vacuum Cleaner. Category: Vacuum Cleaner. Subcategory: Appliance. Price: 13,290৳16,500৳.
",223,1034027,1034250
4269,recursive,"
Product: Sharp EC-CA1820 20 Ltr 1800W Tank Vacuum Cleaner. Category: Vacuum Cleaner. Subcategory: Appliance. Price: 13,700৳16,900৳.

Product: Panasonic MC-CL603 Bagless Canister Vacuum Cleaner. Category: Vacuum Cleaner. Subcategory: Appliance. Price: 14,990৳17,500৳.
",268,1034250,1034518
4270,recursive,"
Product: Sharp EC-CA2422-Z 22 Ltr 2400W Vacuum Cleaner. Category: Vacuum Cleaner. Subcategory: Appliance. Price: 14,390৳17,500৳.

Product: Panasonic MC-CL605 Bagless Vacuum Cleaner. Category: Vacuum Cleaner. Subcategory: Appliance. Price: 18,500৳22,000৳.
",256,1034518,1034774
4271,recursive,"
Product: Sharp EC-BG2405A-G 5 Liter 2400W Vacuum Cleaner. Category: Vacuum Cleaner. Subcategory: Appliance. Price: 18,800৳22,000৳.

Product: Panasonic MC-YL633 Tank Vacuum Cleaner. Category: Vacuum Cleaner. Subcategory: Appliance. Price: 21,300৳23,000৳.
",255,1034774,1035029
4272,recursive,"
Product: Hitachi CV-950F 2100W Vacuum Cleaner 18 Ltr. Category: Vacuum Cleaner. Subcategory: Appliance. Price: 22,000৳24,000৳.

Product: Panasonic MC-CL607 2.2L 2100W Bagless Vacuum Cleaner. Category: Vacuum Cleaner. Subcategory: Appliance. Price: 21,500৳25,900৳.
",265,1035029,1035294
4273,recursive,"
Product: Hitachi CV-960F 21L 2200W Vacuum Cleaner. Category: Vacuum Cleaner. Subcategory: Appliance. Price: 19,000৳26,500৳.

Product: Panasonic MC-YL635 Tank Vacuum Cleaner. Category: Vacuum Cleaner. Subcategory: Appliance. Price: 23,500৳29,000৳.
",248,1035294,1035542
4274,recursive,"
Product: Anker Eufy G50 Hybrid Robot Vacuum Cleaner. Category: Vacuum Cleaner. Subcategory: Appliance. Price: 27,990৳29,990৳.

Product: Hitachi CV-9800YJ 21L 2300W Vacuum Cleaner. Category: Vacuum Cleaner. Subcategory: Appliance. Price: 28,000৳33,000৳.
",254,1035542,1035796
4275,recursive,"
Product: Panasonic MC-YL799 21L 2400W Tank Vacuum Cleaner. Category: Vacuum Cleaner. Subcategory: Appliance. Price: 33,000৳37,000৳.

Product: JONR P20 Pro Robot Vacuum Cleaner. Category: Vacuum Cleaner. Subcategory: Appliance. Price: 104,990৳114,999৳.
",253,1035796,1036049
4276,recursive,"
Product: Baseus A2 Pro Car Vacuum Cleaner. Category: Vacuum Cleaner. Subcategory: Appliance. Price: Out Of Stock.

Product: Panasonic MC-YL620 Drum Vacuum Cleaner. Category: Vacuum Cleaner. Subcategory: Appliance. Price: Out Of Stock.
",236,1036049,1036285
4277,recursive,"
Product: Panasonic MC-YL631 Tank Vacuum Cleaner. Category: Vacuum Cleaner. Subcategory: Appliance. Price: Out Of Stock.

Product: AirRobo T20+ Smart Cleaning Robot Vacuum Cleaner. Category: Vacuum Cleaner. Subcategory: Appliance. Price: Out Of Stock.
",252,1036285,1036537
4278,recursive,"
Product: Xiaomi Smart Air Purifier 4 Lite Filter (CN Variant). Category: Air Purifier. Subcategory: Appliance. Price: 17,990৳21,999৳.

Product: Sharp FP-J30E-B Air Purifier. Category: Air Purifier. Subcategory: Appliance. Price: 18,290৳23,000৳.
",246,1036537,1036783
4279,recursive,"
Product: Sharp FPJM30LB Air Purifier with Mosquito Catcher. Category: Air Purifier. Subcategory: Appliance. Price: 26,500৳28,000৳.

Product: Sharp FP-JM30E-B Air Purifier With Mosquito Catcher. Category: Air Purifier. Subcategory: Appliance. Price: 28,500৳33,000৳.
",266,1036783,1037049
4280,recursive,"
Product: Sharp FP-GM30L-B Air Purifier with Mosquito Catcher. Category: Air Purifier. Subcategory: Appliance. Price: 27,500৳33,000৳.

Product: Sharp FP-J40E-W Air Purifier. Category: Air Purifier. Subcategory: Appliance. Price: 33,000৳37,000৳.
",245,1037049,1037294
4281,recursive,"
Product: Sharp FP-J50E-H Air Purifier. Category: Air Purifier. Subcategory: Appliance. Price: 32,500৳40,000৳.

Product: Sharp FP-J60E-W Air Purifier. Category: Air Purifier. Subcategory: Appliance. Price: 45,000৳55,000৳.
",222,1037294,1037516
4282,recursive,"
Product: Sharp FP-J80E-H Air Purifier. Category: Air Purifier. Subcategory: Appliance. Price: 49,000৳56,000৳.

Product: Walton WMWO-M23CDS 23L Convection Microwave Oven. Category: Walton. Subcategory: Oven. Price: 16,800৳17,500৳.
",231,1037516,1037747
4283,recursive,"
Product: Walton WMWO-M28EGN 28L Convection Microwave Oven. Category: Walton. Subcategory: Oven. Price: 17,500৳17,990৳.

Product: Walton WMWO-M25SCD 25L Convection Microwave Oven. Category: Walton. Subcategory: Oven. Price: 18,150৳18,500৳.
",240,1037747,1037987
4284,recursive,"
Product: Walton WMWO-M25CDS 25L Convection Microwave Oven. Category: Walton. Subcategory: Oven. Price: 18,250৳18,700৳.

Product: Walton WMWO-G30SCT 30L Convection Microwave Oven. Category: Walton. Subcategory: Oven. Price: 21,550৳22,000৳.
",240,1037987,1038227
4285,recursive,"
Product: Hisense H20MOBS2H 20L Solo Microwave Oven. Category: Hisense. Subcategory: Oven. Price: 9,690৳10,900৳.

Product: Hisense H20MOBS5H 20L Solo Microwave Oven. Category: Hisense. Subcategory: Oven. Price: 10,590৳11,900৳.
",227,1038227,1038454
4286,recursive,"
Product: Hisense H25MOBS5H 25L Solo Microwave Oven. Category: Hisense. Subcategory: Oven. Price: 12,990৳15,400৳.

Product: Hisense H28MOBS10HC 28L Convection Microwave Oven. Category: Hisense. Subcategory: Oven. Price: 20,890৳24,900৳.
",236,1038454,1038690
4287,recursive,"
Product: Hisense HMBC2809DSC 28L Convection Microwave Oven. Category: Hisense. Subcategory: Oven. Price: 21,590৳25,900৳.

Product: Hisense H26MOBS5HG 26L Grill Microwave Oven. Category: Hisense. Subcategory: Oven. Price: Out Of Stock.
",236,1038690,1038926
4288,recursive,"
Product: Xiaomi MIJIA MJZZB01PL 300ml Portable Juicer Cup. Category: Xiaomi. Subcategory: Blender. Price: 3,190৳4,490৳.

Product: Sharp EO-42K 42L Rotisserie Convection Electric Oven. Category: Oven. Subcategory: Appliance. Price: 13,000৳14,000৳.
",248,1038926,1039174
4289,recursive,"
Product: Sharp R-20A0(K)V 20 Liters Microwave Oven. Category: Oven. Subcategory: Appliance. Price: 12,400৳16,700৳.

Product: SHARP EO-60K 60L Rotisserie Convection Electric Oven. Category: Oven. Subcategory: Appliance. Price: 14,390৳16,900৳.
",243,1039174,1039417
4290,recursive,"
Product: SHARP R-32A0-SM-V 25L Microwave Oven. Category: Oven. Subcategory: Appliance. Price: 17,800৳18,800৳.

Product: Sharp R-72A1-SM-V 25L Grill Microwave Oven. Category: Oven. Subcategory: Appliance. Price: 19,000৳19,500৳.
",228,1039417,1039645
4291,recursive,"
Product: Sharp R-75MT-S 25L Grill Microwave Oven. Category: Oven. Subcategory: Appliance. Price: 18,000৳19,500৳.

Product: Panasonic NN-ST34NB 25L Solo Microwave Oven. Category: Oven. Subcategory: Appliance. Price: 20,000৳20,700৳.
",232,1039645,1039877
4292,recursive,"
Product: Sharp R-72E0(SM)V 25L Grill Microwave Oven. Category: Oven. Subcategory: Appliance. Price: 19,500৳22,000৳.

Product: Sharp R-28CT(S) 28L Grill Microwave Oven. Category: Oven. Subcategory: Appliance. Price: 18,790৳22,000৳.
",232,1039877,1040109
4293,recursive,"
Product: Sharp R-2235H(R) 24L Solo Microwave Oven. Category: Oven. Subcategory: Appliance. Price: 19,000৳24,700৳.

Product: Panasonic NN-CT645 27L Convection Grill Microwave Oven. Category: Panasonic. Subcategory: Oven. Price: 26,890৳29,500৳.
",244,1040109,1040353
4294,recursive,"
Product: Panasonic NN-CD684 27L Convection Grill Microwave Oven. Category: Panasonic. Subcategory: Oven. Price: 31,000৳31,500৳.

Product: Panasonic NN-CT69 30L Convection Grill Microwave Oven. Category: Panasonic. Subcategory: Oven. Price: 34,500৳35,000৳.
",257,1040353,1040610
4295,recursive,"
Product: Panasonic NN-CT68 30L Convection Grill Microwave Oven. Category: Panasonic. Subcategory: Oven. Price: 36,000৳37,000৳.

Product: Midea 30 Liter Geyser (D30-15A6). Category: Midea. Subcategory: Geyser. Price: 11,300৳16,000৳.
",233,1040610,1040843
4296,recursive,"
Product: Midea 40 Liter Geyser (D40-20A). Category: Midea. Subcategory: Geyser. Price: 13,700৳17,000৳.

Product: Midea 50 Liter Geyser (D50-20A). Category: Midea. Subcategory: Geyser. Price: 15,300৳19,500৳.
",208,1040843,1041051
4297,recursive,"
Product: Sharp R-77AT(ST) 34L Grill Microwave Oven. Category: Sharp. Subcategory: Oven. Price: 22,000৳28,000৳.

Product: SHARP R-28CN(K) 28L Convection Grill Microwave Oven. Category: Sharp. Subcategory: Oven. Price: 28,000৳30,500৳.
",234,1041051,1041285
4298,recursive,"
Product: Sharp R-84AO(ST)V 25L Convection Microwave Oven. Category: Sharp. Subcategory: Oven. Price: 29,500৳32,700৳.

Product: Sharp R-92A0-ST-V 32L Convection Microwave Oven. Category: Sharp. Subcategory: Oven. Price: 31,390৳41,200৳.
",236,1041285,1041521
4299,recursive,"
Product: Philips HL1606/03 500W Mixer Grinder. Category: Philips. Subcategory: Blender. Price: 7,000৳9,590৳.

Product: Philips HL7505/00 500W Mixer Grinder. Category: Philips. Subcategory: Blender. Price: 7,490৳9,900৳.
",220,1041521,1041741
4300,recursive,"
Product: Philips HL7757 750W 3 Jar Mixer Grinder. Category: Philips. Subcategory: Blender. Price: 9,290৳12,490৳.

Product: Philips HL7756/00 750 Watt Mixer Grinder. Category: Philips. Subcategory: Blender. Price: 9,950৳13,290৳.
",229,1041741,1041970
4301,recursive,"
Product: Panasonic MX-M200 1L Durable & Lightweight Blender. Category: Panasonic. Subcategory: Blender. Price: 5,200৳5,500৳.

Product: Panasonic MX-EX1081 1.35L Blender. Category: Panasonic. Subcategory: Blender. Price: 6,500৳7,000৳.
",235,1041970,1042205
4302,recursive,"
Product: Panasonic MX-900M 1L Blender. Category: Panasonic. Subcategory: Blender. Price: 6,500৳8,000৳.

Product: Panasonic MX-GX1511W 1500ml Blender. Category: Panasonic. Subcategory: Blender. Price: 6,500৳8,000৳.
",215,1042205,1042420
4303,recursive,"
Product: Panasonic MX-EX1561 1.5L Blender. Category: Panasonic. Subcategory: Blender. Price: 7,000৳8,300৳.

Product: Panasonic MX-AC300 3 Jar Mixer Grinder. Category: Panasonic. Subcategory: Blender. Price: 12,000৳11,500৳.
",224,1042420,1042644
4304,recursive,"
Product: Panasonic MX-AC400 4 Jar Mixer Grinder. Category: Panasonic. Subcategory: Blender. Price: 13,400৳14,000৳.

Product: Panasonic MX-AV425 4 Jar Mixer Grinder. Category: Panasonic. Subcategory: Blender. Price: 14,400৳15,000৳.
",232,1042644,1042876
4305,recursive,"
Product: Panasonic MJ-CB100 2L Juicer Blender. Category: Panasonic. Subcategory: Blender. Price: 13,500৳15,000৳.

Product: Panasonic MJ-H300K Juicer Blender. Category: Panasonic. Subcategory: Blender. Price: 14,600৳15,500৳.
",225,1042876,1043101
4306,recursive,"
Product: Panasonic MX-AC460 Mixer Grinder. Category: Panasonic. Subcategory: Blender. Price: 13,500৳15,800৳.

Product: Panasonic MX-AE375 Super Mixer Grinder. Category: Panasonic. Subcategory: Blender. Price: 14,000৳16,500৳.
",226,1043101,1043327
4307,recursive,"
Product: Panasonic MX-AE475 2000W Mixer Grinder. Category: Panasonic. Subcategory: Blender. Price: 15,500৳16,500৳.

Product: PANASONIC MX-AC560 5 Jar Mixer Grinder. Category: Panasonic. Subcategory: Blender. Price: 15,500৳17,500৳.
",232,1043327,1043559
4308,recursive,"
Product: Panasonic MJ-CB600 2L Juicer Blender. Category: Panasonic. Subcategory: Blender. Price: 17,000৳20,000৳.

Product: Panasonic MX-AC555 Super Mixer Grinder. Category: Panasonic. Subcategory: Blender. Price: 17,000৳20,500৳.
",230,1043559,1043789
4309,recursive,"
Product: Panasonic MJ-DJ31 3 in 1 Juicer Blender. Category: Panasonic. Subcategory: Blender. Price: 20,500৳23,500৳.

Product: Panasonic MX-M210SSL 1.35L Blender. Category: Panasonic. Subcategory: Blender. Price: Up Coming.
",224,1043789,1044013
4310,recursive,"
Product: Panasonic MX-KM3070 1.5L Ice Crushing Blender. Category: Panasonic. Subcategory: Blender. Price: Out Of Stock.

Product: Panasonic MX-AC310 Super Mixer Grinder. Category: Panasonic. Subcategory: Blender. Price: Out Of Stock.
",235,1044013,1044248
4311,recursive,"
Product: Haier 30 Litre Water Heater Geyser - ES30H-CK3(BD). Category: Haier. Subcategory: Geyser. Price: 10,990৳14,500৳.

Product: Haier 50 Litre Water Heater Geyser - ES50H-CK3(BD). Category: Haier. Subcategory: Geyser. Price: 13,190৳18,900৳.
",246,1044248,1044494
4312,recursive,"
Product: Haier 40 Litre Water Heater Geyser - ES40H-CK3(BD). Category: Haier. Subcategory: Geyser. Price: 12,190৳15,300৳.

Product: Walton WRH-PTC205T Mini Room Heater. Category: Room Heater. Subcategory: Appliance. Price: 4,900৳4,990৳.
",238,1044494,1044732
4313,recursive,"
Product: Walton WRH-PTC302W Room Heater. Category: Room Heater. Subcategory: Appliance. Price: 7,000৳7,500৳.

Product: Xiaomi VIOMI VXNF01 Mini Portable Heater. Category: Room Heater. Subcategory: Appliance. Price: Up Coming.
",227,1044732,1044959
4314,recursive,"
Product: Xiaomi MI Mijia ZMNFJ01YM 600W Desktop Electric Heater. Category: Room Heater. Subcategory: Appliance. Price: Out Of Stock.

Product: Xiaomi Mijia N1 1.5L Electric Kettle. Category: Electric Kettle. Subcategory: Appliance. Price: 3,199৳3,699৳.
",254,1044959,1045213
4315,recursive,"
Product: Smart SEK-PC55SS 5.5 Liters Pressure Cooker. Category: Cooker. Subcategory: Appliance. Price: 2,790৳3,490৳.

Product: SMART SEK-RC18FS 1.8 Liter Rice Cooker. Category: Cooker. Subcategory: Appliance. Price: 2,990৳3,990৳.
",231,1045213,1045444
4316,recursive,"
Product: SMART SEK-PC65SS 6.5 Liter Pressure Cooker. Category: Cooker. Subcategory: Appliance. Price: 2,990৳3,990৳.

Product: SMART SEK-RC28FS 2.8 Ltr Rice Cooker. Category: Cooker. Subcategory: Appliance. Price: 3,590৳4,790৳.
",228,1045444,1045672
4317,recursive,"
Product: Panasonic SR-3NA Rice Cooker. Category: Cooker. Subcategory: Appliance. Price: 4,500৳4,900৳.

Product: Xiaomi Mijia Induction Cooker Youth Edition. Category: Cooker. Subcategory: Appliance. Price: 8,000৳8,490৳.
",221,1045672,1045893
4318,recursive,"
Product: Shameem Tropica 30 Litre Geyser (7 Gallon Standard). Category: Geyser. Subcategory: Appliance. Price: 9,300৳11,000৳.

Product: Shameem Tropica 10 Gallon Standard Geyser (45 Litre). Category: Geyser. Subcategory: Appliance. Price: 9,190৳11,500৳.
",255,1045893,1046148
4319,recursive,"
Product: Shameem Tropica 10 Gallon Wall Hanging Standard Geyser (45 Litre). Category: Geyser. Subcategory: Appliance. Price: 9,900৳12,000৳.

Product: Shameem Tropica 30 Litre Geyser (7 Gallon Special). Category: Geyser. Subcategory: Appliance. Price: 8,990৳12,000৳.
",267,1046148,1046415
4320,recursive,"
Product: Shameem Tropica 15 Gallon Standard Geyser (67.5 Litre). Category: Geyser. Subcategory: Appliance. Price: 9,990৳12,500৳.

Product: Shameem Tropica 15 Gallon Wall Hanging Standard Geyser (67.5 Litre). Category: Geyser. Subcategory: Appliance. Price: 10,800৳13,000৳.
",274,1046415,1046689
4321,recursive,"
Product: Shameem Tropica 15 Gallon Special Geyser (67.5 Litre). Category: Geyser. Subcategory: Appliance. Price: 11,290৳13,500৳.

Product: Shameem Tropica 10 Gallon Special Geyser (45 Litre). Category: Geyser. Subcategory: Appliance. Price: 9,890৳14,500৳.
",257,1046689,1046946
4322,recursive,"
Product: Shameem Tropica 20 Gallon Standard Geyser (90 Liter). Category: Geyser. Subcategory: Appliance. Price: 15,000৳16,000৳.

Product: Shameem Tropica 20 Gallon Wall Hanging Standard Geyser (90 Liter). Category: Geyser. Subcategory: Appliance. Price: 13,950৳16,500৳.
",271,1046946,1047217
4323,recursive,"
Product: Shameem Tropica 20 Gallon Special Geyser (90 Liter). Category: Geyser. Subcategory: Appliance. Price: 16,500৳17,000৳.

Product: Shameem Tropica 25 Gallon Standard Geyser (112.5 Liter). Category: Geyser. Subcategory: Appliance. Price: 24,000৳25,000৳.
",260,1047217,1047477
4324,recursive,"
Product: Shameem Tropica 25 Gallon Special Geyser (112.5 Liter). Category: Geyser. Subcategory: Appliance. Price: 26,000৳28,000৳.

Product: Shameem Tropica 30 Gallon Standard Geyser (135 Litre). Category: Geyser. Subcategory: Appliance. Price: 29,500৳34,000৳.
",261,1047477,1047738
4325,recursive,"
Product: Shameem Tropica 40 Gallon Standard Geyser (180 Litre). Category: Geyser. Subcategory: Appliance. Price: 35,500৳40,000৳.

Product: Shameem Tropica 50 Gallon Standard Geyser (225 Litre). Category: Shameem. Subcategory: Geyser. Price: 42,500৳45,000৳.
",258,1047738,1047996
4326,recursive,"
Product: Shameem Tropica 60 Gallon Standard Geyser (270 Litre). Category: Shameem. Subcategory: Geyser. Price: 51,000৳55,000৳.

Product: Shameem Tropica 80 Gallon Standard Geyser (360 Litre). Category: Shameem. Subcategory: Geyser. Price: 63,500৳70,000৳.
",256,1047996,1048252
4327,recursive,"
Product: Shameem Tropica 100 Gallon Standard Geyser (450 Litre). Category: Shameem. Subcategory: Geyser. Price: 85,500৳90,000৳.

Product: Shameem Tropica 150 Gallon Standard Geyser (675 Litre). Category: Shameem. Subcategory: Geyser. Price: 125,000৳130,000৳.
",260,1048252,1048512
4328,recursive,"
Product: Panasonic NI-P300T Multi-Directional Steam Iron. Category: Iron. Subcategory: Appliance. Price: 3,500৳3,800৳.

Product: Panasonic NI-M250T Steam Iron. Category: Iron. Subcategory: Appliance. Price: 3,400৳3,900৳.
",222,1048512,1048734
4329,recursive,"
Product: Panasonic NI-E410T Steam Iron. Category: Iron. Subcategory: Appliance. Price: 4,500৳5,000৳.

Product: Philips GC181/80 1000 Watt Dry Iron. Category: Iron. Subcategory: Appliance. Price: 3,790৳5,090৳.
",210,1048734,1048944
4330,recursive,"
Product: Xiaomi Mijia 1200W Handheld Electric Ironing Machine. Category: Iron. Subcategory: Appliance. Price: 7,890৳9,990৳.

Product: Panasonic NI-GSE040PTH Garment Steamer Iron. Category: Iron. Subcategory: Appliance. Price: 14,200৳15,000৳.
",243,1048944,1049187
4331,recursive,"
Product: Panasonic NI-GSG060 Garment Steamer Iron. Category: Iron. Subcategory: Appliance. Price: 14,500৳17,000৳.

Product: Panasonic NI-GSE050ATH Garment Steamer Iron. Category: Iron. Subcategory: Appliance. Price: 16,500৳17,500৳.
",233,1049187,1049420
4332,recursive,"
Product: Panasonic NI-GWE080 2140W Garment Steamer. Category: Iron. Subcategory: Appliance. Price: 20,000৳25,000৳.",115,1049420,1049535
