chunk_id,strategy,text,length,start_index,end_index
0,sentence,"Product: Intel Core i3-12100 12th Gen Budget Desktop PC. Category: Intel PC. Subcategory: Star PC. Price: 28,300৳30,120৳.

Product: Intel 10th Gen Core i5-10400 Desktop PC. Category: Intel PC. ",193,0,193
1,sentence,"Category: Intel PC. Subcategory: Star PC. Price: 32,150৳.

Product: Intel 12th Gen Core i5-12400 Desktop PC. Category: Intel PC. Subcategory: Star PC. Price: 33,248৳35,750৳.
",174,173,347
2,sentence,"Subcategory: Star PC. Price: 33,248৳35,750৳.

Product: Intel Core i5 14500 14th Gen Desktop PC. Category: Intel PC. Subcategory: Star PC. Price: 48,500৳51,800৳.
",161,302,463
3,sentence,"Subcategory: Star PC. Price: 48,500৳51,800৳.

Product: Intel 13th Gen Core i5 13400 Budget Desktop PC with Monitor. Category: Intel PC. Subcategory: Star PC. Price: 58,999৳60,600৳.
",181,418,599
4,sentence,"Subcategory: Star PC. Price: 58,999৳60,600৳.

Product: Acer Veriton S2690G Core i5 12th Gen Tower Brand PC. Category: Acer. Subcategory: Brand PC. Price: 56,500৳.
",163,554,717
5,sentence,"Subcategory: Brand PC. Price: 56,500৳.

Product: Acer Veriton MT M4690G Core i3 14th Gen Tower Brand PC. Category: Acer. Subcategory: Brand PC. Price: 51,500৳.
",160,678,838
6,sentence,"Subcategory: Brand PC. Price: 51,500৳.

Product: Acer Veriton MT M4690G Core i5 14th Gen Tower Brand PC. Category: Acer. Subcategory: Brand PC. Price: 61,000৳.
",160,799,959
7,sentence,"Subcategory: Brand PC. Price: 61,000৳.

Product: ASUS ExpertCenter D5 D500ME Core i3 13th Gen Brand PC. Category: ASUS. Subcategory: Brand PC. Price: 63,000৳.
",159,920,1079
8,sentence,"Subcategory: Brand PC. Price: 63,000৳.

Product: ASUS ExpertCenter D5 D500ME Core i5 13th Gen Mini Tower Brand PC. Category: ASUS. Subcategory: Brand PC. Price: 67,000৳.
",170,1040,1210
9,sentence,"Subcategory: Brand PC. Price: 67,000৳.

Product: ASUS ExpertCenter D5 D500ME Core i7 13th Gen Mini Tower Brand PC. Category: ASUS. Subcategory: Brand PC. Price: 101,850৳.
",171,1171,1342
10,sentence,"Subcategory: Brand PC. Price: 101,850৳.

Product: MSI PRO DP180 13th Gen Core i5 512GB SSD Desktop PC With Monitor. Category: MSI. Subcategory: Brand PC. Price: 67,500৳76,500৳.
",177,1302,1479
11,sentence,"Subcategory: Brand PC. Price: 67,500৳76,500৳.

Product: Intel 13th Gen Core i5 13400F Gaming Desktop PC. Category: Intel PC. Subcategory: Gaming PC. Price: 79,999৳84,500৳.
",172,1433,1605
12,sentence,"Subcategory: Gaming PC. Price: 79,999৳84,500৳.

Product: Intel Core Ultra 5 245K Desktop PC. Category: Intel PC. Subcategory: Gaming PC. Price: 94,499৳99,850৳.
",160,1558,1718
13,sentence,"Subcategory: Gaming PC. Price: 94,499৳99,850৳.

Product: Intel Core Ultra 5 245K Gaming Desktop PC. Category: Intel PC. Subcategory: Gaming PC. Price: 109,999৳117,599৳.
",169,1671,1840
14,sentence,"Price: 109,999৳117,599৳.

Product: Intel Core i5 14400 14th Gen Gaming Desktop PC. Category: Intel PC. Subcategory: Gaming PC. Price: 131,999৳135,950৳.
",152,1815,1967
15,sentence,"Price: 131,999৳135,950৳.

Product: Intel Core i7 14700K 14th Gen Gaming Desktop PC. Category: Intel PC. Subcategory: Gaming PC. Price: 145,999৳153,100৳.
",153,1942,2095
16,sentence,"Price: 145,999৳153,100৳.

Product: Intel Core Ultra 7 265K Gaming Desktop PC. Category: Intel PC. Subcategory: Gaming PC. Price: 167,999৳172,300৳.
",147,2070,2217
17,sentence,"Price: 167,999৳172,300৳.

Product: Intel Core i7 14700KF 14th Gen Gaming Desktop PC. Category: Intel PC. Subcategory: Gaming PC. Price: 235,999৳245,850৳.
",154,2192,2346
18,sentence,"Price: 235,999৳245,850৳.

Product: Intel Core Ultra 9 285K Gaming Desktop PC. Category: Intel PC. Subcategory: Gaming PC. Price: 415,000৳425,955৳.

Product: AMD Ryzen 5 5600G Desktop PC. ",187,2321,2508
19,sentence,"
Product: AMD Ryzen 5 5600G Desktop PC. Category: Star PC. Subcategory: Desktop. Price: 30,750৳.

Product: AMD Ryzen 5 5600G Budget Desktop PC. Category: Star PC. Subcategory: Desktop. ",185,2468,2653
20,sentence,"Category: Star PC. Subcategory: Desktop. Price: 28,999৳31,350৳.

Product: AMD Ryzen 7 5700G Custom Desktop PC. Category: Star PC. Subcategory: Desktop. Price: 30,622৳33,650৳.
",175,2612,2787
21,sentence,"Subcategory: Desktop. Price: 30,622৳33,650৳.

Product: AMD Ryzen 5 5600G Budget Desktop PC. Category: Star PC. Subcategory: Desktop. Price: 39,700৳.

Product: AMD Ryzen 5 8500G Desktop PC. ",189,2742,2931
22,sentence,"
Product: AMD Ryzen 5 8500G Desktop PC. Category: Star PC. Subcategory: Desktop. Price: 44,500৳46,000৳.

Product: AMD Ryzen 5 3400G Processor Desktop PC. Category: RYZEN PC. Subcategory: Gaming PC. ",198,2891,3089
23,sentence,"Category: RYZEN PC. Subcategory: Gaming PC. Price: 21,999৳23,950৳.

Product: AMD Ryzen 5 5600G Custom Desktop PC. Category: RYZEN PC. Subcategory: Gaming PC. Price: 29,500৳31,700৳.
",181,3045,3226
24,sentence,"Subcategory: Gaming PC. Price: 29,500৳31,700৳.

Product: AMD Ryzen 5 5600GT Budget Desktop PC. Category: RYZEN PC. Subcategory: Gaming PC. Price: 28,704৳31,200৳.
",162,3179,3341
25,sentence,"Subcategory: Gaming PC. Price: 28,704৳31,200৳.

Product: AMD Ryzen 5 5500 Gaming PC. Category: RYZEN PC. Subcategory: Gaming PC. Price: 44,252৳48,100৳.

Product: AMD Ryzen 5 7600 Desktop PC. ",191,3294,3485
26,sentence,"
Product: AMD Ryzen 5 7600 Desktop PC. Category: RYZEN PC. Subcategory: Gaming PC. Price: 50,600৳.

Product: AMD Ryzen 7 7700 Budget Gaming Desktop PC. Category: RYZEN PC. Subcategory: Gaming PC. ",196,3446,3642
27,sentence,"Category: RYZEN PC. Subcategory: Gaming PC. Price: 52,780৳56,149৳.

Product: AMD Ryzen 7 8700G Budget Desktop PC. Category: RYZEN PC. Subcategory: Gaming PC. Price: 60,019৳63,850৳.
",181,3598,3779
28,sentence,"Subcategory: Gaming PC. Price: 60,019৳63,850৳.

Product: AMD Ryzen 5 9600X Gaming Desktop PC. Category: RYZEN PC. Subcategory: Gaming PC. Price: 63,000৳67,100৳.
",161,3732,3893
29,sentence,"Subcategory: Gaming PC. Price: 63,000৳67,100৳.

Product: AMD Ryzen 5 7500F Gaming PC. Category: RYZEN PC. Subcategory: Gaming PC. Price: 77,499৳81,899৳.
",153,3846,3999
30,sentence,"Subcategory: Gaming PC. Price: 77,499৳81,899৳.

Product: AMD Ryzen 5 7500F Gaming Desktop PC. Category: RYZEN PC. Subcategory: Gaming PC. Price: 86,999৳91,800৳.
",161,3952,4113
31,sentence,"Subcategory: Gaming PC. Price: 86,999৳91,800৳.

Product: AMD Ryzen 5 8400F Gaming Desktop PC. Category: RYZEN PC. Subcategory: Gaming PC. Price: 88,999৳94,700৳.
",161,4066,4227
32,sentence,"Subcategory: Gaming PC. Price: 88,999৳94,700৳.

Product: AMD Ryzen 5 7500F Budget Gaming PC. Category: RYZEN PC. Subcategory: Gaming PC. Price: 90,499৳95,950৳.
",160,4180,4340
33,sentence,"Subcategory: Gaming PC. Price: 90,499৳95,950৳.

Product: AMD Ryzen 7 9700X Gaming Desktop PC. Category: RYZEN PC. Subcategory: Gaming PC. Price: 134,499৳141,100৳.
",163,4293,4456
34,sentence,"Price: 134,499৳141,100৳.

Product: AMD Ryzen 7 7700X Gaming Desktop PC. Category: RYZEN PC. Subcategory: Gaming PC. Price: 149,999৳155,900৳.

Product: AMD Ryzen 7 9800X3D Gaming Desktop PC. ",190,4431,4621
35,sentence,"
Product: AMD Ryzen 7 9800X3D Gaming Desktop PC. Category: RYZEN PC. Subcategory: Gaming PC. Price: 160,099৳.

Product: AMD Ryzen 7 7700 Gaming PC. Category: RYZEN PC. Subcategory: Gaming PC. ",192,4572,4764
36,sentence,"Category: RYZEN PC. Subcategory: Gaming PC. Price: 162,600৳.

Product: AMD Ryzen 9 9950X3D Gaming PC. Category: RYZEN PC. Subcategory: Gaming PC. Price: 874,999৳884,850৳.
",171,4720,4891
37,sentence,"Price: 874,999৳884,850৳.

Product: AMD Ryzen 7 9700X Gaming PC. Category: RYZEN PC. Subcategory: Gaming PC. Price: Up Coming.

Product: AMD Ryzen 5 2400G Desktop PC. Category: RYZEN PC. ",186,4866,5052
38,sentence,"Category: RYZEN PC. Subcategory: Gaming PC. Price: Out Of Stock.

Product: AMD Ryzen 5 8600G Desktop PC. Category: RYZEN PC. Subcategory: Gaming PC. Price: Out Of Stock.
",170,5032,5202
39,sentence,"Subcategory: Gaming PC. Price: Out Of Stock.

Product: Lenovo IdeaCentre 3 07IRB8 Core i3 13th Gen Brand PC. Category: Lenovo. Subcategory: Brand PC. Price: 48,500৳.
",166,5157,5323
40,sentence,"Subcategory: Brand PC. Price: 48,500৳.

Product: Lenovo ThinkCentre Neo 50t Gen 4 Core i3 12th Gen Brand PC. Category: Lenovo. Subcategory: Brand PC. Price: 50,000৳.
",166,5284,5450
41,sentence,"Subcategory: Brand PC. Price: 50,000৳.

Product: Lenovo ThinkCentre Neo 50s Gen 4 Core i3 13th Gen 512GB SSD Brand PC. Category: Lenovo. Subcategory: Brand PC. Price: 51,500৳.
",176,5411,5587
42,sentence,"Subcategory: Brand PC. Price: 51,500৳.

Product: Lenovo ThinkCentre Neo 50t Gen 4 Core i3 13th Gen Brand PC. Category: Lenovo. Subcategory: Brand PC. Price: 52,500৳.
",166,5548,5714
43,sentence,"Subcategory: Brand PC. Price: 52,500৳.

Product: Lenovo IdeaCentre 3 07IRB8 Core i5 14th Gen Brand PC (Upgraded). Category: Lenovo. Subcategory: Brand PC. Price: 62,000৳.
",171,5675,5846
44,sentence,"Subcategory: Brand PC. Price: 62,000৳.

Product: Lenovo ThinkCentre Neo 50t Gen 4 Core i5 13th Gen Brand PC. Category: Lenovo. Subcategory: Brand PC. Price: 62,500৳.
",166,5807,5973
45,sentence,"Subcategory: Brand PC. Price: 62,500৳.

Product: Lenovo ThinkCentre Neo 50s Gen 4 Core i5 12th Gen 512GB SSD Brand PC. Category: Lenovo. Subcategory: Brand PC. Price: 62,500৳.
",176,5934,6110
46,sentence,"Subcategory: Brand PC. Price: 62,500৳.

Product: Lenovo ThinkCentre Neo 50t Gen 4 Core i5 13th Gen Brand PC. Category: Lenovo. Subcategory: Brand PC. Price: 65,500৳.
",166,6071,6237
47,sentence,"Subcategory: Brand PC. Price: 65,500৳.

Product: Lenovo ThinkCentre Neo 50t Gen 4 Core i5 13th Gen 512GB SSD Brand PC. Category: Lenovo. Subcategory: Brand PC. Price: 65,500৳.
",176,6198,6374
48,sentence,"Subcategory: Brand PC. Price: 65,500৳.

Product: Lenovo ThinkCentre Neo 50s SFF Core i7 12th Gen Brand PC. Category: Lenovo. Subcategory: Brand PC. Price: 71,500৳.
",164,6335,6499
49,sentence,"Subcategory: Brand PC. Price: 71,500৳.

Product: Lenovo ThinkCentre Neo 50s Core i7 12th Gen 1TB SSD Brand PC. Category: Lenovo. Subcategory: Brand PC. Price: 72,500৳.
",168,6460,6628
50,sentence,"Subcategory: Brand PC. Price: 72,500৳.

Product: Lenovo IdeaCentre 3 07IAB7 Core i7 12th Gen Desktop PC. Category: Lenovo. Subcategory: Brand PC. Price: 71,500৳73,500৳.
",169,6589,6758
51,sentence,"Subcategory: Brand PC. Price: 71,500৳73,500৳.

Product: Lenovo ThinkCentre M70s Gen 3 SFF Core i7 12th Gen Brand PC. Category: Lenovo. Subcategory: Brand PC. Price: 83,000৳.
",174,6712,6886
52,sentence,"Subcategory: Brand PC. Price: 83,000৳.

Product: Asus NUC 13 Pro Core i3 13th Gen Portable Mini Pc. Category: Desktop. Price: 46,500৳.

Product: Asus NUC 13 Pro Core i5 13th Gen Portable Mini Pc. ",196,6847,7043
53,sentence,"Category: Desktop. Price: 60,500৳.

Product: Asus PN41 Celeron N5100 Mini PC. Category: Desktop. Price: 26,000৳.

Product: Asus Nuc 14 Essential Core 3 N355 Portable Mini Pc. Category: Desktop. ",194,7043,7237
54,sentence,"Category: Desktop. Price: 36,000৳.

Product: Asus ExpertCenter PN64 Core i3 12th Gen Portable Mini PC. Category: Desktop. Price: 41,000৳.
",138,7218,7356
55,sentence,"Category: Desktop. Price: 41,000৳.

Product: TECLAST K24 Air Intel Celeron N5095 24"" FHD All-in-One PC. Category: Desktop. Price: 42,000৳.
",139,7321,7460
56,sentence,"Category: Desktop. Price: 42,000৳.

Product: AOC A33 Intel Celeron N5095 23.8"" FHD All in One PC. Category: Desktop. Price: 46,500৳.
",133,7425,7558
57,sentence,"Category: Desktop. Price: 46,500৳.

Product: HP Pro Tower 280 G9 Core i3 12th Gen 8GB RAM Desktop PC. Category: Brand PC. Subcategory: Desktop. Price: 52,500৳.
",160,7523,7683
58,sentence,"Subcategory: Desktop. Price: 52,500৳.

Product: Dell OptiPlex 7010 Core i3 12th Gen Tower Desktop PC. Category: Brand PC. Subcategory: Desktop. Price: 53,500৳.
",160,7645,7805
59,sentence,"Subcategory: Desktop. Price: 53,500৳.

Product: Dell VOSTRO 3030 MT Core i5 12th Gen Brand PC (Upgraded). Category: Brand PC. Subcategory: Desktop. Price: 56,000৳.
",164,7767,7931
60,sentence,"Subcategory: Desktop. Price: 56,000৳.

Product: Dell VOSTRO 3030 MT Core i3 14th Gen Brand PC. Category: Brand PC. Subcategory: Desktop. Price: 50,500৳.
",153,7893,8046
61,sentence,"Subcategory: Desktop. Price: 50,500৳.

Product: Dell VOSTRO 3030 MT Core i3 12th Gen Brand PC (Upgraded). Category: Brand PC. Subcategory: Desktop. Price: 46,500৳.
",164,8008,8172
62,sentence,"Subcategory: Desktop. Price: 46,500৳.

Product: Dell VOSTRO 3030 MT Core i7 12th Gen Brand PC (Upgraded). Category: Brand PC. Subcategory: Desktop. Price: 76,000৳.
",164,8134,8298
63,sentence,"Subcategory: Desktop. Price: 76,000৳.

Product: DELL OptiPlex 7010 Core i3 13th Gen 8GB RAM Desktop PC. Category: Brand PC. Subcategory: Desktop. Price: 57,500৳.
",162,8260,8422
64,sentence,"Subcategory: Desktop. Price: 57,500৳.

Product: Dell OptiPlex 7020 Core i3 12th Gen Tower Brand PC. Category: Brand PC. Subcategory: Desktop. Price: 55,000৳.
",158,8384,8542
65,sentence,"Subcategory: Desktop. Price: 55,000৳.

Product: Dell OptiPlex 7020 Core i3 14th Gen Tower Brand PC. Category: Brand PC. Subcategory: Desktop. Price: 63,000৳.
",158,8504,8662
66,sentence,"Subcategory: Desktop. Price: 63,000৳.

Product: HP 280 Pro G9 MT Core i3 14th Gen Brand PC. Category: Brand PC. Subcategory: Desktop. Price: 60,000৳.
",150,8624,8774
67,sentence,"Subcategory: Desktop. Price: 60,000৳.

Product: Dell OptiPlex 7010 Core i5 12th Gen Tower Desktop PC. Category: Brand PC. Subcategory: Desktop. Price: 64,500৳.
",160,8736,8896
68,sentence,"Subcategory: Desktop. Price: 64,500৳.

Product: HP 280 Pro G9 MT Core i5 14th Gen Brand PC. Category: HP. Subcategory: Brand PC. Price: 72,500৳.
",145,8858,9003
69,sentence,"Subcategory: Brand PC. Price: 72,500৳.

Product: HP Pro Tower 400 G9 Core i7 12th Gen Desktop PC with Windows 11 Pro. Category: HP. Subcategory: Brand PC. Price: 95,000৳.
",171,8964,9135
70,sentence,"Subcategory: Brand PC. Price: 95,000৳.

Product: HP Pro Tower 290 G9 Core i3 12th Gen Brand PC. Category: HP. Subcategory: Brand PC. Price: 49,000৳.
",149,9096,9245
71,sentence,"Subcategory: Brand PC. Price: 49,000৳.

Product: HP Pro Tower 290 G9 Core i5 12th Gen Brand PC (Upgraded). Category: HP. Subcategory: Brand PC. Price: 58,000৳.
",160,9206,9366
72,sentence,"Subcategory: Brand PC. Price: 58,000৳.

Product: HP Pro Tower 290 G9 Core i7 12th Gen Brand PC (Upgraded). Category: HP. Subcategory: Brand PC. Price: 76,000৳.
",160,9327,9487
73,sentence,"Subcategory: Brand PC. Price: 76,000৳.

Product: HP Pro Tower 400 G9 Core i5 13th Gen Brand PC (Upgraded). Category: HP. Subcategory: Brand PC. Price: 74,000৳.
",160,9448,9608
74,sentence,"Subcategory: Brand PC. Price: 74,000৳.

Product: HP Pro Tower 280 G9 Core i7 12th Gen 16GB RAM 512GB SSD Desktop PC. Category: HP. Subcategory: Brand PC. Price: 83,000৳.
",170,9569,9739
75,sentence,"Subcategory: Brand PC. Price: 83,000৳.

Product: HP Pro Tower 280 G9 Core i7 14th Gen Brand PC. Category: HP. Subcategory: Brand PC. Price: Up Coming.

Product: AMD Ryzen 5 8400F Gaming PC. ",190,9700,9890
76,sentence,"
Product: AMD Ryzen 5 8400F Gaming PC. Category: Ryzen PC. Subcategory: Star PC. Price: Out Of Stock.

Product: Dell OptiPlex 3000 Core i5 12th Gen Tower Brand PC. Category: Dell. ",180,9851,10031
77,sentence,"Category: Dell. Subcategory: Brand PC. Price: 65,000৳.

Product: Dell OptiPlex 7020 Core i5 12th Gen Tower Brand PC. Category: Dell. Subcategory: Brand PC. Price: 66,500৳.
",172,10015,10187
78,sentence,"Subcategory: Brand PC. Price: 66,500৳.

Product: DELL OptiPlex 7010 Tower Core i5 13th Gen 512GB Brand PC. Category: Dell. Subcategory: Brand PC. Price: 70,500৳.
",162,10148,10310
79,sentence,"Subcategory: Brand PC. Price: 70,500৳.

Product: Dell VOSTRO 3030 MT Core i5 14th Gen Brand PC. Category: Dell. Subcategory: Brand PC. Price: 64,000৳.
",151,10271,10422
80,sentence,"Subcategory: Brand PC. Price: 64,000৳.

Product: Dell OptiPlex 7020 Core i5 13th Gen Tower Brand PC. Category: Dell. Subcategory: Brand PC. Price: 72,000৳.
",156,10383,10539
81,sentence,"Subcategory: Brand PC. Price: 72,000৳.

Product: Dell Inspiron 3030 MT Core i5 14th Gen Brand PC. Category: Dell. Subcategory: Brand PC. Price: 73,000৳.
",153,10500,10653
82,sentence,"Subcategory: Brand PC. Price: 73,000৳.

Product: Dell OptiPlex Tower 7020 Plus Core i5 14th Gen Brand PC. Category: Dell. Subcategory: Brand PC. Price: 75,000৳.
",161,10614,10775
83,sentence,"Subcategory: Brand PC. Price: 75,000৳.

Product: Dell OptiPlex 7010 Core i7 13th Gen Brand PC. Category: Dell. Subcategory: Brand PC. Price: 93,000৳.
",150,10736,10886
84,sentence,"Subcategory: Brand PC. Price: 93,000৳.

Product: Dell Vostro 3020T Core i7 13th Gen Desktop PC. Category: Dell. Subcategory: Brand PC. Price: 95,000৳.
",151,10847,10998
85,sentence,"Subcategory: Brand PC. Price: 95,000৳.

Product: Dell OptiPlex 7020 MT Core i7 13th Gen Mini Tower Brand PC. Category: Dell. Subcategory: Brand PC. Price: 95,000৳.
",164,10959,11123
86,sentence,"Subcategory: Brand PC. Price: 95,000৳.

Product: Dell OptiPlex 7020 Core i7 12th Gen Tower Brand PC. Category: Dell. Subcategory: Brand PC. Price: 93,000৳.
",156,11084,11240
87,sentence,"Subcategory: Brand PC. Price: 93,000৳.

Product: Dell Inspiron 5430 Intel Core 5 120U 23.8"" FHD All-in-One PC. Category: Dell. Subcategory: All-in-One PC. Price: 92,000৳.
",171,11201,11372
88,sentence,"Subcategory: All-in-One PC. Price: 92,000৳.

Product: Dell Inspiron 5430 Intel Core 7 150U 23.8"" FHD All-in-One PC. Category: Dell. Subcategory: All-in-One PC. Price: 118,000৳.
",177,11328,11505
89,sentence,"Subcategory: All-in-One PC. Price: 118,000৳.

Product: Dell OptiPlex 7420 Core i5 14th Gen 23.8"" FHD Touch All-in-One PC. Category: Dell. Subcategory: All-in-One PC. Price: Out Of Stock.
",187,11460,11647
90,sentence,"Price: Out Of Stock.

Product: Dell OptiPlex 7420 Core i7 14th Gen 23.8"" FHD Touch All-in-One PC. Category: Dell. Subcategory: All-in-One PC. Price: Out Of Stock.
",163,11626,11789
91,sentence,"Price: Out Of Stock.

Product: Lenovo IdeaCentre AIO 24IRH9 Core i5 13th Gen 23.8"" FHD All-in-One Desktop PC. Category: LENOVO. Subcategory: All-in-One PC. Price: 89,500৳.
",172,11768,11940
92,sentence,"Subcategory: All-in-One PC. Price: 89,500৳.

Product: AOC B911 Intel Celeron N95 23.8"" Full HD All in One PC. Category: All-in-One PC. Subcategory: Desktop. Price: 50,300৳.
",173,11896,12069
93,sentence,"Subcategory: Desktop. Price: 50,300৳.

Product: AOC A33 Core i5 7th Gen 23.8"" FHD All in One PC. Category: All-in-One PC. Subcategory: Desktop. Price: 55,200৳.
",160,12031,12191
94,sentence,"Subcategory: Desktop. Price: 55,200৳.

Product: AOC B911 Core i5 8th Gen 23.8"" Full HD All in One PC With WebCam. Category: All-in-One PC. Subcategory: Desktop. Price: 58,800৳.
",177,12153,12330
95,sentence,"Subcategory: Desktop. Price: 58,800৳.

Product: AOC B911 Core i5 8th Gen 27"" Full HD All in One PC With WebCam & Battery. Category: All-in-One PC. Subcategory: Desktop. Price: 61,500৳.
",185,12292,12477
96,sentence,"Subcategory: Desktop. Price: 61,500৳.

Product: TECLAST K24 Air Core i5 12th Gen 24"" FHD All-in-One PC. Category: All-in-One PC. Subcategory: Desktop. Price: 68,000৳.
",167,12439,12606
97,sentence,"Subcategory: Desktop. Price: 68,000৳.

Product: ASUS ExpertCenter P440VAK Core i3 13th Gen 23.8"" FHD All-in-One PC. Category: All-in-One PC. Subcategory: Desktop. Price: 68,500৳.
",179,12568,12747
98,sentence,"Subcategory: Desktop. Price: 68,500৳.

Product: AOC B911 Core i5 12th Gen 23.8"" Full HD All in One PC With WebCam & Battery. Category: All-in-One PC. Subcategory: Desktop. Price: 71,700৳.
",188,12709,12897
99,sentence,"Subcategory: Desktop. Price: 71,700৳.

Product: AOC A99 Core i7 13th Gen 27"" Full HD All in One PC With WebCam & Battery. Category: All-in-One PC. Subcategory: Desktop. Price: 85,600৳.
",185,12859,13044
100,sentence,"Subcategory: Desktop. Price: 85,600৳.

Product: HP All-in-One 24-cr0085d Core i5 13th Gen FHD Touch Desktop PC. Category: All-in-One PC. Subcategory: Desktop. Price: 112,000৳.
",176,13006,13182
101,sentence,"Subcategory: Desktop. Price: 112,000৳.

Product: HP Pro 240 G9 Core i5 12th Gen All-in-One Desktop PC. Category: All-in-One PC. Subcategory: Desktop. Price: 91,000৳94,500৳.
",173,13143,13316
102,sentence,"Subcategory: Desktop. Price: 91,000৳94,500৳.

Product: ASUS ExpertCenter P440VAK Core i7 13th Gen 23.8"" FHD All-in-One PC. Category: All-in-One PC. Subcategory: Desktop. Price: 95,000৳.
",186,13271,13457
103,sentence,"Subcategory: Desktop. Price: 95,000৳.

Product: HP All-in-One 24-cr0086d Core i5 13th Gen Desktop PC. Category: All-in-One PC. Subcategory: Desktop. Price: 99,500৳.
",165,13419,13584
104,sentence,"Subcategory: Desktop. Price: 99,500৳.

Product: ASUS ExpertCenter E5 E5202WHAK Core i3 11th Gen 21.5"" FHD All-in-One PC. Category: All-in-One PC. Subcategory: Desktop. Price: Up Coming.
",186,13546,13732
105,sentence,"Subcategory: Desktop. Price: Up Coming.

Product: dHP R240 Core i5 4th Gen 23.8"" FHD All-in-One PC. Category: All-in-One PC. Subcategory: Desktop. Price: 40,000৳.
",163,13692,13855
106,sentence,"Subcategory: Desktop. Price: 40,000৳.

Product: dHP E270 Core i5 7th Gen 27"" FHD All-in-One PC. Category: All-in-One PC. Subcategory: Desktop. Price: 46,800৳.
",159,13817,13976
107,sentence,"Subcategory: Desktop. Price: 46,800৳.

Product: Asus ExpertCenter E3202 Core i3 12th Gen 21.5"" FHD All-in-One PC. Category: ASUS. Subcategory: All-in-One PC. Price: Out Of Stock.
",179,13938,14117
108,sentence,"Price: Out Of Stock.

Product: HP Pro 240 G9 Core i7 12th Gen All-in-One Desktop PC. Category: HP. Subcategory: All-in-One PC. Price: Out Of Stock.
",148,14096,14244
109,sentence,"Price: Out Of Stock.

Product: HP All-in-One 27-cr0051d Core i7 13th Gen FHD Desktop PC. Category: HP. Subcategory: All-in-One PC. Price: 134,000৳.
",148,14223,14371
110,sentence,"Subcategory: All-in-One PC. Price: 134,000৳.

Product: ASUS NUC 12 Pro Core i3 12th Gen Portable Mini PC. Category: Portable Mini PC. Subcategory: Desktop. Price: 48,500৳.
",172,14326,14498
111,sentence,"Subcategory: Desktop. Price: 48,500৳.

Product: Asus ExpertCenter PN64 Core i5 12th Gen Portable Mini PC. Category: Portable Mini PC. Subcategory: Desktop. Price: 58,000৳.
",172,14460,14632
112,sentence,"Subcategory: Desktop. Price: 58,000৳.

Product: ASUS ROG NUC Core Ultra 7 155H RTX 4060 8GB Graphics Mini Gaming PC. Category: Portable Mini PC. Subcategory: Desktop. Price: Out Of Stock.
",188,14594,14782
113,sentence,"Subcategory: Desktop. Price: Out Of Stock.

Product: ASUS NUC 15 Pro Core Ultra 5 225H Portable Mini PC. Category: Portable Mini PC. Subcategory: Desktop. Price: 76,000৳.
",171,14739,14910
114,sentence,"Subcategory: Desktop. Price: 76,000৳.

Product: ASUS ROG NUC Core Ultra 9 185H RTX 4070 8GB Graphics Mini Gaming PC. Category: Portable Mini PC. Subcategory: Desktop. Price: Out Of Stock.
",188,14872,15060
115,sentence,"Subcategory: Desktop. Price: Out Of Stock.

Product: ASUS ROG NUC Core Ultra 9 275HX RTX 5070Ti 12GB Graphics Mini Gaming PC. Category: Portable Mini PC. Subcategory: Desktop. Price: 390,000৳.
",193,15017,15210
116,sentence,"Subcategory: Desktop. Price: 390,000৳.

Product: Asus PN41 Celeron Dual Core Mini PC. Category: Portable Mini PC. Subcategory: Desktop. Price: 26,000৳.
",152,15171,15323
117,sentence,"Subcategory: Desktop. Price: 26,000৳.

Product: Zotac ZBOX BI322 Intel N3050 Portable Mini PC. Category: Portable Mini PC. Subcategory: Desktop. Price: Up Coming.
",163,15285,15448
118,sentence,"Subcategory: Desktop. Price: Up Coming.

Product: Zotac ZBOX PI330 Intel Atom Portable Mini PC. Category: Portable Mini PC. Subcategory: Desktop. Price: Up Coming.
",164,15408,15572
119,sentence,"Subcategory: Desktop. Price: Up Coming.

Product: Asus PN40 Celeron Dual Core Mini PC. Category: Portable Mini PC. Subcategory: Desktop. Price: Out Of Stock.
",158,15532,15690
120,sentence,"Subcategory: Desktop. Price: Out Of Stock.

Product: ASUS PN50 Ryzen 7 4700U Ultracompact Mini PC. Category: Portable Mini PC. Subcategory: Desktop. Price: Out Of Stock.
",170,15647,15817
121,sentence,"Subcategory: Desktop. Price: Out Of Stock.

Product: Apple Mac Studio M2 Ultra chip 24-core CPU 64GB Memory 1TB SSD (MQH63X/A). Category: Apple Mac Studio. Subcategory: Desktop. Price: Up Coming.
",196,15774,15970
122,sentence,"Subcategory: Desktop. Price: Up Coming.

Product: Apple Mac Studio M2 Max chip 12-core CPU 32GB Memory 512GB SSD (MQH73). Category: Apple Mac Studio. Subcategory: Desktop. Price: Up Coming.
",190,15930,16120
123,sentence,"Subcategory: Desktop. Price: Up Coming.

Product: Apple Mac Pro M2 Ultra Tower Desktop PC. Category: Apple Mac Pro. Subcategory: Desktop. Price: Up Coming.
",156,16080,16236
124,sentence,"Subcategory: Desktop. Price: Up Coming.

Product: Apple iMac M4 Chip 256GB SSD 24"" 4.5K Retina Display All-in-One PC (Late 2024). Category: Apple iMac. Subcategory: Desktop. Price: 210,000৳235,000৳.
",199,16196,16395
125,sentence,"Subcategory: Desktop. Price: 210,000৳235,000৳.

Product: Apple iMac M4 Chip 10 Core GPU 256GB SSD 24"" 4.5K Retina Display All-in-One PC (Late 2024). Category: Apple iMac. Subcategory: Desktop. ",193,16348,16541
126,sentence,"Category: Apple iMac. Subcategory: Desktop. Price: 250,000৳.

Product: Apple iMac M4 Chip 10 Core GPU 512GB SSD 24"" 4.5K Retina Display All-in-One PC (Late 2024). Category: Apple iMac. ",185,16497,16682
127,sentence,"Category: Apple iMac. Subcategory: Desktop. Price: 279,999৳.

Product: Apple iMac M4 Chip 10 Core GPU 24GB RAM 24"" 4.5K Retina Display All-in-One PC (Late 2024). Category: Apple iMac. ",184,16660,16844
128,sentence,"Category: Apple iMac. Subcategory: Desktop. Price: 305,000৳315,000৳.

Product: Apple Mac Mini M4 chip with 10-core CPU 10-Core GPU 16GB Memory 256GB Storage. Category: Apple Mac Mini. ",184,16822,17006
129,sentence,"Category: Apple Mac Mini. Subcategory: Desktop. Price: 79,000৳83,000৳.

Product: Apple Mac Mini M4 chip with 10-core CPU 10-Core GPU 16GB Memory 512GB Storage. Category: Apple Mac Mini. ",186,16980,17166
130,sentence,"Category: Apple Mac Mini. Subcategory: Desktop. Price: 110,000৳115,000৳.

Product: Apple Mac Mini M4 chip with 10-core CPU 10-Core GPU 24GB Memory 512GB Storage. Category: Apple Mac Mini. ",188,17140,17328
131,sentence,"Category: Apple Mac Mini. Subcategory: Desktop. Price: 145,000৳.

Product: Apple Mac Mini M4 Pro chip with 12-core CPU 16-Core GPU 24GB Memory 512GB Storage #MCX44ZP/A. Category: Apple Mac Mini. ",195,17302,17497
132,sentence,"Category: Apple Mac Mini. Subcategory: Desktop. Price: 195,000৳.

Product: Asus ExpertBook B1 B1503CVA Core i5 13th Gen 15.6"" FHD Laptop. Category: Asus. Subcategory: All Laptop. Price: 81,000৳.
",195,17471,17666
133,sentence,"Subcategory: All Laptop. Price: 81,000৳.

Product: ASUS Vivobook Go 15 L510KA Intel Celeron N4500 15.6"" FHD Laptop. Category: Asus. Subcategory: All Laptop. Price: 36,000৳.
",173,17625,17798
134,sentence,"Subcategory: All Laptop. Price: 36,000৳.

Product: ASUS Vivobook Go 15 L510KA Celeron N4500 15.6"" FHD Laptop Star Black. Category: Asus. Subcategory: All Laptop. Price: 36,800৳.
",178,17757,17935
135,sentence,"Subcategory: All Laptop. Price: 36,800৳.

Product: ASUS Vivobook Go 15 E1504GA Core i3 N305 15.6"" FHD Laptop. Category: Asus. Subcategory: All Laptop. Price: 49,000৳.
",167,17894,18061
136,sentence,"Subcategory: All Laptop. Price: 49,000৳.

Product: ASUS Vivobook Go 15 E1504GA Core i3 N305 512GB SSD 15.6"" FHD Laptop. Category: Asus. Subcategory: All Laptop. Price: 52,000৳.
",177,18020,18197
137,sentence,"Subcategory: All Laptop. Price: 52,000৳.

Product: ASUS Vivobook 15 F1504ZA Core i3 15.6-inch FHD Laptop. Category: Asus. Subcategory: All Laptop. Price: 52,500৳.
",163,18156,18319
138,sentence,"Subcategory: All Laptop. Price: 52,500৳.

Product: ASUS Vivobook 15 F1504ZA Core i3 12th Gen 15.6"" FHD Laptop Cool Silver. Category: Asus. Subcategory: All Laptop. Price: 52,500৳.
",180,18278,18458
139,sentence,"Subcategory: All Laptop. Price: 52,500৳.

Product: ASUS Vivobook 15 F1504ZA Core i3 12th Gen 512GB SSD 15.6"" FHD Laptop. Category: Asus. Subcategory: All Laptop. Price: 52,500৳.
",178,18417,18595
140,sentence,"Subcategory: All Laptop. Price: 52,500৳.

Product: ASUS VivoBook 15 X515EA Core i3 11th Gen 512GB SSD 15.6"" FHD Laptop. Category: Asus. Subcategory: All Laptop. Price: 55,000৳.
",177,18554,18731
141,sentence,"Subcategory: All Laptop. Price: 55,000৳.

Product: ASUS Vivobook 15 X1504VA Core i3 13th Gen 15.6"" FHD Laptop. Category: Asus. Subcategory: All Laptop. Price: 54,500৳57,500৳.
",175,18690,18865
142,sentence,"Subcategory: All Laptop. Price: 54,500৳57,500৳.

Product: ASUS Vivobook 15 X1504VA Core i3 13th Gen 15.6-inch FHD Laptop. Category: Asus. Subcategory: All Laptop. Price: 57,000৳.
",179,18817,18996
143,sentence,"Subcategory: All Laptop. Price: 57,000৳.

Product: ASUS Vivobook 15 X1504VA Core i3 13th Gen 16GB RAM 15.6"" FHD Laptop. Category: Asus. Subcategory: All Laptop. Price: 56,000৳58,500৳.
",184,18955,19139
144,sentence,"Subcategory: All Laptop. Price: 56,000৳58,500৳.

Product: ASUS Vivobook Go 15 L1504FA Ryzen 5 7520U 15.6"" FHD Laptop. Category: Asus. Subcategory: All Laptop. Price: 59,500৳.
",175,19091,19266
145,sentence,"Subcategory: All Laptop. Price: 59,500৳.

Product: ASUS Vivobook Go 15 L1504FA Ryzen 5 7520U 15.6"" FHD Laptop Cool Silver. Category: Asus. Subcategory: All Laptop. Price: 59,500৳.
",180,19225,19405
146,sentence,"Subcategory: All Laptop. Price: 59,500৳.

Product: ASUS Vivobook Go 15 L1504FA Ryzen 5 7520U 8GB RAM 15.6"" FHD Laptop. Category: Asus. Subcategory: All Laptop. Price: 59,500৳.
",176,19364,19540
147,sentence,"Subcategory: All Laptop. Price: 59,500৳.

Product: ASUS ExpertBook P1 P1403CVA Core i3 13th Gen 14"" FHD Laptop. Category: Asus. Subcategory: All Laptop. Price: 59,500৳.
",169,19499,19668
148,sentence,"Subcategory: All Laptop. Price: 59,500৳.

Product: ASUS Vivobook 15 X1504VA Core i3 15.6-inch FHD Laptop. Category: Asus. Subcategory: All Laptop. Price: 60,800৳.
",163,19627,19790
149,sentence,"Subcategory: All Laptop. Price: 60,800৳.

Product: ASUS Vivobook 15 X1504VA Core i3 512GB SSD 15.6-inch FHD Laptop. Category: Asus. Subcategory: All Laptop. Price: 60,800৳.
",173,19749,19922
150,sentence,"Subcategory: All Laptop. Price: 60,800৳.

Product: ASUS VivoBook 15 X1500EA Core i3 11th Gen 15.6"" FHD Laptop. Category: Asus. Subcategory: All Laptop. Price: 58,000৳62,500৳.
",175,19881,20056
151,sentence,"Subcategory: All Laptop. Price: 58,000৳62,500৳.

Product: Asus VivoBook Go 15 OLED E1504FA Ryzen 3 7320U 15.6"" FHD Laptop. Category: Asus. Subcategory: All Laptop. Price: 63,500৳.
",180,20008,20188
152,sentence,"Subcategory: All Laptop. Price: 63,500৳.

Product: Lenovo IdeaPad Slim 3 15AMN8 Ryzen 3 7320U 15.6"" FHD Laptop. Category: All Laptop. Subcategory: Laptop. Price: 51,500৳.
",171,20147,20318
153,sentence,"Subcategory: Laptop. Price: 51,500৳.

Product: Gigabyte A16 GA6H Core i7 13th Gen 16"" FHD+ WUXGA Nvidia RTX 5050 Gaming Laptop. Category: All Laptop. Subcategory: Laptop. Price: 145,000৳154,000৳.
",196,20281,20477
154,sentence,"Subcategory: Laptop. Price: 145,000৳154,000৳.

Product: Lenovo IdeaPad Slim 3 15ABR8 Ryzen 5 5625U 15.6"" Laptop. Category: All Laptop. Subcategory: Laptop. Price: 61,500৳.
",172,20431,20603
155,sentence,"Subcategory: Laptop. Price: 61,500৳.

Product: Lenovo IdeaPad Slim 3 15ABR8 Ryzen 5 5625U 15.6"" FHD Laptop. Category: All Laptop. Subcategory: Laptop. Price: 61,500৳.
",167,20566,20733
156,sentence,"Subcategory: Laptop. Price: 61,500৳.

Product: Lenovo IdeaPad Slim 3 15ABR8 Ryzen 5 5625U Laptop. Category: All Laptop. Subcategory: Laptop. Price: 63,500৳.
",157,20696,20853
157,sentence,"Subcategory: Laptop. Price: 63,500৳.

Product: Lenovo IdeaPad Slim 3 14ABR8 Ryzen 7 5825U 14"" FHD Laptop. Category: All Laptop. Subcategory: Laptop. Price: 67,500৳.
",165,20816,20981
158,sentence,"Subcategory: Laptop. Price: 67,500৳.

Product: Lenovo IdeaPad Slim 3 15ABR8 Ryzen 7 5825U 15.6 Inch Laptop. Category: All Laptop. Subcategory: Laptop. Price: 66,500৳.
",167,20944,21111
159,sentence,"Subcategory: Laptop. Price: 66,500৳.

Product: Lenovo IdeaPad Slim 3 15ABR8 Ryzen 7 5825U 15.6"" Laptop. Category: All Laptop. Subcategory: Laptop. Price: 72,000৳.
",163,21074,21237
160,sentence,"Subcategory: Laptop. Price: 72,000৳.

Product: Lenovo IdeaPad Slim 3 15ABR8 Ryzen 7 5825U 15.6"" FHD Laptop. Category: All Laptop. Subcategory: Laptop. Price: 72,000৳.
",167,21200,21367
161,sentence,"Subcategory: Laptop. Price: 72,000৳.

Product: Lenovo IdeaPad Flex 5 14ABR8 Ryzen 5 5625U 14"" WUXZA X360 Touch Laptop. Category: All Laptop. Subcategory: Laptop. Price: 85,000৳.
",178,21330,21508
162,sentence,"Subcategory: Laptop. Price: 85,000৳.

Product: Lenovo IdeaPad Slim 3 14AHP10 Ryzen 5 8640HS 14"" WUXGA AI Integrated Laptop. Category: All Laptop. Subcategory: Laptop. Price: 89,000৳.
",183,21471,21654
163,sentence,"Subcategory: Laptop. Price: 89,000৳.

Product: Lenovo IdeaPad Slim 5 13ARP10 Ryzen 7 7735HS 13.3"" WUXGA Laptop. Category: All Laptop. Subcategory: Laptop. Price: 93,000৳.
",171,21617,21788
164,sentence,"Subcategory: Laptop. Price: 93,000৳.

Product: Lenovo IdeaPad Slim 5 16AKP10 Ryzen AI 5 340 16"" 2.8K Laptop. Category: All Laptop. Subcategory: Laptop. Price: 125,000৳.
",169,21751,21920
165,sentence,"Subcategory: Laptop. Price: 125,000৳.

Product: Lenovo IdeaPad Slim 5 14Q8X9 Snapdragon X Plus 14"" WUXGA OLED Copilot+ PC Laptop. Category: All Laptop. Subcategory: Laptop. Price: 125,000৳.
",190,21882,22072
166,sentence,"Subcategory: Laptop. Price: 125,000৳.

Product: Lenovo IdeaPad Slim 5 14AKP10 Ryzen AI 7 350 14"" OLED Laptop. Category: All Laptop. Subcategory: Laptop. Price: Out Of Stock.
",174,22034,22208
167,sentence,"Subcategory: Laptop. Price: Out Of Stock.

Product: Lenovo IdeaPad Slim 5 16AKP10 Ryzen AI 7 350 16"" 2.8K Laptop. Category: All Laptop. Subcategory: Laptop. Price: 160,000৳.
",174,22166,22340
168,sentence,"Subcategory: Laptop. Price: 160,000৳.

Product: Lenovo Yoga Pro 7 14ASP9 Ryzen AI 9 365 14.5"" 2.8K Laptop. Category: All Laptop. Subcategory: Laptop. Price: 205,000৳.
",167,22302,22469
169,sentence,"Subcategory: Laptop. Price: 205,000৳.

Product: Lenovo IdeaPad Slim 3 15AMN8 Ryzen 5 7520U 15.6"" FHD TN Laptop. Category: All Laptop. Subcategory: Laptop. Price: 61,000৳.
",171,22431,22602
170,sentence,"Subcategory: Laptop. Price: 61,000৳.

Product: Lenovo IdeaPad Slim 3 Ryzen 5 7520U 15.6"" FHD IPS Laptop 16GB DDR5 RAM 512GB SSD with 2 Years Warranty. Category: All Laptop. Subcategory: Laptop. ",194,22565,22759
171,sentence,"Category: All Laptop. Subcategory: Laptop. Price: 67,500৳.

Product: Lenovo IdeaPad Slim 3 Ryzen 5 7520U 15.6"" FHD Laptop FingerPrint 16GB DDR5 RAM 512GB SSD Abyss Blue with 2 Years Warranty. ",192,22716,22908
172,sentence,"Category: All Laptop. Subcategory: Laptop. Price: 67,500৳.

Product: Dell Inspiron 15 3520 Core i3 12th Gen 15.6"" FHD Laptop. Category: Dell. Subcategory: All Laptop. Price: 54,000৳.
",183,22908,23091
173,sentence,"Subcategory: All Laptop. Price: 54,000৳.

Product: Dell Inspiron 15 3520 Core i3 12th Gen 15.6"" FHD Laptop (For Business). Category: Dell. Subcategory: All Laptop. Price: 53,000৳.
",180,23050,23230
174,sentence,"Subcategory: All Laptop. Price: 53,000৳.

Product: Dell Inspiron 15 3530 Core i3 13th Gen 15.6"" FHD Laptop (Business Series). Category: Dell. Subcategory: All Laptop. Price: 59,500৳.
",183,23189,23372
175,sentence,"Subcategory: All Laptop. Price: 59,500৳.

Product: Dell Inspiron 3530 Core i3 13th Gen 15.6"" FHD Laptop. Category: Dell. Subcategory: All Laptop. Price: 57,000৳64,500৳.
",169,23331,23500
176,sentence,"Subcategory: All Laptop. Price: 57,000৳64,500৳.

Product: Dell Inspiron 15 3520 Core i5 12th Gen 15.6"" FHD Laptop (For Business). Category: Dell. Subcategory: All Laptop. Price: 65,500৳.
",187,23452,23639
177,sentence,"Subcategory: All Laptop. Price: 65,500৳.

Product: Dell Latitude 3530 Core i3 12th Gen 15.6"" FHD Touch Laptop. Category: Dell. Subcategory: All Laptop. Price: 68,500৳.
",168,23598,23766
178,sentence,"Subcategory: All Laptop. Price: 68,500৳.

Product: Dell Inspiron 15 3530 Core i5 13th Gen 15.6"" FHD Laptop With Finger Print (Business Series). Category: Dell. Subcategory: All Laptop. ",185,23725,23910
179,sentence,"Category: Dell. Subcategory: All Laptop. Price: 67,500৳70,500৳.

Product: Dell Inspiron 3530 Core i5 13th Gen 15.6"" FHD Laptop. Category: Dell. Subcategory: All Laptop. Price: 72,500৳.
",185,23869,24054
180,sentence,"Subcategory: All Laptop. Price: 72,500৳.

Product: Dell Latitude 3440 Core i5 12th Gen 14"" FHD Laptop. Category: Dell. Subcategory: All Laptop. Price: 81,000৳84,500৳.
",167,24013,24180
181,sentence,"Subcategory: All Laptop. Price: 81,000৳84,500৳.

Product: Dell Latitude 3540 Core i5 12th Gen 15.6"" FHD Laptop. Category: Dell. Subcategory: All Laptop. Price: 86,500৳.
",169,24132,24301
182,sentence,"Subcategory: All Laptop. Price: 86,500৳.

Product: Dell Inspiron 14 5440 Core 5 120U 14"" FHD Laptop. Category: Dell. Subcategory: All Laptop. Price: 85,000৳.
",158,24260,24418
183,sentence,"Subcategory: All Laptop. Price: 85,000৳.

Product: Dell Inspiron 14 5440 Intel Core i5 13th Gen 14"" FHD Laptop. Category: Dell. Subcategory: All Laptop. Price: 89,500৳.
",169,24377,24546
184,sentence,"Subcategory: All Laptop. Price: 89,500৳.

Product: Dell Inspiron 15 3530 Core i7 13th Gen 15.6"" FHD Laptop. Category: Dell. Subcategory: All Laptop. Price: 94,000৳.
",165,24505,24670
185,sentence,"Subcategory: All Laptop. Price: 94,000৳.

Product: Dell Inspiron 14 5440 Core 7 150U 14"" FHD Laptop. Category: Dell. Subcategory: All Laptop. Price: 115,000৳.
",159,24629,24788
186,sentence,"Subcategory: All Laptop. Price: 115,000৳.

Product: Dell Latitude 5450 Core Ultra 5 125U 14"" FHD Laptop. Category: Dell. Subcategory: All Laptop. Price: 132,000৳.
",163,24746,24909
187,sentence,"Subcategory: All Laptop. Price: 132,000৳.

Product: Dell XPS 13 9340 Intel Core Ultra 7 155H 13.4"" FHD+ Laptop. Category: Dell. Subcategory: All Laptop. Price: 235,000৳.
",170,24867,25037
188,sentence,"Subcategory: All Laptop. Price: 235,000৳.

Product: Dell XPS 13 Plus 9320 Intel Core i7 13th Gen 13.4"" 3.5K OLED Touch Laptop. Category: Dell. Subcategory: All Laptop. Price: 297,000৳.
",185,24995,25180
189,sentence,"Subcategory: All Laptop. Price: 297,000৳.

Product: Dell Inspiron 15 3520 Core i5 12th Gen 15.6"" FHD Laptop. Category: Dell. Subcategory: All Laptop. Price: Up Coming.
",168,25138,25306
190,sentence,"Subcategory: All Laptop. Price: Up Coming.

Product: Dell Latitude 3430 Core i3 12th Gen 14"" FHD Laptop. Category: Dell. Subcategory: All Laptop. Price: Out Of Stock.
",167,25263,25430
191,sentence,"Subcategory: All Laptop. Price: Out Of Stock.

Product: Dell Vostro 3530 Core i3 13th Gen 15.6"" FHD Laptop. Category: Dell. Subcategory: All Laptop. Price: Out Of Stock.
",170,25384,25554
192,sentence,"Subcategory: All Laptop. Price: Out Of Stock.

Product: Lenovo IdeaPad Slim 3 Ryzen 5 7520U 14"" FHD Laptop FingerPrint 16GB DDR5 RAM 512GB SSD with 2 Years Warranty. Category: Lenovo. ",184,25508,25692
193,sentence,"Category: Lenovo. Subcategory: All Laptop. Price: 67,500৳.

Product: Smart Flairedge Celeron N4020C 15.6"" FHD Laptop. Category: Smart. Subcategory: All Laptop. Price: 29,400৳.
",176,25674,25850
194,sentence,"Subcategory: All Laptop. Price: 29,400৳.

Product: Smart Flairedge Ryzen 3 3200U 15.6"" FHD Laptop. Category: Smart. Subcategory: All Laptop. Price: 37,800৳.
",157,25809,25966
195,sentence,"Subcategory: All Laptop. Price: 37,800৳.

Product: Smart Flairedge Ryzen 5 3500U 15.6"" FHD Laptop. Category: Smart. Subcategory: All Laptop. Price: 41,400৳.
",157,25925,26082
196,sentence,"Subcategory: All Laptop. Price: 41,400৳.

Product: Smart Flairedge Core i3 12th Gen 15.6"" FHD Laptop. Category: Smart. Subcategory: All Laptop. Price: 44,000৳.
",160,26041,26201
197,sentence,"Subcategory: All Laptop. Price: 44,000৳.

Product: Smart Flairedge Core i3 13th Gen 15.6"" FHD Laptop. Category: Smart. Subcategory: All Laptop. Price: 48,000৳.
",160,26160,26320
198,sentence,"Subcategory: All Laptop. Price: 48,000৳.

Product: Smart Flairedge Core i5 12th Gen 15.6"" FHD Laptop. Category: Smart. Subcategory: All Laptop. Price: 53,000৳.
",160,26279,26439
199,sentence,"Subcategory: All Laptop. Price: 53,000৳.

Product: Smart Flairedge Core i5 13th Gen 15.6"" FHD Laptop. Category: Smart. Subcategory: All Laptop. Price: 57,500৳.
",160,26398,26558
200,sentence,"Subcategory: All Laptop. Price: 57,500৳.

Product: Smart Flairedge Core i7 12th Gen 15.6"" FHD Laptop. Category: Smart. Subcategory: All Laptop. Price: 66,500৳.
",160,26517,26677
201,sentence,"Subcategory: All Laptop. Price: 66,500৳.

Product: Smart Flairedge Core i7 12th Gen 16"" FHD Laptop. Category: Smart. Subcategory: All Laptop. Price: 66,500৳.
",158,26636,26794
202,sentence,"Subcategory: All Laptop. Price: 66,500৳.

Product: Acer Aspire 3 A325-45 Celeron N4500 15.6 Inch HD Laptop. Category: Acer. Subcategory: All Laptop. Price: 32,000৳34,500৳.
",172,26753,26925
203,sentence,"Subcategory: All Laptop. Price: 32,000৳34,500৳.

Product: Acer Aspire Lite AL15-41 AMD Ryzen 3 5300U 15.6"" FHD Laptop. Category: Acer. Subcategory: All Laptop. Price: 45,500৳47,500৳.
",183,26877,27060
204,sentence,"Subcategory: All Laptop. Price: 45,500৳47,500৳.

Product: Acer Aspire Lite AL15-52 Core i3 12th Gen 16GB RAM 15.6"" FHD Laptop. Category: Acer. Subcategory: All Laptop. Price: 51,900৳.
",184,27012,27196
205,sentence,"Subcategory: All Laptop. Price: 51,900৳.

Product: Acer Aspire 3 A325-53 Core i3 13th Gen 15.6"" FHD Laptop. Category: Acer. Subcategory: All Laptop. Price: 53,900৳.
",165,27155,27320
206,sentence,"Subcategory: All Laptop. Price: 53,900৳.

Product: Acer TravelLite TL14-52M Core i3 13th Gen 8GB RAM 512GB Storage 14"" FHD Laptop. Category: Acer. Subcategory: All Laptop. Price: 56,000৳.
",188,27279,27467
207,sentence,"Subcategory: All Laptop. Price: 56,000৳.

Product: Acer Aspire Lite AL15-41 AMD Ryzen 5 5500U 15.6"" FHD Laptop. Category: Acer. Subcategory: All Laptop. Price: 56,000৳.
",169,27426,27595
208,sentence,"Subcategory: All Laptop. Price: 56,000৳.

Product: Acer Aspire Lite AL15-41 AMD Ryzen 5 5625U 15.6"" FHD Laptop. Category: Acer. Subcategory: All Laptop. Price: 56,500৳.
",169,27554,27723
209,sentence,"Subcategory: All Laptop. Price: 56,500৳.

Product: Acer Aspire Lite AL15-41 AMD Ryzen 5 7430U 15.6"" FHD Laptop. Category: Acer. Subcategory: All Laptop. Price: 55,000৳58,500৳.
",176,27682,27858
210,sentence,"Subcategory: All Laptop. Price: 55,000৳58,500৳.

Product: Acer Aspire 3 A325-53 Core i5 13th Gen 15.6"" FHD Laptop. Category: Acer. Subcategory: All Laptop. Price: 64,900৳.
",172,27810,27982
211,sentence,"Subcategory: All Laptop. Price: 64,900৳.

Product: Acer TravelMate P2 TMP215-54 Core i5 12th Gen 15.6"" FHD Laptop. Category: Acer. Subcategory: All Laptop. Price: 66,500৳.
",172,27941,28113
212,sentence,"Subcategory: All Laptop. Price: 66,500৳.

Product: Acer TravelMate TMP214-54 Core i5 12th Gen 14"" FHD Laptop. Category: Acer. Subcategory: All Laptop. Price: 66,800৳.
",167,28072,28239
213,sentence,"Subcategory: All Laptop. Price: 66,800৳.

Product: Acer TravelLite TL14-52M Core i5 13th Gen 8GB RAM 512GB Storage 14"" FHD Laptop. Category: Acer. Subcategory: All Laptop. Price: 75,500৳.
",188,28198,28386
214,sentence,"Subcategory: All Laptop. Price: 75,500৳.

Product: Acer Aspire Vero AV14-52P Core i5 13th Gen 14"" FHD Laptop. Category: Acer. Subcategory: All Laptop. Price: 94,000৳.
",167,28345,28512
215,sentence,"Subcategory: All Laptop. Price: 94,000৳.

Product: Acer Nitro V 15 ANV15-51 Core i5 13th Gen 15.6"" FHD Gaming Laptop. Category: Acer. Subcategory: All Laptop. Price: 125,000৳.
",176,28471,28647
216,sentence,"Subcategory: All Laptop. Price: 125,000৳.

Product: Acer Swift Go 14 SFG14-73 Core Ultra 5 125H 14"" WQXGA+ OLED AI Laptop. Category: Acer. Subcategory: All Laptop. Price: 121,000৳.
",181,28605,28786
217,sentence,"Subcategory: All Laptop. Price: 121,000৳.

Product: Acer Swift Go 14 SFG14-73T Core Ultra 7 155H 16GB RAM 1TB SSD 14"" WUXGA Touch Laptop. Category: Acer. Subcategory: All Laptop. Price: 141,000৳.
",196,28744,28940
218,sentence,"Subcategory: All Laptop. Price: 141,000৳.

Product: Acer Swift Go 14 SFG14-73 Core Ultra 7 155H 14"" WQXGA+ OLED AI Laptop. Category: Acer. Subcategory: All Laptop. Price: 148,500৳.
",181,28898,29079
219,sentence,"Subcategory: All Laptop. Price: 148,500৳.

Product: Acer Predator Helios Neo 16 PH16-72-74W1 Core i7 14th Gen 16"" Gaming Laptop. Category: Acer. Subcategory: All Laptop. Price: 205,000৳.
",187,29037,29224
220,sentence,"Subcategory: All Laptop. Price: 205,000৳.

Product: Acer Aspire Lite AL15-52 Core i3 12th Gen 15.6"" FHD Laptop. Category: Acer. Subcategory: All Laptop. Price: Out Of Stock.
",174,29182,29356
221,sentence,"Subcategory: All Laptop. Price: Out Of Stock.

Product: Acer Aspire Lite AL15-52 Core i5 12th Gen 15.6"" FHD Laptop With Backlit Keyboard. Category: Acer. Subcategory: All Laptop. ",179,29310,29489
222,sentence,"Category: Acer. Subcategory: All Laptop. Price: Out Of Stock.

Product: MSI Modern 15 F13MG Core i3 13th Gen 16GB RAM 15.6"" FHD Laptop Platinum Gray. Category: MSI. Subcategory: All Laptop. ",190,29448,29638
223,sentence,"Category: MSI. Subcategory: All Laptop. Price: 55,500৳58,500৳.

Product: MSI Modern 15 F13MG Core i3 13th Gen 15.6"" FHD Laptop Platinum Gray. Category: MSI. Subcategory: All Laptop. Price: 56,500৳.
",198,29598,29796
224,sentence,"Subcategory: All Laptop. Price: 56,500৳.

Product: MSI Modern 15 F13MG Core i3 13th Gen 15.6"" FHD Laptop Urban Silver. Category: MSI. Subcategory: All Laptop. Price: 56,500৳.
",175,29755,29930
225,sentence,"Subcategory: All Laptop. Price: 56,500৳.

Product: MSI Modern 15 F13MG Core i3 13th Gen 16GB RAM 15.6"" FHD Laptop Urban Silver. Category: MSI. Subcategory: All Laptop. Price: 55,500৳58,500৳.
",191,29889,30080
226,sentence,"Subcategory: All Laptop. Price: 55,500৳58,500৳.

Product: MSI Modern 14 F13MG Core i3 13th Gen 16GB RAM 14"" FHD Laptop Urban Silver. Category: MSI. Subcategory: All Laptop. Price: 55,500৳58,500৳.
",196,30032,30228
227,sentence,"Subcategory: All Laptop. Price: 55,500৳58,500৳.

Product: MSI Modern 14 F13MG Core i3 13th Gen 14"" FHD Laptop Urban Silver. Category: MSI. Subcategory: All Laptop. Price: 56,500৳.
",180,30180,30360
228,sentence,"Subcategory: All Laptop. Price: 56,500৳.

Product: MSI Modern 14 F13MG Core i3 13th Gen 14"" FHD Laptop Platinum Gray. Category: MSI. Subcategory: All Laptop. Price: 56,500৳.
",174,30319,30493
229,sentence,"Subcategory: All Laptop. Price: 56,500৳.

Product: MSI Modern 14 F13MG Core i3 13th Gen 16GB RAM 14"" FHD Laptop Platinum Gray. Category: MSI. Subcategory: All Laptop. Price: 55,500৳58,500৳.
",190,30452,30642
230,sentence,"Subcategory: All Laptop. Price: 55,500৳58,500৳.

Product: MSI Modern 14 C7M AMD Ryzen 5 7430U 14"" FHD Laptop. Category: MSI. Subcategory: All Laptop. Price: 66,000৳68,000৳.
",173,30594,30767
231,sentence,"Subcategory: All Laptop. Price: 66,000৳68,000৳.

Product: MSI Modern 15 B7M AMD Ryzen 5 7430U 15.6"" FHD Laptop. Category: MSI. Subcategory: All Laptop. Price: 66,000৳68,000৳.
",175,30719,30894
232,sentence,"Subcategory: All Laptop. Price: 66,000৳68,000৳.

Product: MSI Modern 14 F13MG Core i5 13th Gen 14"" FHD Laptop Urban Silver. Category: MSI. Subcategory: All Laptop. Price: 69,500৳.
",180,30846,31026
233,sentence,"Subcategory: All Laptop. Price: 69,500৳.

Product: MSI Modern 15 F13MG Core i5 13th Gen 15.6"" FHD Laptop Urban Silver. Category: MSI. Subcategory: All Laptop. Price: 72,000৳.
",175,30985,31160
234,sentence,"Subcategory: All Laptop. Price: 72,000৳.

Product: MSI Modern 15 B7M Ryzen 7 7730U 15.6"" FHD Laptop. Category: MSI. Subcategory: All Laptop. Price: 72,000৳77,500৳.
",164,31119,31283
235,sentence,"Subcategory: All Laptop. Price: 72,000৳77,500৳.

Product: MSI Modern 15 F1MG Core 5 120U AI Optimized 15.6"" FHD Laptop Urban Silver. Category: MSI. Subcategory: All Laptop. Price: 78,900৳.
",189,31235,31424
236,sentence,"Subcategory: All Laptop. Price: 78,900৳.

Product: MSI Modern 14 C7M Ryzen 7 7730U 14"" Laptop. Category: MSI. Subcategory: All Laptop. Price: 77,500৳79,000৳.
",158,31383,31541
237,sentence,"Subcategory: All Laptop. Price: 77,500৳79,000৳.

Product: MSI Modern 15 B7M Ryzen 7 7730U 16GB RAM 15.6"" FHD Laptop Classic Black. Category: MSI. Subcategory: All Laptop. Price: 77,500৳79,000৳.
",194,31493,31687
238,sentence,"Subcategory: All Laptop. Price: 77,500৳79,000৳.

Product: MSI Modern 15 F1MG Core 5 120U AI Optimized 15.6"" FHD Laptop Platinum Gray. Category: MSI. Subcategory: All Laptop. Price: 79,500৳.
",190,31639,31829
239,sentence,"Subcategory: All Laptop. Price: 79,500৳.

Product: MSI Modern 14 F13MG Core i7 13th Gen 14"" FHD Laptop Platinum Gray. Category: MSI. Subcategory: All Laptop. Price: 87,900৳.
",174,31788,31962
240,sentence,"Subcategory: All Laptop. Price: 87,900৳.

Product: MSI Modern 14 F13MG Core i7 13th Gen 14"" FHD Laptop Urban Silver. Category: MSI. Subcategory: All Laptop. Price: 87,900৳.
",173,31921,32094
241,sentence,"Subcategory: All Laptop. Price: 87,900৳.

Product: MSI Thin 15 B13UC Core i5 13th Gen RTX 3050 4GB Graphics 15.6"" FHD Gaming Laptop. Category: MSI. Subcategory: All Laptop. Price: 89,900৳.
",189,32053,32242
242,sentence,"Subcategory: All Laptop. Price: 89,900৳.

Product: Apple MacBook Air (2022) M2 Chip 13.6-Inch Liquid Retina Display 16GB RAM 256GB SSD Midnight #MC7X4ZP/A. Category: MacBook. ",175,32201,32376
243,sentence,"Category: MacBook. Subcategory: All Laptop. Price: 101,000৳107,000৳.

Product: Apple MacBook Air 13 inch M4 Liquid Retina Display 16GB RAM 256GB SSD Midnight #MW123. Category: MacBook. ",185,32357,32542
244,sentence,"Category: MacBook. Subcategory: All Laptop. Price: 125,000৳130,000৳.

Product: Apple MacBook Air 13 inch M4 Liquid Retina Display 16GB RAM 256GB SSD Sky Blue #MC6T4. Category: MacBook. ",185,32523,32708
245,sentence,"Category: MacBook. Subcategory: All Laptop. Price: 125,000৳130,000৳.

Product: Apple MacBook Air 13 inch M4 Liquid Retina Display 16GB RAM 256GB SSD Starlight. Category: MacBook. ",179,32689,32868
246,sentence,"Category: MacBook. Subcategory: All Laptop. Price: 125,000৳130,000৳.

Product: Apple MacBook Air 13 inch M4 Liquid Retina Display 16GB RAM 256GB SSD Silver #MW0W3. Category: MacBook. ",183,32849,33032
247,sentence,"Category: MacBook. Subcategory: All Laptop. Price: 130,000৳136,000৳.

Product: Apple MacBook Air 13 inch M4 Liquid Retina Display 16GB RAM 512GB SSD Sky Blue. Category: MacBook. ",178,33013,33191
248,sentence,"Category: MacBook. Subcategory: All Laptop. Price: 160,000৳162,000৳.

Product: Apple MacBook Air 13 inch M4 Liquid Retina Display 16GB RAM 512GB SSD Midnight. Category: MacBook. ",178,33172,33350
249,sentence,"Category: MacBook. Subcategory: All Laptop. Price: 159,000৳162,000৳.

Product: Apple MacBook Air 15 inch M4 Liquid Retina Display 16GB RAM 256GB SSD Midnight #MW1L3. Category: MacBook. ",185,33331,33516
250,sentence,"Category: MacBook. Subcategory: All Laptop. Price: 160,000৳162,000৳.

Product: Apple MacBook Air 13 inch M4 Liquid Retina Display 16GB RAM 512GB SSD Silver. Category: MacBook. ",176,33497,33673
251,sentence,"Category: MacBook. Subcategory: All Laptop. Price: 159,000৳162,000৳.

Product: Apple MacBook Air 15 inch M4 Liquid Retina Display 16GB RAM 256GB SSD Sky Blue. Category: MacBook. ",178,33654,33832
252,sentence,"Category: MacBook. Subcategory: All Laptop. Price: 160,000৳162,000৳.

Product: Apple MacBook Air 13 inch M4 Liquid Retina Display 16GB RAM 512GB SSD Starlight. Category: MacBook. ",179,33813,33992
253,sentence,"Category: MacBook. Subcategory: All Laptop. Price: 168,000৳175,000৳.

Product: Apple MacBook Air 15 inch M4 Liquid Retina Display 16GB RAM 512GB SSD Midnight. Category: MacBook. ",178,33973,34151
254,sentence,"Category: MacBook. Subcategory: All Laptop. Price: 192,000৳.

Product: Apple MacBook Air 15 inch M4 Liquid Retina Display 16GB RAM 512GB SSD Starlight. Category: MacBook. Subcategory: All Laptop. ",196,34132,34328
255,sentence,"Category: MacBook. Subcategory: All Laptop. Price: 195,000৳198,000৳.

Product: Apple MacBook Air 15 inch M4 Liquid Retina Display 16GB RAM 512GB SSD Sky Blue. Category: MacBook. ",178,34284,34462
256,sentence,"Category: MacBook. Subcategory: All Laptop. Price: 192,000৳.

Product: Apple MacBook Air 13 inch M4 Liquid Retina Display 24GB RAM 512GB SSD Sky Blue. Category: MacBook. Subcategory: All Laptop. ",195,34443,34638
257,sentence,"Category: MacBook. Subcategory: All Laptop. Price: 187,000৳195,000৳.

Product: Apple MacBook Air 13 inch M4 Liquid Retina Display 24GB RAM 512GB SSD Starlight. Category: MacBook. ",179,34594,34773
258,sentence,"Category: MacBook. Subcategory: All Laptop. Price: 192,000৳199,000৳.

Product: Apple MacBook Pro 14 inch M4 Chip Liquid Retina XDR Display 16GB RAM 512GB SSD Space Black. Category: MacBook. ",190,34754,34944
259,sentence,"Category: MacBook. Subcategory: All Laptop. Price: 204,500৳215,000৳.

Product: Apple MacBook Pro 14 inch M4 Chip Liquid Retina XDR Display 16GB RAM 512GB SSD Silver #MW2W3. Category: MacBook. ",192,34925,35117
260,sentence,"Category: MacBook. Subcategory: All Laptop. Price: 204,500৳215,000৳.

Product: Apple MacBook Pro 14 inch M4 Chip Liquid Retina XDR Display 16GB RAM 1TB SSD Space Black. Category: MacBook. ",188,35098,35286
261,sentence,"Category: MacBook. Subcategory: All Laptop. Price: 238,000৳.

Product: Apple MacBook Pro 14 inch M4 Chip Liquid Retina XDR Display 16GB RAM 1TB SSD Silver. Category: MacBook. ",175,35267,35442
262,sentence,"Category: MacBook. Subcategory: All Laptop. Price: 238,000৳.

Product: HP 15-fc0266AU Ryzen 3 7320U 15.6"" FHD Laptop. Category: HP. Subcategory: All Laptop. Price: 51,500৳.
",173,35423,35596
263,sentence,"Subcategory: All Laptop. Price: 51,500৳.

Product: HP 14s-dq3139TU Intel Celeron N4500 14"" FHD Laptop. Category: HP. Subcategory: All Laptop. Price: 37,500৳39,500৳.
",165,35555,35720
264,sentence,"Subcategory: All Laptop. Price: 37,500৳39,500৳.

Product: HP 15-fc0239AU AMD Athlon Silver 7120U 15.6"" FHD Laptop. Category: HP. Subcategory: All Laptop. Price: 42,000৳.
",170,35672,35842
265,sentence,"Subcategory: All Laptop. Price: 42,000৳.

Product: HP 15-fc0238AU AMD Athlon Silver 7120U 15.6"" FHD Laptop. Category: HP. Subcategory: All Laptop. Price: 43,500৳.
",163,35801,35964
266,sentence,"Subcategory: All Laptop. Price: 43,500৳.

Product: HP 15s-eq2330AU AMD Ryzen 3 5300U 15.6"" FHD Laptop. Category: HP. Subcategory: All Laptop. Price: 51,000৳53,000৳.
",165,35923,36088
267,sentence,"Subcategory: All Laptop. Price: 51,000৳53,000৳.

Product: HP 250 G9 Core i3 12th Gen 15.6"" HD DDR4 RAM Laptop With 1 Year Warranty. Category: HP. Subcategory: All Laptop. Price: 53,500৳.
",187,36040,36227
268,sentence,"Subcategory: All Laptop. Price: 53,500৳.

Product: HP 255 G9 Ryzen 5 5625U 15.6"" HD Laptop With 2 Year Warranty. Category: HP. Subcategory: All Laptop. Price: 57,000৳.
",168,36186,36354
269,sentence,"Subcategory: All Laptop. Price: 57,000৳.

Product: HP 15-fc0166AU Ryzen 5 7520U 15.6"" FHD Laptop With Fingerprint. Category: HP. Subcategory: All Laptop. Price: 63,500৳.
",170,36313,36483
270,sentence,"Subcategory: All Laptop. Price: 63,500৳.

Product: HP 15-fc0333AU Ryzen 5 7520U 15.6"" FHD Laptop. Category: HP. Subcategory: All Laptop. Price: 63,500৳.
",153,36442,36595
271,sentence,"Subcategory: All Laptop. Price: 63,500৳.

Product: HP 15-fd1108TU Core 3 100U 15.6"" FHD Laptop. Category: HP. Subcategory: All Laptop. Price: 63,800৳.
",151,36554,36705
272,sentence,"Subcategory: All Laptop. Price: 63,800৳.

Product: HP 15-fd1110TU Core 3 100U 15.6"" FHD Laptop. Category: HP. Subcategory: All Laptop. Price: 63,800৳.
",151,36664,36815
273,sentence,"Subcategory: All Laptop. Price: 63,800৳.

Product: HP 15-fc0229AU Ryzen 5 7520U 15.6"" FHD Laptop. Category: HP. Subcategory: All Laptop. Price: 59,500৳65,500৳.
",160,36774,36934
274,sentence,"Subcategory: All Laptop. Price: 59,500৳65,500৳.

Product: HP 15-fd0268TU Core i5 13th Gen 15.6"" FHD Laptop with Original Windows & Office. Category: HP. Subcategory: All Laptop. ",178,36886,37064
275,sentence,"Category: HP. Subcategory: All Laptop. Price: 70,000৳72,800৳.

Product: HP 15-fc0170AU Ryzen 7 7730U 15.6"" FHD Laptop. Category: HP. Subcategory: All Laptop. Price: 72,500৳.
",174,37025,37199
276,sentence,"Subcategory: All Laptop. Price: 72,500৳.

Product: HP 14-ep0200TU Core i5 13th Gen 14"" FHD Laptop With Backlit Keyboard. Category: HP. Subcategory: All Laptop. Price: 70,000৳74,000৳.
",183,37158,37341
277,sentence,"Subcategory: All Laptop. Price: 70,000৳74,000৳.

Product: HP 15-fd1112TU Intel Core 5 120U 15.6"" FHD Laptop. Category: HP. Subcategory: All Laptop. Price: 75,000৳76,500৳.
",171,37293,37464
278,sentence,"Subcategory: All Laptop. Price: 75,000৳76,500৳.

Product: HP 15-fd1113TU Intel Core 5 120U 15.6"" FHD Laptop. Category: HP. Subcategory: All Laptop. Price: 76,500৳.
",164,37416,37580
279,sentence,"Subcategory: All Laptop. Price: 76,500৳.

Product: HP 15-fd1191TU Intel Core 5 120U 15.6"" FHD Laptop. Category: HP. Subcategory: All Laptop. Price: 80,000৳.
",157,37539,37696
280,sentence,"Subcategory: All Laptop. Price: 80,000৳.

Product: HP ProBook 440 G10 Core i5 13th Gen 14"" FHD Laptop. Category: HP. Subcategory: All Laptop. Price: 93,000৳.
",158,37655,37813
281,sentence,"Subcategory: All Laptop. Price: 93,000৳.

Product: HP ProBook 450 G10 Core i5 13th Gen 15.6"" FHD Laptop. Category: HP. Subcategory: All Laptop. Price: Out Of Stock.
",165,37772,37937
282,sentence,"Subcategory: All Laptop. Price: Out Of Stock.

Product: Infinix INBook X2 Core i5 11th Gen 14"" FHD Laptop. Category: Infinix. Subcategory: All Laptop. Price: Out Of Stock.
",172,37891,38063
283,sentence,"Subcategory: All Laptop. Price: Out Of Stock.

Product: Walton Prelude N41 Pro Celeron N4120 14"" FHD Laptop. Category: Walton. Subcategory: All Laptop. Price: 25,500৳29,500৳.
",175,38017,38192
284,sentence,"Subcategory: All Laptop. Price: 25,500৳29,500৳.

Product: Walton Prelude N50 Pro Pentium Silver N5030 14"" FHD Laptop. Category: Walton. Subcategory: All Laptop. Price: 28,550৳32,000৳.
",184,38144,38328
285,sentence,"Subcategory: All Laptop. Price: 28,550৳32,000৳.

Product: Walton Tamarind MX311G Core i3 11th Gen 14"" FHD Laptop. Category: Walton. Subcategory: All Laptop. Price: 39,550৳42,500৳.
",180,38280,38460
286,sentence,"Subcategory: All Laptop. Price: 39,550৳42,500৳.

Product: Walton Tamarind MX511G Core i5 11th Gen 14"" FHD Laptop. Category: Walton. Subcategory: All Laptop. Price: 55,500৳.
",173,38412,38585
287,sentence,"Subcategory: All Laptop. Price: 55,500৳.

Product: Walton Tamarind MX711G Core i7 11th Gen 14"" FHD Laptop. Category: Walton. Subcategory: All Laptop. Price: 58,550৳65,500৳.
",173,38544,38717
288,sentence,"Subcategory: All Laptop. Price: 58,550৳65,500৳.

Product: Walton Passion BX710U Core i7 10th Gen 15.6"" FHD Laptop. Category: Walton. Subcategory: All Laptop. Price: 67,500৳77,850৳.
",181,38669,38850
289,sentence,"Subcategory: All Laptop. Price: 67,500৳77,850৳.

Product: Walton ACC PASSION BX513U Pro Core i5 13th Gen 16GB RAM 16"" 2.5K IPS Display Laptop. Category: Walton. Subcategory: All Laptop. ",186,38802,38988
290,sentence,"Category: Walton. Subcategory: All Laptop. Price: 85,550৳.

Product: Walton ACC TAMARIND EX514H Core Ultra 5 14"" 2.8K IPS 120Hz Display Laptop. Category: Walton. Subcategory: All Laptop. ",187,38945,39132
291,sentence,"Category: Walton. Subcategory: All Laptop. Price: 112,550৳.

Product: Walton ACC KARONDA GX713H Core i7 13th Gen RTX 4050 6GB Graphics 15.3"" 2.5K Gaming Laptop. Category: Walton. ",179,39089,39268
292,sentence,"Category: Walton. Subcategory: All Laptop. Price: 137,750৳.

Product: Walton ACC WAXJAMBU GL714HX Core i7 14th Gen RTX 4060 8GB Graphics 16"" 2.5K 240Hz Gaming Laptop. Category: Walton. ",185,39250,39435
293,sentence,"Category: Walton. Subcategory: All Laptop. Price: 162,550৳.

Product: Walton Passion BX311G Core i3 11th Gen 15.6"" FHD Laptop. Category: Walton. Subcategory: All Laptop. Price: 36,200৳38,750৳.
",193,39417,39610
294,sentence,"Subcategory: All Laptop. Price: 36,200৳38,750৳.

Product: Microsoft Surface Laptop 5 Core i5 12th Gen 8GB RAM 512GB SSD 13.5"" QHD Multi-Touch Laptop (R1S-00026). Category: Microsoft. ",183,39562,39745
295,sentence,"Category: Microsoft. Subcategory: All Laptop. Price: 149,500৳.

Product: Microsoft Surface Laptop 7 Copilot+ PC 7th Edition Copilot Plus & AI Optimized Platinum Laptop. Category: Microsoft. ",190,39724,39914
296,sentence,"Category: Microsoft. Subcategory: All Laptop. Price: 195,000৳.

Product: Microsoft Surface Laptop 7th Edition Snapdragon X Plus 12 Core Copilot+ & AI Optimized Laptop Black. Category: Microsoft. ",195,39893,40088
297,sentence,"Category: Microsoft. Subcategory: All Laptop. Price: 195,000৳.

Product: Microsoft Surface Laptop 7th Edition Snapdragon X Plus 12 Core 256GB SSD 13.8"" 120Hz Touch Copilot+ PC Laptop. ",184,40067,40251
298,sentence,"Category: Microsoft. Subcategory: All Laptop. Price: 170,000৳.

Product: Microsoft Surface Pro 9 Core i7 12th Gen 16GB RAM 512GB SSD 13"" 120Hz Touch Laptop Graphite (VQ1-00001). Category: Microsoft. ",199,40251,40450
299,sentence,"Category: Microsoft. Subcategory: All Laptop. Price: 215,000৳.

Product: Microsoft Surface Pro 10 Core Ultra 5 135U 13"" 120Hz Touch Laptop. Category: Microsoft. Subcategory: All Laptop. ",186,40429,40615
300,sentence,"Category: Microsoft. Subcategory: All Laptop. Price: 215,000৳.

Product: Microsoft Surface Pro 9 Core i7 12th Gen 13"" Touch Laptop. Category: Microsoft. Subcategory: All Laptop. Price: Out Of Stock.
",199,40569,40768
301,sentence,"Subcategory: All Laptop. Price: Out Of Stock.

Product: Microsoft Surface Laptop 7th Edition Snapdragon X Plus 10 Core 13.8"" 120Hz Touch Copilot+ PC Laptop. Category: Microsoft. ",178,40722,40900
302,sentence,"Category: Microsoft. Subcategory: All Laptop. Price: Out Of Stock.

Product: Microsoft Surface Pro 10 Core Ultra 7 165U 13"" 120Hz Touch Laptop. Category: Microsoft. Subcategory: All Laptop. ",190,40879,41069
303,sentence,"Category: Microsoft. Subcategory: All Laptop. Price: Out Of Stock.

Product: Microsoft Surface Pro 11th Edition Snapdragon X Elite 13"" OLED 120Hz Copilot+ PC Touch Laptop. Category: Microsoft. ",193,41023,41216
304,sentence,"Category: Microsoft. Subcategory: All Laptop. Price: Out Of Stock.

Product: Microsoft Surface Laptop Studio 2 Core i7 13th Gen 16GB RAM 512GB SSD 14.4"" Touch Laptop (ZRF-00001). ",179,41195,41374
305,sentence,"Category: Microsoft. Subcategory: All Laptop. Price: Up Coming.

Product: Chuwi HeroBook Pro Intel Celeron N4020 14.1 inch Full HD Laptop with Windows 11. Category: Chuwi. Subcategory: All Laptop. ",197,41374,41571
306,sentence,"Category: Chuwi. Subcategory: All Laptop. Price: 27,900৳.

Product: Chuwi HeroBook Plus Intel N4020 15.6"" Inch FHD Laptop. Category: Chuwi. Subcategory: All Laptop. Price: 28,000৳30,500৳.
",188,41529,41717
307,sentence,"Subcategory: All Laptop. Price: 28,000৳30,500৳.

Product: Chuwi GemiBook XPro Intel Celeron N150 12th Gen 14.1 inch Full HD Laptop. Category: Chuwi. Subcategory: All Laptop. Price: 34,900৳.
",190,41669,41859
308,sentence,"Subcategory: All Laptop. Price: 34,900৳.

Product: Chuwi GemiBook Plus Intel Celeron N100 15.6 inch Full HD Laptop. Category: Chuwi. Subcategory: All Laptop. Price: 35,000৳.
",174,41818,41992
309,sentence,"Subcategory: All Laptop. Price: 35,000৳.

Product: Chuwi GemiBook Plus Intel Celeron N150 15.6 inch Full HD Laptop. Category: Chuwi. Subcategory: All Laptop. Price: 39,900৳.
",174,41951,42125
310,sentence,"Subcategory: All Laptop. Price: 39,900৳.

Product: Chuwi MiniBook X Intel Celeron N150 10.5"" FHD+ Touch Laptop. Category: Chuwi. Subcategory: All Laptop. Price: 49,500৳.
",170,42084,42254
311,sentence,"Subcategory: All Laptop. Price: 49,500৳.

Product: Chuwi CoreBook X Core i3 12th Gen 14"" 2K QHD Laptop. Category: Chuwi. Subcategory: All Laptop. Price: 51,900৳.
",162,42213,42375
312,sentence,"Subcategory: All Laptop. Price: 51,900৳.

Product: Chuwi CoreBook X Ryzen 5 7430U 14"" 2K QHD Laptop. Category: Chuwi. Subcategory: All Laptop. Price: 54,900৳.
",159,42334,42493
313,sentence,"Subcategory: All Laptop. Price: 54,900৳.

Product: Chuwi FreeBook Celeron N150 13th Gen 13.5"" 2K Touch Laptop. Category: Chuwi. Subcategory: All Laptop. Price: Up Coming.
",171,42452,42623
314,sentence,"Subcategory: All Laptop. Price: Up Coming.

Product: Chuwi GemiBook XPro Intel Celeron N100 14.1 inch Full HD Laptop. Category: Chuwi. Subcategory: All Laptop. Price: Out Of Stock.
",181,42580,42761
315,sentence,"Subcategory: All Laptop. Price: Out Of Stock.

Product: Chuwi CoreBook XPro Intel core i3 15.6"" FHD Laptop. Category: Chuwi. Subcategory: All Laptop. Price: Out Of Stock.
",171,42715,42886
316,sentence,"Subcategory: All Laptop. Price: Out Of Stock.

Product: Chuwi CoreBook XPro Core i5 12th Gen 15.6"" FHD Laptop. Category: Chuwi. Subcategory: All Laptop. Price: Out Of Stock.
",174,42840,43014
317,sentence,"Subcategory: All Laptop. Price: Out Of Stock.

Product: Gigabyte G5 MF5 Core i7 13th Gen RTX 4050 6GB Graphics 512GB SSD 15.6"" FHD 144Hz Gaming Laptop. Category: Gigabyte. Subcategory: All Laptop. ",197,42968,43165
318,sentence,"Category: Gigabyte. Subcategory: All Laptop. Price: 129,000৳.

Product: Gigabyte G5 MF5 Core i7 13th Gen RTX 4050 6GB Graphics 15.6"" FHD 144Hz Gaming Laptop. Category: Gigabyte. ",178,43120,43298
319,sentence,"Category: Gigabyte. Subcategory: All Laptop. Price: 134,000৳.

Product: Gigabyte G6 MF Core i7 13th Gen RTX 4050 6GB Graphics 16"" WUXGA 165Hz Gaming Laptop. Category: Gigabyte. ",177,43278,43455
320,sentence,"Category: Gigabyte. Subcategory: All Laptop. Price: 134,000৳.

Product: Gigabyte G6 MF Core i7 13th Gen RTX 4050 6GB Graphics 16"" Gaming Laptop. Category: Gigabyte. Subcategory: All Laptop. ",190,43435,43625
321,sentence,"Category: Gigabyte. Subcategory: All Laptop. Price: 138,000৳.

Product: Gigabyte G6 KF Core i7 13th Gen RTX 4060 8GB Graphics 16"" WUXGA 165Hz Gaming Laptop. Category: Gigabyte. ",177,43580,43757
322,sentence,"Category: Gigabyte. Subcategory: All Laptop. Price: 144,500৳.

Product: Gigabyte AORUS MASTER 16 BYH Core Ultra 9 RTX 5080 16GB Graphics 16"" OLED Gaming Laptop. Category: Gigabyte. ",181,43737,43918
323,sentence,"Category: Gigabyte. Subcategory: All Laptop. Price: 418,000৳.

Product: Gigabyte AERO X16 1VH AMD Ryzen AI 7 350 RTX 5060 8GB Graphics 16"" FHD+ WUXGA Gaming Laptop. Category: Gigabyte. ",185,43898,44083
324,sentence,"Category: Gigabyte. Subcategory: All Laptop. Price: 185,000৳.

Product: GIGABYTE G5 KF Core i5 12th Gen RTX 4060 8GB Graphics 15.6'' FHD 144Hz Gaming Laptop. Category: Gigabyte. ",178,44063,44241
325,sentence,"Category: Gigabyte. Subcategory: All Laptop. Price: Out Of Stock.

Product: Gigabyte G5 KF5 Core i7 13th Gen RTX 4060 8GB Graphics 15.6"" FHD 144Hz Gaming Laptop. Category: Gigabyte. ",182,44221,44403
326,sentence,"Category: Gigabyte. Subcategory: All Laptop. Price: Out Of Stock.

Product: GIGABYTE AORUS 15 BKG Core Ultra 7 RTX 4060 8GB Graphics 15.6"" QHD Gaming Laptop. Category: Gigabyte. ",178,44383,44561
327,sentence,"Category: Gigabyte. Subcategory: All Laptop. Price: Out Of Stock.

Product: Gigabyte AORUS 16X AKG 2024 Core i7 14th Gen RTX 4060 8GB Graphics 16"" WQXGA 2K 165Hz Gaming Laptop. Category: Gigabyte. ",197,44541,44738
328,sentence,"Category: Gigabyte. Subcategory: All Laptop. Price: Out Of Stock.

Product: Gigabyte AORUS 16X ASG 2024 Core i7 14th Gen 32GB RAM RTX 4070 8GB Graphics 16"" WQXGA 2K 165Hz Gaming Laptop. ",186,44718,44904
329,sentence,"Category: Gigabyte. Subcategory: All Laptop. Price: Out Of Stock.

Product: AOC N141 Intel N100 12th Gen 14"" FHD Laptop. Category: AOC. Subcategory: All Laptop. Price: 37,000৳.
",177,44904,45081
330,sentence,"Subcategory: All Laptop. Price: 37,000৳.

Product: Lenovo Legion Slim 7i Core i7 12th Gen RTX 3060 6GB Graphics 16"" 2.5K 165Hz Gaming Laptop. Category: Lenovo. Subcategory: Gaming Laptop. ",188,45040,45228
331,sentence,"Category: Lenovo. Subcategory: Gaming Laptop. Price: 165,000৳.

Product: Lenovo Legion 5 15IRX10 Core i7 14th Gen RTX 5050 8GB Graphics 15.1"" WQXGA 165Hz Gaming Laptop. Category: Lenovo. ",187,45182,45369
332,sentence,"Category: Lenovo. Subcategory: Gaming Laptop. Price: 190,000৳.

Product: Lenovo Legion 5 15IRX10 Core i7 14th Gen RTX 5050 8GB Graphics 15.1"" WQXGA Gaming Laptop With RGB Backlit Keyboard. ",189,45351,45540
333,sentence,"Category: Lenovo. Subcategory: Gaming Laptop. Price: 200,000৳.

Product: Lenovo Legion 5 15IRX10 Core i7 14th Gen RTX 5060 8GB Graphics 15.1"" WQXGA Gaming Laptop. Category: Lenovo. ",181,45540,45721
334,sentence,"Category: Lenovo. Subcategory: Gaming Laptop. Price: 204,000৳.

Product: Lenovo Legion 5 15IRX10 Core i7 14th Gen RTX 5070 8GB Graphics 15.1"" WQXGA Gaming Laptop. Category: Lenovo. ",181,45703,45884
335,sentence,"Category: Lenovo. Subcategory: Gaming Laptop. Price: 230,000৳.

Product: Lenovo Legion 5 15IRX10 Core i9 14th Gen RTX 5070 8GB Graphics 15.1"" WQXGA Gaming Laptop. Category: Lenovo. ",181,45866,46047
336,sentence,"Category: Lenovo. Subcategory: Gaming Laptop. Price: 255,000৳.

Product: Lenovo Legion 5 15IRX10 Core i9 14th Gen 32GB RAM RTX 5070 8GB Graphics 15.1"" WQXGA Gaming Laptop. Category: Lenovo. ",190,46029,46219
337,sentence,"Category: Lenovo. Subcategory: Gaming Laptop. Price: 295,000৳.

Product: Lenovo Legion Pro 7 16IRX9H Core i9 14th Gen RTX 4080 12GB Graphics 16"" WQXGA 240Hz Gaming Laptop. Category: Lenovo. ",190,46201,46391
338,sentence,"Category: Lenovo. Subcategory: Gaming Laptop. Price: 450,000৳.

Product: Lenovo Legion 9 16IRX9 Core i9 14th Gen RTX 4080 12GB Graphics 16"" 3.2K 165Hz Gaming Laptop. Category: Lenovo. ",184,46373,46557
339,sentence,"Category: Lenovo. Subcategory: Gaming Laptop. Price: 495,000৳.

Product: Lenovo Legion 9 16IRX9 Core i9 14th Gen RTX 4090 16GB Graphics 16"" 3.2K 165Hz Gaming Laptop. Category: Lenovo. ",184,46539,46723
340,sentence,"Category: Lenovo. Subcategory: Gaming Laptop. Price: 515,000৳.

Product: Lenovo LOQ 15IAX9E Core i5 12th Gen RTX 2050 4GB Graphics 15.6"" FHD Gaming Laptop. Category: Lenovo. ",174,46705,46879
341,sentence,"Category: Lenovo. Subcategory: Gaming Laptop. Price: Out Of Stock.

Product: Lenovo LOQ 15ARP9 Ryzen 7 7435HS AI Integrated RTX 4050 6GB Graphics 15.6"" FHD Gaming Laptop. Category: Lenovo. ",189,46861,47050
342,sentence,"Category: Lenovo. Subcategory: Gaming Laptop. Price: Out Of Stock.

Product: Lenovo LOQ 15AHP9 Ryzen 5 8645HS AI Integrated RTX 4050 6GB Graphics 15.6"" Gaming Laptop. Category: Lenovo. ",185,47032,47217
343,sentence,"Category: Lenovo. Subcategory: Gaming Laptop. Price: Out Of Stock.

Product: Lenovo LOQ 15AHP9 Ryzen 7 7435HS AI Integrated RTX 4060 8GB Graphics 15.6"" FHD Gaming Laptop. Category: Lenovo. ",189,47199,47388
344,sentence,"Category: Lenovo. Subcategory: Gaming Laptop. Price: Out Of Stock.

Product: Lenovo LOQ 15IRX9 Core i7 14th Gen RTX 4060 8GB Graphics 15.6"" FHD AI Powered Gaming Laptop. Category: Lenovo. ",188,47370,47558
345,sentence,"Category: Lenovo. Subcategory: Gaming Laptop. Price: Out Of Stock.

Product: Lenovo LOQ 15IRX9 Core i7 13th Gen RTX 3050 6GB Graphics 15.6"" FHD Gaming Laptop. Category: Lenovo. ",177,47540,47717
346,sentence,"Category: Lenovo. Subcategory: Gaming Laptop. Price: Out Of Stock.

Product: Tecno MEGABOOK K15SDA AMD Ryzen 5 7430U 15.6″ FHD Laptop. Category: Tecno. Subcategory: All Laptop. Price: 53,500৳.
",193,47699,47892
347,sentence,"Subcategory: All Laptop. Price: 53,500৳.

Product: HP Victus Gaming 15-fb1053AX Ryzen 5-7535HS RTX 2050 4GB Graphics 15.6"" FHD Gaming Laptop. Category: HP. Subcategory: Gaming Laptop. ",184,47851,48035
348,sentence,"Category: HP. Subcategory: Gaming Laptop. Price: 98,000৳.

Product: HP Victus 16-r1237TX Core i5 14th Gen RTX 3050 6GB Graphics 16"" FHD Gaming Laptop. Category: HP. Subcategory: Gaming Laptop. ",193,47993,48186
349,sentence,"Category: HP. Subcategory: Gaming Laptop. Price: 130,000৳.

Product: HP Victus Gaming 15-fa1251TX Core i7 13th Gen RTX 3050 6GB Graphics 15.6"" FHD Gaming Laptop. Category: HP. ",176,48144,48320
350,sentence,"Category: HP. Subcategory: Gaming Laptop. Price: 143,500৳.

Product: HP Victus 15-fb2132AX Ryzen 7 8845HS RTX 3050 6GB Graphics 15.6"" FHD Gaming Laptop. Category: HP. Subcategory: Gaming Laptop. ",195,48306,48501
351,sentence,"Category: HP. Subcategory: Gaming Laptop. Price: 153,000৳.

Product: HP Victus 16-r1241TX Core i7 14th Gen RTX 4060 8GB Graphics 16"" FHD Gaming Laptop. Category: HP. Subcategory: Gaming Laptop. ",194,48459,48653
352,sentence,"Category: HP. Subcategory: Gaming Laptop. Price: Out Of Stock.

Product: HP OMEN 16-wf1156TX Core i9 14th Gen RTX 4070 8GB Graphics 16.1"" QHD 240Hz Gaming Laptop. Category: HP. ",177,48611,48788
353,sentence,"Category: HP. Subcategory: Gaming Laptop. Price: Out Of Stock.

Product: Asus TUF Gaming A15 FA506NFR Ryzen 7 7435HS RTX 2050 4GB Graphics 15.6"" FHD Gaming Laptop. Category: Asus. ",180,48774,48954
354,sentence,"Category: Asus. Subcategory: Gaming Laptop. Price: 95,500৳.

Product: Asus TUF Gaming A15 FA506NCR Ryzen 7 7435HS RTX 3050 4GB Graphics (Up To 75W TGP) Gaming Laptop. Category: Asus. ",183,48938,49121
355,sentence,"Category: Asus. Subcategory: Gaming Laptop. Price: 103,500৳107,000৳.

Product: ASUS TUF Gaming F16 FX607VB Core 5 210H RTX 3050A 4GB Graphics 16"" WUXGA Gaming Laptop. Category: Asus. ",183,49105,49288
356,sentence,"Category: Asus. Subcategory: Gaming Laptop. Price: 112,000৳115,800৳.

Product: Asus TUF Gaming A15 FA507NUR Ryzen 7 7435HS RTX 4050 6GB Graphics 15.6"" FHD Gaming Laptop. Category: Asus. ",186,49272,49458
357,sentence,"Category: Asus. Subcategory: Gaming Laptop. Price: 140,000৳143,500৳.

Product: ASUS TUF Gaming A16 FA617NSR Advantage Edition Ryzen 7 7435HS RX 7600S 8GB Graphics 16"" WUXGA Gaming Laptop. ",188,49442,49630
358,sentence,"Category: Asus. Subcategory: Gaming Laptop. Price: 144,000৳.

Product: ASUS TUF Gaming F16 FX607VU Core 5 210H RTX 4050 6GB Graphics 16"" WUXGA Gaming Laptop. Category: Asus. ",174,49630,49804
359,sentence,"Category: Asus. Subcategory: Gaming Laptop. Price: 148,900৳.

Product: Asus Vivobook Pro 16X OLED M7600QE Ryzen 7 5800H RTX 3050Ti 4GB Graphics 16"" 4K Gaming Laptop. Category: Asus. ",182,49788,49970
360,sentence,"Category: Asus. Subcategory: Gaming Laptop. Price: 131,000৳153,900৳.

Product: ASUS ROG Strix G16 G614JU Core i5 13th Gen RTX 4050 6GB Graphics 16"" WUXGA Gaming Laptop. Category: Asus. ",185,49954,50139
361,sentence,"Category: Asus. Subcategory: Gaming Laptop. Price: 170,000৳.

Product: ASUS TUF Gaming F16 FX608JMR Core i7 14th Gen 16"" FHD+ Gaming Laptop. Category: Asus. Subcategory: Gaming Laptop. ",185,50123,50308
362,sentence,"Category: Asus. Subcategory: Gaming Laptop. Price: 214,000৳.

Product: ASUS TUF Gaming A14 FA401UH Ryzen 7 260 14"" 2.5K WQXGA Gaming Laptop. Category: Asus. Subcategory: Gaming Laptop. ",185,50264,50449
363,sentence,"Category: Asus. Subcategory: Gaming Laptop. Price: 194,000৳.

Product: ASUS TUF Gaming A16 FA608UH Ryzen 7 260 16"" FHD+ Gaming Laptop. Category: Asus. Subcategory: Gaming Laptop. Price: 187,000৳.
",196,50405,50601
364,sentence,"Subcategory: Gaming Laptop. Price: 187,000৳.

Product: ASUS TUF Gaming A14 FA401WU Ryzen AI 9 HX 370 RTX 4050 6GB Graphics 14"" 2.5K Laptop. Category: Asus. Subcategory: Gaming Laptop. ",184,50556,50740
365,sentence,"Category: Asus. Subcategory: Gaming Laptop. Price: 220,000৳.

Product: ASUS ROG Strix G16  G615LP Ultra 9 275HX 16"" FHD+ Gaming Laptop. Category: Asus. Subcategory: Gaming Laptop. Price: 287,000৳.
",197,50696,50893
366,sentence,"Subcategory: Gaming Laptop. Price: 287,000৳.

Product: ASUS ROG Strix G16 G615LM Ultra 9 275HX RTX 5060 8GB Graphics 16"" WUXGA Gaming Laptop. Category: Asus. Subcategory: Gaming Laptop. ",186,50848,51034
367,sentence,"Category: Asus. Subcategory: Gaming Laptop. Price: 250,000৳.

Product: ASUS TUF Gaming A16 FA608WV Ryzen AI 9 HX 370 RTX 4060 8GB Graphics 16"" 2.5K Laptop. Category: Asus. ",172,50990,51162
368,sentence,"Category: Asus. Subcategory: Gaming Laptop. Price: 253,000৳.

Product: ASUS ProArt Studiobook 16 OLED H5600QR Ryzen 9 5900HX RTX 3070 8GB Graphics 16"" OLED Laptop. Category: Asus. ",180,51146,51326
369,sentence,"Category: Asus. Subcategory: Gaming Laptop. Price: 298,000৳.

Product: ASUS ROG Strix G16 G614FR AMD Ryzen 9 9955HX3D RTX 5070 Ti 12GB Graphics 16"" FHD+ Gaming Laptop. Category: Asus. ",184,51310,51494
370,sentence,"Category: Asus. Subcategory: Gaming Laptop. Price: 330,000৳.

Product: Asus ROG Zephyrus G16 GU605CR Core Ultra 9 285H RTX 5070 Ti Graphics 16"" 2.5K QHD+ WQXGA Gaming Laptop. Category: Asus. ",191,51478,51669
371,sentence,"Category: Asus. Subcategory: Gaming Laptop. Price: 385,000৳.

Product: ASUS ROG Strix SCAR 16 G635LW Core Ultra 9 RTX 5080 16GB Graphics 16"" WQXGA Copilot+PC Gaming Laptop. Category: Asus. ",189,51653,51842
372,sentence,"Category: Asus. Subcategory: Gaming Laptop. Price: 482,000৳.

Product: ASUS ROG Strix SCAR 18 (2025) G835LX Core Ultra 9 RTX 5090 24GB Graphics 18"" 2.5K 240Hz Laptop. Category: Asus. ",183,51826,52009
373,sentence,"Category: Asus. Subcategory: Gaming Laptop. Price: 649,900৳.

Product: Acer Aspire 5 A515-58GM-57GF Core i5 13th Gen RTX 2050 4GB GDDR6 15.6"" FHD Gaming Laptop. Category: Acer. ",177,51993,52170
374,sentence,"Category: Acer. Subcategory: Gaming Laptop. Price: Out Of Stock.

Product: Acer Nitro V 15 ANV15-51 Core i5 13th Gen RTX 4050 6GB GDDR6 15.6"" FHD IPS Gaming Laptop. Category: Acer. ",181,52154,52335
375,sentence,"Category: Acer. Subcategory: Gaming Laptop. Price: Out Of Stock.

Product: Acer Nitro V 15 ANV15-51 Core i7 13th Gen 15.6"" FHD Gaming Laptop. Category: Acer. Subcategory: Gaming Laptop. ",186,52319,52505
376,sentence,"Category: Acer. Subcategory: Gaming Laptop. Price: Out Of Stock.

Product: Acer Predator Helios 16 PH16-71-74MN Core i7 13th Gen RTX 4070 8GB GDDR6 16"" 240HZ Gaming Laptop. Category: Acer. ",189,52461,52650
377,sentence,"Category: Acer. Subcategory: Gaming Laptop. Price: Out Of Stock.

Product: MSI Thin 15 B13VE Core i5 13th Gen RTX 4050 6GB Graphics 15.6"" FHD Gaming Laptop. Category: Gaming Laptop. ",182,52634,52816
378,sentence,"Category: Gaming Laptop. Subcategory: Laptop. Price: 102,900৳.

Product: MSI Thin A15 B7UC Ryzen 5 7535HS RTX 3050 4GB GDDR6 Graphics 15.6"" FHD Gaming Laptop. Category: Gaming Laptop. ",184,52791,52975
379,sentence,"Category: Gaming Laptop. Subcategory: Laptop. Price: 95,000৳105,000৳.

Product: MSI Thin A15 B7VE Ryzen 7 7735HS RTX 4050 6GB GDDR6 Graphics 15.6"" FHD Gaming Laptop. Category: Gaming Laptop. ",191,52950,53141
380,sentence,"Category: Gaming Laptop. Subcategory: Laptop. Price: 135,000৳140,000৳.

Product: MSI VenturePro 15 A2RWEG Core 5 210H RTX 5050 8GB Graphics 15.6"" FHD Gaming Laptop. Category: MSI. ",180,53116,53296
381,sentence,"Category: MSI. Subcategory: Gaming Laptop. Price: 144,900৳.

Product: MSI Katana 15 HX B14WGK Core i7 14th Gen RTX 5070 8GB Graphics 15.6"" FHD Gaming Laptop. Category: MSI. ",173,53281,53454
382,sentence,"Category: MSI. Subcategory: Gaming Laptop. Price: 219,900৳.

Product: MSI Katana 15 HX B14WFK Core i7 14th Gen RTX 5060 8GB Graphics 15.6"" FHD Gaming Laptop. Category: MSI. ",173,53439,53612
383,sentence,"Category: MSI. Subcategory: Gaming Laptop. Price: 185,900৳.

Product: MSI Katana 15 HX B14WEK Core i7 14th Gen RTX 5050 8GB Graphics 15.6"" FHD Gaming Laptop. Category: MSI. ",173,53597,53770
384,sentence,"Category: MSI. Subcategory: Gaming Laptop. Price: 165,900৳.

Product: MSI Raider 18 HX AI A2XWIG Core Ultra 9 200HX RTX 5080 16GB Graphics 18"" UHD+ MiniLED 120Hz Gaming Laptop. Category: MSI. ",192,53755,53947
385,sentence,"Category: MSI. Subcategory: Gaming Laptop. Price: 629,800৳.

Product: MSI Titan 18 HX Dragon Edition Norse Myth A2XWJG Core Ultra 9 285HX RTX 5090 24GB Graphics 18"" UHD+ MiniLED 120Hz Gaming Laptop. ",199,53932,54131
386,sentence,"Category: MSI. Subcategory: Gaming Laptop. Price: 989,900৳.

Product: MSI Raider 18 HX A14VIG Core i9 14th Gen RTX 4090 16GB GDDR6 Graphics 18"" Gaming Laptop. Category: MSI. ",174,54131,54305
387,sentence,"Category: MSI. Subcategory: Gaming Laptop. Price: Pre Order.

Product: MSI Stealth 17 Studio A13VI Core i9 13th Gen 64GB RAM 4TB SSD RTX 4090 16GB Graphics 17.3"" 4K UHD 144Hz Gaming Laptop. ",190,54290,54480
388,sentence,"Category: MSI. Subcategory: Gaming Laptop. Price: Up Coming.

Product: MSI Sword 16 HX B14VEKG Core i7 14th Gen 14650HX RTX 4050 GDDR6 6GB Graphics 16"" Gaming Laptop. Category: MSI. ",182,54480,54662
389,sentence,"Category: MSI. Subcategory: Gaming Laptop. Price: Up Coming.

Product: MSI Sword 16 HX B14VEKG Core i7 14th Gen RTX 4050 GDDR6 6GB Graphics 16"" Gaming Laptop. Category: MSI. ",174,54647,54821
390,sentence,"Category: MSI. Subcategory: Gaming Laptop. Price: Up Coming.

Product: MSI Sword 16 HX B14VFKG Core i7 14th Gen RTX 4060 GDDR6 8GB Graphics 16"" Gaming Laptop. Category: MSI. ",174,54806,54980
391,sentence,"Category: MSI. Subcategory: Gaming Laptop. Price: Up Coming.

Product: MSI GF63 THIN 12UCX Core i5 12th Gen RTX 2050 4GB Graphics 15.6"" FHD 144hz Gaming Laptop. Category: MSI. ",176,54965,55141
392,sentence,"Category: MSI. Subcategory: Gaming Laptop. Price: Out Of Stock.

Product: MSI Cyborg 15 A12UCX Core i5 12th Gen RTX 2050 4GB Graphics 8GB RAM 15.6"" FHD Gaming Laptop. Category: MSI. ",182,55126,55308
393,sentence,"Category: MSI. Subcategory: Gaming Laptop. Price: Out Of Stock.

Product: MSI Thin A15 B7UCX Ryzen 5 7535HS RTX 2050 4GB GDDR6 Graphics 16GB RAM 15.6"" Gaming Laptop. Category: MSI. ",181,55293,55474
394,sentence,"Category: MSI. Subcategory: Gaming Laptop. Price: Out Of Stock.

Product: MSI Thin 15 B13UC Core i5 13th Gen RTX 3050 4GB Graphics 15.6"" FHD Gaming Laptop. Category: MSI. Subcategory: Gaming Laptop. ",199,55459,55658
395,sentence,"Category: MSI. Subcategory: Gaming Laptop. Price: Out Of Stock.

Product: MSI Cyborg 15 A13UDX Core i5 13th Gen RTX 3050 6GB Graphics 15.6"" FHD 144Hz Gaming Laptop. Category: MSI. ",180,55615,55795
396,sentence,"Category: MSI. Subcategory: Gaming Laptop. Price: Out Of Stock.

Product: HP Spectre X360 Convertible 14-eu0080TU Core Ultra 7 14"" 3K OLED Touch Laptop. Category: HP. Subcategory: Premium Ultrabook. ",199,55780,55979
397,sentence,"Category: HP. Subcategory: Premium Ultrabook. Price: Out Of Stock.

Product: HP ZBook FireFly 14 G10 Core i7 13th Gen RTX A500 4GB Graphics 14"" Workstation Laptop. Category: HP. ",178,55933,56111
398,sentence,"Category: HP. Subcategory: Premium Ultrabook. Price: Out Of Stock.

Product: HP Spectre X360 Convertible 14-eu0089TU Core Ultra 7 14"" 3K OLED Touch Laptop. Category: HP. ",170,56097,56267
399,sentence,"Category: HP. Subcategory: Premium Ultrabook. Price: Out Of Stock.

Product: Lenovo IdeaPad 5 2-in-1 14AHP9 Ryzen 5 8645HS 14"" WUXGA Touch Laptop. Category: Premium Ultrabook. Subcategory: Laptop. ",197,56253,56450
400,sentence,"Subcategory: Laptop. Price: 101,000৳.

Product: Lenovo IdeaPad 5 2-in-1 14AHP9 Ryzen 5 8645HS 14"" WUXGA Touch Laptop Luna Grey. Category: Premium Ultrabook. Subcategory: Laptop. Price: 101,000৳.
",195,56429,56624
401,sentence,"Subcategory: Laptop. Price: 101,000৳.

Product: Lenovo IdeaPad 5 2-in-1 14IAL10 Core Ultra 5 225H 14"" WUXGA Touch Laptop. Category: Premium Ultrabook. Subcategory: Laptop. Price: 123,000৳.
",189,56586,56775
402,sentence,"Subcategory: Laptop. Price: 123,000৳.

Product: ASUS Zenbook A14 UX3407RA Snapdragon X Elite 14"" OLED Copilot+ PC Laptop. Category: Premium Ultrabook. Subcategory: Laptop. Price: 182,000৳.
",189,56737,56926
403,sentence,"Subcategory: Laptop. Price: 182,000৳.

Product: ASUS Zenbook A14 UX3407RA Snapdragon X Elite 14"" OLED Copilot+ PC Laptop Iceland Gray. Category: Premium Ultrabook. Subcategory: Laptop. ",185,56888,57073
404,sentence,"Subcategory: Laptop. Price: 182,000৳.

Product: ASUS Zenbook 14 OLED UM3406KA Ryzen AI 7-350 14"" Copilot+ PC Laptop. Category: Premium Ultrabook. Subcategory: Laptop. Price: 185,000৳.
",184,57052,57236
405,sentence,"Subcategory: Laptop. Price: 185,000৳.

Product: ASUS Zenbook S 14 OLED UX5406SA Core Ultra 7 256V 14"" 3K OLED Copilot+ PC Laptop. Category: Premium Ultrabook. Subcategory: Laptop. Price: 214,000৳.
",197,57198,57395
406,sentence,"Subcategory: Laptop. Price: 214,000৳.

Product: ASUS Zenbook S 14 OLED UX5406SA Core Ultra 7 256V 14"" 3K Copilot+ PC Touch Laptop White. Category: Premium Ultrabook. Subcategory: Laptop. ",187,57357,57544
407,sentence,"Subcategory: Laptop. Price: 214,000৳.

Product: ASUS Zenbook Duo UX8406CA Core Ultra 9 14.0-inch OLED Laptop. Category: Premium Ultrabook. Subcategory: Laptop. Price: 269,900৳.
",177,57523,57700
408,sentence,"Subcategory: Laptop. Price: 269,900৳.

Product: Lenovo Yoga Slim 7 15ILL9 Core Ultra 7 15.3"" IPS Touch Laptop. Category: Lenovo. Subcategory: Premium Ultrabook. Price: Out Of Stock.
",182,57662,57844
409,sentence,"Price: Out Of Stock.

Product: Lenovo Yoga Pro 7 14AHP9 Ryzen 7 8845HS AI Integrated RTX 3050 6GB Graphics 14.5"" Gaming Laptop. Category: Lenovo. Subcategory: Premium Ultrabook. Price: Out Of Stock.
",199,57823,58022
410,sentence,"Price: Out Of Stock.

Product: Lenovo IdeaPad 5 2-in-1 14IAL10 Core Ultra 7 255H 14"" WUXGA IPS Touch Laptop. Category: Lenovo. Subcategory: Premium Ultrabook. Price: Out Of Stock.
",180,58001,58181
411,sentence,"Price: Out Of Stock.

Product: ASUS AP4600 Professional Backpack. Category: Asus. Subcategory: Laptop Bag. Price: 1,990৳.

Product: Asus ROG BP1501G 17"" Laptop Gaming Backpack. Category: Asus. ",193,58160,58353
412,sentence,"Category: Asus. Subcategory: Laptop Bag. Price: 2,600৳.

Product: ASUS ROG BP1800 18"" Laptop Gaming Backpack. Category: Asus. Subcategory: Laptop Bag. Price: 2,990৳.
",166,58337,58503
413,sentence,"Subcategory: Laptop Bag. Price: 2,990৳.

Product: MSI Summit 13 AI+ Evo A2VMTG Core Ultra 7 258V 13.3"" FHD+ Touch Laptop. Category: MSI. Subcategory: Premium Ultrabook. Price: Out Of Stock.
",190,58463,58653
414,sentence,"Price: Out Of Stock.

Product: Star Backpack Blue. Category: Laptop Bag. Subcategory: Laptop. Price: 1,200৳.

Product: MaxGreen MGB-455 13.3-inch Laptop Sleeve Bag. Category: Laptop Bag. ",187,58632,58819
415,sentence,"Category: Laptop Bag. Subcategory: Laptop. Price: 1,000৳1,700৳.

Product: WiWU iShield Ultra Thin Hard Shell White Frosted Laptop Case for 12 inch Macbook (A1534). Category: Laptop Bag. ",186,58797,58983
416,sentence,"Category: Laptop Bag. Subcategory: Laptop. Price: 1,500৳1,700৳.

Product: WiWu iShield Ultra Thin Hard Shell Anti-Slip Laptop Case. Category: Laptop Bag. Subcategory: Laptop. Price: 1,500৳1,900৳.
",196,58961,59157
417,sentence,"Subcategory: Laptop. Price: 1,500৳1,900৳.

Product: WiWU iSHIELD Ultra Thin Hard Shell Laptop Case for Macbook 16"". Category: Laptop Bag. Subcategory: Laptop. Price: 1,500৳1,950৳.
",180,59115,59295
418,sentence,"Subcategory: Laptop. Price: 1,500৳1,950৳.

Product: Wiwu Cosmo Slim Case for 13.3"" Laptop Black Color. Category: Laptop Bag. Subcategory: Laptop. Price: 1,800৳2,000৳.
",167,59253,59420
419,sentence,"Subcategory: Laptop. Price: 1,800৳2,000৳.

Product: Targus TBS64602GL Cypress 14"" EcoSmart Laptop Sleeve Case. Category: Laptop Bag. Subcategory: Laptop. Price: 1,800৳2,000৳.
",175,59378,59553
420,sentence,"Subcategory: Laptop. Price: 1,800৳2,000৳.

Product: Targus Intellect Laptop Backpack 15.6""-Black/Grey ( TBB565GL). Category: Laptop Bag. Subcategory: Laptop. Price: 1,900৳2,100৳.
",179,59511,59690
421,sentence,"Subcategory: Laptop. Price: 1,900৳2,100৳.

Product: Targus TSB883-72 15.6"" Safire Backpack. Category: Laptop Bag. Subcategory: Laptop. Price: 1,900৳2,100৳.
",156,59648,59804
422,sentence,"Subcategory: Laptop. Price: 1,900৳2,100৳.

Product: Targus TSS898 15.6"" Business Casual Slipcase Laptop Bag. Category: Laptop Bag. Subcategory: Laptop. Price: 1,800৳2,200৳.
",173,59762,59935
423,sentence,"Subcategory: Laptop. Price: 1,800৳2,200৳.

Product: Targus TSB194US-70 Motor 16"" Laptop Backpack. Category: Laptop Bag. Subcategory: Laptop. Price: 2,200৳2,450৳.
",162,59893,60055
424,sentence,"Subcategory: Laptop. Price: 2,200৳2,450৳.

Product: Wiwu Minimalist Shoulder Laptop Bag 15.6 inch. Category: Laptop Bag. Subcategory: Laptop. Price: 2,600৳.
",157,60013,60170
425,sentence,"Subcategory: Laptop. Price: 2,600৳.

Product: WiWU Warriors Backpack X Pro 15.6"" Waterproof Laptop Backpack. Category: Laptop Bag. Subcategory: Laptop. Price: 9,900৳.
",167,60134,60301
426,sentence,"Subcategory: Laptop. Price: 9,900৳.

Product: WiWU Minimalist Waterproof Large Capacity Business Laptop Backpack. Category: Laptop Bag. Subcategory: Laptop. Price: 2,250৳2,700৳.
",178,60265,60443
427,sentence,"Subcategory: Laptop. Price: 2,250৳2,700৳.

Product: Honor Official Backpack For Tablet. Category: Laptop Bag. Subcategory: Laptop. Price: 3,400৳.
",146,60401,60547
428,sentence,"Subcategory: Laptop. Price: 3,400৳.

Product: WiWU Campus Slim Case 13.3-inch Laptop Bag. Category: Laptop Bag. Subcategory: Laptop. Price: 2,500৳3,000৳.
",154,60511,60665
429,sentence,"Subcategory: Laptop. Price: 2,500৳3,000৳.

Product: WiWU Pilot Backpack 15.6-inch Travelling Laptop Business School Backpack. Category: Laptop Bag. Subcategory: Laptop. Price: 2,500৳.
",184,60623,60807
430,sentence,"Subcategory: Laptop. Price: 2,500৳.

Product: Dell ES1520P Essential 15 Backpack for 15.6"" Laptop. Category: Dell. Subcategory: Laptop Bag. Price: 1,800৳.
",155,60771,60926
431,sentence,"Subcategory: Laptop Bag. Price: 1,800৳.

Product: Fantech BG-984 Waterproof 15.6"" Gaming Backpack. Category: Fantech. Subcategory: Laptop Bag. Price: 3,400৳3,600৳.
",164,60886,61050
432,sentence,"Subcategory: Laptop Bag. Price: 3,400৳3,600৳.

Product: Targus Terra Black Laptop Backpack (TSB226AP). Category: Targus. Subcategory: Laptop Bag. Price: 3,100৳.
",161,61004,61165
433,sentence,"Subcategory: Laptop Bag. Price: 3,100৳.

Product: Targus TSB913AP-70 City Smart 15.6"" Professional Back Pack. Category: Targus. Subcategory: Laptop Bag. Price: 3,850৳5,000৳.
",174,61125,61299
434,sentence,"Subcategory: Laptop Bag. Price: 3,850৳5,000৳.

Product: Targus CN514CA 13-14"" Classic Top Load Laptop Bag. Category: Targus. Subcategory: Laptop Bag. Price: Out Of Stock.
",171,61253,61424
435,sentence,"Subcategory: Laptop Bag. Price: Out Of Stock.

Product: Targus TBB565GL-74 Intellect 15.6"" Laptop Backpack. Category: Targus. Subcategory: Laptop Bag. Price: 1,900৳.
",166,61378,61544
436,sentence,"Subcategory: Laptop Bag. Price: 1,900৳.

Product: Targus TBS64602GL-70 Cypress 14"" EcoSmart Laptop Sleeve Case. Category: Targus. Subcategory: Laptop Bag. Price: 2,000৳.
",170,61504,61674
437,sentence,"Subcategory: Laptop Bag. Price: 2,000৳.

Product: Targus TBT913EU-72 Citysmart Essential 12 to 14 Inch Laptop Bag. Category: Targus. Subcategory: Laptop Bag. Price: 3,000৳.
",173,61634,61807
438,sentence,"Subcategory: Laptop Bag. Price: 3,000৳.

Product: Targus 15.6"" Element Laptop Backpack (Black). Category: Targus. Subcategory: Laptop Bag. Price: 3,000৳.
",154,61767,61921
439,sentence,"Subcategory: Laptop Bag. Price: 3,000৳.

Product: WiWU Minimalist Laptop Sleeve for 14"" Macbook Air. Category: WiWU. Subcategory: Laptop Bag. Price: 1,600৳.
",157,61881,62038
440,sentence,"Subcategory: Laptop Bag. Price: 1,600৳.

Product: WiWU Minimalist II 14"" Laptop Bag For MacBook. Category: WiWU. Subcategory: Laptop Bag. Price: 2,150৳.
",153,61998,62151
441,sentence,"Subcategory: Laptop Bag. Price: 2,150৳.

Product: WiWU Cozy Classic 16"" Waterproof Laptop Bag. Category: WiWU. Subcategory: Laptop Bag. Price: 2,400৳.

Product: Wiwu City Commuter 15.6"" Laptop Bag. ",198,62111,62309
442,sentence,"
Product: Wiwu City Commuter 15.6"" Laptop Bag. Category: WiWU. Subcategory: Laptop Bag. Price: 3,150৳.

Product: WiWU Pioneer Shoulder Bag for 14 Inch Laptop. Category: WiWU. ",175,62262,62437
443,sentence,"Category: WiWU. Subcategory: Laptop Bag. Price: 2,500৳.

Product: WiWU Dual Color iSHIELD TPU Frame Frosted Case for 13.3"" Macbook Air (A2179/A2337). Category: WiWU. Subcategory: Laptop Bag. ",191,62421,62612
444,sentence,"Category: WiWU. Subcategory: Laptop Bag. Price: Up Coming.

Product: WiWU Alpha Double Vertical Layer Bag for 12.9"" Laptop. Category: WiWU. Subcategory: Laptop Bag. Price: Up Coming.
",183,62571,62754
445,sentence,"Subcategory: Laptop Bag. Price: Up Coming.

Product: WiWU Haliz 15.6"" Laptop Bag. Category: WiWU. Subcategory: Laptop Bag. Price: 2,250৳.

Product: WiWU Elite 15.6 Inch Waterproof Laptop Backpack. ",197,62711,62908
446,sentence,"Category: WiWU. Subcategory: Laptop Bag. Price: Out Of Stock.

Product: WiWU Elite S 15.6 Inch Waterproof Laptop Backpack. Category: WiWU. Subcategory: Laptop Bag. Price: 6,500৳.
",179,62908,63087
447,sentence,"Subcategory: Laptop Bag. Price: 6,500৳.

Product: Tucano Vario BKVAR BackPack Black. Category: Tucano. Subcategory: Laptop Bag. Price: Up Coming.
",146,63047,63193
448,sentence,"Subcategory: Laptop Bag. Price: Up Coming.

Product: Arctic Hunter B00346 15.6"" Laptop Backpack. Category: Arctic Hunter. Subcategory: Laptop Bag. Price: Out Of Stock.
",168,63150,63318
449,sentence,"Subcategory: Laptop Bag. Price: Out Of Stock.

Product: Arctic Hunter B00328 15.6"" Laptop Backpack. Category: Arctic Hunter. Subcategory: Laptop Bag. Price: Out Of Stock.
",171,63272,63443
450,sentence,"Subcategory: Laptop Bag. Price: Out Of Stock.

Product: Arctic Hunter B00388 15.6"" Laptop Backpack. Category: Arctic Hunter. Subcategory: Laptop Bag. Price: Out Of Stock.
",171,63397,63568
451,sentence,"Subcategory: Laptop Bag. Price: Out Of Stock.

Product: Xiaomi Classic Business Backpack 2. Category: Xiaomi. Subcategory: Laptop Bag. Price: 2,500৳.
",150,63522,63672
452,sentence,"Subcategory: Laptop Bag. Price: 2,500৳.

Product: MaxGreen 19v 2.37a 45W Laptop Charger Adapter For ASUS Laptop. Category: Laptop Accessories. Subcategory: Laptop. Price: Out Of Stock.
",185,63632,63817
453,sentence,"Subcategory: Laptop. Price: Out Of Stock.

Product: Metal Portable Laptop Stand. Category: Laptop Accessories. Subcategory: Laptop. Price: 380৳449৳.
",149,63775,63924
454,sentence,"Subcategory: Laptop. Price: 380৳449৳.

Product: Second Hard Disk Drive CADDY-Secondary CD-ROM Storage for Laptop. Category: Laptop Accessories. Subcategory: Laptop. Price: 550৳.
",178,63886,64064
455,sentence,"Subcategory: Laptop. Price: 550৳.

Product: Aluminum Alloy Adjustable and Foldable Air-Ventilated Laptop Stand. Category: Laptop Accessories. Subcategory: Laptop. Price: 370৳600৳.
",180,64030,64210
456,sentence,"Subcategory: Laptop. Price: 370৳600৳.

Product: Adjustable & Foldable 10"" to 17.5"" 6 Angles Travel Laptop Stand (10810). Category: Laptop Accessories. Subcategory: Laptop. Price: 480৳790৳.
",189,64172,64361
457,sentence,"Subcategory: Laptop. Price: 480৳790৳.

Product: WiWU S500 Foldable Lightweight Aluminium Alloy Laptop Stand. Category: Laptop Accessories. Subcategory: Laptop. Price: 850৳.
",173,64323,64496
458,sentence,"Subcategory: Laptop. Price: 850৳.

Product: BlackCat BC1 14"" Laptop Cooler. Category: Laptop Accessories. Subcategory: Laptop. Price: 790৳850৳.
",144,64462,64606
459,sentence,"Subcategory: Laptop. Price: 790৳850৳.

Product: Acer swift 3 Thin Port 19V 3.42A 65W Laptop Charger Adapter. Category: Laptop Accessories. Subcategory: Laptop. Price: 1,300৳.
",175,64568,64743
460,sentence,"Subcategory: Laptop. Price: 1,300৳.

Product: Lenovo Big Port 20V 3.25A 65W Laptop Charger Adapter. Category: Laptop Accessories. Subcategory: Laptop. Price: 1,000৳.
",166,64707,64873
461,sentence,"Subcategory: Laptop. Price: 1,000৳.

Product: Lenovo IdeaPad Thin Port 20V 2.25A 45W Laptop Charger Adapter. Category: Laptop Accessories. Subcategory: Laptop. Price: 1,000৳.
",175,64837,65012
462,sentence,"Subcategory: Laptop. Price: 1,000৳.

Product: Havit F2067 Laptop Cooler For Up to 18.3"" Laptop. Category: Laptop Accessories. Subcategory: Laptop. Price: 1,750৳.
",162,64976,65138
463,sentence,"Subcategory: Laptop. Price: 1,750৳.

Product: Havit F2075 Laptop Cooler for up to 17"" Laptop. Category: Laptop Accessories. Subcategory: Laptop. Price: 990৳1,050৳.
",164,65102,65266
464,sentence,"Subcategory: Laptop. Price: 990৳1,050৳.

Product: Havit F2035 Dual Fan Laptop Cooler. Category: Laptop Accessories. Subcategory: Laptop. Price: 1,070৳.
",152,65226,65378
465,sentence,"Subcategory: Laptop. Price: 1,070৳.

Product: HP 19.5V 4.62A 90W Laptop Charger Adapter. Category: Laptop Accessories. Subcategory: Laptop. Price: 1,100৳.
",155,65342,65497
466,sentence,"Subcategory: Laptop. Price: 1,100৳.

Product: HP Compaq 510 18.5V 3.5A 65W Laptop Charger Adapter. Category: Laptop Accessories. Subcategory: Laptop. Price: 1,100৳.
",165,65461,65626
467,sentence,"Subcategory: Laptop. Price: 1,100৳.

Product: Dell 19V 4.62A 90W Laptop Charger Adapter. Category: Laptop Accessories. Subcategory: Laptop. Price: 1,500৳.
",155,65590,65745
468,sentence,"Subcategory: Laptop. Price: 1,500৳.

Product: Yuanxin X-ZJ801 Retractable Adjustable Laptop Stand with Anti Slip Pad. Category: Laptop Accessories. Subcategory: Laptop. Price: 850৳1,120৳.
",188,65709,65897
469,sentence,"Subcategory: Laptop. Price: 850৳1,120৳.

Product: Laptop Keyboard For Dell 3521. Category: Laptop Accessories. Subcategory: Laptop. Price: 1,200৳.
",147,65857,66004
470,sentence,"Subcategory: Laptop. Price: 1,200৳.

Product: Laptop Keyboard For Acer NAV 50/D260/D255. Category: Laptop Accessories. Subcategory: Laptop. Price: 1,200৳.

Product: Laptop Keyboard For Acer E-725. ",197,65968,66165
471,sentence,"
Product: Laptop Keyboard For Acer E-725. Category: Laptop Accessories. Subcategory: Laptop. Price: 1,200৳.

Product: Foldable Laptop Table with Cup Holder & Tablet Slot. Category: Laptop Desk. ",194,66123,66317
472,sentence,"Category: Laptop Desk. Subcategory: Laptop Accessories. Price: 640৳1,550৳.

Product: Trend Bubbles Filled Fleece Cushion LED Light Laptop Lap Desk. Category: Laptop Desk. ",171,66294,66465
473,sentence,"Category: Laptop Desk. Subcategory: Laptop Accessories. Price: Out Of Stock.

Product: Multifunctional Laptop Desk With Adjustable Folding Stand. Category: Laptop Desk. ",169,66442,66611
474,sentence,"Category: Laptop Desk. Subcategory: Laptop Accessories. Price: Out Of Stock.

Product: Ergonomic Laptop Desk With Built In Cooler. Category: Laptop Desk. Subcategory: Laptop Accessories. ",187,66588,66775
475,sentence,"Subcategory: Laptop Accessories. Price: Out Of Stock.

Product: T9 Multifunctional Folding Laptop Table. Category: Laptop Desk. Subcategory: Laptop Accessories. Price: Out Of Stock.
",182,66742,66924
476,sentence,"Price: Out Of Stock.

Product: Multifunctional Foldable Laptop Desk. Category: Laptop Desk. Subcategory: Laptop Accessories. Price: Out Of Stock.

Product: Portable Folding Double Head Laptop Desk. ",198,66903,67101
477,sentence,"Category: Laptop Desk. Subcategory: Laptop Accessories. Price: Out Of Stock.

Product: T8 Multifunctional Folding Laptop Table. Category: Laptop Desk. Subcategory: Laptop Accessories. ",184,67101,67285
478,sentence,"Subcategory: Laptop Accessories. Price: Out Of Stock.

Product: Bamboo Wooden Single Fan Laptop Cooler Table Desk. Category: Laptop Desk. Subcategory: Laptop Accessories. Price: Out Of Stock.
",192,67252,67444
479,sentence,"Price: Out Of Stock.

Product: Height Adjustable Movable Laptop Desk 1 Layer. Category: Laptop Desk. Subcategory: Laptop Accessories. Price: Out Of Stock.
",155,67423,67578
480,sentence,"Price: Out Of Stock.

Product: Bamboo Wooden Dual Fan Laptop Cooler Table Desk. Category: Laptop Desk. Subcategory: Laptop Accessories. Price: Out Of Stock.
",157,67557,67714
481,sentence,"Price: Out Of Stock.

Product: XGear A8 Laptop Desk with Built-in Cooling Fans. Category: Laptop Desk. Subcategory: Laptop Accessories. Price: Out Of Stock.
",157,67693,67850
482,sentence,"Price: Out Of Stock.

Product: Height Adjustable Movable Laptop Desk with Storage Shelf. Category: Laptop Desk. Subcategory: Laptop Accessories. Price: Out Of Stock.
",166,67829,67995
483,sentence,"Price: Out Of Stock.

Product: Alluminium Foldable Laptop Table with Cup Holder & IPad Slot. Category: Laptop Desk. Subcategory: Laptop Accessories. Price: Out Of Stock.
",170,67974,68144
484,sentence,"Price: Out Of Stock.

Product: Laptop Battery for Asus 450 and 550 Series. Category: Laptop Battery. Subcategory: Laptop Accessories. Price: 2,000৳.
",149,68123,68272
485,sentence,"Subcategory: Laptop Accessories. Price: 2,000৳.

Product: MaxGreen BP195B Laptop Battery For Fujitsu. Category: Laptop Battery. Subcategory: Laptop Accessories. Price: 2,000৳.
",176,68224,68400
486,sentence,"Subcategory: Laptop Accessories. Price: 2,000৳.

Product: Laptop Battery For Fujitsu LH530. Category: Laptop Battery. Subcategory: Laptop Accessories. Price: 2,000৳.
",166,68352,68518
487,sentence,"Subcategory: Laptop Accessories. Price: 2,000৳.

Product: Laptop Battery For Toshiba Satellite 1305. Category: Laptop Battery. Subcategory: Laptop Accessories. Price: 2,100৳.
",175,68470,68645
488,sentence,"Subcategory: Laptop Accessories. Price: 2,100৳.

Product: Laptop Battery For Toshiba 3356. Category: Laptop Battery. Subcategory: Laptop Accessories. Price: 2,100৳.
",165,68597,68762
489,sentence,"Subcategory: Laptop Accessories. Price: 2,100৳.

Product: Laptop Battery For Toshiba PA5024. Category: Laptop Battery. Subcategory: Laptop Accessories. Price: 2,100৳.
",167,68714,68881
490,sentence,"Subcategory: Laptop Accessories. Price: 2,100৳.

Product: Laptop Battery For Toshiba 3733. Category: Laptop Battery. Subcategory: Laptop Accessories. Price: 2,100৳.
",165,68833,68998
491,sentence,"Subcategory: Laptop Accessories. Price: 2,100৳.

Product: Laptop Battery For Toshiba PA3634U PA3817U. Category: Laptop Battery. Subcategory: Laptop Accessories. Price: 2,100৳.
",176,68950,69126
492,sentence,"Subcategory: Laptop Accessories. Price: 2,100৳.

Product: Laptop Battery A Grade for HP. Category: Laptop Battery. Subcategory: Laptop Accessories. Price: 2,200৳.
",163,69078,69241
493,sentence,"Subcategory: Laptop Accessories. Price: 2,200৳.

Product: Laptop Battery A Grade for Dell. Category: Laptop Battery. Subcategory: Laptop Accessories. Price: 2,200৳.
",165,69193,69358
494,sentence,"Subcategory: Laptop Accessories. Price: 2,200৳.

Product: Laptop Battery A Grade For FUJITSU Laptop & Notebook. Category: Laptop Battery. Subcategory: Laptop Accessories. Price: 2,200৳.
",186,69310,69496
495,sentence,"Subcategory: Laptop Accessories. Price: 2,200৳.

Product: Laptop Battery for HP Probook 400 G1 Series. Category: Laptop Battery. Subcategory: Laptop Accessories. Price: 2,200৳.
",177,69448,69625
496,sentence,"Subcategory: Laptop Accessories. Price: 2,200৳.

Product: Laptop Battery for HP Probook 4440S/4530S. Category: Laptop Battery. Subcategory: Laptop Accessories. Price: 2,200৳.
",175,69577,69752
497,sentence,"Subcategory: Laptop Accessories. Price: 2,200৳.

Product: Laptop Battery A Grade for HP HS04 Laptop. Category: Laptop Battery. Subcategory: Laptop Accessories. Price: 2,200৳.
",175,69704,69879
498,sentence,"Subcategory: Laptop Accessories. Price: 2,200৳.

Product: Laptop Battery for Acer Aspire V5 Series. Category: Laptop Battery. Subcategory: Laptop Accessories. Price: 2,200৳.
",174,69831,70005
499,sentence,"Subcategory: Laptop Accessories. Price: 2,200৳.

Product: Laptop Battery for Acer Aspire 4000, 5000 and 7000 Series. Category: Laptop Battery. Subcategory: Laptop Accessories. Price: 2,200৳.
",191,69957,70148
500,sentence,"Subcategory: Laptop Accessories. Price: 2,200৳.

Product: JC04 and JC03 A Grade Laptop Battery For HP 15-bs, 15-bw, 14-bw, 255/ 250 G6. Category: Laptop Battery. Subcategory: Laptop Accessories. ",195,70100,70295
501,sentence,"Subcategory: Laptop Accessories. Price: 2,200৳.

Product: Ki04 A Grade Laptop Battery For HP 14-ab, 15-ab, 15-an, 15t-ak, 15t-ab, 17-g0. Category: Laptop Battery. Subcategory: Laptop Accessories. ",196,70262,70458
502,sentence,"Subcategory: Laptop Accessories. Price: 2,200৳.

Product: Ki04 LA04 Laptop Battery For HP 15-f0, 15-f1, 15-f2, 15-f3 and 14-n0 Models. Category: Laptop Battery. Subcategory: Laptop Accessories. ",194,70425,70619
503,sentence,"Subcategory: Laptop Accessories. Price: 2,200৳.

Product: Laptop Battery Ri04 A-Grade HP for ProBook 450 455 470 G3. Category: Laptop Battery. Subcategory: Laptop Accessories. Price: 2,200৳.
",191,70586,70777
504,sentence,"Subcategory: Laptop Accessories. Price: 2,200৳.

Product: Havit F2051 Laptop Cooler Pad. Category: Laptop Cooler. Subcategory: Laptop Accessories. Price: 1,200৳1,350৳.
",168,70729,70897
505,sentence,"Price: 1,200৳1,350৳.

Product: Havit F2081 Gaming Laptop Cooling Pad. Category: Laptop Cooler. Subcategory: Laptop Accessories. Price: 1,290৳1,390৳.

Product: DeepCool U PAL Laptop Cooler. ",189,70876,71065
506,sentence,"
Product: DeepCool U PAL Laptop Cooler. Category: Laptop Cooler. Subcategory: Laptop Accessories. Price: 1,400৳.

Product: Fantech NC14 Laptop Cooler. Category: Laptop Cooler. ",176,71025,71201
507,sentence,"Category: Laptop Cooler. Subcategory: Laptop Accessories. Price: 1,350৳1,450৳.

Product: Havit Gamenote F2069 RGB Gaming Laptop Cooling Pad. Category: Laptop Cooler. Subcategory: Laptop Accessories. ",199,71176,71375
508,sentence,"Subcategory: Laptop Accessories. Price: 1,690৳1,750৳.

Product: Xtrike Me FN-813 Laptop Cooler. Category: Laptop Cooler. Subcategory: Laptop Accessories. Price: 1,250৳1,400৳.
",175,71342,71517
509,sentence,"Price: 1,250৳1,400৳.

Product: Xtrike Me FN-811 Red Backlit Laptop Cooler. Category: Laptop Cooler. Subcategory: Laptop Accessories. Price: 1,350৳1,500৳.
",154,71496,71650
510,sentence,"Price: 1,350৳1,500৳.

Product: DeepCool Multi Core X6 4-fan Laptop Cooler. Category: Laptop Cooler. Subcategory: Laptop Accessories. Price: 2,000৳2,200৳.
",154,71629,71783
511,sentence,"Price: 2,000৳2,200৳.

Product: Gamdias AETHER M1 RGB Laptop Cooler With Phone Stand. Category: Laptop Cooler. Subcategory: Laptop Accessories. Price: 2,500৳.
",158,71762,71920
512,sentence,"Subcategory: Laptop Accessories. Price: 2,500৳.

Product: Fantech NC21 RGB Laptop Cooler. Category: Laptop Cooler. Subcategory: Laptop Accessories. Price: 2,660৳2,800৳.
",169,71872,72041
513,sentence,"Price: 2,660৳2,800৳.

Product: Redragon Ingrid GCP511 Laptop Cooler. Category: Laptop Cooler. Subcategory: Laptop Accessories. Price: 2,450৳2,700৳.
",148,72020,72168
514,sentence,"Price: 2,450৳2,700৳.

Product: Redragon GCP500 IVY RGB Backlighting Laptop Cooler. Category: Laptop Cooler. Subcategory: Laptop Accessories. Price: 3,100৳.

Product: Rapoo CF100 Laptop Cooler. ",193,72147,72340
515,sentence,"
Product: Rapoo CF100 Laptop Cooler. Category: Laptop Cooler. Subcategory: Laptop Accessories. Price: 1,100৳.

Product: Rapoo CF200 Laptop Cooler. Category: Laptop Cooler. ",172,72303,72475
516,sentence,"Category: Laptop Cooler. Subcategory: Laptop Accessories. Price: 1,450৳.

Product: Rapoo CF300 Laptop Cooler. Category: Laptop Cooler. Subcategory: Laptop Accessories. Price: 2,350৳.
",183,72450,72633
517,sentence,"Subcategory: Laptop Accessories. Price: 2,350৳.

Product: Suntech A8 Duble Fan LED Laptop Cooling Pad. Category: Laptop Cooler. Subcategory: Laptop Accessories. Price: Out Of Stock.
",182,72585,72767
518,sentence,"Price: Out Of Stock.

Product: Laptop Keyboard For Acer D730. Category: Laptop Keyboard. Subcategory: Laptop Accessories. Price: 1,200৳.

Product: Laptop Keyboard For Lenovo G-430. ",181,72746,72927
519,sentence,"
Product: Laptop Keyboard For Lenovo G-430. Category: Laptop Keyboard. Subcategory: Laptop Accessories. Price: 1,300৳.

Product: Laptop Keyboard For Acer Aspire 5749. Category: Laptop Keyboard. ",194,72883,73077
520,sentence,"Category: Laptop Keyboard. Subcategory: Laptop Accessories. Price: 1,300৳.

Product: Laptop Keyboard For Dell 3421. Category: Laptop Keyboard. Subcategory: Laptop Accessories. Price: 1,400৳.
",191,73050,73241
521,sentence,"Subcategory: Laptop Accessories. Price: 1,400৳.

Product: Laptop Keyboard For Acer 5736. Category: Laptop Keyboard. Subcategory: Laptop Accessories. Price: 1,400৳.
",164,73193,73357
522,sentence,"Subcategory: Laptop Accessories. Price: 1,400৳.

Product: Laptop Keyboard For Acer 4736. Category: Laptop Keyboard. Subcategory: Laptop Accessories. Price: 1,400৳.
",164,73309,73473
523,sentence,"Subcategory: Laptop Accessories. Price: 1,400৳.

Product: 14 inch Keyboard for Laptop & Notebook. Category: Laptop Keyboard. Subcategory: Laptop Accessories. Price: 1,500৳.
",173,73425,73598
524,sentence,"Subcategory: Laptop Accessories. Price: 1,500৳.

Product: Laptop Keyboard For HP Probook 4430S 4330S 4331S 4431S 4435S 4436S Series. Category: Laptop Keyboard. Subcategory: Laptop Accessories. ",193,73550,73743
525,sentence,"Subcategory: Laptop Accessories. Price: 1,500৳.

Product: Laptop Keyboard For HP 240, HP 14-E000. Category: Laptop Keyboard. Subcategory: Laptop Accessories. Price: 1,500৳.
",173,73710,73883
526,sentence,"Subcategory: Laptop Accessories. Price: 1,500৳.

Product: Laptop Keyboard For Dell 3442-14-3000. Category: Laptop Keyboard. Subcategory: Laptop Accessories. Price: 1,500৳.
",172,73835,74007
527,sentence,"Subcategory: Laptop Accessories. Price: 1,500৳.

Product: Laptop Keyboard For Dell 4110. Category: Laptop Keyboard. Subcategory: Laptop Accessories. Price: 1,500৳.
",164,73959,74123
528,sentence,"Subcategory: Laptop Accessories. Price: 1,500৳.

Product: Laptop Keyboard For Lenovo Ideapad 100-15IBY/IBD. Category: Laptop Keyboard. Subcategory: Laptop Accessories. Price: 1,500৳.
",183,74075,74258
529,sentence,"Subcategory: Laptop Accessories. Price: 1,500৳.

Product: Laptop Keyboard For Toshiba L500. Category: Laptop Keyboard. Subcategory: Laptop Accessories. Price: 1,500৳.
",167,74210,74377
530,sentence,"Subcategory: Laptop Accessories. Price: 1,500৳.

Product: Laptop Keyboard For Toshiba Z830. Category: Laptop Keyboard. Subcategory: Laptop Accessories. Price: 1,500৳.
",167,74329,74496
531,sentence,"Subcategory: Laptop Accessories. Price: 1,500৳.

Product: Laptop Keyboard For Toshiba L800. Category: Laptop Keyboard. Subcategory: Laptop Accessories. Price: 1,500৳.
",167,74448,74615
532,sentence,"Subcategory: Laptop Accessories. Price: 1,500৳.

Product: Laptop Keyboard For Toshiba C640. Category: Laptop Keyboard. Subcategory: Laptop Accessories. Price: 1,500৳.
",167,74567,74734
533,sentence,"Subcategory: Laptop Accessories. Price: 1,500৳.

Product: Laptop Keyboard For Toshiba C-50. Category: Laptop Keyboard. Subcategory: Laptop Accessories. Price: 1,500৳.
",167,74686,74853
534,sentence,"Subcategory: Laptop Accessories. Price: 1,500৳.

Product: UGREEN LP230 Adjustable Laptop Desk Stand #80348. Category: Laptop Stand. Subcategory: Laptop Accessories. Price: 900৳1,375৳.
",184,74805,74989
535,sentence,"Price: 900৳1,375৳.

Product: ORICO MA13 Verticle Adjustable Foldable Laptop Stand. Category: Laptop Stand. Subcategory: Laptop Accessories. Price: 1,500৳.

Product: Fantech NS12 Laptop Stand. ",192,74970,75162
536,sentence,"
Product: Fantech NS12 Laptop Stand. Category: Laptop Stand. Subcategory: Laptop Accessories. Price: 1,680৳.

Product: UGREEN LP258 Vertical Laptop Stand #20471. Category: Laptop Stand. ",186,75125,75311
537,sentence,"Category: Laptop Stand. Subcategory: Laptop Accessories. Price: 1,640৳1,800৳.

Product: Ugreen LP451 Foldable Laptop Stand #40289. Category: Laptop Stand. Subcategory: Laptop Accessories. ",188,75287,75475
538,sentence,"Subcategory: Laptop Accessories. Price: 1,849৳1,980৳.

Product: Vention KDLI0 Foldable and Portable Laptop Stand. Category: Laptop Stand. Subcategory: Laptop Accessories. Price: 1,490৳2,250৳.
",192,75442,75634
539,sentence,"Price: 1,490৳2,250৳.

Product: ORICO LST02 Adjustable Foldable Laptop Stand. Category: Laptop Stand. Subcategory: Laptop Accessories. Price: 2,300৳.
",149,75613,75762
540,sentence,"Subcategory: Laptop Accessories. Price: 2,300৳.

Product: UGREEN LP258 Vertical Dual Slot Laptop Stand #60643. Category: Laptop Stand. Subcategory: Laptop Accessories. Price: 2,200৳2,550৳.
",189,75714,75903
541,sentence,"Price: 2,200৳2,550৳.

Product: Fantech NS10 Laptop Stand. Category: Laptop Stand. Subcategory: Laptop Accessories. Price: 2,390৳3,450৳.

Product: Squire Ergonomic Push-Button Laptop Stand. ",189,75882,76071
542,sentence,"Category: Laptop Stand. Subcategory: Laptop Accessories. Price: 2,300৳3,600৳.

Product: UGREEN LP339 Adjustable Laptop Desk Stand #40291. Category: Laptop Stand. Subcategory: Laptop Accessories. ",195,76071,76266
543,sentence,"Subcategory: Laptop Accessories. Price: 4,000৳4,349৳.

Product: Ugreen LP592 Adjustable Swivel Laptop Stand #90849. Category: Laptop Stand. Subcategory: Laptop Accessories. Price: 4,920৳.
",188,76233,76421
544,sentence,"Subcategory: Laptop Accessories. Price: 4,920৳.

Product: Vyvylabs Wisdom Series VHW06-GY Laptop Stand 6-in-1 Multifunctional HUB Docking Station. Category: Laptop Stand. ",171,76373,76544
545,sentence,"Category: Laptop Stand. Subcategory: Laptop Accessories. Price: 10,470৳.

Product: Baseus Pro Series Rotatable and Foldable Laptop Stand. Category: Laptop Stand. Subcategory: Laptop Accessories. ",195,76520,76715
546,sentence,"Subcategory: Laptop Accessories. Price: Up Coming.

Product: Orico PFB-A23 7-Angles Adjustable Foldable Laptop Stand. Category: Laptop Stand. Subcategory: Laptop Accessories. Price: Out Of Stock.
",196,76682,76878
547,sentence,"Price: Out Of Stock.

Product: ORICO Aluminum Hard Drive Caddy (L95SS). Category: Caddy. Subcategory: Laptop Accessories. Price: Out Of Stock.
",143,76857,77000
548,sentence,"Price: Out Of Stock.

Product: Orico M95SS Laptop Hard Drive Caddy for Optical Drive. Category: Caddy. Subcategory: Laptop Accessories. Price: Out Of Stock.
",157,76979,77136
549,sentence,"Price: Out Of Stock.

Product: Laptop Display for 14"" 40 Pins Connector Laptop. Category: Display. Subcategory: Laptop Accessories. Price: 4,400৳.
",147,77115,77262
550,sentence,"Subcategory: Laptop Accessories. Price: 4,400৳.

Product: LED Laptop Display for 15.6"" Laptop & Notebook. Category: Display. Subcategory: Laptop Accessories. Price: 4,500৳.
",173,77214,77387
551,sentence,"Subcategory: Laptop Accessories. Price: 4,500৳.

Product: LCD Display for 14.1"" Laptop & Notebook. Category: Display. Subcategory: Laptop Accessories. Price: 5,000৳.
",166,77339,77505
552,sentence,"Subcategory: Laptop Accessories. Price: 5,000৳.

Product: Laptop Display for 14"" Laptop & Notebook with Ultra Normal Port. Category: Display. Subcategory: Laptop Accessories. Price: 5,000৳.
",190,77457,77647
553,sentence,"Subcategory: Laptop Accessories. Price: 5,000৳.

Product: Laptop Display for 15.6"" Ultra Slim High Resolution Laptop. Category: Display. Subcategory: Laptop Accessories. Price: 5,000৳.
",185,77599,77784
554,sentence,"Subcategory: Laptop Accessories. Price: 5,000৳.

Product: Laptop Display for 14"" HD Laptop & Notebook. Category: Display. Subcategory: Laptop Accessories. Price: 5,000৳.
",170,77736,77906
555,sentence,"Subcategory: Laptop Accessories. Price: 5,000৳.

Product: Laptop Display for 15.6"" HD Laptop. Category: Display. Subcategory: Laptop Accessories. Price: 5,000৳.
",161,77858,78019
556,sentence,"Subcategory: Laptop Accessories. Price: 5,000৳.

Product: Laptop Display for 14"" Laptop & Notebook with Ultra Micro Port. Category: Display. Subcategory: Laptop Accessories. Price: 6,000৳.
",189,77971,78160
557,sentence,"Subcategory: Laptop Accessories. Price: 6,000৳.

Product: LCD Display for 15"" Laptop & Notebook. Category: Display. Subcategory: Laptop Accessories. Price: 6,000৳.
",164,78112,78276
558,sentence,"Subcategory: Laptop Accessories. Price: 6,000৳.

Product: Laptop Display for 15.6"" Full HD Laptop & Notebook. Category: Display. Subcategory: Laptop Accessories. Price: 6,000৳.
",177,78228,78405
559,sentence,"Subcategory: Laptop Accessories. Price: 6,000৳.

Product: Laptop Display Full HD 15.6"" Ultra 40pin 144Hz Series. Category: Display. Subcategory: Laptop Accessories. Price: 9,000৳.
",180,78357,78537
560,sentence,"Subcategory: Laptop Accessories. Price: 9,000৳.

Product: Acer Swift 3 SF315-51-54BJ 15.6"" Convertible Display. Category: Display. Subcategory: Laptop Accessories. Price: 25,900৳.
",180,78489,78669
561,sentence,"Price: 25,900৳.

Product: Dell Inspiron 13-5368 13.3"" Front Part Convertible Touch Display. Category: Display. Subcategory: Laptop Accessories. Price: 26,900৳.
",160,78653,78813
562,sentence,"Price: 26,900৳.

Product: Dell XPS 13-7391 Front Panel Part With Touch For Notebook. Category: Display. Subcategory: Laptop Accessories. Price: 28,000৳.
",153,78797,78950
563,sentence,"Price: 28,000৳.

Product: HP Pavilion X360 14-BA Series 14"" Front Part Convertible Touch Display. Category: Display. Subcategory: Laptop Accessories. Price: 31,800৳.
",166,78934,79100
564,sentence,"Price: 31,800৳.

Product: Asus UX362F Convertible Full Touch Panel For Notebook. Category: Display. Subcategory: Laptop Accessories. Price: 34,400৳.
",149,79084,79233
565,sentence,"Price: 34,400৳.

Product: HP Pavilion X360 13-BA Series 13"" Convertible Touch Display. Category: Display. Subcategory: Laptop Accessories. Price: 35,000৳.
",155,79217,79372
566,sentence,"Price: 35,000৳.

Product: HP Spectra X360 Convertible Touch Display. Category: Display. Subcategory: Laptop Accessories. Price: 35,100৳.
",137,79356,79493
567,sentence,"Price: 35,100৳.

Product: Lenovo Yoga 520-14IKB 14"" Front Part Convertible Touch Display. Category: Display. Subcategory: Laptop Accessories. Price: 36,800৳.
",158,79477,79635
568,sentence,"Price: 36,800৳.

Product: HP Spectra X360 15-EB1043DX 15.6"" Front Part Convertible Touch Display. Category: Display. Subcategory: Laptop Accessories. Price: 38,200৳.
",166,79619,79785
569,sentence,"Price: 38,200৳.

Product: Laptop Charger Adapter A Grade for Acer. Category: Laptop Charger / Adapter. Subcategory: Laptop Accessories. Price: 1,300৳.
",151,79769,79920
570,sentence,"Subcategory: Laptop Accessories. Price: 1,300৳.

Product: Laptop Power Charger Adapter for Asus. Category: Laptop Charger / Adapter. Subcategory: Laptop Accessories. Price: 1,300৳.
",181,79872,80053
571,sentence,"Subcategory: Laptop Accessories. Price: 1,300৳.

Product: Laptop Power Charger Adapter for Dell Laptop & Notebook. Category: Laptop Charger / Adapter. Subcategory: Laptop Accessories. Price: 1,300৳.
",199,80005,80204
572,sentence,"Subcategory: Laptop Accessories. Price: 1,300৳.

Product: Laptop Power Charger Adapter A Grade for Fujitsu. Category: Laptop Charger / Adapter. Subcategory: Laptop Accessories. Price: 1,300৳.
",192,80156,80348
573,sentence,"Subcategory: Laptop Accessories. Price: 1,300৳.

Product: Laptop Power Charger Adapter A Grade for HP. Category: Laptop Charger / Adapter. Subcategory: Laptop Accessories. Price: 1,300৳.
",187,80300,80487
574,sentence,"Subcategory: Laptop Accessories. Price: 1,300৳.

Product: Laptop Power Charger Adapter Blue Pin 2.31A for HP. Category: Laptop Charger / Adapter. Subcategory: Laptop Accessories. Price: 1,500৳.
",194,80439,80633
575,sentence,"Subcategory: Laptop Accessories. Price: 1,500৳.

Product: Laptop Power Charger Adapter 65W Blue Pin 3.33A for HP. Category: Laptop Charger / Adapter. Subcategory: Laptop Accessories. Price: 1,500৳.
",198,80585,80783
576,sentence,"Subcategory: Laptop Accessories. Price: 1,500৳.

Product: Laptop Power Charger Adapter 3.34A for Dell. Category: Laptop Charger / Adapter. Subcategory: Laptop Accessories. Price: 1,500৳.
",187,80735,80922
577,sentence,"Subcategory: Laptop Accessories. Price: 1,500৳.

Product: Laptop Power Charger Adapter 65W 3.25A USB for Lenovo. Category: Laptop Charger / Adapter. Subcategory: Laptop Accessories. Price: 1,300৳.
",197,80874,81071
578,sentence,"Subcategory: Laptop Accessories. Price: 1,300৳.

Product: Laptop Power Charger Adapter 3.16A for Samsung. Category: Laptop Charger / Adapter. Subcategory: Laptop Accessories. Price: 1,300৳.
",190,81023,81213
579,sentence,"Subcategory: Laptop Accessories. Price: 1,300৳.

Product: MaxGreen 19V 3.42A 65W Laptop Charger Adapter For Acer Laptop. Category: Laptop Charger / Adapter. Subcategory: Laptop Accessories. ",190,81165,81355
580,sentence,"Subcategory: Laptop Accessories. Price: 1,500৳.

Product: MaxGreen 19V 3.42A 65W Common Port Laptop Charger Adapter For Asus Laptop. Category: Laptop Charger / Adapter. ",169,81322,81491
581,sentence,"Category: Laptop Charger / Adapter. Subcategory: Laptop Accessories. Price: 1,500৳.

Product: MaxGreen 19.5V 3.34A 65W Big Port Laptop Charger Adapter For Dell Laptop. ",168,81455,81623
582,sentence,"Category: Laptop Charger / Adapter. Subcategory: Laptop Accessories. Price: 1,500৳.

Product: Intel Pentium Gold G6400 10th gen Coffee Lake Processor. Category: Intel. Subcategory: Processor. ",192,81623,81815
583,sentence,"Category: Intel. Subcategory: Processor. Price: 5,700৳6,100৳.

Product: Intel 10th Gen Core i3 10100F Processor. Category: Intel. Subcategory: Processor. Price: 6,900৳7,300৳.
",175,81774,81949
584,sentence,"Subcategory: Processor. Price: 6,900৳7,300৳.

Product: Intel Pentium Gold G7400 Alder Lake Processor. Category: Intel. Subcategory: Processor. Price: 7,499৳7,900৳.
",164,81904,82068
585,sentence,"Subcategory: Processor. Price: 7,499৳7,900৳.

Product: Intel Pentium Gold G6405 Coffee Lake Processor. Category: Intel. Subcategory: Processor. Price: 7,600৳8,200৳.
",165,82023,82188
586,sentence,"Subcategory: Processor. Price: 7,600৳8,200৳.

Product: Intel 10th Gen Core i5-10400F Processor. Category: Intel. Subcategory: Processor. Price: 8,900৳9,600৳.
",158,82143,82301
587,sentence,"Subcategory: Processor. Price: 8,900৳9,600৳.

Product: Intel 11th Gen Core i5-11400F Rocket Lake Processor. Category: Intel. Subcategory: Processor. Price: 9,500৳10,500৳.
",171,82256,82427
588,sentence,"Subcategory: Processor. Price: 9,500৳10,500৳.

Product: Intel 5th Gen Core i7 5930K Processor. Category: Intel. Subcategory: Processor. Price: 9,900৳10,500৳.
",158,82381,82539
589,sentence,"Subcategory: Processor. Price: 9,900৳10,500৳.

Product: Intel Core i3-12100 12th Gen Alder Lake Processor (Tray). Category: Intel. Subcategory: Processor. Price: 9,900৳10,500৳.
",177,82493,82670
590,sentence,"Subcategory: Processor. Price: 9,900৳10,500৳.

Product: Intel 10th Gen Core i3 10100 Processor. Category: Intel. Subcategory: Processor. Price: 10,600৳11,500৳.
",160,82624,82784
591,sentence,"Subcategory: Processor. Price: 10,600৳11,500৳.

Product: Intel Core i3-12100 12th Gen Alder Lake Processor. Category: Intel. Subcategory: Processor. Price: 11,450৳11,800৳.
",172,82737,82909
592,sentence,"Subcategory: Processor. Price: 11,450৳11,800৳.

Product: Intel Core i3 13100 13th Gen Processor (TRAY). Category: Intel. Subcategory: Processor. Price: 11,900৳.
",161,82862,83023
593,sentence,"Subcategory: Processor. Price: 11,900৳.

Product: Intel Core i3 10105 10th Gen Comet Lake Processor. Category: Intel. Subcategory: Processor. Price: 10,400৳12,500৳.
",165,82983,83148
594,sentence,"Subcategory: Processor. Price: 10,400৳12,500৳.

Product: Intel 13th Gen Core i3-13100 Raptor Lake Processor. Category: Intel. Subcategory: Processor. Price: 12,500৳13,100৳.
",173,83101,83274
595,sentence,"Subcategory: Processor. Price: 12,500৳13,100৳.

Product: Intel 12th Gen Core i5-12400F Alder Lake Processor. Category: Intel. Subcategory: Processor. Price: 12,450৳13,200৳.
",173,83227,83400
596,sentence,"Subcategory: Processor. Price: 12,450৳13,200৳.

Product: Intel 11th Gen Core i5-11500 Rocket Lake Processor. Category: Intel. Subcategory: Processor. Price: 13,000৳13,500৳.
",173,83353,83526
597,sentence,"Subcategory: Processor. Price: 13,000৳13,500৳.

Product: Intel 11th Gen Core i5-11400 Rocket Lake Processor. Category: Intel. Subcategory: Processor. Price: 13,500৳14,000৳.
",173,83479,83652
598,sentence,"Subcategory: Processor. Price: 13,500৳14,000৳.

Product: Intel 10th Gen Core i5-10400 Processor. Category: Intel. Subcategory: Processor. Price: 13,800৳14,500৳.
",161,83605,83766
599,sentence,"Subcategory: Processor. Price: 13,800৳14,500৳.

Product: Intel Core i3 14100 14th Gen Raptor Lake Processor. Category: Intel. Subcategory: Processor. Price: 13,950৳14,700৳.
",173,83719,83892
600,sentence,"Subcategory: Processor. Price: 13,950৳14,700৳.

Product: Intel 10th Gen Core i5-10500 Processor. Category: Intel. Subcategory: Processor. Price: 13,900৳14,800৳.
",161,83845,84006
601,sentence,"Subcategory: Processor. Price: 13,900৳14,800৳.

Product: Intel 13th Gen Core i5 13400F Raptor Lake Processor. Category: Intel. Subcategory: Processor. Price: 16,200৳16,500৳.
",174,83959,84133
602,sentence,"Subcategory: Processor. Price: 16,200৳16,500৳.

Product: AMD Athlon PRO 300GE AM4 Socket Desktop Processor with Radeon Vega 3 Graphics (Rebox). Category: AMD. Subcategory: Processor. ",183,84086,84269
603,sentence,"Category: AMD. Subcategory: Processor. Price: 4,900৳5,500৳.

Product: AMD Ryzen 5 3400G Processor with Radeon RX Vega 11 Graphics. Category: AMD. Subcategory: Processor. Price: 7,200৳7,700৳.
",191,84230,84421
604,sentence,"Subcategory: Processor. Price: 7,200৳7,700৳.

Product: AMD Ryzen 5 5500 Processor. Category: AMD. Subcategory: Processor. Price: 8,300৳8,900৳.

Product: AMD Ryzen 3 4100 Processor. Category: AMD. ",196,84376,84572
605,sentence,"Category: AMD. Subcategory: Processor. Price: 9,300৳10,000৳.

Product: AMD Ryzen Threadripper 1900X Processor. Category: AMD. Subcategory: Processor. Price: 10,000৳10,500৳.
",173,84557,84730
606,sentence,"Subcategory: Processor. Price: 10,000৳10,500৳.

Product: AMD Ryzen 5 8400F Processor. Category: AMD. Subcategory: Processor. Price: 11,200৳11,500৳.

Product: AMD Ryzen 5 5600 Processor. ",186,84683,84869
607,sentence,"
Product: AMD Ryzen 5 5600 Processor. Category: AMD. Subcategory: Processor. Price: 11,500৳12,000৳.

Product: AMD Ryzen 5 5600X Processor. Category: AMD. Subcategory: Processor. ",178,84831,85009
608,sentence,"Category: AMD. Subcategory: Processor. Price: 12,500৳12,900৳.

Product: AMD Ryzen 5 3600 Processor. Category: AMD. Subcategory: Processor. Price: 11,900৳13,500৳.
",162,84970,85132
609,sentence,"Subcategory: Processor. Price: 11,900৳13,500৳.

Product: AMD Ryzen 5 5600GT AM4 Processor with Radeon Graphics. Category: AMD. Subcategory: Processor. Price: 13,500৳13,900৳.
",174,85085,85259
610,sentence,"Subcategory: Processor. Price: 13,500৳13,900৳.

Product: AMD Ryzen 7 5700X Processor. Category: AMD. Subcategory: Processor. Price: 13,000৳14,000৳.
",148,85212,85360
611,sentence,"Subcategory: Processor. Price: 13,000৳14,000৳.

Product: AMD Ryzen 5 5600G Processor with Radeon Graphics (Tray Box). Category: AMD. Subcategory: Processor. Price: 13,500৳14,500৳.
",180,85313,85493
612,sentence,"Subcategory: Processor. Price: 13,500৳14,500৳.

Product: AMD Ryzen 5 5600G Processor with Radeon Graphics. Category: AMD. Subcategory: Processor. Price: 14,800৳.
",162,85446,85608
613,sentence,"Subcategory: Processor. Price: 14,800৳.

Product: AMD Ryzen 5 7400F Processor. Category: AMD. Subcategory: Processor. Price: 14,799৳15,800৳.
",141,85568,85709
614,sentence,"Subcategory: Processor. Price: 14,799৳15,800৳.

Product: AMD Ryzen 7 5700G Processor with Radeon Graphics. Category: AMD. Subcategory: Processor. Price: 15,500৳16,500৳.
",169,85662,85831
615,sentence,"Subcategory: Processor. Price: 15,500৳16,500৳.

Product: AMD Ryzen 5 7500F Processor. Category: AMD. Subcategory: Processor. Price: 15,800৳17,000৳.

Product: AMD Ryzen 5 7600 Gaming Processor. ",193,85784,85977
616,sentence,"
Product: AMD Ryzen 5 7600 Gaming Processor. Category: AMD. Subcategory: Processor. Price: 20,700৳.

Product: AMD Ryzen 7 5800X Processor. Category: AMD. Subcategory: Processor. ",178,85932,86110
617,sentence,"Category: AMD. Subcategory: Processor. Price: 21,000৳21,500৳.

Product: AMD Ryzen 5 8500G Processor with Radeon Graphics. Category: AMD. Subcategory: Processor. Price: 21,500৳.
",177,86071,86248
618,sentence,"Subcategory: Processor. Price: 21,500৳.

Product: AMD Ryzen 5 7600X Processor. Category: AMD. Subcategory: Processor. Price: 20,998৳22,000৳.

Product: Netac Basic 8GB DDR4 2666MHZ Desktop RAM. ",193,86208,86401
619,sentence,"Category: Component. Price: Up Coming.

Product: Corsair SF850L 850W 80 PLUS Gold Fully Modular SFX Power Supply. Category: Component. Price: 19,500৳20,000৳.
",158,86401,86559
620,sentence,"Category: Component. Price: 19,500৳20,000৳.

Product: Gamdias AEOLUS M2 1201 120mm RGB Casing Cooling Fan. Category: Component. Price: 1,150৳.

Product: MaxGreen M19 ARGB 120mm Casing Fan. ",189,86515,86704
621,sentence,"
Product: MaxGreen M19 ARGB 120mm Casing Fan. Category: Component. Price: 450৳.

Product: PC Power CFX 120MM ARGB Case Fan White. Category: Component. Price: 375৳490৳.
",168,86658,86826
622,sentence,"Category: Component. Price: 375৳490৳.

Product: Deepcool RF 120 B Blue LED Case Fan. Category: Component. Price: 500৳550৳.

Product: Deepcool RF 120 W White LED Case Fan. Category: Component. ",192,86788,86980
623,sentence,"Category: Component. Price: 500৳550৳.

Product: Deepcool RF 120 R Red LED Case Fan. Category: Component. Price: 500৳550৳.

Product: MaxGreen M59 ARGB 120mm Casing Fan. Category: Component. ",189,86959,87148
624,sentence,"Category: Component. Price: 550৳.

Product: MaxGreen M57 ARGB 120mm Casing Fan. Category: Component. Price: 650৳.

Product: upHere U3KC1 120mm ARGB Casing Fan. Category: Component. Price: 700৳.
",194,87127,87321
625,sentence,"Category: Component. Price: 700৳.

Product: upHere U3TC1 120mm ARGB Casing Fan. Category: Component. Price: 600৳700৳.

Product: Antec F12 120mm RGB Case Fan (Single Pack). Category: Component. ",193,87287,87480
626,sentence,"Category: Component. Price: 750৳.

Product: Arctic P8 Silent 80mm Low Noise Casing Cooler. Category: Component. Price: 700৳750৳.

Product: EKWB EK-Quantum Torque HDC 12 Black. Category: Component. ",197,87459,87656
627,sentence,"Category: Component. Price: 300৳799৳.

Product: Cooler Master CF120 ARGB Case Fan. Category: Component. Price: 850৳.

Product: Gamdias NOTUS M1-1201 120mm Casing Cooling Fan. Category: Component. ",196,87635,87831
628,sentence,"Category: Component. Price: 850৳.

Product: Antec I Shape Prism GPU Holder. Category: Component. Price: 900৳.

Product: Arctic F12 120 mm Casing Fan. Category: Component. Price: 900৳.
",184,87810,87994
629,sentence,"Category: Component. Price: 900৳.

Product: Gamdias NOTUS M1-1201 ARGB 120mm Casing Cooling Fan. Category: Component. Price: 975৳.

Product: EKWB EK-HD Tube Reamer. Category: EKWB. ",181,87960,88141
630,sentence,"Category: EKWB. Subcategory: Water / Liquid Cooling. Price: 600৳1,200৳.

Product: EKWB EK-CryoFuel Solid Scarlet RED 250ml (Conc.) Non-transparent Coolants. Category: EKWB. ",173,88125,88298
631,sentence,"Category: EKWB. Subcategory: Water / Liquid Cooling. Price: 799৳1,700৳.

Product: EKWB EK-DuraClear 11,1/15,9mm 3M Retail. Category: EKWB. Subcategory: Water / Liquid Cooling. Price: 899৳2,000৳.
",195,88282,88477
632,sentence,"Price: 899৳2,000৳.

Product: EKWB 6-Pack HDC 12 EK-Quantum Torque. Category: EKWB. Subcategory: Water / Liquid Cooling. Price: 1,999৳4,000৳.

Product: EKWB EK-Loop Soft 12/16mm 3mm Tube. ",187,88458,88645
633,sentence,"
Product: EKWB EK-Loop Soft 12/16mm 3mm Tube. Category: EKWB. Subcategory: Water / Liquid Cooling. Price: 3,600৳4,500৳.

Product: EKWB EK-Quantum Velocity D-RGB AMD Nickel + Acetal Water Block. ",194,88599,88793
634,sentence,"Category: EKWB. Subcategory: Water / Liquid Cooling. Price: 4,000৳11,000৳.

Product: EKWB EK-XTOP DDC 3.2 PWM Elite Plexi. Category: EKWB. Subcategory: Water / Liquid Cooling. Price: 6,000৳12,300৳.
",198,88793,88991
635,sentence,"Price: 6,000৳12,300৳.

Product: EKWB EK-Quantum Velocity Nickel Plexi. Category: EKWB. Subcategory: Water / Liquid Cooling. Price: Up Coming.

Product: EKWB EK-Loop Multi Allen Key. Category: EKWB. ",198,88969,89167
636,sentence,"Category: EKWB. Subcategory: Water / Liquid Cooling. Price: Out Of Stock.

Product: EKWB PVC 10-12mm Tube Clamp. Category: EKWB. Subcategory: Water / Liquid Cooling. Price: Out Of Stock.
",187,89151,89338
637,sentence,"Price: Out Of Stock.

Product: EKWB Filling 1000mL Bottle. Category: EKWB. Subcategory: Water / Liquid Cooling. Price: Out Of Stock.

Product: EKWB EK-HD PETG 10/12mm 500mm Tube. Category: EKWB. ",195,89317,89512
638,sentence,"Category: EKWB. Subcategory: Water / Liquid Cooling. Price: Out Of Stock.

Product: EKWB EK-Quantum 90Â° Torque Rotary. Category: EKWB. Subcategory: Water / Liquid Cooling. Price: Out Of Stock.
",194,89496,89690
639,sentence,"Price: Out Of Stock.

Product: EKWB EK-HD 10/12mm 500mm Tube. Category: EKWB. Subcategory: Water / Liquid Cooling. Price: Out Of Stock.

Product: EKWB EK-D-RGB 6-Way Splitter Cable. Category: EKWB. ",198,89669,89867
640,sentence,"Category: EKWB. Subcategory: Water / Liquid Cooling. Price: Out Of Stock.

Product: EKWB EK-CryoFuel Solid Concentrate Coolant 250mL Cloud White. Category: EKWB. Subcategory: Water / Liquid Cooling. ",199,89851,90050
641,sentence,"Subcategory: Water / Liquid Cooling. Price: Out Of Stock.

Product: EKWB EK-CryoFuel Solid Concentrate Coolant 250mL Neon Green. Category: EKWB. Subcategory: Water / Liquid Cooling. ",182,90013,90195
642,sentence,"Subcategory: Water / Liquid Cooling. Price: Out Of Stock.

Product: EKWB EK-CryoFuel Dye Pack. Category: EKWB. Subcategory: Water / Liquid Cooling. Price: Out Of Stock.
",169,90158,90327
643,sentence,"Price: Out Of Stock.

Product: EKWB EK-CryoFuel Solid Electric Purple Concentrate 250mL Coolant. Category: EKWB. Subcategory: Water / Liquid Cooling. Price: Out Of Stock.
",171,90306,90477
644,sentence,"Price: Out Of Stock.

Product: DeepCool ICE EDGE MINI FS V2.0 CPU Air Cooler. Category: CPU Cooler. Subcategory: Component. Price: 1,000৳1,100৳.

Product: Arctic Alpine 23 CO Compact AMD CPU Cooler. ",199,90456,90655
645,sentence,"Category: CPU Cooler. Subcategory: Component. Price: 1,200৳1,250৳.

Product: Arctic Alpine 17 CO Low Profile Intel CPU Cooler. Category: CPU Cooler. Subcategory: Component. Price: 1,000৳1,250৳.
",194,90655,90849
646,sentence,"Subcategory: Component. Price: 1,000৳1,250৳.

Product: Xtreme XJOGOS XJC100A 90W CPU Cooler. Category: CPU Cooler. Subcategory: Component. Price: 1,300৳1,400৳.
",160,90804,90964
647,sentence,"Subcategory: Component. Price: 1,300৳1,400৳.

Product: Arctic Freezer 8i Air CPU Cooler. Category: CPU Cooler. Subcategory: Component. Price: 1,999৳.

Product: Arctic Freezer 8A AMD Air CPU Cooler. ",198,90919,91117
648,sentence,"
Product: Arctic Freezer 8A AMD Air CPU Cooler. Category: CPU Cooler. Subcategory: Component. Price: 1,999৳.

Product: Arctic Freezer 8A CO AMD Air CPU Cooler. Category: CPU Cooler. ",182,91069,91251
649,sentence,"Category: CPU Cooler. Subcategory: Component. Price: 2,199৳.

Product: Arctic Freezer 8i CO Intel Air CPU Cooler. Category: CPU Cooler. Subcategory: Component. Price: 2,300৳.
",175,91229,91404
650,sentence,"Subcategory: Component. Price: 2,300৳.

Product: Thermaltake UX400 ARGB Sync AIR CPU Cooler. Category: CPU Cooler. Subcategory: Component. Price: 2,300৳2,400৳.
",160,91365,91525
651,sentence,"Subcategory: Component. Price: 2,300৳2,400৳.

Product: upHere UP1K4 120mm Air CPU Cooler. Category: CPU Cooler. Subcategory: Component. Price: 2,300৳2,500৳.
",157,91480,91637
652,sentence,"Subcategory: Component. Price: 2,300৳2,500৳.

Product: Thermaltake UX400 ARGB Sync AIR CPU Cooler White. Category: CPU Cooler. Subcategory: Component. Price: 2,500৳2,600৳.
",172,91592,91764
653,sentence,"Subcategory: Component. Price: 2,500৳2,600৳.

Product: DeepCool AG400 ARGB CPU Cooler. Category: CPU Cooler. Subcategory: Component. Price: 2,650৳.
",148,91719,91867
654,sentence,"Subcategory: Component. Price: 2,650৳.

Product: Huntkey Frozen 400X Fantasy ARGB CPU Cooler. Category: CPU Cooler. Subcategory: Component. Price: 2,400৳2,800৳.
",161,91828,91989
655,sentence,"Subcategory: Component. Price: 2,400৳2,800৳.

Product: Arctic Freezer 7 X Multi-Compatible Air CPU Cooler. Category: CPU Cooler. Subcategory: Component. Price: 2,423৳2,850৳.
",174,91944,92118
656,sentence,"Subcategory: Component. Price: 2,423৳2,850৳.

Product: DeepCool AG500 ARGB 120mm Single Tower CPU Cooler. Category: CPU Cooler. Subcategory: Component. Price: 2,899৳.
",167,92073,92240
657,sentence,"Subcategory: Component. Price: 2,899৳.

Product: DeepCool AG400 BK ARGB Single Tower 120mm CPU Cooler. Category: CPU Cooler. Subcategory: Component. Price: 2,950৳.
",164,92201,92365
658,sentence,"Subcategory: Component. Price: 2,950৳.

Product: upHere UP1KC4C ARGB 120mm Air CPU Cooler. Category: CPU Cooler. Subcategory: Component. Price: 3,000৳3,200৳.
",158,92326,92484
659,sentence,"Subcategory: Component. Price: 3,000৳3,200৳.

Product: upHere UP1TC4C ARGB 120mm Air CPU Cooler. Category: CPU Cooler. Subcategory: Component. Price: 3,000৳3,200৳.
",164,92439,92603
660,sentence,"Subcategory: Component. Price: 3,000৳3,200৳.

Product: upHere H85KC6 ARGB 120mm Air CPU Cooler. Category: CPU Cooler. Subcategory: Component. Price: 3,200৳3,500৳.
",163,92558,92721
661,sentence,"Subcategory: Component. Price: 3,200৳3,500৳.

Product: upHere D6SEC ARGB Dual Tower Air CPU Cooler. Category: CPU Cooler. Subcategory: Component. Price: 3,500৳3,700৳.
",167,92676,92843
662,sentence,"Subcategory: Component. Price: 3,500৳3,700৳.

Product: ASROCK H610M-H2/M.2 14th, 13th and 12th Gen mATX DDR4 Motherboard. Category: ASRock (Intel). Subcategory: Motherboard. Price: 9,800৳10,000৳.
",196,92798,92994
663,sentence,"Subcategory: Motherboard. Price: 9,800৳10,000৳.

Product: ASRock B760M PG Lightning DDR5 14th, 13th and 12th Gen Micro ATX Motherboard. Category: ASRock (Intel). Subcategory: Motherboard. ",188,92946,93134
664,sentence,"Subcategory: Motherboard. Price: 16,300৳.

Product: ASRock B760M Pro-A DDR5 Micro ATX Motherboard. Category: ASRock (Intel). Subcategory: Motherboard. Price: 16,900৳17,500৳.
",174,93108,93282
665,sentence,"Price: 16,900৳17,500৳.

Product: ASRock B760M Pro RS DDR5 mATX Motherboard. Category: ASRock (Intel). Subcategory: Motherboard. Price: 18,900৳.
",144,93259,93403
666,sentence,"Subcategory: Motherboard. Price: 18,900৳.

Product: ASRock B760M Pro-A WiFi DDR5 Micro ATX Motherboard. Category: ASRock (Intel). Subcategory: Motherboard. Price: 19,400৳.
",172,93361,93533
667,sentence,"Subcategory: Motherboard. Price: 19,400৳.

Product: ASRock Z890 Pro-A WiFi LGA1851 DDR5 ATX Motherboard. Category: ASRock (Intel). Subcategory: Motherboard. Price: 34,500৳.
",173,93491,93664
668,sentence,"Subcategory: Motherboard. Price: 34,500৳.

Product: ASRock Z890 Pro RS WiFi White LGA1851 DDR5 ATX Motherboard. Category: ASRock (Intel). Subcategory: Motherboard. Price: 40,000৳.
",180,93622,93802
669,sentence,"Subcategory: Motherboard. Price: 40,000৳.

Product: ASRock Z890 Steel Legend WiFi LGA1851 DDR5 ATX Motherboard. Category: ASRock (Intel). Subcategory: Motherboard. Price: 44,000৳.
",180,93760,93940
670,sentence,"Subcategory: Motherboard. Price: 44,000৳.

Product: ASRock Z790 PG Lightning/D4 ATX Motherboard. Category: ASRock (Intel). Subcategory: Motherboard. Price: Up Coming.
",167,93898,94065
671,sentence,"Subcategory: Motherboard. Price: Up Coming.

Product: ASRock Z790M PG Lightning/D4 Micro ATX Motherboard. Category: ASRock (Intel). Subcategory: Motherboard. Price: Up Coming.
",176,94021,94197
672,sentence,"Subcategory: Motherboard. Price: Up Coming.

Product: ASRock Z790 PG Lightning ATX Motherboard. Category: ASRock (Intel). Subcategory: Motherboard. Price: Up Coming.
",166,94153,94319
673,sentence,"Subcategory: Motherboard. Price: Up Coming.

Product: ASRock H610M-HDV/M.2 Micro ATX Motherboard. Category: ASRock (Intel). Subcategory: Motherboard. Price: Out Of Stock.
",171,94275,94446
674,sentence,"Subcategory: Motherboard. Price: Out Of Stock.

Product: ASRock B760M-HDV/M.2 D4 Micro ATX Motherboard. Category: ASRock (Intel). Subcategory: Motherboard. Price: Out Of Stock.
",177,94399,94576
675,sentence,"Subcategory: Motherboard. Price: Out Of Stock.

Product: ASRock B760M-HDV/M.2 DDR5 Micro ATX Motherboard. Category: ASRock (Intel). Subcategory: Motherboard. Price: Out Of Stock.
",179,94529,94708
676,sentence,"Subcategory: Motherboard. Price: Out Of Stock.

Product: ASRock B760 Pro RS/D4 ATX Motherboard. Category: ASRock (Intel). Subcategory: Motherboard. Price: Out Of Stock.
",169,94661,94830
677,sentence,"Subcategory: Motherboard. Price: Out Of Stock.

Product: ASRock Z790 Pro RS/D4 ATX Motherboard. Category: ASRock (Intel). Subcategory: Motherboard. Price: Out Of Stock.
",169,94783,94952
678,sentence,"Subcategory: Motherboard. Price: Out Of Stock.

Product: ASRock B450M-HDV R4.0 AMD Motherboard. Category: ASRock (AMD). Subcategory: Motherboard. Price: 7,999৳8,400৳.
",167,94905,95072
679,sentence,"Subcategory: Motherboard. Price: 7,999৳8,400৳.

Product: ASRock A520M-HVS AMD AM4 Micro ATX Motherboard. Category: ASRock (AMD). Subcategory: Motherboard. Price: 7,900৳8,450৳.
",176,95025,95201
680,sentence,"Subcategory: Motherboard. Price: 7,900৳8,450৳.

Product: ASRock B850M Pro-A WiFi AM5 DDR5 mATX Motherboard. Category: ASRock (AMD). Subcategory: Motherboard. Price: 24,999৳.
",174,95154,95328
681,sentence,"Subcategory: Motherboard. Price: 24,999৳.

Product: ASRock B850M-X WiFi AM5 DDR5 Micro ATX Motherboard. Category: ASRock (AMD). Subcategory: Motherboard. Price: 18,500৳.
",170,95286,95456
682,sentence,"Subcategory: Motherboard. Price: 18,500৳.

Product: ASRock B850 Pro-A WiFi AM5 DDR5 ATX Motherboard. Category: ASRock (AMD). Subcategory: Motherboard. Price: 27,500৳.
",167,95414,95581
683,sentence,"Subcategory: Motherboard. Price: 27,500৳.

Product: ASRock B850 STEEL LEGEND WIFI AM5 DDR5 ATX Motherboard. Category: ASRock (AMD). Subcategory: Motherboard. Price: 33,999৳.
",174,95539,95713
684,sentence,"Subcategory: Motherboard. Price: 33,999৳.

Product: ASRock B850M STEEL LEGEND WIFI AM5 DDR5 mATX Motherboard. Category: ASRock (AMD). Subcategory: Motherboard. Price: 27,500৳.
",176,95671,95847
685,sentence,"Subcategory: Motherboard. Price: 27,500৳.

Product: ASRock X870 Pro RS WiFi AM5 DDR5 ATX Motherboard. Category: ASRock (AMD). Subcategory: Motherboard. Price: 35,500৳36,000৳.
",175,95805,95980
686,sentence,"Price: 35,500৳36,000৳.

Product: ASRock X870E Nova WiFi AM5 DDR5 ATX Motherboard. Category: ASRock (AMD). Subcategory: Motherboard. Price: 55,500৳.
",148,95957,96105
687,sentence,"Subcategory: Motherboard. Price: 55,500৳.

Product: ASRock B650M PG Riptide AMD AM5 Micro ATX Motherboard. Category: ASRock (AMD). Subcategory: Motherboard. Price: Up Coming.
",175,96063,96238
688,sentence,"Subcategory: Motherboard. Price: Up Coming.

Product: ASRock B650M PG Riptide WiFi AMD AM5 Micro ATX Motherboard. Category: ASRock (AMD). Subcategory: Motherboard. Price: Up Coming.
",182,96194,96376
689,sentence,"Subcategory: Motherboard. Price: Up Coming.

Product: ASRock B650 PG Lightning AMD AM5 ATX Motherboard. Category: ASRock (AMD). Subcategory: Motherboard. Price: Up Coming.
",172,96332,96504
690,sentence,"Subcategory: Motherboard. Price: Up Coming.

Product: ASRock A620M-HDV/M.2 AM5 DDR5 Micro ATX Motherboard. Category: ASRock (AMD). Subcategory: Motherboard. Price: Out Of Stock.
",178,96460,96638
691,sentence,"Subcategory: Motherboard. Price: Out Of Stock.

Product: Asrock B450M Steel Legend AMD Micro-ATX Motherboard. Category: ASRock (AMD). Subcategory: Motherboard. Price: 13,300৳.
",176,96591,96767
692,sentence,"Subcategory: Motherboard. Price: 13,300৳.

Product: Asrock B450 Steel Legend AMD Motherboard. Category: ASRock (AMD). Subcategory: Motherboard. Price: Out Of Stock.
",165,96725,96890
693,sentence,"Subcategory: Motherboard. Price: Out Of Stock.

Product: ASRock B650M PG Lightning AM5 Micro ATX Motherboard. Category: ASRock (AMD). Subcategory: Motherboard. Price: Out Of Stock.
",181,96843,97024
694,sentence,"Subcategory: Motherboard. Price: Out Of Stock.

Product: ASRock B650M Pro RS AM5 Micro ATX Motherboard. Category: ASRock (AMD). Subcategory: Motherboard. Price: Out Of Stock.
",175,96977,97152
695,sentence,"Subcategory: Motherboard. Price: Out Of Stock.

Product: ASRock B650M PG Lightning WiFi AM5 Micro ATX Motherboard. Category: ASRock (AMD). Subcategory: Motherboard. Price: Out Of Stock.
",186,97105,97291
696,sentence,"Subcategory: Motherboard. Price: Out Of Stock.

Product: ASRock B650M Pro RS WiFi AM5 Micro ATX Motherboard. Category: ASRock (AMD). Subcategory: Motherboard. Price: Out Of Stock.
",180,97244,97424
697,sentence,"Subcategory: Motherboard. Price: Out Of Stock.

Product: ASRock X870 Steel Legend WiFi AM5 DDR5 ATX Motherboard. Category: ASRock (AMD). Subcategory: Motherboard. Price: 40,499৳.
",179,97377,97556
698,sentence,"Subcategory: Motherboard. Price: 40,499৳.

Product: Intel Core i5-7640X Processor & Asus TUF X299 MARK 2 Motherboard Combo. Category: Motherboard. Subcategory: Component. Price: 50,000৳.
",187,97514,97701
699,sentence,"Subcategory: Component. Price: 50,000৳.

Product: MSI A520M-A Pro AM4 AMD Micro-ATX Motherboard. Category: Motherboard. Subcategory: Component. Price: 8,100৳8,300৳.
",165,97661,97826
700,sentence,"Subcategory: Component. Price: 8,100৳8,300৳.

Product: GIGABYTE B450M K AMD AM4 Micro ATX Motherboard. Category: Motherboard. Subcategory: Component. Price: 7,650৳8,500৳.
",171,97781,97952
701,sentence,"Subcategory: Component. Price: 7,650৳8,500৳.

Product: GIGABYTE A520M K V2 AM4 Micro ATX Motherboard. Category: Motherboard. Subcategory: Component. Price: 8,100৳8,500৳.
",170,97907,98077
702,sentence,"Subcategory: Component. Price: 8,100৳8,500৳.

Product: Asus PRIME A520M-R AM4 micro ATX Motherboard. Category: Motherboard. Subcategory: Component. Price: 8,300৳8,500৳.
",169,98032,98201
703,sentence,"Subcategory: Component. Price: 8,300৳8,500৳.

Product: MSI B450M-A PRO MAX II AMD AM4 Motherboard. Category: Motherboard. Subcategory: Component. Price: 8,500৳8,700৳.
",167,98156,98323
704,sentence,"Subcategory: Component. Price: 8,500৳8,700৳.

Product: GIGABYTE H410M H V2 10th Gen Micro ATX Motherboard. Category: Motherboard. Subcategory: Component. Price: 8,280৳9,000৳.
",175,98278,98453
705,sentence,"Subcategory: Component. Price: 8,280৳9,000৳.

Product: MSI H310M PRO-VDH Intel 9th Gen Motherboard. Category: Motherboard. Subcategory: Component. Price: 8,800৳9,000৳.
",168,98408,98576
706,sentence,"Subcategory: Component. Price: 8,800৳9,000৳.

Product: Asus H81M-K 4th Gen Motherboard. Category: Motherboard. Subcategory: Component. Price: 9,300৳.
",150,98531,98681
707,sentence,"Subcategory: Component. Price: 9,300৳.

Product: GIGABYTE GA-H81M-H 4th Gen Micro ATX Motherboard. Category: Motherboard. Subcategory: Component. Price: 9,000৳9,500৳.
",167,98642,98809
708,sentence,"Subcategory: Component. Price: 9,000৳9,500৳.

Product: GIGABYTE H510M K Intel Micro ATX Motherboard. Category: Motherboard. Subcategory: Component. Price: 9,300৳9,500৳.
",169,98764,98933
709,sentence,"Subcategory: Component. Price: 9,300৳9,500৳.

Product: Asus PRIME B450M-K II DDR4 AMD AM4 micro ATX Motherboard. Category: Motherboard. Subcategory: Component. Price: 9,100৳9,500৳.
",181,98888,99069
710,sentence,"Subcategory: Component. Price: 9,100৳9,500৳.

Product: MSI PRO H510M-B II 10th Gen Micro-ATX Motherboard. Category: Motherboard. Subcategory: Component. Price: 9,000৳9,500৳.
",174,99024,99198
711,sentence,"Subcategory: Component. Price: 9,000৳9,500৳.

Product: GIGABYTE H510M H V2 11th/10th Gen Micro ATX Motherboard. Category: Motherboard. Subcategory: Component. Price: 9,118৳9,700৳.
",180,99153,99333
712,sentence,"Subcategory: Component. Price: 9,118৳9,700৳.

Product: Gigabyte GA-H110M-H Micro ATX Motherboard. Category: Motherboard. Subcategory: Component. Price: 9,200৳9,800৳.
",166,99288,99454
713,sentence,"Subcategory: Component. Price: 9,200৳9,800৳.

Product: Gigabyte H310M M.2 9th Gen Micro ATX Motherboard. Category: Motherboard. Subcategory: Component. Price: 9,200৳9,900৳.
",173,99409,99582
714,sentence,"Subcategory: Component. Price: 9,200৳9,900৳.

Product: MSI PRO H610M-S DDR4 m-ATX Motherboard. Category: Motherboard. Subcategory: Component. Price: 9,900৳.
",157,99537,99694
715,sentence,"Subcategory: Component. Price: 9,900৳.

Product: MSI PRO H610M-E DDR4 mATX Motherboard. Category: Motherboard. Subcategory: Component. Price: 9,950৳.
",150,99655,99805
716,sentence,"Subcategory: Component. Price: 9,950৳.

Product: MSI B550M-A PRO DDR4 AMD AM4 Micro ATX Motherboard. Category: MSI (AMD). Subcategory: Motherboard. Price: 10,900৳.
",164,99766,99930
717,sentence,"Subcategory: Motherboard. Price: 10,900৳.

Product: MSI PRO A620M-E AMD AM5 mATX Motherboard. Category: MSI (AMD). Subcategory: Motherboard. Price: 11,300৳11,499৳.
",164,99888,100052
718,sentence,"Price: 11,300৳11,499৳.

Product: MSI PRO A620M-B AM5 mATX Motherboard. Category: MSI (AMD). Subcategory: Motherboard. Price: 11,800৳.

Product: MSI PRO B650M-E AM5 mATX Motherboard. ",182,100029,100211
719,sentence,"
Product: MSI PRO B650M-E AM5 mATX Motherboard. Category: MSI (AMD). Subcategory: Motherboard. Price: 13,100৳.

Product: MSI PRO B650M-B DDR5 AMD AM5 m-ATX Motherboard. Category: MSI (AMD). ",190,100163,100353
720,sentence,"Category: MSI (AMD). Subcategory: Motherboard. Price: 13,500৳.

Product: MSI B550M Pro-VDH AMD AM4 DDR4 Micro-ATX Motherboard. Category: MSI (AMD). Subcategory: Motherboard. Price: 14,600৳14,800৳.
",197,100332,100529
721,sentence,"Price: 14,600৳14,800৳.

Product: MSI PRO B650M-P DDR5 AMD AM5 mATX Motherboard. Category: MSI (AMD). Subcategory: Motherboard. Price: 15,700৳15,900৳.
",150,100506,100656
722,sentence,"Price: 15,700৳15,900৳.

Product: MSI B550M Pro-VDH Wi-Fi AM4 AMD Micro-ATX Motherboard. Category: MSI (AMD). Subcategory: Motherboard. Price: 15,900৳16,000৳.
",158,100633,100791
723,sentence,"Price: 15,900৳16,000৳.

Product: MSI B650M GAMING WIFI AM5 mATX Motherboard. Category: MSI (AMD). Subcategory: Motherboard. Price: 18,800৳19,000৳.
",147,100768,100915
724,sentence,"Price: 18,800৳19,000৳.

Product: MSI B840M GAMING WIFI6E AM5 mATX Motherboard. Category: MSI (AMD). Subcategory: Motherboard. Price: 19,400৳.

Product: MSI PRO B650-S WIFI DDR5 AM5 ATX Motherboard. ",198,100892,101090
725,sentence,"Category: MSI (AMD). Subcategory: Motherboard. Price: 20,700৳.

Product: MSI B650M GAMING PLUS WIFI AM5 Motherboard. Category: MSI (AMD). Subcategory: Motherboard. Price: 20,999৳22,500৳.
",187,101090,101277
726,sentence,"Price: 20,999৳22,500৳.

Product: MSI PRO B840-P WIFI AMD AM5 ATX Motherboard. Category: MSI (AMD). Subcategory: Motherboard. Price: 22,600৳23,500৳.
",148,101254,101402
727,sentence,"Price: 22,600৳23,500৳.

Product: MSI B840 GAMING PLUS WIFI AMD AM5 ATX Motherboard. Category: MSI (AMD). Subcategory: Motherboard. Price: 23,800৳24,500৳.
",154,101379,101533
728,sentence,"Price: 23,800৳24,500৳.

Product: MSI B850M GAMING PLUS WIFI6E AM5 mATX Motherboard. Category: MSI (AMD). Subcategory: Motherboard. Price: 25,000৳.
",147,101510,101657
729,sentence,"Subcategory: Motherboard. Price: 25,000৳.

Product: MSI B650M PROJECT ZERO AM5 m-ATX Motherboard. Category: MSI (AMD). Subcategory: Motherboard. Price: 24,900৳25,500৳.
",168,101615,101783
730,sentence,"Price: 24,900৳25,500৳.

Product: MSI PRO B850M-A WIFI AM5 mATX Motherboard. Category: MSI (AMD). Subcategory: Motherboard. Price: 27,200৳.

Product: MSI B850 GAMING PLUS WIFI AM5 ATX Motherboard. ",196,101760,101956
731,sentence,"Category: MSI (AMD). Subcategory: Motherboard. Price: 28,300৳28,500৳.

Product: MSI PRO H610M-E mATX Motherboard. Category: MSI (Intel). Subcategory: Motherboard. Price: 10,700৳.
",179,101956,102135
732,sentence,"Subcategory: Motherboard. Price: 10,700৳.

Product: MSI PRO H610M-G DDR4 Micro-ATX Motherboard. Category: MSI (Intel). Subcategory: Motherboard. Price: 10,900৳.
",161,102093,102254
733,sentence,"Subcategory: Motherboard. Price: 10,900৳.

Product: MSI PRO H610M-G DDR5 mATX Motherboard. Category: MSI (Intel). Subcategory: Motherboard. Price: 10,800৳11,200৳.
",163,102212,102375
734,sentence,"Price: 10,800৳11,200৳.

Product: MSI H310M Pro-M2 Intel 9th Gen Motherboard. Category: MSI (Intel). Subcategory: Motherboard. Price: 10,300৳11,200৳.

Product: MSI PRO B760M-E DDR4 mATX Motherboard. ",198,102352,102550
735,sentence,"
Product: MSI PRO B760M-E DDR4 mATX Motherboard. Category: MSI (Intel). Subcategory: Motherboard. Price: 13,000৳13,500৳.

Product: MSI PRO B760M-E DDR5 m-ATX Motherboard. Category: MSI (Intel). ",194,102501,102695
736,sentence,"Category: MSI (Intel). Subcategory: Motherboard. Price: 13,400৳13,500৳.

Product: MSI PRO H610M-G WIFI DDR4 m-ATX Motherboard. Category: MSI (Intel). Subcategory: Motherboard. Price: 13,200৳13,500৳.
",199,102672,102871
737,sentence,"Price: 13,200৳13,500৳.

Product: MSI PRO B760M-P DDR5 mATX Motherboard. Category: MSI (Intel). Subcategory: Motherboard. Price: 15,300৳15,700৳.
",144,102848,102992
738,sentence,"Price: 15,300৳15,700৳.

Product: MSI PRO H810M-B DDR5 LGA1851 mATX Motherboard. Category: MSI (Intel). Subcategory: Motherboard. Price: 17,000৳.

Product: MSI B760M BOMBER WIFI mATX Motherboard. ",195,102969,103164
739,sentence,"Category: MSI (Intel). Subcategory: Motherboard. Price: 19,200৳19,500৳.

Product: MSI B760M GAMING PLUS WIFI 6E mATX Motherboard. Category: MSI (Intel). Subcategory: Motherboard. ",179,103164,103343
740,sentence,"Subcategory: Motherboard. Price: 19,200৳19,500৳.

Product: MSI PRO B760M-A WIFI mATX Motherboard. Category: MSI (Intel). Subcategory: Motherboard. Price: 19,600৳19,700৳.
",170,103317,103487
741,sentence,"Price: 19,600৳19,700৳.

Product: MSI B760 GAMING PLUS WIFI ATX Motherboard. Category: MSI (Intel). Subcategory: Motherboard. Price: 22,800৳23,000৳.
",148,103464,103612
742,sentence,"Price: 22,800৳23,000৳.

Product: MSI B760M PROJECT ZERO m-ATX Motherboard. Category: MSI (Intel). Subcategory: Motherboard. Price: 24,500৳24,800৳.
",147,103589,103736
743,sentence,"Price: 24,500৳24,800৳.

Product: MSI MAG B760M MORTAR WIFI II DDR5 mATX Motherboard. Category: MSI (Intel). Subcategory: Motherboard. Price: 25,800৳26,200৳.
",157,103713,103870
744,sentence,"Price: 25,800৳26,200৳.

Product: MSI MAG B760 TOMAHAWK WIFI DDR5 ATX Motherboard. Category: MSI (Intel). Subcategory: Motherboard. Price: 26,300৳.
",147,103847,103994
745,sentence,"Subcategory: Motherboard. Price: 26,300৳.

Product: ASUS PRIME H510M-F R3.0 LGA1200 Micro-ATX Motherboard. Category: ASUS (Intel). Subcategory: Motherboard. Price: 9,700৳10,200৳.
",179,103952,104131
746,sentence,"Subcategory: Motherboard. Price: 9,700৳10,200৳.

Product: ASUS H110M-K Motherboard. Category: ASUS (Intel). Subcategory: Motherboard. Price: 10,300৳.
",150,104083,104233
747,sentence,"Subcategory: Motherboard. Price: 10,300৳.

Product: Asus PRIME H610M-CS D4 mATX Motherboard. Category: ASUS (Intel). Subcategory: Motherboard. Price: 10,300৳10,400৳.
",166,104191,104357
748,sentence,"Price: 10,300৳10,400৳.

Product: ASUS PRIME H610M-F D4 R2.0 DDR4 LGA1700 mATX Motherboard. Category: ASUS (Intel). Subcategory: Motherboard. Price: 10,000৳10,500৳.
",164,104334,104498
749,sentence,"Price: 10,000৳10,500৳.

Product: ASUS PRIME H610M-R DDR5 LGA1700 mATX Motherboard. Category: ASUS (Intel). Subcategory: Motherboard. Price: 11,100৳11,450৳.
",156,104475,104631
750,sentence,"Price: 11,100৳11,450৳.

Product: Asus PRIME H610M-CS DDR5 mATX Motherboard. Category: ASUS (Intel). Subcategory: Motherboard. Price: 11,350৳11,700৳.
",149,104608,104757
751,sentence,"Price: 11,350৳11,700৳.

Product: Asus PRIME N100I-D D4 Mini-ITX Motherboard. Category: ASUS (Intel). Subcategory: Motherboard. Price: 12,800৳12,900৳.

Product: Asus PRIME B760M-F mATX Motherboard. ",197,104734,104931
752,sentence,"
Product: Asus PRIME B760M-F mATX Motherboard. Category: ASUS (Intel). Subcategory: Motherboard. Price: 14,400৳15,000৳.

Product: Asus PRIME B760M-K D4 mATX Motherboard. Category: ASUS (Intel). ",194,104884,105078
753,sentence,"Category: ASUS (Intel). Subcategory: Motherboard. Price: 14,200৳15,200৳.

Product: ASUS EX-B760M-V5 D4 mATX Motherboard. Category: ASUS (Intel). Subcategory: Motherboard. Price: 16,000৳16,300৳.
",194,105054,105248
754,sentence,"Price: 16,000৳16,300৳.

Product: ASUS Pro B660M-C D4-CSM mATX Motherboard. Category: ASUS (Intel). Subcategory: Motherboard. Price: 16,200৳16,900৳.
",148,105225,105373
755,sentence,"Price: 16,200৳16,900৳.

Product: ASUS PRO B760M-C-CSM Micro-ATX Motherboard. Category: ASUS (Intel). Subcategory: Motherboard. Price: 16,900৳17,000৳.
",150,105350,105500
756,sentence,"Price: 16,900৳17,000৳.

Product: ASUS PRIME H610I-PLUS D4 Mini ITX Motherboard. Category: ASUS (Intel). Subcategory: Motherboard. Price: 16,800৳17,000৳.
",153,105477,105630
757,sentence,"Price: 16,800৳17,000৳.

Product: Asus PRIME B760M-K mATX Motherboard. Category: ASUS (Intel). Subcategory: Motherboard. Price: 16,800৳17,200৳.
",143,105607,105750
758,sentence,"Price: 16,800৳17,200৳.

Product: ASUS PRIME H610I-PLUS DDR5 Mini ITX Motherboard. Category: ASUS (Intel). Subcategory: Motherboard. Price: 17,500৳.

Product: ASUS B760M-AYW WIFI D4 mATX Motherboard. ",199,105727,105926
759,sentence,"Category: ASUS (Intel). Subcategory: Motherboard. Price: 18,900৳.

Product: ASUS B760M-AYW WIFI mATX Motherboard. Category: ASUS (Intel). Subcategory: Motherboard. Price: 19,000৳.
",180,105926,106106
760,sentence,"Subcategory: Motherboard. Price: 19,000৳.

Product: Asus PRIME B760M-A mATX Motherboard. Category: ASUS (Intel). Subcategory: Motherboard. Price: 20,500৳.
",155,106064,106219
761,sentence,"Subcategory: Motherboard. Price: 20,500৳.

Product: Asus PRIME A520M-A II AM4 micro ATX Motherboard. Category: ASUS (AMD). Subcategory: Motherboard. Price: 11,200৳11,300৳.
",172,106177,106349
762,sentence,"Price: 11,200৳11,300৳.

Product: Asus PRIME A620M-K AM5 mATX Motherboard. Category: ASUS (AMD). Subcategory: Motherboard. Price: 11,700৳.
",138,106326,106464
763,sentence,"Subcategory: Motherboard. Price: 11,700৳.

Product: Asus TUF GAMING A520M-PLUS II AMD AM4 microATX Motherboard. Category: ASUS (AMD). Subcategory: Motherboard. Price: 12,200৳12,300৳.
",183,106422,106605
764,sentence,"Price: 12,200৳12,300৳.

Product: Asus PRIME A620M-K-CSM AM5 mATX Motherboard. Category: ASUS (AMD). Subcategory: Motherboard. Price: 12,900৳13,000৳.
",149,106582,106731
765,sentence,"Price: 12,900৳13,000৳.

Product: Asus PRIME B650M-F AM5 mATX Motherboard. Category: ASUS (AMD). Subcategory: Motherboard. Price: 14,200৳.

Product: Asus EX-B650M-V7 AM5 micro-ATX Motherboard. ",192,106708,106900
766,sentence,"Category: ASUS (AMD). Subcategory: Motherboard. Price: 16,300৳16,500৳.

Product: Asus PRIME B650M-A II AM5 mATX Motherboard. Category: ASUS (AMD). Subcategory: Motherboard. Price: 16,800৳17,200৳.
",196,106900,107096
767,sentence,"Price: 16,800৳17,200৳.

Product: Asus TUF GAMING B550M Plus WIFI II AMD AM4 microATX Motherboard. Category: ASUS (AMD). Subcategory: Motherboard. Price: 19,500৳.
",162,107073,107235
768,sentence,"Subcategory: Motherboard. Price: 19,500৳.

Product: ASUS TUF GAMING A620M-PLUS AMD AM5 Micro-ATX Motherboard. Category: ASUS (AMD). Subcategory: Motherboard. Price: 19,206৳19,800৳.
",181,107193,107374
769,sentence,"Price: 19,206৳19,800৳.

Product: ASUS TUF GAMING A620M-PLUS WIFI AMD AM5 Micro-ATX Motherboard. Category: ASUS (AMD). Subcategory: Motherboard. Price: 19,300৳19,800৳.
",167,107351,107518
770,sentence,"Price: 19,300৳19,800৳.

Product: ASUS B650M-AYW WIFI AMD AM5 DDR5 Micro-ATX Motherboard. Category: ASUS (AMD). Subcategory: Motherboard. Price: 19,400৳20,200৳.
",160,107495,107655
771,sentence,"Price: 19,400৳20,200৳.

Product: Asus B850M AYW GAMING WIFI AM5 m-ATX Motherboard. Category: ASUS (AMD). Subcategory: Motherboard. Price: 26,200৳26,400৳.
",154,107632,107786
772,sentence,"Price: 26,200৳26,400৳.

Product: Asus TUF GAMING B650M-E AMD AM5 micro-ATX Motherboard. Category: ASUS (AMD). Subcategory: Motherboard. Price: 27,500৳.
",152,107763,107915
773,sentence,"Subcategory: Motherboard. Price: 27,500৳.

Product: Asus TUF GAMING B650-E WIFI DDR5 AM5 ATX Motherboard. Category: ASUS (AMD). Subcategory: Motherboard. Price: 27,500৳.
",170,107873,108043
774,sentence,"Subcategory: Motherboard. Price: 27,500৳.

Product: Asus PRIME B840M-A WIFI-CSM AM5 mATX Motherboard. Category: ASUS (AMD). Subcategory: Motherboard. Price: 29,500৳.
",166,108001,108167
775,sentence,"Subcategory: Motherboard. Price: 29,500৳.

Product: Asus TUF GAMING B850-E WIFI AM5 ATX Motherboard. Category: ASUS (AMD). Subcategory: Motherboard. Price: 34,100৳34,500৳.
",172,108125,108297
776,sentence,"Price: 34,100৳34,500৳.

Product: Asus B850 MAX GAMING WIFI W AM5 ATX Motherboard. Category: ASUS (AMD). Subcategory: Motherboard. Price: 34,200৳34,500৳.
",153,108274,108427
777,sentence,"Price: 34,200৳34,500৳.

Product: Asus ROG STRIX B850-G GAMING WIFI mATX Motherboard. Category: ASUS (AMD). Subcategory: Motherboard. Price: 38,800৳39,000৳.
",156,108404,108560
778,sentence,"Price: 38,800৳39,000৳.

Product: GIGABYTE H510M H Intel 10th and 11th Gen Micro ATX Motherboard. Category: GIGABYTE (Intel). Subcategory: Motherboard. Price: 9,500৳10,000৳.
",173,108537,108710
779,sentence,"Subcategory: Motherboard. Price: 9,500৳10,000৳.

Product: GIGABYTE H610M H V3 DDR4 Micro ATX Motherboard. Category: GIGABYTE (Intel). Subcategory: Motherboard. Price: 9,900৳10,600৳.
",182,108662,108844
780,sentence,"Subcategory: Motherboard. Price: 9,900৳10,600৳.

Product: GIGABYTE H610M K DDR4 Micro ATX Motherboard. Category: GIGABYTE (Intel). Subcategory: Motherboard. Price: 9,999৳10,700৳.
",179,108796,108975
781,sentence,"Subcategory: Motherboard. Price: 9,999৳10,700৳.

Product: GIGABYTE H610M K DDR5 Micro ATX Motherboard. Category: GIGABYTE (Intel). Subcategory: Motherboard. Price: 10,200৳11,000৳.
",180,108927,109107
782,sentence,"Price: 10,200৳11,000৳.

Product: GIGABYTE H610M H DDR5 mATX Motherboard. Category: GIGABYTE (Intel). Subcategory: Motherboard. Price: 10,600৳11,200৳.
",150,109084,109234
783,sentence,"Price: 10,600৳11,200৳.

Product: GIGABYTE H610M S2H DDR5 mATX Motherboard. Category: GIGABYTE (Intel). Subcategory: Motherboard. Price: 11,300৳12,500৳.
",152,109211,109363
784,sentence,"Price: 11,300৳12,500৳.

Product: GIGABYTE B760M H DDR4 mATX Motherboard. Category: GIGABYTE (Intel). Subcategory: Motherboard. Price: 13,700৳14,200৳.
",150,109340,109490
785,sentence,"Price: 13,700৳14,200৳.

Product: GIGABYTE B760M D2H DDR4 mATX Motherboard. Category: GIGABYTE (Intel). Subcategory: Motherboard. Price: 14,500৳15,500৳.
",152,109467,109619
786,sentence,"Price: 14,500৳15,500৳.

Product: GIGABYTE B760M D3HP DDR5 Micro ATX Motherboard. Category: GIGABYTE (Intel). Subcategory: Motherboard. Price: 16,500৳16,900৳.
",158,109596,109754
787,sentence,"Price: 16,500৳16,900৳.

Product: GIGABYTE B760M D3HP DDR4 Micro ATX Motherboard. Category: GIGABYTE (Intel). Subcategory: Motherboard. Price: 16,300৳17,000৳.
",158,109731,109889
788,sentence,"Price: 16,300৳17,000৳.

Product: GIGABYTE B760M DS3H DDR4 mATX Motherboard. Category: GIGABYTE (Intel). Subcategory: Motherboard. Price: 16,600৳17,200৳.

Product: GIGABYTE B760 DS3H ATX Motherboard. ",199,109866,110065
789,sentence,"
Product: GIGABYTE B760 DS3H ATX Motherboard. Category: GIGABYTE (Intel). Subcategory: Motherboard. Price: 18,200৳20,000৳.

Product: GIGABYTE B760M GAMING PLUS WIFI DDR4 Micro ATX Motherboard. ",193,110019,110212
790,sentence,"Category: GIGABYTE (Intel). Subcategory: Motherboard. Price: 20,000৳20,200৳.

Product: GIGABYTE B760M GAMING X DDR4 mATX Motherboard. Category: GIGABYTE (Intel). Subcategory: Motherboard. ",188,110212,110400
791,sentence,"Subcategory: Motherboard. Price: 19,800৳20,500৳.

Product: Gigabyte A520M DS3H V2 Micro-ATX DDR4 AMD AM4 Motherboard. Category: GIGABYTE (AMD). Subcategory: Motherboard. Price: 9,200৳10,000৳.
",192,110374,110566
792,sentence,"Subcategory: Motherboard. Price: 9,200৳10,000৳.

Product: GIGABYTE A520M DS3H AC Ultra Durable AM4 Micro-ATX Motherboard. Category: GIGABYTE (AMD). Subcategory: Motherboard. Price: 10,010৳11,000৳.
",197,110518,110715
793,sentence,"Price: 10,010৳11,000৳.

Product: Gigabyte B450M DS3H V2 AMD AM4 Micro ATX Motherboard. Category: GIGABYTE (AMD). Subcategory: Motherboard. Price: 9,680৳11,000৳.
",161,110692,110853
794,sentence,"Subcategory: Motherboard. Price: 9,680৳11,000৳.

Product: GIGABYTE A620M H AM5 Micro-ATX Motherboard. Category: GIGABYTE (AMD). Subcategory: Motherboard. Price: 10,208৳11,600৳.
",177,110805,110982
795,sentence,"Price: 10,208৳11,600৳.

Product: GIGABYTE B450M DS3H WIFI AM4 AMD Micro ATX Motherboard. Category: GIGABYTE (AMD). Subcategory: Motherboard. Price: 11,000৳12,200৳.
",164,110959,111123
796,sentence,"Price: 11,000৳12,200৳.

Product: GIGABYTE B650M H AM5 Micro-ATX Motherboard. Category: GIGABYTE (AMD). Subcategory: Motherboard. Price: 12,834৳13,800৳.
",152,111100,111252
797,sentence,"Price: 12,834৳13,800৳.

Product: GIGABYTE B650M S2H AM5 Micro-ATX Motherboard. Category: GIGABYTE (AMD). Subcategory: Motherboard. Price: 13,299৳14,300৳.
",154,111229,111383
798,sentence,"Price: 13,299৳14,300৳.

Product: GIGABYTE B650M K AMD AM5 Micro-ATX Motherboard. Category: GIGABYTE (AMD). Subcategory: Motherboard. Price: 14,065৳14,500৳.
",156,111360,111516
799,sentence,"Price: 14,065৳14,500৳.

Product: GIGABYTE B650M GAMING WIFI mATX AM5 Motherboard. Category: GIGABYTE (AMD). Subcategory: Motherboard. Price: 16,500৳17,000৳.
",157,111493,111650
800,sentence,"Price: 16,500৳17,000৳.

Product: GIGABYTE B650M D3HP DDR5 AM5 Motherboard. Category: GIGABYTE (AMD). Subcategory: Motherboard. Price: 17,500৳18,500৳.
",150,111627,111777
801,sentence,"Price: 17,500৳18,500৳.

Product: GIGABYTE B650M GAMING PLUS WIFI DDR5 AM5 Motherboard. Category: GIGABYTE (AMD). Subcategory: Motherboard. Price: 20,500৳21,500৳.
",162,111754,111916
802,sentence,"Price: 20,500৳21,500৳.

Product: GIGABYTE B850M D3HP AMD AM5 DDR5 Micro ATX Motherboard. Category: GIGABYTE (AMD). Subcategory: Motherboard. Price: 21,000৳21,500৳.
",164,111893,112057
803,sentence,"Price: 21,000৳21,500৳.

Product: GIGABYTE B650M D3HP AX DDR5 AM5 Motherboard. Category: GIGABYTE (AMD). Subcategory: Motherboard. Price: 18,500৳23,800৳.
",153,112034,112187
804,sentence,"Price: 18,500৳23,800৳.

Product: GIGABYTE B650 UD AC AM5 ATX Motherboard. Category: GIGABYTE (AMD). Subcategory: Motherboard. Price: 23,999৳25,500৳.
",149,112164,112313
805,sentence,"Price: 23,999৳25,500৳.

Product: GIGABYTE B650M GAMING X AX DDR5 AM5 Motherboard. Category: GIGABYTE (AMD). Subcategory: Motherboard. Price: 25,000৳26,000৳.
",157,112290,112447
806,sentence,"Price: 25,000৳26,000৳.

Product: GIGABYTE B650 EAGLE AX DDR5 AM5 Motherboard. Category: GIGABYTE (AMD). Subcategory: Motherboard. Price: 25,500৳26,000৳.
",153,112424,112577
807,sentence,"Price: 25,500৳26,000৳.

Product: GIGABYTE B850M EAGLE WIFI6E AMD AM5 DDR5 Micro ATX Motherboard. Category: GIGABYTE (AMD). Subcategory: Motherboard. Price: 26,000৳27,500৳.
",172,112554,112726
808,sentence,"Price: 26,000৳27,500৳.

Product: GIGABYTE B850M GAMING X WIFI6E AMD AM5 DDR5 Micro ATX Motherboard. Category: GIGABYTE (AMD). Subcategory: Motherboard. Price: 29,700৳30,500৳.
",175,112703,112878
809,sentence,"Price: 29,700৳30,500৳.

Product: Colorful BATTLE-AX H610M-E WIFI V20 mATX Motherboard. Category: Colorful (Intel). Subcategory: Motherboard. Price: 10,200৳.
",157,112855,113012
810,sentence,"Subcategory: Motherboard. Price: 10,200৳.

Product: Colorful BATTLE-AX B760M-T PRO V20 mATX Motherboard. Category: Colorful (Intel). Subcategory: Motherboard. Price: 11,300৳11,500৳.
",182,112970,113152
811,sentence,"Price: 11,300৳11,500৳.

Product: Colorful BATTLE-AX B760M-PLUS V20 M-ATX Motherboard. Category: Colorful (Intel). Subcategory: Motherboard. Price: 17,000৳.
",156,113129,113285
812,sentence,"Subcategory: Motherboard. Price: 17,000৳.

Product: Colorful BATTLE-AX B760M-PLUS D5 V20 mATX Motherboard. Category: Colorful (Intel). Subcategory: Motherboard. Price: 17,500৳18,000৳.
",184,113243,113427
813,sentence,"Price: 17,500৳18,000৳.

Product: Colorful CVN B760I FROZEN WIFI V20 ITX Motherboard. Category: Colorful (Intel). Subcategory: Motherboard. Price: 19,500৳20,000৳.
",162,113404,113566
814,sentence,"Price: 19,500৳20,000৳.

Product: Colorful CVN B760M FROZEN WIFI V20 mATX Motherboard. Category: Colorful (Intel). Subcategory: Motherboard. Price: 21,500৳22,000৳.
",163,113543,113706
815,sentence,"Price: 21,500৳22,000৳.

Product: Colorful BATTLE-AX B550M-T PRO V14 AM4 mATX Motherboard. Category: Colorful (AMD). Subcategory: Motherboard. Price: Out Of Stock.
",163,113683,113846
816,sentence,"Subcategory: Motherboard. Price: Out Of Stock.

Product: Colorful CVN B550M GAMING FROZEN V15 AM4 mATX Motherboard. Category: Colorful (AMD). Subcategory: Motherboard. Price: Out Of Stock.
",189,113799,113988
817,sentence,"Subcategory: Motherboard. Price: Out Of Stock.

Product: Colorful GeForce GT710-2GD3-V 2GB Graphics Card. Category: Graphics Card. Subcategory: Component. Price: 4,900৳5,200৳.
",176,113941,114117
818,sentence,"Subcategory: Component. Price: 4,900৳5,200৳.

Product: PELADN GeForce KaiTian GT 730 4GB GDDR3 Graphics Card. Category: Graphics Card. Subcategory: Component. Price: 5,200৳.
",174,114072,114246
819,sentence,"Subcategory: Component. Price: 5,200৳.

Product: Gigabyte GT 710 2GB DDR3 Graphics Card. Category: Graphics Card. Subcategory: Component. Price: 5,800৳6,200৳.
",159,114207,114366
820,sentence,"Subcategory: Component. Price: 5,800৳6,200৳.

Product: OCPC GeForce GT 730 4GB DDR3 Graphics Card. Category: Graphics Card. Subcategory: Component. Price: 6,200৳6,250৳.
",169,114321,114490
821,sentence,"Subcategory: Component. Price: 6,200৳6,250৳.

Product: ASUS GeForce GT 710 2GB GDDR5 EVO Low-profile Graphics Card. Category: Graphics Card. Subcategory: Component. Price: 6,800৳.
",180,114445,114625
822,sentence,"Subcategory: Component. Price: 6,800৳.

Product: MSI GeForce GT 730 2GB DDR3 Graphics Card. Category: Graphics Card. Subcategory: Component. Price: 6,800৳6,900৳.
",162,114586,114748
823,sentence,"Subcategory: Component. Price: 6,800৳6,900৳.

Product: Asus Geforce Gt 730 2GB GDDR5 Graphics Card. Category: Graphics Card. Subcategory: Component. Price: 9,100৳9,300৳.
",170,114703,114873
824,sentence,"Subcategory: Component. Price: 9,100৳9,300৳.

Product: Gigabyte GT 1030 Low Profile D4 2GB DDR4 Graphics Card. Category: Graphics Card. Subcategory: Component. Price: 9,300৳.
",175,114828,115003
825,sentence,"Subcategory: Component. Price: 9,300৳.

Product: Colorful GeForce GT1030 V3 2GB Graphics Card. Category: Graphics Card. Subcategory: Component. Price: 9,300৳9,700৳.
",165,114964,115129
826,sentence,"Subcategory: Component. Price: 9,300৳9,700৳.

Product: OCPC Radeon RX 550 4GB SE GDDR5 Graphics Card. Category: Graphics Card. Subcategory: Component. Price: 9,750৳.
",166,115084,115250
827,sentence,"Subcategory: Component. Price: 9,750৳.

Product: PELADN RX 550 4G Gaming GDDR5 128 Bit Black Graphics Card. Category: Graphics Card. Subcategory: Component. Price: 9,900৳.
",172,115211,115383
828,sentence,"Subcategory: Component. Price: 9,900৳.

Product: ASUS GeForce GT 1030 2GB GDDR5 low Profile Graphics Card. Category: Graphics Card. Subcategory: Component. Price: 10,800৳.
",172,115344,115516
829,sentence,"Subcategory: Component. Price: 10,800৳.

Product: PowerColor Red Dragon Radeon RX 550 4GB GDDR5 Graphics Card. Category: Graphics Card. Subcategory: Component. Price: 11,000৳11,500৳.
",183,115476,115659
830,sentence,"Subcategory: Component. Price: 11,000৳11,500৳.

Product: PELADN RX 580 8G 256Bit Dual Fans Gaming Graphics Card. Category: Graphics Card. Subcategory: Component. Price: 11,500৳12,000৳.
",185,115612,115797
831,sentence,"Subcategory: Component. Price: 11,500৳12,000৳.

Product: OCPC Radeon RX 580 8GB XE GDDR5 Graphics Card. Category: Graphics Card. Subcategory: Component. Price: 13,500৳13,700৳.
",176,115750,115926
832,sentence,"Subcategory: Component. Price: 13,500৳13,700৳.

Product: GIGABYTE Intel Arc A310 WINDFORCE 4G GDDR6 Graphics Card. Category: Graphics Card. Subcategory: Component. Price: 14,300৳15,000৳.
",187,115879,116066
833,sentence,"Subcategory: Component. Price: 14,300৳15,000৳.

Product: Asus Geforce GT 730 2GB GDDR5 Graphics Card with 4 HDMI Ports. Category: Graphics Card. Subcategory: Component. Price: 15,400৳.
",185,116019,116204
834,sentence,"Subcategory: Component. Price: 15,400৳.

Product: GUNNIR Intel Arc A380 Index 6G GDDR6 Graphics Card. Category: Graphics Card. Subcategory: Component. Price: 15,000৳15,800৳.
",174,116164,116338
835,sentence,"Subcategory: Component. Price: 15,000৳15,800৳.

Product: GUNNIR Intel Arc A380 Photon 6G OC GDDR6 Graphics Card. Category: Graphics Card. Subcategory: Component. Price: 16,000৳17,000৳.
",185,116291,116476
836,sentence,"Subcategory: Component. Price: 16,000৳17,000৳.

Product: GUNNIR Intel Arc A380 Photon 6G OC W GDDR6 Graphics Card. Category: Graphics Card. Subcategory: Component. Price: 16,500৳17,000৳.
",187,116429,116616
837,sentence,"Subcategory: Component. Price: 16,500৳17,000৳.

Product: ASUS Dual Radeon RX 6500 XT V2 OC Edition 4GB GDDR6 Graphics Card. Category: ASUS. Subcategory: Graphics Card. Price: 20,500৳20,900৳.
",191,116569,116760
838,sentence,"Price: 20,500৳20,900৳.

Product: ASUS Dual GeForce RTX 3050 6GB GDDR6 Graphics Card. Category: ASUS. Subcategory: Graphics Card. Price: 28,300৳30,000৳.
",152,116737,116889
839,sentence,"Price: 28,300৳30,000৳.

Product: ASUS Dual GeForce RTX 5060 8GB GDDR7 Graphics Card. Category: ASUS. Subcategory: Graphics Card. Price: 50,300৳50,500৳.
",152,116866,117018
840,sentence,"Price: 50,300৳50,500৳.

Product: ASUS Dual GeForce RTX 5060 8GB GDDR7 OC Edition Graphics Card. Category: ASUS. Subcategory: Graphics Card. Price: 50,300৳52,000৳.
",163,116995,117158
841,sentence,"Price: 50,300৳52,000৳.

Product: ASUS Dual GeForce RTX 4060 Ti EVO OC Edition 8GB GDDR6 Graphics Card. Category: ASUS. Subcategory: Graphics Card. Price: 57,900৳63,500৳.
",170,117135,117305
842,sentence,"Price: 57,900৳63,500৳.

Product: ASUS TUF Gaming GeForce RTX 5070 12GB GDDR7 OC Edition Graphics Card. Category: ASUS. Subcategory: Graphics Card. Price: 118,000৳.
",164,117282,117446
843,sentence,"Subcategory: Graphics Card. Price: 118,000৳.

Product: ASUS PRIME GeForce RTX 5070 Ti 16GB GDDR7 OC Edition Graphics Card. Category: ASUS. Subcategory: Graphics Card. Price: 141,000৳.
",184,117401,117585
844,sentence,"Subcategory: Graphics Card. Price: 141,000৳.

Product: ASUS TUF Gaming GeForce RTX 4070 Ti SUPER BTF White OC Edition 16GB GDDR6X Graphics Card. Category: ASUS. Subcategory: Graphics Card. ",189,117540,117729
845,sentence,"Category: ASUS. Subcategory: Graphics Card. Price: 157,000৳161,000৳.

Product: ASUS TUF Gaming GeForce RTX 5070 Ti 16GB GDDR7 OC Edition Graphics Card. Category: ASUS. Subcategory: Graphics Card. ",196,117685,117881
846,sentence,"Category: ASUS. Subcategory: Graphics Card. Price: 161,000৳165,000৳.

Product: ASUS ROG Strix GeForce RTX 5070 Ti 16GB GDDR7 OC Edition Graphics Card. Category: ASUS. Subcategory: Graphics Card. ",195,117837,118032
847,sentence,"Category: ASUS. Subcategory: Graphics Card. Price: 168,000৳.

Product: ASUS PRIME GeForce RTX 5070 12GB GDDR7 OC Edition Graphics Card. Category: ASUS. Subcategory: Graphics Card. Price: Up Coming.
",198,117988,118186
848,sentence,"Subcategory: Graphics Card. Price: Up Coming.

Product: ASUS TUF Gaming GeForce RTX 5080 16GB GDDR7 OC Edition Graphics Card. Category: ASUS. Subcategory: Graphics Card. Price: 239,000৳.
",187,118140,118327
849,sentence,"Subcategory: Graphics Card. Price: 239,000৳.

Product: ASUS ROG Astral GeForce RTX 5080 16GB GDDR7 OC Edition Graphics Card. Category: ASUS. Subcategory: Graphics Card. Price: 239,000৳.
",186,118282,118468
850,sentence,"Subcategory: Graphics Card. Price: 239,000৳.

Product: ASUS TUF Gaming GeForce RTX 5090 32GB GDDR7 OC Edition Graphics Card. Category: ASUS. Subcategory: Graphics Card. Price: 453,000৳.
",186,118423,118609
851,sentence,"Subcategory: Graphics Card. Price: 453,000৳.

Product: ASUS ROG Astral GeForce RTX 5090 32GB GDDR7 OC Edition Graphics Card. Category: ASUS. Subcategory: Graphics Card. Price: 496,000৳.
",186,118564,118750
852,sentence,"Subcategory: Graphics Card. Price: 496,000৳.

Product: ASUS KO NVIDIA GeForce RTX 3060 Ti OC Edition 8GB GDDR6 Graphics Card. Category: ASUS. Subcategory: Graphics Card. Price: Up Coming.
",188,118705,118893
853,sentence,"Subcategory: Graphics Card. Price: Up Coming.

Product: Colorful GeForce RTX 3050 6GB-V GDDR6 Graphics Card. Category: Colorful. Subcategory: Graphics Card. Price: 24,900৳.
",173,118847,119020
854,sentence,"Subcategory: Graphics Card. Price: 24,900৳.

Product: Colorful GeForce RTX 3050 NB DUO V2-V 8GB GDDR6 Graphics Card. Category: Colorful. Subcategory: Graphics Card. Price: 28,500৳29,000৳.
",188,118976,119164
855,sentence,"Price: 28,500৳29,000৳.

Product: Colorful iGame GeForce RTX 3050 Ultra W DUO OC V2-V 8GB GDDR6 Graphics Card. Category: Colorful. Subcategory: Graphics Card. Price: 30,000৳30,500৳.
",181,119141,119322
856,sentence,"Price: 30,000৳30,500৳.

Product: Colorful GeForce RTX 3060 NB DUO 12G V4 L-V GDDR6 Graphics Card. Category: Colorful. Subcategory: Graphics Card. Price: 39,500৳.
",162,119299,119461
857,sentence,"Subcategory: Graphics Card. Price: 39,500৳.

Product: Colorful iGame GeForce RTX 5050 Ultra W DUO OC 8GB-V GDDR6 Graphics Card. Category: Colorful. Subcategory: Graphics Card. Price: 39,900৳.
",192,119417,119609
858,sentence,"Subcategory: Graphics Card. Price: 39,900৳.

Product: Colorful iGame GeForce RTX 5060 Ultra W DUO OC 8GB-V GDDR7 Graphics Card. Category: Colorful. Subcategory: Graphics Card. Price: 49,500৳.
",192,119565,119757
859,sentence,"Subcategory: Graphics Card. Price: 49,500৳.

Product: Colorful iGame GeForce RTX 5060 Ultra W OC 8GB-V GDDR7 Graphics Card. Category: Colorful. Subcategory: Graphics Card. Price: 51,500৳52,500৳.
",195,119713,119908
860,sentence,"Price: 51,500৳52,500৳.

Product: Colorful GeForce RTX 5060 Ti Battle AX DUO 8GB-V GDDR7 Graphics Card. Category: Colorful. Subcategory: Graphics Card. Price: 59,900৳.
",167,119885,120052
861,sentence,"Subcategory: Graphics Card. Price: 59,900৳.

Product: Colorful iGame GeForce RTX 5060 Ti Ultra W DUO OC 8GB-V GDDR7 Graphics Card. Category: Colorful. Subcategory: Graphics Card. ",179,120008,120187
862,sentence,"Category: Colorful. Subcategory: Graphics Card. Price: 59,800৳62,900৳.

Product: Colorful iGame GeForce RTX 5060 Ti Ultra W OC 8GB-V GDDR7 Graphics Card. Category: Colorful. ",174,120139,120313
863,sentence,"Category: Colorful. Subcategory: Graphics Card. Price: 62,900৳65,000৳.

Product: Colorful iGame GeForce RTX 5060 Ti Ultra W DUO OC 16GB-V GDDR7 Graphics Card. Category: Colorful. ",179,120293,120472
864,sentence,"Category: Colorful. Subcategory: Graphics Card. Price: 69,900৳.

Product: Colorful GeForce RTX 5070 NB EX 12GB V2-V GDDR7 Graphics Card. Category: Colorful. Subcategory: Graphics Card. ",185,120452,120637
865,sentence,"Category: Colorful. Subcategory: Graphics Card. Price: 85,000৳87,000৳.

Product: Colorful iGame GeForce RTX 5070 Ultra W OC 12GB-V GDDR7 Graphics Card. Category: Colorful. ",172,120589,120761
866,sentence,"Category: Colorful. Subcategory: Graphics Card. Price: 91,900৳94,000৳.

Product: Colorful iGame GeForce RTX 5070 Vulcan OC 12GB-V GDDR7 Graphics Card. Category: Colorful. Subcategory: Graphics Card. ",199,120741,120940
867,sentence,"Category: Colorful. Subcategory: Graphics Card. Price: 109,900৳118,000৳.

Product: Colorful GeForce RTX 5070 Ti Battle AX 16GB-V GDDR7 Graphics Card. Category: Colorful. Subcategory: Graphics Card. ",198,120892,121090
868,sentence,"Category: Colorful. Subcategory: Graphics Card. Price: 124,000৳.

Product: Colorful iGame GeForce RTX 5070 Ti Ultra W OC 16GB-V GDDR7 Graphics Card. Category: Colorful. Subcategory: Graphics Card. ",197,121042,121239
869,sentence,"Category: Colorful. Subcategory: Graphics Card. Price: 129,900৳133,000৳.

Product: Colorful iGame GeForce RTX 5080 Ultra W OC 16GB-V GDDR7 Graphics Card. Category: Colorful. ",174,121191,121365
870,sentence,"Category: Colorful. Subcategory: Graphics Card. Price: 182,500৳193,000৳.

Product: Colorful iGame GeForce RTX 5080 Vulcan OC 16GB-V GDDR7 Graphics Card. Category: Colorful. ",173,121345,121518
871,sentence,"Category: Colorful. Subcategory: Graphics Card. Price: 199,900৳225,000৳.

Product: Intel Arc A750 8GB GDDR6 Graphics Card. Category: INTEL. Subcategory: Graphics Card. Price: Out Of Stock.
",189,121498,121687
872,sentence,"Price: Out Of Stock.

Product: Intel Arc A750 Limited Edition 8GB GDDR6 Graphics Card. Category: INTEL. Subcategory: Graphics Card. Price: Out Of Stock.
",153,121666,121819
873,sentence,"Price: Out Of Stock.

Product: Sapphire Pulse AMD Radeon RX 9060 XT Gaming OC 8GB GDDR6 Graphics Card. Category: Sapphire. Subcategory: Graphics Card. Price: 47,500৳.
",167,121798,121965
874,sentence,"Subcategory: Graphics Card. Price: 47,500৳.

Product: Sapphire Pulse AMD Radeon RX 9060 XT GAMING OC 16GB GDDR6 Graphics Card. Category: Sapphire. Subcategory: Graphics Card. Price: 55,400৳.
",191,121921,122112
875,sentence,"Subcategory: Graphics Card. Price: 55,400৳.

Product: Sapphire PULSE AMD Radeon RX 9070 Gaming 16GB GDDR6 Graphics Card. Category: Sapphire. Subcategory: Graphics Card. Price: 94,900৳.
",185,122068,122253
876,sentence,"Subcategory: Graphics Card. Price: 94,900৳.

Product: Sapphire PURE AMD Radeon RX 9070 Gaming OC 16GB GDDR6 Graphics Card. Category: Sapphire. Subcategory: Graphics Card. Price: 98,000৳98,900৳.
",194,122209,122403
877,sentence,"Price: 98,000৳98,900৳.

Product: Sapphire Pulse AMD Radeon RX 9070 XT Gaming 16GB GDDR6 Graphics Card. Category: Sapphire. Subcategory: Graphics Card. Price: 106,900৳.
",168,122380,122548
878,sentence,"Subcategory: Graphics Card. Price: 106,900৳.

Product: Sapphire NITRO+ AMD Radeon RX 9070 Gaming OC 16GB GDDR6 Graphics Card. Category: Sapphire. Subcategory: Graphics Card. Price: 101,900৳.
",191,122503,122694
879,sentence,"Subcategory: Graphics Card. Price: 101,900৳.

Product: Sapphire NITRO+ AMD Radeon RX 9070 XT 16GB Gaming OC GDDR6 Graphics Card. Category: Sapphire. Subcategory: Graphics Card. Price: 110,900৳.
",194,122649,122843
880,sentence,"Subcategory: Graphics Card. Price: 110,900৳.

Product: Sapphire NITRO+ AMD Radeon RX 7900 XTX Vapor-X 24GB GDDR6 Gaming Graphics Card. Category: Sapphire. Subcategory: Graphics Card. ",183,122798,122981
881,sentence,"Category: Sapphire. Subcategory: Graphics Card. Price: 155,900৳.

Product: Sapphire Pulse Radeon RX 550 4GB GDDR5 Graphics Card. Category: Sapphire. Subcategory: Graphics Card. Price: Up Coming.
",195,122933,123128
882,sentence,"Subcategory: Graphics Card. Price: Up Coming.

Product: Sapphire Pulse Radeon RX 570 4GB GDDR5 HDMI DP Graphics card. Category: Sapphire. Subcategory: Graphics Card. Price: Up Coming.
",184,123082,123266
883,sentence,"Subcategory: Graphics Card. Price: Up Coming.

Product: Sapphire Pulse Radeon RX 570 8GB GDDR5 Graphics Card. Category: Sapphire. Subcategory: Graphics Card. Price: Up Coming.
",176,123220,123396
884,sentence,"Subcategory: Graphics Card. Price: Up Coming.

Product: Sapphire Pulse Radeon RX 5600 XT 6GB GDDR6 Graphics Card. Category: Sapphire. Subcategory: Graphics Card. Price: Up Coming.
",180,123350,123530
885,sentence,"Subcategory: Graphics Card. Price: Up Coming.

Product: Sapphire Pulse Radeon RX 5600 XT BE 6GB Graphics Card. Category: Sapphire. Subcategory: Graphics Card. Price: Up Coming.
",177,123484,123661
886,sentence,"Subcategory: Graphics Card. Price: Up Coming.

Product: Sapphire Radeon RX 5700 8GB GDDR6 Graphics Card. Category: Sapphire. Subcategory: Graphics Card. Price: Up Coming.
",171,123615,123786
887,sentence,"Subcategory: Graphics Card. Price: Up Coming.

Product: Sapphire NITRO+ AMD Radeon RX 6800 XT 16GB GDDR6 Graphics Card. Category: Sapphire. Subcategory: Graphics Card. Price: Up Coming.
",186,123740,123926
888,sentence,"Subcategory: Graphics Card. Price: Up Coming.

Product: Sapphire Pulse AMD Radeon RX 6500 XT Gaming OC 4GB GDDR6 Graphics Card. Category: Sapphire. Subcategory: Graphics Card. Price: Out Of Stock.
",197,123880,124077
889,sentence,"Price: Out Of Stock.

Product: Sapphire PULSE AMD Radeon RX 6500 XT 8GB GDDR6 Graphics Card. Category: Sapphire. Subcategory: Graphics Card. Price: Out Of Stock.
",162,124056,124218
890,sentence,"Price: Out Of Stock.

Product: Sapphire PULSE AMD Radeon RX 6500XT OC 8GB GDDR6 Graphics Card. Category: Sapphire. Subcategory: Graphics Card. Price: Out Of Stock.
",164,124197,124361
891,sentence,"Price: Out Of Stock.

Product: Sapphire Pulse AMD Radeon RX 6600 8GB GDDR6 Graphics Card. Category: Sapphire. Subcategory: Graphics Card. Price: Out Of Stock.
",159,124340,124499
892,sentence,"Price: Out Of Stock.

Product: Sapphire PULSE AMD Radeon RX 7600 Gaming OC 8GB GDDR6 Graphics Card. Category: Sapphire. Subcategory: Graphics Card. Price: Out Of Stock.
",169,124478,124647
893,sentence,"Price: Out Of Stock.

Product: Zotac GAMING GeForce RTX 3050 Twin Edge OC 6GB GDDR6 Graphics Card. Category: ZOTAC. Subcategory: Graphics Card. Price: 25,900৳.
",160,124626,124786
894,sentence,"Subcategory: Graphics Card. Price: 25,900৳.

Product: ZOTAC GAMING GEFORCE RTX 3050 ECO 8GB GDDR6 Graphics Card. Category: ZOTAC. Subcategory: Graphics Card. Price: 29,000৳31,500৳.
",181,124742,124923
895,sentence,"Price: 29,000৳31,500৳.

Product: ZOTAC GAMING GeForce RTX 5050 SOLO 8GB GDDR6 Graphics Card. Category: ZOTAC. Subcategory: Graphics Card. Price: 37,900৳.
",154,124900,125054
896,sentence,"Subcategory: Graphics Card. Price: 37,900৳.

Product: ZOTAC GAMING GeForce RTX 5050 Twin Edge 8GB GDDR6 Graphics Card. Category: ZOTAC. Subcategory: Graphics Card. Price: 38,900৳.
",180,125010,125190
897,sentence,"Subcategory: Graphics Card. Price: 38,900৳.

Product: ZOTAC GAMING GeForce RTX 3060 Twin Edge 12GB GDDR6 Graphics Card. Category: ZOTAC. Subcategory: Graphics Card. Price: 39,000৳40,000৳.
",188,125146,125334
898,sentence,"Price: 39,000৳40,000৳.

Product: ZOTAC GAMING GeForce RTX 5050 Twin Edge OC 8GB GDDR6 Graphics Card. Category: ZOTAC. Subcategory: Graphics Card. Price: 40,900৳.
",162,125311,125473
899,sentence,"Subcategory: Graphics Card. Price: 40,900৳.

Product: ZOTAC GAMING GeForce RTX 5060 SOLO 8GB GDDR7 Graphics Card. Category: ZOTAC. Subcategory: Graphics Card. Price: 43,400৳43,900৳.
",182,125429,125611
900,sentence,"Price: 43,400৳43,900৳.

Product: ZOTAC GeForce RTX 5060 AMP 8GB GDDR7 Graphics Card. Category: ZOTAC. Subcategory: Graphics Card. Price: 48,500৳.
",146,125588,125734
901,sentence,"Subcategory: Graphics Card. Price: 48,500৳.

Product: ZOTAC GAMING GeForce RTX 5060 Twin Edge OC White Edition 8GB GDDR7 Graphics Card. Category: ZOTAC. Subcategory: Graphics Card. Price: 48,900৳.
",197,125690,125887
902,sentence,"Subcategory: Graphics Card. Price: 48,900৳.

Product: ZOTAC GAMING GeForce RTX 5060 Ti AMP 16GB GDDR7 Graphics Card. Category: ZOTAC. Subcategory: Graphics Card. Price: 69,900৳.
",178,125843,126021
903,sentence,"Subcategory: Graphics Card. Price: 69,900৳.

Product: ZOTAC GAMING GeForce RTX 5070 SOLID 12GB GDDR7 Graphics Card. Category: ZOTAC. Subcategory: Graphics Card. Price: 88,000৳88,900৳.
",184,125977,126161
904,sentence,"Price: 88,000৳88,900৳.

Product: ZOTAC GAMING GeForce RTX 5070 AMP White Edition 12GB GDDR7 Graphics Card. Category: ZOTAC. Subcategory: Graphics Card. Price: 95,900৳96,900৳.
",175,126138,126313
905,sentence,"Price: 95,900৳96,900৳.

Product: ZOTAC GAMING GeForce RTX 5070 Ti SOLID SFF OC 16GB GDDR7 Graphics Card. Category: ZOTAC. Subcategory: Graphics Card. Price: 128,000৳128,900৳.
",175,126290,126465
906,sentence,"Price: 128,000৳128,900৳.

Product: ZOTAC GAMING GeForce RTX 5070 Ti SOLID CORE OC White Edition 16GB GDDR7 Graphics Card. Category: ZOTAC. Subcategory: Graphics Card. Price: 135,900৳.
",184,126440,126624
907,sentence,"Subcategory: Graphics Card. Price: 135,900৳.

Product: ZOTAC GAMING GeForce RTX 5070 Ti AMP Extreme INFINITY 16GB GDDR7 Graphics Card. Category: ZOTAC. Subcategory: Graphics Card. ",180,126579,126759
908,sentence,"Category: ZOTAC. Subcategory: Graphics Card. Price: 142,000৳142,900৳.

Product: ZOTAC GAMING GeForce RTX 5070 Ti AMP Extreme INFINITY ULTRA 16GB GDDR7 Graphics Card. Category: ZOTAC. ",183,126714,126897
909,sentence,"Category: ZOTAC. Subcategory: Graphics Card. Price: 148,000৳148,900৳.

Product: ZOTAC GAMING GeForce RTX 5080 SOLID CORE OC 16GB GDDR7 Graphics Card. Category: ZOTAC. Subcategory: Graphics Card. ",195,126880,127075
910,sentence,"Category: ZOTAC. Subcategory: Graphics Card. Price: 169,000৳169,900৳.

Product: ZOTAC GAMING GeForce RTX 5090 SOLID OC 32GB GDDR7 Graphics Card. Category: ZOTAC. Subcategory: Graphics Card. ",190,127030,127220
911,sentence,"Category: ZOTAC. Subcategory: Graphics Card. Price: 347,900৳349,900৳.

Product: ZOTAC GAMING GeForce RTX 5090 SOLID OC White Edition 32GB GDDR7 Graphics Card. Category: ZOTAC. ",176,127175,127351
912,sentence,"Category: ZOTAC. Subcategory: Graphics Card. Price: 359,000৳359,900৳.

Product: ZOTAC GAMING GeForce RTX 5090 AMP Extreme INFINITY 32GB GDDR7 Graphics Card. Category: ZOTAC. ",174,127334,127508
913,sentence,"Category: ZOTAC. Subcategory: Graphics Card. Price: 375,000৳375,900৳.

Product: GUNNIR Intel Arc A580 Index 8G GDDR6 Graphics Card. Category: GUNNIR. Subcategory: Graphics Card. ",178,127491,127669
914,sentence,"Category: GUNNIR. Subcategory: Graphics Card. Price: 23,500৳24,500৳.

Product: GUNNIR Intel Arc A750 Index 8GB GDDR6 Graphics Card. Category: GUNNIR. Subcategory: Graphics Card. Price: 26,500৳.
",194,127623,127817
915,sentence,"Subcategory: Graphics Card. Price: 26,500৳.

Product: GUNNIR Intel Arc A750 Photon 8G OC W GDDR6 Graphics Card. Category: GUNNIR. Subcategory: Graphics Card. Price: 29,000৳.
",174,127773,127947
916,sentence,"Subcategory: Graphics Card. Price: 29,000৳.

Product: GUNNIR Intel Arc B570 Index 10G GDDR6 Graphics Card. Category: GUNNIR. Subcategory: Graphics Card. Price: 32,300৳32,400৳.
",176,127903,128079
917,sentence,"Price: 32,300৳32,400৳.

Product: GUNNIR Intel Arc B570 Tri 10G OC GDDR6 Graphics Card. Category: GUNNIR. Subcategory: Graphics Card. Price: 32,300৳32,999৳.
",156,128056,128212
918,sentence,"Price: 32,300৳32,999৳.

Product: GUNNIR Intel Arc A770 Photon 16G OC W GDDR6 Graphics Card. Category: GUNNIR. Subcategory: Graphics Card. Price: 35,000৳36,500৳.
",161,128189,128350
919,sentence,"Price: 35,000৳36,500৳.

Product: GUNNIR Intel Arc A770 Photon 16G OC X ELDEN RING Shadow Of The Erdtree Graphics Card. Category: GUNNIR. Subcategory: Graphics Card. Price: 36,500৳.
",181,128327,128508
920,sentence,"Subcategory: Graphics Card. Price: 36,500৳.

Product: GUNNIR Intel Arc B580 Index 12G GDDR6 Graphics Card. Category: GUNNIR. Subcategory: Graphics Card. Price: 36,500৳37,500৳.
",176,128464,128640
921,sentence,"Price: 36,500৳37,500৳.

Product: GUNNIR Intel Arc A770 Photon 16G OC GDDR6 Graphics Card (Black). Category: GUNNIR. Subcategory: Graphics Card. Price: 34,500৳38,500৳.
",167,128617,128784
922,sentence,"Price: 34,500৳38,500৳.

Product: GUNNIR Intel Arc B580 Photon 12G OC GDDR6 Graphics Card. Category: GUNNIR. Subcategory: Graphics Card. Price: 39,000৳41,000৳.
",159,128761,128920
923,sentence,"Price: 39,000৳41,000৳.

Product: GUNNIR Intel Arc B580 Photon 12G OC W GDDR6 Graphics Card. Category: GUNNIR. Subcategory: Graphics Card. Price: 39,500৳41,000৳.
",161,128897,129058
924,sentence,"Price: 39,500৳41,000৳.

Product: GUNNIR Intel Arc A770 Flux 16G OC GDDR6 Graphics Card. Category: GUNNIR. Subcategory: Graphics Card. Price: Up Coming.
",152,129035,129187
925,sentence,"Subcategory: Graphics Card. Price: Up Coming.

Product: GUNNIR Intel Arc A750 Photon 8G OC GDDR6 Graphics Card. Category: GUNNIR. Subcategory: Graphics Card. Price: Out Of Stock.
",179,129141,129320
926,sentence,"Price: Out Of Stock.

Product: GUNNIR Intel Arc A750 Photon 8G OC WX GDDR6 Asian Games Limited Edition Graphics Card. Category: GUNNIR. Subcategory: Graphics Card. Price: Out Of Stock.
",185,129299,129484
927,sentence,"Price: Out Of Stock.

Product: GUNNIR Intel Arc A750 Photon 8G OC X ELDEN RING Shadow Of The Erdtree Graphics Card. Category: GUNNIR. Subcategory: Graphics Card. Price: Out Of Stock.
",183,129463,129646
928,sentence,"Price: Out Of Stock.

Product: GUNNIR Intel Arc A770 Photon 16G OC W GDDR6 Asian Games Limited Edition Graphics Card. Category: GUNNIR. Subcategory: Graphics Card. Price: Out Of Stock.
",185,129625,129810
929,sentence,"Price: Out Of Stock.

Product: GUNNIR Intel Arc A770 Photon 8G OC GDDR6 Graphics Card. Category: GUNNIR. Subcategory: Graphics Card. Price: Out Of Stock.
",154,129789,129943
930,sentence,"Price: Out Of Stock.

Product: PELADN RX 5500 8G GDDR6 Dual Fan Gaming Graphics Card. Category: PELADN. Subcategory: Graphics Card. Price: 17,900৳.
",148,129922,130070
931,sentence,"Subcategory: Graphics Card. Price: 17,900৳.

Product: PELADN RX 5500 XT 8G GDDR6 Dual Fan Black Gaming Graphics Card. Category: PELADN. Subcategory: Graphics Card. Price: 18,500৳.
",180,130026,130206
932,sentence,"Subcategory: Graphics Card. Price: 18,500৳.

Product: PELADN RX 5500 XT 8G GDDR6 Dual Fan Gaming White Graphics Card. Category: PELADN. Subcategory: Graphics Card. Price: Out Of Stock.
",185,130162,130347
933,sentence,"Price: Out Of Stock.

Product: PELADN GTX 1660 Ti 6G GDDR6 Black Dual Fan Gaming Graphics Card. Category: PELADN. Subcategory: Graphics Card. Price: Out Of Stock.
",163,130326,130489
934,sentence,"Price: Out Of Stock.

Product: PELADN GTX 1660 Ti 6G GDDR6 Dual Fan Gaming Graphics Card. Category: PELADN. Subcategory: Graphics Card. Price: Out Of Stock.
",157,130468,130625
935,sentence,"Price: Out Of Stock.

Product: MSI GeForce RTX 3050 VENTUS 2X E 6G OC GDDR6 Graphics Card. Category: MSI. Subcategory: Graphics Card. Price: 26,800৳.
",150,130604,130754
936,sentence,"Subcategory: Graphics Card. Price: 26,800৳.

Product: MSI GeForce RTX 3050 VENTUS 2X 6G OC GDDR6 Graphics Card. Category: MSI. Subcategory: Graphics Card. Price: 23,500৳23,900৳.
",178,130710,130888
937,sentence,"Price: 23,500৳23,900৳.

Product: MSI GeForce RTX 3050 VENTUS 2X XS 8GB OC GDDR6 Graphics Card. Category: MSI. Subcategory: Graphics Card. Price: 28,900৳29,300৳.
",161,130865,131026
938,sentence,"Price: 28,900৳29,300৳.

Product: MSI GeForce RTX 5050 8G SHADOW 2X OC 8GB GDDR6 Graphics Card. Category: MSI. Subcategory: Graphics Card. Price: 37,900৳.
",154,131003,131157
939,sentence,"Subcategory: Graphics Card. Price: 37,900৳.

Product: MSI GeForce RTX 3060 VENTUS 2X OC 12GB Graphics Card. Category: MSI. Subcategory: Graphics Card. Price: 39,500৳.
",167,131113,131280
940,sentence,"Subcategory: Graphics Card. Price: 39,500৳.

Product: MSI GeForce RTX 5050 8G VENTUS 2X OC 8GB GDDR6 Graphics Card. Category: MSI. Subcategory: Graphics Card. Price: 39,800৳.
",175,131236,131411
941,sentence,"Subcategory: Graphics Card. Price: 39,800৳.

Product: MSI GeForce RTX 4060 VENTUS 2X BLACK 8GB OC GDDR6 Graphics Card. Category: MSI. Subcategory: Graphics Card. Price: 45,500৳46,200৳.
",185,131367,131552
942,sentence,"Price: 45,500৳46,200৳.

Product: MSI GeForce RTX 5060 8G SHADOW 2X OC 8GB GDDR7 Graphics Card. Category: MSI. Subcategory: Graphics Card. Price: 44,500৳48,900৳.
",161,131529,131690
943,sentence,"Price: 44,500৳48,900৳.

Product: MSI GeForce RTX 5060 8G VENTUS 2X OC 8GB GDDR7 Graphics Card. Category: MSI. Subcategory: Graphics Card. Price: 49,900৳.
",154,131667,131821
944,sentence,"Subcategory: Graphics Card. Price: 49,900৳.

Product: MSI GeForce RTX 5060 8G VENTUS 2X OC WHITE 8GB GDDR7 Graphics Card. Category: MSI. Subcategory: Graphics Card. Price: 50,900৳.
",181,131777,131958
945,sentence,"Subcategory: Graphics Card. Price: 50,900৳.

Product: MSI GeForce RTX 5060 8G INSPIRE 2X OC 8GB GDDR7 Graphics Card. Category: MSI. Subcategory: Graphics Card. Price: 51,900৳.
",176,131914,132090
946,sentence,"Subcategory: Graphics Card. Price: 51,900৳.

Product: MSI GeForce RTX 5060 8G GAMING OC 8GB GDDR7 Graphics Card. Category: MSI. Subcategory: Graphics Card. Price: 54,900৳.
",172,132046,132218
947,sentence,"Subcategory: Graphics Card. Price: 54,900৳.

Product: MSI GeForce RTX 5060 8G GAMING TRIO OC 8GB GDDR7 Graphics Card. Category: MSI. Subcategory: Graphics Card. Price: 56,900৳.
",177,132174,132351
948,sentence,"Subcategory: Graphics Card. Price: 56,900৳.

Product: MSI GeForce RTX 5060 Ti 8G VENTUS 2X PLUS 8GB GDDR7 Graphics Card. Category: MSI. Subcategory: Graphics Card. Price: 61,900৳.
",180,132307,132487
949,sentence,"Subcategory: Graphics Card. Price: 61,900৳.

Product: MSI GeForce RTX 5060 Ti 8G SHADOW 2X OC PLUS 8GB GDDR7 Graphics Card. Category: MSI. Subcategory: Graphics Card. Price: 53,900৳62,900৳.
",190,132443,132633
950,sentence,"Price: 53,900৳62,900৳.

Product: MSI GeForce RTX 5060 Ti 8G VENTUS 3X OC 8GB GDDR7 Graphics Card. Category: MSI. Subcategory: Graphics Card. Price: 63,900৳.
",157,132610,132767
951,sentence,"Subcategory: Graphics Card. Price: 63,900৳.

Product: MSI GeForce RTX 5060 Ti 8G VENTUS 2X OC PLUS 8GB GDDR7 Graphics Card. Category: MSI. Subcategory: Graphics Card. Price: 55,500৳64,900৳.
",190,132723,132913
952,sentence,"Price: 55,500৳64,900৳.

Product: MSI GeForce RTX 5060 Ti 8G INSPIRE 2X OC 8GB GDDR7 Graphics Card. Category: MSI. Subcategory: Graphics Card. Price: 66,900৳.
",158,132890,133048
953,sentence,"Subcategory: Graphics Card. Price: 66,900৳.

Product: MSI GeForce RTX 5060 Ti 8G GAMING OC 8GB GDDR7 Graphics Card. Category: MSI. Subcategory: Graphics Card. Price: 66,900৳.
",175,133004,133179
954,sentence,"Subcategory: Graphics Card. Price: 66,900৳.

Product: GIGABYTE Intel Arc A380 WINDFORCE OC 6G GDDR6 Graphics Card. Category: GIGABYTE. Subcategory: Graphics Card. Price: 20,000৳.
",179,133135,133314
955,sentence,"Subcategory: Graphics Card. Price: 20,000৳.

Product: GIGABYTE GeForce RTX 5050 GAMING OC 8GB GDDR6 Graphics Card. Category: GIGABYTE. Subcategory: Graphics Card. Price: 44,500৳.
",179,133270,133449
956,sentence,"Subcategory: Graphics Card. Price: 44,500৳.

Product: GIGABYTE GeForce RTX 5050 OC Low Profile 8GB GDDR6 Graphics Card. Category: GIGABYTE. Subcategory: Graphics Card. Price: 41,000৳.
",184,133405,133589
957,sentence,"Subcategory: Graphics Card. Price: 41,000৳.

Product: GIGABYTE GeForce RTX 5050 WINDFORCE OC 8GB GDDR6 Graphics Card. Category: GIGABYTE. Subcategory: Graphics Card. Price: 40,500৳.
",182,133545,133727
958,sentence,"Subcategory: Graphics Card. Price: 40,500৳.

Product: GIGABYTE Radeon RX 9060 XT GAMING OC 8GB GDDR6 Graphics Card. Category: GIGABYTE. Subcategory: Graphics Card. Price: 57,000৳.
",180,133683,133863
959,sentence,"Subcategory: Graphics Card. Price: 57,000৳.

Product: GIGABYTE GeForce RTX 5060 WINDFORCE MAX OC 8GB GDDR7 Graphics Card. Category: GIGABYTE. Subcategory: Graphics Card. Price: 49,500৳.
",186,133819,134005
960,sentence,"Subcategory: Graphics Card. Price: 49,500৳.

Product: GIGABYTE GeForce RTX 5060 OC Low Profile 8GB GDDR7 Graphics Card. Category: GIGABYTE. Subcategory: Graphics Card. Price: 48,000৳.
",184,133961,134145
961,sentence,"Subcategory: Graphics Card. Price: 48,000৳.

Product: GIGABYTE GeForce RTX 5060 Ti EAGLE OC ICE 16GB GDDR7 Graphics Card. Category: GIGABYTE. Subcategory: Graphics Card. Price: 74,500৳.
",186,134101,134287
962,sentence,"Subcategory: Graphics Card. Price: 74,500৳.

Product: GIGABYTE GeForce RTX 5060 Ti WINDFORCE MAX OC 16GB GDDR7 Graphics Card. Category: GIGABYTE. Subcategory: Graphics Card. Price: 72,000৳.
",190,134243,134433
963,sentence,"Subcategory: Graphics Card. Price: 72,000৳.

Product: GIGABYTE GeForce RTX 3050 OC Low Profile 6G GDDR6 Graphics Card. Category: GIGABYTE. Subcategory: Graphics Card. Price: 26,200৳27,000৳.
",190,134389,134579
964,sentence,"Price: 26,200৳27,000৳.

Product: GIGABYTE GeForce RTX 3050 WINDFORCE OC 6GB GDDR6 Graphics Card. Category: GIGABYTE. Subcategory: Graphics Card. Price: 26,500৳27,900৳.
",168,134556,134724
965,sentence,"Price: 26,500৳27,900৳.

Product: GIGABYTE GeForce RTX 3050 WINDFORCE OC V2 8GB GDDR6 Graphics Card. Category: GIGABYTE. Subcategory: Graphics Card. Price: 29,000৳.
",164,134701,134865
966,sentence,"Subcategory: Graphics Card. Price: 29,000৳.

Product: GIGABYTE GeForce RTX 3050 WINDFORCE OC 8GB GDDR6 Graphics Card. Category: GIGABYTE. Subcategory: Graphics Card. Price: 29,000৳32,000৳.
",189,134821,135010
967,sentence,"Price: 29,000৳32,000৳.

Product: GIGABYTE GeForce RTX 3060 WINDFORCE OC 12GB GDDR6 Graphics Card. Category: GIGABYTE. Subcategory: Graphics Card. Price: 38,900৳.
",162,134987,135149
968,sentence,"Subcategory: Graphics Card. Price: 38,900৳.

Product: GIGABYTE GeForce RTX 5060 WINDFORCE 8G GDDR7 Graphics Card. Category: GIGABYTE. Subcategory: Graphics Card. Price: 47,000৳48,500৳.
",185,135105,135290
969,sentence,"Price: 47,000৳48,500৳.

Product: GIGABYTE GeForce RTX 5060 WINDFORCE OC 8G GDDR7 Graphics Card. Category: GIGABYTE. Subcategory: Graphics Card. Price: 48,000৳.
",160,135267,135427
970,sentence,"Subcategory: Graphics Card. Price: 48,000৳.

Product: GIGABYTE GeForce RTX 5060 EAGLE OC 8G GDDR7 Graphics Card. Category: GIGABYTE. Subcategory: Graphics Card. Price: 49,500৳51,500৳.
",184,135383,135567
971,sentence,"Price: 49,500৳51,500৳.

Product: OCPC GeForce GTX 1660 Ti XE 6GB GDDR6 Graphics Card. Category: OCPC. Subcategory: Graphics Card. Price: 24,999৳25,200৳.
",153,135544,135697
972,sentence,"Price: 24,999৳25,200৳.

Product: OCPC Radeon RX 6600 LE 8GB XE GDDR6 Graphics Card. Category: OCPC. Subcategory: Graphics Card. Price: 27,700৳.
",144,135674,135818
973,sentence,"Subcategory: Graphics Card. Price: 27,700৳.

Product: OCPC GeForce RTX 3060 12GB XM GDDR6 Graphics Card. Category: OCPC. Subcategory: Graphics Card. Price: 39,000৳.
",165,135774,135939
974,sentence,"Subcategory: Graphics Card. Price: 39,000৳.

Product: OCPC RX 550 4GB XE GDDR5 Graphics Card. Category: OCPC. Subcategory: Graphics Card. Price: Out Of Stock.
",159,135895,136054
975,sentence,"Price: Out Of Stock.

Product: OCPC Radeon RX 580 8GB GDDR5 Graphics Card. Category: OCPC. Subcategory: Graphics Card. Price: Out Of Stock.

Product: OCPC RX 5500 XT 8GB GDDR6 Graphics Card. ",191,136033,136224
976,sentence,"Category: OCPC. Subcategory: Graphics Card. Price: Out Of Stock.

Product: OCPC GeForce RTX 3060 12GB GDDR6 Graphics Card. Category: OCPC. Subcategory: Graphics Card. Price: Out Of Stock.
",188,136224,136412
977,sentence,"Price: Out Of Stock.

Product: OCPC GeForce RTX 4060 8GB GDDR6 Graphics Card. Category: OCPC. Subcategory: Graphics Card. Price: Out Of Stock.
",143,136391,136534
978,sentence,"Price: Out Of Stock.

Product: Palit GeForce RTX 3050 Dual 8GB GDDR6 Graphics Card. Category: Palit. Subcategory: Graphics Card. Price: Out Of Stock.
",150,136513,136663
979,sentence,"Price: Out Of Stock.

Product: Palit GeForce RTX 5060 Ti Infinity 3 16GB GDDR7 Graphics Card. Category: Palit. Subcategory: Graphics Card. Price: Out Of Stock.
",160,136642,136802
980,sentence,"Price: Out Of Stock.

Product: Deepcool GH-01 A-RGB Graphics Card Holder. Category: VGA Holder. Subcategory: Graphics Card. Price: 1,200৳.
",139,136781,136920
981,sentence,"Subcategory: Graphics Card. Price: 1,200৳.

Product: Cooler Master Universal VGA Holder for all size Tower Chassis. Category: VGA Holder. Subcategory: Graphics Card. Price: Out Of Stock.
",187,136877,137064
982,sentence,"Price: Out Of Stock.

Product: Manli GeForce RTX 3050 6GB Nebula Twin GDDR6 Graphics Card. Category: Manli. Subcategory: Graphics Card. Price: 24,999৳.
",152,137043,137195
983,sentence,"Subcategory: Graphics Card. Price: 24,999৳.

Product: Manli Nebula GeForce RTX 5050 8GB GDDR6 Graphics Card. Category: Manli. Subcategory: Graphics Card. Price: 37,500৳.
",170,137151,137321
984,sentence,"Subcategory: Graphics Card. Price: 37,500৳.

Product: Manli Polar Fox GeForce RTX 5050 OC 8GB GDDR6 Graphics Card. Category: Manli. Subcategory: Graphics Card. Price: 40,500৳.
",176,137277,137453
985,sentence,"Subcategory: Graphics Card. Price: 40,500৳.

Product: Manli Nebula GeForce RTX 5060 8GB GDDR7 Graphics Card. Category: Manli. Subcategory: Graphics Card. Price: 44,999৳.
",170,137409,137579
986,sentence,"Subcategory: Graphics Card. Price: 44,999৳.

Product: Manli Polar Fox GeForce RTX 5060 OC 8GB GDDR7 Graphics Card. Category: Manli. Subcategory: Graphics Card. Price: 47,500৳.
",176,137535,137711
987,sentence,"Subcategory: Graphics Card. Price: 47,500৳.

Product: Manli Nebula GeForce RTX 5060 OC 8GB GDDR7 Graphics Card. Category: Manli. Subcategory: Graphics Card. Price: 51,999৳.
",173,137667,137840
988,sentence,"Subcategory: Graphics Card. Price: 51,999৳.

Product: Manli Nebula GeForce RTX 5060 Ti 8GB GDDR7 Graphics Card. Category: Manli. Subcategory: Graphics Card. Price: 56,000৳56,999৳.
",180,137796,137976
989,sentence,"Price: 56,000৳56,999৳.

Product: Manli Nebula GeForce RTX 5060 Ti 16GB GDDR7 Graphics Card. Category: Manli. Subcategory: Graphics Card. Price: 66,500৳.
",153,137953,138106
990,sentence,"Subcategory: Graphics Card. Price: 66,500৳.

Product: Manli Polar Fox GeForce RTX 5060 Ti OC 16GB GDDR7 Graphics Card. Category: Manli. Subcategory: Graphics Card. Price: 69,000৳.
",180,138062,138242
991,sentence,"Subcategory: Graphics Card. Price: 69,000৳.

Product: Manli Polar Fox GeForce RTX 5060 Ti OC Triple Fan 16GB GDDR7 Graphics Card. Category: Manli. Subcategory: Graphics Card. Price: 71,500৳.
",191,138198,138389
992,sentence,"Subcategory: Graphics Card. Price: 71,500৳.

Product: Manli Nebula GeForce RTX 5070 12GB GDDR7 Graphics Card. Category: Manli. Subcategory: Graphics Card. Price: 87,500৳.
",171,138345,138516
993,sentence,"Subcategory: Graphics Card. Price: 87,500৳.

Product: Manli Polar Fox V2 GeForce RTX 5070 OC 12GB GDDR7 Graphics Card. Category: Manli. Subcategory: Graphics Card. Price: 91,000৳.
",180,138472,138652
994,sentence,"Subcategory: Graphics Card. Price: 91,000৳.

Product: Manli Nebula GeForce RTX 5070 Ti 16GB GDDR7 Graphics Card. Category: Manli. Subcategory: Graphics Card. Price: 120,999৳.
",175,138608,138783
995,sentence,"Subcategory: Graphics Card. Price: 120,999৳.

Product: Manli Polar Fox GeForce RTX 5070 Ti OC 16GB GDDR7 Graphics Card. Category: Manli. Subcategory: Graphics Card. Price: 129,000৳.
",182,138738,138920
996,sentence,"Subcategory: Graphics Card. Price: 129,000৳.

Product: Manli Nebula GeForce RTX 5080 16GB GDDR7 Graphics Card. Category: Manli. Subcategory: Graphics Card. Price: 153,500৳.
",173,138875,139048
997,sentence,"Subcategory: Graphics Card. Price: 153,500৳.

Product: Manli Polar Fox V2 GeForce RTX 5080 OC 16GB GDDR7 Graphics Card. Category: Manli. Subcategory: Graphics Card. Price: 159,000৳.
",182,139003,139185
998,sentence,"Subcategory: Graphics Card. Price: 159,000৳.

Product: Manli Gallardo GeForce RTX 5090 OC 32GB GDDR7 Graphics Card. Category: Manli. Subcategory: Graphics Card. Price: Up Coming.
",179,139140,139319
999,sentence,"Subcategory: Graphics Card. Price: Up Coming.

Product: PowerColor Fighter AMD Radeon RX 7600 8GB GDDR6 Graphics Card. Category: PowerColor. Subcategory: Graphics Card. Price: 35,500৳.
",185,139273,139458
1000,sentence,"Subcategory: Graphics Card. Price: 35,500৳.

Product: PowerColor Reaper AMD Radeon RX 9060 XT 8GB GDDR6 Graphics Card. Category: PowerColor. Subcategory: Graphics Card. Price: 49,000৳50,000৳.
",192,139414,139606
1001,sentence,"Price: 49,000৳50,000৳.

Product: PowerColor Hellhound AMD Radeon RX 9060 XT 8GB GDDR6 Graphics Card. Category: PowerColor. Subcategory: Graphics Card. Price: 51,500৳.
",167,139583,139750
1002,sentence,"Subcategory: Graphics Card. Price: 51,500৳.

Product: PowerColor Reaper AMD Radeon RX 9060 XT 16GB GDDR6 Graphics Card. Category: PowerColor. Subcategory: Graphics Card. Price: 55,400৳.
",186,139706,139892
1003,sentence,"Subcategory: Graphics Card. Price: 55,400৳.

Product: PowerColor Hellhound Spectral White AMD Radeon RX 9060 XT 16GB Graphics Card. Category: PowerColor. Subcategory: Graphics Card. Price: 58,990৳.
",198,139848,140046
1004,sentence,"Subcategory: Graphics Card. Price: 58,990৳.

Product: PowerColor Fighter AMD Radeon RX 7700 XT 12GB GDDR6 Graphics Card. Category: PowerColor. Subcategory: Graphics Card. Price: 66,500৳67,500৳.
",194,140002,140196
1005,sentence,"Price: 66,500৳67,500৳.

Product: PowerColor AMD Radeon RX 7800 XT 16GB GDDR6 Graphics Card. Category: PowerColor. Subcategory: Graphics Card. Price: 68,500৳69,500৳.
",165,140173,140338
1006,sentence,"Price: 68,500৳69,500৳.

Product: PowerColor Fighter AMD Radeon RX 7800 XT 16GB GDDR6 Graphics Card. Category: PowerColor. Subcategory: Graphics Card. Price: 71,000৳.
",166,140315,140481
1007,sentence,"Subcategory: Graphics Card. Price: 71,000৳.

Product: PowerColor Hellhound Sakura AMD Radeon RX 7800 XT 16GB GDDR6 Limited Edition Graphics Card. Category: PowerColor. Subcategory: Graphics Card. ",196,140437,140633
1008,sentence,"Subcategory: Graphics Card. Price: 72,800৳75,000৳.

Product: PowerColor Hellhound Spectral White AMD Radeon RX 7800 XT 16GB GDDR6 Graphics Card. Category: PowerColor. Subcategory: Graphics Card. ",195,140605,140800
1009,sentence,"Subcategory: Graphics Card. Price: 73,500৳75,000৳.

Product: PowerColor Reaper AMD Radeon RX 9070 16GB GDDR6 Graphics Card. Category: PowerColor. Subcategory: Graphics Card. Price: 87,000৳88,000৳.
",197,140772,140969
1010,sentence,"Price: 87,000৳88,000৳.

Product: PowerColor Reaper AMD Radeon RX 9070 XT 16GB GDDR6 Graphics Card. Category: PowerColor. Subcategory: Graphics Card. Price: 99,900৳.
",165,140946,141111
1011,sentence,"Subcategory: Graphics Card. Price: 99,900৳.

Product: PowerColor Red Devil Spectral White AMD Radeon RX 9070 XT 16GB GDDR6 Graphics Card. Category: PowerColor. Subcategory: Graphics Card. ",188,141067,141255
1012,sentence,"Subcategory: Graphics Card. Price: 115,000৳.

Product: PowerColor Red Devil AMD Radeon RX 9070 XT 16GB GDDR6 Graphics Card. Category: PowerColor. Subcategory: Graphics Card. Price: 115,900৳.
",191,141227,141418
1013,sentence,"Subcategory: Graphics Card. Price: 115,900৳.

Product: PowerColor Fighter AMD Radeon RX 6500 XT 4GB GDDR6 Graphics Card. Category: PowerColor. Subcategory: Graphics Card. Price: Out Of Stock.
",192,141373,141565
1014,sentence,"Price: Out Of Stock.

Product: PowerColor Hellhound AMD Radeon RX 9060 XT 16GB GDDR6 Graphics Card. Category: PowerColor. Subcategory: Graphics Card. Price: Out Of Stock.
",171,141544,141715
1015,sentence,"Price: Out Of Stock.

Product: PowerColor AMD Radeon RX 7700 XT 12GB GDDR6 Graphics Card. Category: PowerColor. Subcategory: Graphics Card. Price: Out Of Stock.
",161,141694,141855
1016,sentence,"Price: Out Of Stock.

Product: PowerColor Hellhound AMD Radeon RX 7700 XT 12GB GDDR6 Graphics Card. Category: PowerColor. Subcategory: Graphics Card. Price: Out Of Stock.
",171,141834,142005
1017,sentence,"Price: Out Of Stock.

Product: PowerColor Hellhound AMD Radeon RX 7800 XT 16GB GDDR6 Graphics Card. Category: PowerColor. Subcategory: Graphics Card. Price: Out Of Stock.
",171,141984,142155
1018,sentence,"Price: Out Of Stock.

Product: Netac Basic DDR3 4GB 1600MHZ Desktop RAM. Category: RAM (Desktop). Subcategory: Component. Price: 950৳1,000৳.

Product: Netac Basic 4GB DDR4 2666MHZ Desktop RAM. ",193,142134,142327
1019,sentence,"Category: RAM (Desktop). Subcategory: Component. Price: 1,300৳.

Product: Netac Shadow II 8GB DDR4 3200MHz Desktop RAM. Category: RAM (Desktop). Subcategory: Component. Price: 2,650৳.
",184,142327,142511
1020,sentence,"Subcategory: Component. Price: 2,650৳.

Product: Colorful Battle-AX DDR4 8GB 3200MHz Desktop RAM White. Category: RAM (Desktop). Subcategory: Component. Price: 3,300৳.
",168,142472,142640
1021,sentence,"Subcategory: Component. Price: 3,300৳.

Product: Colorful Battle-AX 8GB DDR4 3200MHz U-DIMM Desktop RAM. Category: RAM (Desktop). Subcategory: Component. Price: 3,100৳.
",169,142601,142770
1022,sentence,"Subcategory: Component. Price: 3,100৳.

Product: Colorful Battle-AX DDR4 8GB 3200MHz Desktop RAM. Category: RAM (Desktop). Subcategory: Component. Price: 3,100৳.
",162,142731,142893
1023,sentence,"Subcategory: Component. Price: 3,100৳.

Product: OCPC XT II DDR4 3200MHz 8GB Desktop RAM White. Category: RAM (Desktop). Subcategory: Component. Price: 3,200৳.
",160,142854,143014
1024,sentence,"Subcategory: Component. Price: 3,200৳.

Product: Gigabyte AORUS RGB 8GB DDR4 3733MHz Desktop RAM. Category: RAM (Desktop). Subcategory: Component. Price: 2,976৳3,200৳.
",168,142975,143143
1025,sentence,"Subcategory: Component. Price: 2,976৳3,200৳.

Product: G.SKILL Aegis 8GB DDR4 3200Mhz Desktop RAM. Category: RAM (Desktop). Subcategory: Component. Price: 3,000৳3,400৳.
",169,143098,143267
1026,sentence,"Subcategory: Component. Price: 3,000৳3,400৳.

Product: OCPC XT II DDR4 3200MHz 8GB Desktop RAM. Category: RAM (Desktop). Subcategory: Component. Price: 3,200৳3,400৳.
",166,143222,143388
1027,sentence,"Subcategory: Component. Price: 3,200৳3,400৳.

Product: Kingston FURY Beast 8GB 3200MHz DDR4 Desktop RAM. Category: RAM (Desktop). Subcategory: Component. Price: 3,300৳3,550৳.
",175,143343,143518
1028,sentence,"Subcategory: Component. Price: 3,300৳3,550৳.

Product: TEAM VULCAN RED 8GB DDR5 5200MHz Gaming Desktop RAM. Category: RAM (Desktop). Subcategory: Component. Price: 3,500৳.
",172,143473,143645
1029,sentence,"Subcategory: Component. Price: 3,500৳.

Product: TEAM VULCAN Black 8GB DDR5 5200MHz Gaming Desktop RAM. Category: RAM (Desktop). Subcategory: Component. Price: 3,550৳.
",168,143606,143774
1030,sentence,"Subcategory: Component. Price: 3,550৳.

Product: G.Skill Trident Z 8GB DDR4 3200MHz Desktop RAM. Category: RAM (Desktop). Subcategory: Component. Price: 3,500৳3,600৳.
",167,143735,143902
1031,sentence,"Subcategory: Component. Price: 3,500৳3,600৳.

Product: Team T-Force Vulcan Z 8GB DDR4 3200MHz CL16 Gaming RAM. Category: RAM (Desktop). Subcategory: Component. Price: 3,300৳.
",175,143857,144032
1032,sentence,"Subcategory: Component. Price: 3,300৳.

Product: Team T-CREATE CLASSIC 8GB DDR4 3200MHz Desktop RAM. Category: RAM (Desktop). Subcategory: Component. Price: 3,600৳.
",165,143993,144158
1033,sentence,"Subcategory: Component. Price: 3,600৳.

Product: Team T-Force VULCAN RED 8GB DDR5 5600MHz Desktop RAM. Category: RAM (Desktop). Subcategory: Component. Price: 3,650৳.
",167,144119,144286
1034,sentence,"Subcategory: Component. Price: 3,650৳.

Product: TEAM T-Force VULCAN 8GB DDR5 5600MHz Desktop RAM. Category: RAM (Desktop). Subcategory: Component. Price: 3,650৳.
",163,144247,144410
1035,sentence,"Subcategory: Component. Price: 3,650৳.

Product: TEAM VULCAN RED 8GB DDR5 6000MHz Gaming Desktop RAM. Category: RAM (Desktop). Subcategory: Component. Price: 3,750৳.
",166,144371,144537
1036,sentence,"Subcategory: Component. Price: 3,750৳.

Product: PNY GeForce RTX 5060 8GB OC Dual Fan GDDR7 Graphics Card. Category: PNY. Subcategory: Graphics Card. Price: 44,900৳47,500৳.
",173,144498,144671
1037,sentence,"Price: 44,900৳47,500৳.

Product: PNY GeForce RTX 5060 Ti 8GB OC Dual Fan GDDR7 Graphics Card. Category: PNY. Subcategory: Graphics Card. Price: 60,900৳61,900৳.
",160,144648,144808
1038,sentence,"Price: 60,900৳61,900৳.

Product: PNY GeForce RTX 5060 Ti 16GB Dual Fan GDDR7 Graphics Card. Category: PNY. Subcategory: Graphics Card. Price: 66,500৳.
",151,144785,144936
1039,sentence,"Subcategory: Graphics Card. Price: 66,500৳.

Product: PNY GeForce RTX 5060 Ti 16GB OC Dual Fan GDDR7 Graphics Card. Category: PNY. Subcategory: Graphics Card. Price: 67,500৳.
",175,144892,145067
1040,sentence,"Subcategory: Graphics Card. Price: 67,500৳.

Product: PNY GeForce RTX 5070 OC Triple Fan 12GB GDDR7 Graphics Card. Category: PNY. Subcategory: Graphics Card. Price: 91,500৳99,500৳.
",181,145023,145204
1041,sentence,"Price: 91,500৳99,500৳.

Product: PNY GeForce RTX 4080 16GB XLR8 Gaming Verto EPIC-X RGB Triple Fan GDDR6X Graphics Card. Category: PNY. Subcategory: Graphics Card. Price: 170,000৳172,000৳.
",189,145181,145370
1042,sentence,"Price: 170,000৳172,000৳.

Product: PNY GeForce RTX 5080 16GB GDDR7 ARGB EPIC-X RGB Overclocked Triple Fan Graphics Card. Category: PNY. Subcategory: Graphics Card. Price: 170,000৳182,000৳.
",189,145345,145534
1043,sentence,"Price: 170,000৳182,000৳.

Product: PNY GeForce RTX 5080 16GB Triple Fan GDDR7 Graphics Card. Category: PNY. Subcategory: Graphics Card. Price: 178,000৳186,000৳.
",161,145509,145670
1044,sentence,"Price: 178,000৳186,000৳.

Product: PNY GeForce RTX 5090 32GB GDDR7 ARGB EPIC-X RGB Overclocked Triple Fan Graphics Card. Category: PNY. Subcategory: Graphics Card. Price: 427,000৳435,000৳.
",189,145645,145834
1045,sentence,"Price: 427,000৳435,000৳.

Product: PNY GeForce RTX 3050 6GB VERTO Dual Fan GDDR6 Graphics Card. Category: PNY. Subcategory: Graphics Card. Price: Out Of Stock.
",160,145809,145969
1046,sentence,"Price: Out Of Stock.

Product: PNY GeForce RTX 3060 12GB VERTO Dual Fan GDDR6 Graphics Card (No Box, No Warranty). Category: PNY. Subcategory: Graphics Card. Price: Out Of Stock.
",179,145948,146127
1047,sentence,"Price: Out Of Stock.

Product: PNY GeForce RTX 4060 Ti 8GB XLR8 Gaming VERTO EPIC-X RGB Triple Fan GDDR6 Graphics Card (No Box, No Warranty). Category: PNY. Subcategory: Graphics Card. ",185,146106,146291
1048,sentence,"Category: PNY. Subcategory: Graphics Card. Price: Out Of Stock.

Product: PNY GeForce RTX 4060 8GB VERTO Dual Fan GDDR6 Graphics Card. Category: PNY. Subcategory: Graphics Card. Price: Out Of Stock.
",199,146248,146447
1049,sentence,"Price: Out Of Stock.

Product: PNY GeForce RTX 4060 8GB XLR8 Gaming VERTO EPIC-X RGB Triple Fan GDDR6 Graphics Card. Category: PNY. Subcategory: Graphics Card. Price: Out Of Stock.
",181,146426,146607
1050,sentence,"Price: Out Of Stock.

Product: PNY GeForce RTX 4060 Ti 8GB XLR8 Gaming VERTO EPIC-X RGB Triple Fan GDDR6 Graphics Card. Category: PNY. Subcategory: Graphics Card. Price: Out Of Stock.
",184,146586,146770
1051,sentence,"Price: Out Of Stock.

Product: PNY GeForce RTX 4070 SUPER 12GB XLR8 Gaming VERTO EPIC-X RGB Triple Fan GDDR6X Graphics Card. Category: PNY. Subcategory: Graphics Card. Price: Out Of Stock.
",189,146749,146938
1052,sentence,"Price: Out Of Stock.

Product: PNY GeForce RTX 5070 Triple Fan 12GB GDDR7 Graphic Card. Category: PNY. Subcategory: Graphics Card. Price: Out Of Stock.
",152,146917,147069
1053,sentence,"Price: Out Of Stock.

Product: PNY GeForce RTX 5070 Ti OC Plus Triple Fan 16GB GDDR7 Graphic Card. Category: PNY. Subcategory: Graphics Card. Price: Out Of Stock.
",163,147048,147211
1054,sentence,"Price: Out Of Stock.

Product: PNY GeForce RTX 4070 Ti SUPER 16GB XLR8 Gaming VERTO EPIC-X RGB Overclocked Triple Fan GDDR6X Graphics Card. Category: PNY. Subcategory: Graphics Card. ",183,147190,147373
1055,sentence,"Category: PNY. Subcategory: Graphics Card. Price: Out Of Stock.

Product: PNY GeForce RTX 5070 Ti Epic-X ARGB OC Triple Fan 16GB GDDR7 Graphic Card. Category: PNY. Subcategory: Graphics Card. ",192,147330,147522
1056,sentence,"Category: PNY. Subcategory: Graphics Card. Price: Out Of Stock.

Product: PNY XLR8 RGB 8GB DDR4 3600MHz Desktop RAM. Category: PNY. Subcategory: RAM (Desktop). Price: 3,999৳.
",175,147479,147654
1057,sentence,"Subcategory: RAM (Desktop). Price: 3,999৳.

Product: PNY XLR8 RGB 16GB DDR4 3200MHz Desktop RAM White. Category: PNY. Subcategory: RAM (Desktop). Price: 6,500৳.
",161,147611,147772
1058,sentence,"Subcategory: RAM (Desktop). Price: 6,500৳.

Product: PNY XLR8 8GB DDR4 3200MHz Desktop Gaming RAM. Category: PNY. Subcategory: RAM (Desktop). Price: Out Of Stock.
",163,147729,147892
1059,sentence,"Price: Out Of Stock.

Product: PNY Performance 8GB DDR4 2666MHz Desktop RAM. Category: PNY. Subcategory: RAM (Desktop). Price: Out Of Stock.
",141,147871,148012
1060,sentence,"Price: Out Of Stock.

Product: PNY XLR8 8GB RGB DDR4 3200MHz White Desktop RAM. Category: PNY. Subcategory: RAM (Desktop). Price: Out Of Stock.
",144,147991,148135
1061,sentence,"Price: Out Of Stock.

Product: PNY XLR8 Gaming EPIC-X RGB 8GB DDR4 3200MHz Desktop RAM. Category: PNY. Subcategory: RAM (Desktop). Price: Out Of Stock.
",152,148114,148266
1062,sentence,"Price: Out Of Stock.

Product: PNY XLR8 RGB 8GB DDR4 3600MHz White Desktop RAM. Category: PNY. Subcategory: RAM (Desktop). Price: Out Of Stock.
",144,148245,148389
1063,sentence,"Price: Out Of Stock.

Product: PNY XLR8 16GB DDR4 3200MHz Desktop Gaming RAM. Category: PNY. Subcategory: RAM (Desktop). Price: Out Of Stock.
",142,148368,148510
1064,sentence,"Price: Out Of Stock.

Product: PNY XLR8 Gaming MAKO 16GB DDR5 6000MHz Desktop RAM. Category: PNY. Subcategory: RAM (Desktop). Price: Out Of Stock.
",147,148489,148636
1065,sentence,"Price: Out Of Stock.

Product: PNY XLR8 Gaming MAKO 16GB DDR5 6000MHz Desktop RAM White. Category: PNY. Subcategory: RAM (Desktop). Price: Out Of Stock.
",153,148615,148768
1066,sentence,"Price: Out Of Stock.

Product: PNY XLR8 RGB 16GB (8GBx2) DDR4 3600MHz Desktop RAM. Category: PNY. Subcategory: RAM (Desktop). Price: Out Of Stock.
",147,148747,148894
1067,sentence,"Price: Out Of Stock.

Product: Gigabyte 8GB DDR4 2666MHz Heatsink Desktop Ram. Category: Gigabyte. Subcategory: RAM (Desktop). Price: Out Of Stock.
",148,148873,149021
1068,sentence,"Price: Out Of Stock.

Product: Gigabyte AORUS RGB 8GB DDR4 3200MHz Desktop RAM. Category: Gigabyte. Subcategory: RAM (Desktop). Price: Out Of Stock.

Product: Gigabyte AORUS 8GB 3200MHz RGB RAM. ",195,149000,149195
1069,sentence,"
Product: Gigabyte AORUS 8GB 3200MHz RGB RAM. Category: Gigabyte. Subcategory: RAM (Desktop). Price: Out Of Stock.

Product: Gigabyte AORUS RGB 8GB DDR4 3600MHz Desktop RAM. Category: Gigabyte. ",194,149149,149343
1070,sentence,"Category: Gigabyte. Subcategory: RAM (Desktop). Price: Out Of Stock.

Product: Gigabyte AORUS RGB 16GB DDR5 6000MHz Desktop RAM. Category: Gigabyte. Subcategory: RAM (Desktop). Price: Out Of Stock.
",198,149323,149521
1071,sentence,"Price: Out Of Stock.

Product: Colorful Battle-AX 8GB DDR4 3200MHz U-DIMM Desktop RAM White. Category: Colorful. Subcategory: RAM (Desktop). Price: 3,100৳.
",156,149500,149656
1072,sentence,"Subcategory: RAM (Desktop). Price: 3,100৳.

Product: Colorful CVN Guardian 8GB DDR4 3200MHz RGB Desktop RAM. Category: Colorful. Subcategory: RAM (Desktop). Price: Out Of Stock.
",178,149613,149791
1073,sentence,"Price: Out Of Stock.

Product: Colorful Battle-AX 16GB DDR4 3200MHz U-DIMM Desktop RAM. Category: Colorful. Subcategory: RAM (Desktop). Price: Out Of Stock.
",157,149770,149927
1074,sentence,"Price: Out Of Stock.

Product: Colorful Battle-AX 16GB DDR4 3200MHz U-DIMM Desktop RAM White. Category: Colorful. Subcategory: RAM (Desktop). Price: Out Of Stock.
",163,149906,150069
1075,sentence,"Price: Out Of Stock.

Product: Colorful Battle-AX Redline 16GB DDR5 6000MHz Desktop RAM. Category: Colorful. Subcategory: RAM (Desktop). Price: Out Of Stock.
",158,150048,150206
1076,sentence,"Price: Out Of Stock.

Product: Colorful CVN 16GB 6000MHz DDR5 Desktop RAM. Category: Colorful. Subcategory: RAM (Desktop). Price: Out Of Stock.
",144,150185,150329
1077,sentence,"Price: Out Of Stock.

Product: Colorful CVN Icicle 16GB DDR5 6600MHz Desktop RAM. Category: Colorful. Subcategory: RAM (Desktop). Price: Out Of Stock.
",151,150308,150459
1078,sentence,"Price: Out Of Stock.

Product: Corsair Vengeance LPX 8GB 3200MHz DDR4 Desktop RAM. Category: Corsair. Subcategory: RAM (Desktop). Price: 3,800৳4,100৳.
",151,150438,150589
1079,sentence,"Price: 3,800৳4,100৳.

Product: Corsair VENGEANCE RGB PRO 16GB DDR4 3000MHz Desktop RAM. Category: Corsair. Subcategory: RAM (Desktop). Price: 4,371৳4,700৳.
",156,150568,150724
1080,sentence,"Price: 4,371৳4,700৳.

Product: Corsair Vengeance LPX 16GB DDR4 DRAM 3200MHz RAM. Category: Corsair. Subcategory: RAM (Desktop). Price: 6,000৳6,200৳.
",149,150703,150852
1081,sentence,"Price: 6,000৳6,200৳.

Product: Corsair VENGEANCE 16GB DDR5 5600MHz CL40 Desktop RAM. Category: Corsair. Subcategory: RAM (Desktop). Price: 6,600৳7,000৳.
",153,150831,150984
1082,sentence,"Price: 6,600৳7,000৳.

Product: Corsair VENGEANCE 16GB DDR5 6000MHz CL36 Desktop RAM. Category: Corsair. Subcategory: RAM (Desktop). Price: 7,050৳7,100৳.
",153,150963,151116
1083,sentence,"Price: 7,050৳7,100৳.

Product: Corsair VENGEANCE 16GB DDR5 6000MHz RAM White. Category: Corsair. Subcategory: RAM (Desktop). Price: 7,500৳.

Product: Corsair VENGEANCE 16GB DDR5 6200MHz Desktop RAM. ",199,151095,151294
1084,sentence,"Category: Corsair. Subcategory: RAM (Desktop). Price: 7,500৳.

Product: Corsair VENGEANCE RGB 16GB DDR5 6000MHz CL36 Desktop RAM. Category: Corsair. Subcategory: RAM (Desktop). Price: 7,200৳7,500৳.
",198,151294,151492
1085,sentence,"Price: 7,200৳7,500৳.

Product: Corsair VENGEANCE RGB 16GB DDR5 6000MHz CL30 Desktop RAM. Category: Corsair. Subcategory: RAM (Desktop). Price: 8,100৳8,300৳.
",157,151471,151628
1086,sentence,"Price: 8,100৳8,300৳.

Product: Corsair VENGEANCE RGB 16GB DDR5 6600MHz RAM. Category: Corsair. Subcategory: RAM (Desktop). Price: 8,400৳8,700৳.
",144,151607,151751
1087,sentence,"Price: 8,400৳8,700৳.

Product: Corsair VENGEANCE RGB 24GB DDR5 7200MHz Desktop RAM. Category: Corsair. Subcategory: RAM (Desktop). Price: 13,999৳.
",147,151730,151877
1088,sentence,"Subcategory: RAM (Desktop). Price: 13,999৳.

Product: Corsair DOMINATOR PLATINUM RGB 16GB (2x8GB) DDR4 3600MHz C18 RAM Kit. Category: Corsair. Subcategory: RAM (Desktop). Price: Up Coming.
",189,151833,152022
1089,sentence,"Subcategory: RAM (Desktop). Price: Up Coming.

Product: Corsair VENGEANCE RGB 16GB DDR5 7200MHz Desktop RAM. Category: Corsair. Subcategory: RAM (Desktop). Price: Up Coming.
",174,151976,152150
1090,sentence,"Subcategory: RAM (Desktop). Price: Up Coming.

Product: Corsair Vengeance LPX 4GB (1x4GB) DDR4 DRAM 2400MHz. Category: Corsair. Subcategory: RAM (Desktop). Price: Out Of Stock.
",177,152104,152281
1091,sentence,"Price: Out Of Stock.

Product: CORSAIR VENGEANCE LPX 8GB DDR4 3600MHz RAM. Category: Corsair. Subcategory: RAM (Desktop). Price: Out Of Stock.

Product: Corsair Vengeance LPX 8GB DDR4 2400MHz RAM. ",197,152260,152457
1092,sentence,"Category: Corsair. Subcategory: RAM (Desktop). Price: Out Of Stock.

Product: CORSAIR VENGEANCE RGB RS 8GB DDR4 3200MHz RAM. Category: Corsair. Subcategory: RAM (Desktop). Price: Out Of Stock.
",193,152457,152650
1093,sentence,"Price: Out Of Stock.

Product: Corsair DOMINATOR PLATINUM RGB 8GB DDR4 3600MHz C18 RAM. Category: Corsair. Subcategory: RAM (Desktop). Price: Out Of Stock.
",156,152629,152785
1094,sentence,"Price: Out Of Stock.

Product: Corsair VENGEANCE RGB PRO 8GB DDR4 3200MHz Desktop RAM White. Category: Corsair. Subcategory: RAM (Desktop). Price: Out Of Stock.
",161,152764,152925
1095,sentence,"Price: Out Of Stock.

Product: CORSAIR VENGEANCE RGB RS 8GB DDR4 3600MHz RAM. Category: Corsair. Subcategory: RAM (Desktop). Price: Out Of Stock.

Product: TEAM VULCAN 8GB DDR5 6000MHz Desktop RAM. ",198,152904,153102
1096,sentence,"Category: TEAM. Subcategory: RAM (Desktop). Price: 3,700৳.

Product: Team T-Force VULCAN Z Red 8GB DDR4 3200MHz Desktop Gaming RAM. Category: TEAM. Subcategory: RAM (Desktop). Price: 3,850৳.
",191,153102,153293
1097,sentence,"Subcategory: RAM (Desktop). Price: 3,850৳.

Product: Team T-CREATE EXPERT 8GB DDR4 3200MHz Desktop RAM. Category: TEAM. Subcategory: RAM (Desktop). Price: 3,850৳.
",163,153250,153413
1098,sentence,"Subcategory: RAM (Desktop). Price: 3,850৳.

Product: TEAM Delta RGB 8GB DDR5 5200MHz Gaming Desktop RAM. Category: TEAM. Subcategory: RAM (Desktop). Price: 3,950৳.
",164,153370,153534
1099,sentence,"Subcategory: RAM (Desktop). Price: 3,950৳.

Product: Team T-FORCE DELTA RGB 8GB DDR5 5600MHz Desktop RAM. Category: TEAM. Subcategory: RAM (Desktop). Price: 4,050৳.
",165,153491,153656
1100,sentence,"Subcategory: RAM (Desktop). Price: 4,050৳.

Product: TEAM T-FORCE DELTA RGB 8GB 6000MHz DDR5 Gaming RAM. Category: TEAM. Subcategory: RAM (Desktop). Price: 4,150৳.
",164,153613,153777
1101,sentence,"Subcategory: RAM (Desktop). Price: 4,150৳.

Product: Team Delta RGB 8GB 3200MHz DDR4 CL16 Desktop RAM. Category: TEAM. Subcategory: RAM (Desktop). Price: 4,150৳.
",162,153734,153896
1102,sentence,"Subcategory: RAM (Desktop). Price: 4,150৳.

Product: Team T-Force Delta 8GB 3200MHz DDR4 RGB White Desktop Gaming RAM. Category: TEAM. Subcategory: RAM (Desktop). Price: 4,250৳.
",178,153853,154031
1103,sentence,"Subcategory: RAM (Desktop). Price: 4,250৳.

Product: TEAM T-FORCE DELTA RGB White 8GB 6000MHz DDR5 Gaming RAM. Category: TEAM. Subcategory: RAM (Desktop). Price: 4,250৳.
",170,153988,154158
1104,sentence,"Subcategory: RAM (Desktop). Price: 4,250৳.

Product: Team T-CREATE EXPERT 16GB DDR4 3200MHz Desktop RAM. Category: TEAM. Subcategory: RAM (Desktop). Price: 5,300৳.
",164,154115,154279
1105,sentence,"Subcategory: RAM (Desktop). Price: 5,300৳.

Product: Team T-Force VULCAN Z Red 16GB DDR4 3200MHz CL16 Gaming RAM. Category: TEAM. Subcategory: RAM (Desktop). Price: 6,199৳.
",173,154236,154409
1106,sentence,"Subcategory: RAM (Desktop). Price: 6,199৳.

Product: Team T-Force Vulcan Z 16GB 3200MHz DDR4 Desktop RAM. Category: TEAM. Subcategory: RAM (Desktop). Price: 6,200৳.
",165,154366,154531
1107,sentence,"Subcategory: RAM (Desktop). Price: 6,200৳.

Product: TEAM VULCAN 16GB DDR5 5600MHz Gaming Desktop RAM. Category: TEAM. Subcategory: RAM (Desktop). Price: 6,500৳.
",162,154488,154650
1108,sentence,"Subcategory: RAM (Desktop). Price: 6,500৳.

Product: Transcend 4GB DDR3 1333 MHz Desktop RAM. Category: Transcend. Subcategory: RAM (Desktop). Price: Out Of Stock.
",164,154607,154771
1109,sentence,"Price: Out Of Stock.

Product: Transcend 4GB DDR4 2400 Mhz Desktop Ram. Category: Transcend. Subcategory: RAM (Desktop). Price: Out Of Stock.
",142,154750,154892
1110,sentence,"Price: Out Of Stock.

Product: Transcend 16GB DDR4 2666Mhz U-DIMM Desktop RAM. Category: Transcend. Subcategory: RAM (Desktop). Price: Out Of Stock.
",149,154871,155020
1111,sentence,"Price: Out Of Stock.

Product: Transcend JetRam 16GB DDR4 3200MHz U-DIMM Desktop RAM. Category: Transcend. Subcategory: RAM (Desktop). Price: Out Of Stock.
",156,154999,155155
1112,sentence,"Price: Out Of Stock.

Product: Transcend JetRam 32GB DDR4 3200MHz U-DIMM Desktop RAM. Category: Transcend. Subcategory: RAM (Desktop). Price: Out Of Stock.
",156,155134,155290
1113,sentence,"Price: Out Of Stock.

Product: Transcend JetRam 4GB DDR4 3200MHz U-DIMM Desktop RAM. Category: Transcend. Subcategory: RAM (Desktop). Price: Out Of Stock.
",155,155269,155424
1114,sentence,"Price: Out Of Stock.

Product: Transcend 4GB DDR4 2666Mhz Desktop RAM. Category: Transcend. Subcategory: RAM (Desktop). Price: Out Of Stock.
",141,155403,155544
1115,sentence,"Price: Out Of Stock.

Product: Transcend JetRam 8GB DDR4 3200MHz U-DIMM Desktop RAM. Category: Transcend. Subcategory: RAM (Desktop). Price: Out Of Stock.
",155,155523,155678
1116,sentence,"Price: Out Of Stock.

Product: Transcend 8GB DDR4 2666MHz Desktop RAM. Category: Transcend. Subcategory: RAM (Desktop). Price: Out Of Stock.
",141,155657,155798
1117,sentence,"Price: Out Of Stock.

Product: Transcend JetRam 8GB DDR5 4800MHz U-DIMM Desktop RAM. Category: Transcend. Subcategory: RAM (Desktop). Price: Out Of Stock.
",155,155777,155932
1118,sentence,"Price: Out Of Stock.

Product: Transcend 32GB DDR4 2666Mhz U-DIMM Desktop RAM. Category: Transcend. Subcategory: RAM (Desktop). Price: Out Of Stock.

Product: Lexar 16GB DDR4 3200Mhz Desktop RAM. ",196,155911,156107
1119,sentence,"
Product: Lexar 16GB DDR4 3200Mhz Desktop RAM. Category: Lexar. Subcategory: RAM (Desktop). Price: 5,300৳5,500৳.

Product: Lexar ARES 32GB (16x2) 6000Mhz DDR5 RGB Gaming Desktop RAM. ",183,156060,156243
1120,sentence,"Category: Lexar. Subcategory: RAM (Desktop). Price: 16,500৳.

Product: Lexar 4GB DDR4 2666 Mhz UDIMM Desktop RAM. Category: Lexar. Subcategory: RAM (Desktop). Price: Out Of Stock.
",180,156243,156423
1121,sentence,"Price: Out Of Stock.

Product: Lexar 8GB DDR4 3200 Mhz UDIMM Desktop RAM. Category: Lexar. Subcategory: RAM (Desktop). Price: Out Of Stock.

Product: Lexar THOR 8GB DDR4 3200Mhz UDIMM Desktop RAM. ",197,156402,156599
1122,sentence,"Category: Lexar. Subcategory: RAM (Desktop). Price: Out Of Stock.

Product: Lexar THOR 8GB DDR4 3200Mhz Desktop RAM. Category: Lexar. Subcategory: RAM (Desktop). Price: Out Of Stock.
",183,156599,156782
1123,sentence,"Price: Out Of Stock.

Product: Lexar 8GB DDR4 2666 Mhz UDIMM Desktop RAM. Category: Lexar. Subcategory: RAM (Desktop). Price: Out Of Stock.

Product: Lexar THOR 16GB 3200Mhz DDR4 Desktop Ram. ",192,156761,156953
1124,sentence,"Category: Lexar. Subcategory: RAM (Desktop). Price: Out Of Stock.

Product: Lexar THOR 16GB DDR4 3200Mhz Desktop RAM. Category: Lexar. Subcategory: RAM (Desktop). Price: Out Of Stock.
",184,156953,157137
1125,sentence,"Price: Out Of Stock.

Product: Lexar ARES 16GB (8x2) 3600Mhz DDR4 RGB Gaming Desktop RAM. Category: Lexar. Subcategory: RAM (Desktop). Price: Out Of Stock.
",156,157116,157272
1126,sentence,"Price: Out Of Stock.

Product: Lexar ARES 16GB DDR5 4800Mhz Desktop RAM. Category: Lexar. Subcategory: RAM (Desktop). Price: Out Of Stock.
",139,157251,157390
1127,sentence,"Price: Out Of Stock.

Product: Lexar ARES 16GB DDR5 5200Mhz OC Desktop Gaming RAM. Category: Lexar. Subcategory: RAM (Desktop). Price: Out Of Stock.
",149,157369,157518
1128,sentence,"Price: Out Of Stock.

Product: Lexar ARES 32GB (16x2) 5600Mhz DDR5 RGB Gaming Desktop Ram. Category: Lexar. Subcategory: RAM (Desktop). Price: Out Of Stock.
",157,157497,157654
1129,sentence,"Price: Out Of Stock.

Product: Kingston FURY Beast 8GB DDR5 5600Mhz Desktop RAM. Category: Kingston. Subcategory: RAM (Desktop). Price: 3,750৳.
",144,157633,157777
1130,sentence,"Subcategory: RAM (Desktop). Price: 3,750৳.

Product: Kingston FURY Beast RGB 8GB 3200MHz DDR4 Desktop RAM. Category: Kingston. Subcategory: RAM (Desktop). Price: 3,850৳.
",170,157734,157904
1131,sentence,"Subcategory: RAM (Desktop). Price: 3,850৳.

Product: Kingston FURY Beast RGB 8GB DDR5 5600Mhz Desktop RAM. Category: Kingston. Subcategory: RAM (Desktop). Price: 4,150৳.
",170,157861,158031
1132,sentence,"Subcategory: RAM (Desktop). Price: 4,150৳.

Product: Kingston FURY Beast 16GB 3200MHz DDR4 Desktop RAM. Category: Kingston. Subcategory: RAM (Desktop). Price: 5,900৳.
",167,157988,158155
1133,sentence,"Subcategory: RAM (Desktop). Price: 5,900৳.

Product: Kingston FURY Beast RGB 16GB 3200MHz DDR4 Heatsink Desktop RAM. Category: Kingston. Subcategory: RAM (Desktop). Price: 6,000৳6,050৳.
",186,158112,158298
1134,sentence,"Price: 6,000৳6,050৳.

Product: Kingston FURY Beast 16GB 6000Mhz CL30 DDR5 Desktop RAM. Category: Kingston. Subcategory: RAM (Desktop). Price: 7,900৳.
",150,158277,158427
1135,sentence,"Subcategory: RAM (Desktop). Price: 7,900৳.

Product: Kingston FURY Beast RGB 16GB 6000Mhz DDR5 EXPO Desktop RAM. Category: Kingston. Subcategory: RAM (Desktop). Price: 8,550৳.
",176,158384,158560
1136,sentence,"Subcategory: RAM (Desktop). Price: 8,550৳.

Product: Kingston FURY Renegade 16GB DDR5 6800MHz Desktop RAM. Category: Kingston. Subcategory: RAM (Desktop). Price: 9,700৳.
",170,158517,158687
1137,sentence,"Subcategory: RAM (Desktop). Price: 9,700৳.

Product: Kingston FURY Renegade RGB 48GB DDR5 6000MHz CL32 Desktop RAM. Category: Kingston. Subcategory: RAM (Desktop). Price: 23,999৳25,000৳.
",187,158644,158831
1138,sentence,"Price: 23,999৳25,000৳.

Product: Kingston FURY Renegade RGB 48GB DDR5 6400MHz CL32 Desktop RAM. Category: Kingston. Subcategory: RAM (Desktop). Price: 24,999৳26,500৳.
",167,158808,158975
1139,sentence,"Price: 24,999৳26,500৳.

Product: Kingston FURY Beast 8GB 3200MHz DDR4 Special Edition RGB Desktop RAM. Category: Kingston. Subcategory: RAM (Desktop). Price: Out Of Stock.
",172,158952,159124
1140,sentence,"Price: Out Of Stock.

Product: Kingston FURY Beast 8GB DDR5 5600Mhz CL36 Desktop RAM. Category: Kingston. Subcategory: RAM (Desktop). Price: 3,600৳3,750৳.
",155,159103,159258
1141,sentence,"Price: 3,600৳3,750৳.

Product: Kingston FURY Beast RGB 16GB 3200MHz DDR4 Desktop RAM. Category: Kingston. Subcategory: RAM (Desktop). Price: Out Of Stock.
",155,159237,159392
1142,sentence,"Price: Out Of Stock.

Product: Kingston FURY Beast 16GB 3200MHz DDR4 CL16 Desktop RAM. Category: Kingston. Subcategory: RAM (Desktop). Price: Out Of Stock.
",156,159371,159527
1143,sentence,"Price: Out Of Stock.

Product: Kingston FURY Beast 16GB 5200MHz DDR5 Desktop RAM. Category: Kingston. Subcategory: RAM (Desktop). Price: Out Of Stock.
",151,159506,159657
1144,sentence,"Price: Out Of Stock.

Product: Kingston FURY Beast 16GB 5600Mhz DDR5 Desktop RAM. Category: Kingston. Subcategory: RAM (Desktop). Price: Out Of Stock.
",151,159636,159787
1145,sentence,"Price: Out Of Stock.

Product: Kingston FURY Beast 16GB 3600MHz DDR4 Desktop RAM. Category: Kingston. Subcategory: RAM (Desktop). Price: Out Of Stock.
",151,159766,159917
1146,sentence,"Price: Out Of Stock.

Product: Kingston FURY Beast 16GB 6000Mhz DDR5 Desktop RAM. Category: Kingston. Subcategory: RAM (Desktop). Price: Out Of Stock.
",151,159896,160047
1147,sentence,"Price: Out Of Stock.

Product: Kingston FURY Beast 16GB 5600MHz DDR5 RGB Desktop RAM. Category: Kingston. Subcategory: RAM (Desktop). Price: 7,390৳7,399৳.
",155,160026,160181
1148,sentence,"Price: 7,390৳7,399৳.

Product: G.Skill Trident Z RGB 8GB DDR4 3200MHz Gaming Desktop RAM. Category: G.Skill. Subcategory: RAM (Desktop). Price: 4,000৳.
",152,160160,160312
1149,sentence,"Subcategory: RAM (Desktop). Price: 4,000৳.

Product: G.Skill Ripjaws V 16GB DDR4 2666MHz C19 RAM. Category: G.Skill. Subcategory: RAM (Desktop). Price: 5,600৳.
",160,160269,160429
1150,sentence,"Subcategory: RAM (Desktop). Price: 5,600৳.

Product: G.SKILL Flare X 8GB DDR4 3200Mhz Desktop RAM. Category: G.Skill. Subcategory: RAM (Desktop). Price: 5,200৳.
",161,160386,160547
1151,sentence,"Subcategory: RAM (Desktop). Price: 5,200৳.

Product: G.SKILL Aegis 16GB DDR4 3200Mhz Desktop RAM. Category: G.Skill. Subcategory: RAM (Desktop). Price: 5,100৳5,300৳.
",166,160504,160670
1152,sentence,"Price: 5,100৳5,300৳.

Product: G-Skill Flare X5 16GB DDR5 5600MHz Desktop RAM. Category: G.Skill. Subcategory: RAM (Desktop). Price: 5,900৳6,100৳.
",147,160649,160796
1153,sentence,"Price: 5,900৳6,100৳.

Product: G-Skill Ripjaws S5 16GB DDR5 6000Mhz CL32 Desktop RAM. Category: G.Skill. Subcategory: RAM (Desktop). Price: 7,200৳.
",148,160775,160923
1154,sentence,"Subcategory: RAM (Desktop). Price: 7,200৳.

Product: G.SKILL Trident Z5 RGB 16GB DDR5 5600MHz CL30 1.25V Desktop RAM. Category: G.Skill. Subcategory: RAM (Desktop). Price: 7,300৳7,600৳.
",186,160880,161066
1155,sentence,"Price: 7,300৳7,600৳.

Product: G.Skill Trident Z5 Neo RGB 16GB DDR5 5600Mhz Desktop RAM. Category: G.Skill. Subcategory: RAM (Desktop). Price: 7,300৳7,700৳.
",157,161045,161202
1156,sentence,"Price: 7,300৳7,700৳.

Product: G.Skill Trident Z5 RGB 16GB DDR5 6000MHz CL32 Desktop RAM Silver. Category: G.Skill. Subcategory: RAM (Desktop). Price: 8,200৳.
",159,161181,161340
1157,sentence,"Subcategory: RAM (Desktop). Price: 8,200৳.

Product: G.Skill Trident Z5 RGB 16GB DDR5 6600MHz Desktop RAM. Category: G.Skill. Subcategory: RAM (Desktop). Price: 8,000৳8,100৳.
",175,161297,161472
1158,sentence,"Price: 8,000৳8,100৳.

Product: G.Skill Trident Z5 RGB 32GB DDR5 5600MHz Desktop RAM. Category: G.Skill. Subcategory: RAM (Desktop). Price: 11,000৳12,000৳.
",155,161451,161606
1159,sentence,"Price: 11,000৳12,000৳.

Product: G.Skill Trident Z5 Neo RGB 32GB DDR5 6000Mhz Desktop RAM. Category: G.Skill. Subcategory: RAM (Desktop). Price: 14,200৳.
",154,161583,161737
1160,sentence,"Subcategory: RAM (Desktop). Price: 14,200৳.

Product: G.Skill Trident Z5 RGB 32GB DDR5 6000MHz Desktop RAM. Category: G.Skill. Subcategory: RAM (Desktop). Price: 14,000৳14,300৳.
",178,161693,161871
1161,sentence,"Price: 14,000৳14,300৳.

Product: G.Skill Trident Z5 16GB DDR5 5600MHz CL36 Desktop RAM Black. Category: G.Skill. Subcategory: RAM (Desktop). Price: Up Coming.
",159,161848,162007
1162,sentence,"Subcategory: RAM (Desktop). Price: Up Coming.

Product: G.Skill Trident Z5 16GB 5600MHz DDR5 CL40 Desktop RAM Silver. Category: G.Skill. Subcategory: RAM (Desktop). Price: Up Coming.
",183,161961,162144
1163,sentence,"Subcategory: RAM (Desktop). Price: Up Coming.

Product: G.Skill Trident Z5 16GB 5600MHz DDR5 CL40 Desktop RAM Black. Category: G.Skill. Subcategory: RAM (Desktop). Price: Up Coming.
",182,162098,162280
1164,sentence,"Subcategory: RAM (Desktop). Price: Up Coming.

Product: G.Skill Trident Z5 RGB 16GB DDR5 5600MHz CL40 Desktop RAM Silver. Category: G.Skill. Subcategory: RAM (Desktop). Price: Up Coming.
",187,162234,162421
1165,sentence,"Subcategory: RAM (Desktop). Price: Up Coming.

Product: G.Skill Trident Z5 RGB 16GB DDR5 5600MHz CL36 Desktop RAM Silver. Category: G.Skill. Subcategory: RAM (Desktop). Price: Up Coming.
",187,162375,162562
1166,sentence,"Subcategory: RAM (Desktop). Price: Up Coming.

Product: HP V6 8GB 3200MHz DDR4 Desktop RAM. Category: HP. Subcategory: RAM (Desktop). Price: Out Of Stock.
",155,162516,162671
1167,sentence,"Price: Out Of Stock.

Product: Adata XPG GAMMIX D10 8GB DDR4 2666 MHz Desktop RAM. Category: Adata. Subcategory: RAM (Desktop). Price: Up Coming.
",146,162650,162796
1168,sentence,"Subcategory: RAM (Desktop). Price: Up Coming.

Product: Adata 32GB DDR5 4800MHz U-DIMM Desktop RAM. Category: Adata. Subcategory: RAM (Desktop). Price: Up Coming.
",163,162750,162913
1169,sentence,"Subcategory: RAM (Desktop). Price: Up Coming.

Product: Adata 8GB DDR5 4800MHz U-DIMM Desktop RAM. Category: Adata. Subcategory: RAM (Desktop). Price: Up Coming.
",162,162867,163029
1170,sentence,"Subcategory: RAM (Desktop). Price: Up Coming.

Product: Adata XPG 8GB D35 DDR4 3200MHz Desktop RAM. Category: Adata. Subcategory: RAM (Desktop). Price: Out Of Stock.
",166,162983,163149
1171,sentence,"Price: Out Of Stock.

Product: Adata Premier 8GB DDR4 3200Mhz Desktop RAM. Category: Adata. Subcategory: RAM (Desktop). Price: Out Of Stock.
",141,163128,163269
1172,sentence,"Price: Out Of Stock.

Product: Adata XPG SPECTRIX D35G RGB 8GB DDR4 3200MHz Gaming Desktop RAM. Category: Adata. Subcategory: RAM (Desktop). Price: Out Of Stock.
",162,163248,163410
1173,sentence,"Price: Out Of Stock.

Product: Netac Shadow Yellow 8GB DDR4 2666MHZ Desktop RAM. Category: Netac. Subcategory: RAM (Desktop). Price: Up Coming.

Product: Netac Basic 16GB DDR4 2666MHz Desktop RAM. ",197,163389,163586
1174,sentence,"Category: Netac. Subcategory: RAM (Desktop). Price: Up Coming.

Product: Netac Basic 8GB DDR4 3200MHz Desktop RAM. Category: Netac. Subcategory: RAM (Desktop). Price: Up Coming.
",178,163586,163764
1175,sentence,"Subcategory: RAM (Desktop). Price: Up Coming.

Product: Netac Basic 16GB DDR4 3200MHz Desktop RAM. Category: Netac. Subcategory: RAM (Desktop). Price: Up Coming.
",162,163718,163880
1176,sentence,"Subcategory: RAM (Desktop). Price: Up Coming.

Product: Netac Shadow Yellow 16GB DDR4 3200MHz Desktop RAM. Category: Netac. Subcategory: RAM (Desktop). Price: Up Coming.
",170,163834,164004
1177,sentence,"Subcategory: RAM (Desktop). Price: Up Coming.

Product: Netac Z RGB 16GB DDR5 6200MHz Desktop RAM. Category: Netac. Subcategory: RAM (Desktop). Price: Up Coming.
",162,163958,164120
1178,sentence,"Subcategory: RAM (Desktop). Price: Up Coming.

Product: Netac Shadow RGB 16GB DDR5 5600MHz Desktop RAM. Category: Netac. Subcategory: RAM (Desktop). Price: Up Coming.
",167,164074,164241
1179,sentence,"Subcategory: RAM (Desktop). Price: Up Coming.

Product: Netac Shadow 16GB DDR4 3600MHz Desktop RAM. Category: Netac. Subcategory: RAM (Desktop). Price: Up Coming.
",163,164195,164358
1180,sentence,"Subcategory: RAM (Desktop). Price: Up Coming.

Product: Netac Basic DDR3 8GB 1600MHZ Desktop RAM. Category: Netac. Subcategory: RAM (Desktop). Price: Up Coming.
",161,164312,164473
1181,sentence,"Subcategory: RAM (Desktop). Price: Up Coming.

Product: OCPC X3 RGB DDR4 3200MHz 8GB Desktop RAM. Category: OCPC. Subcategory: RAM (Desktop). Price: 3,800৳.
",157,164427,164584
1182,sentence,"Subcategory: RAM (Desktop). Price: 3,800৳.

Product: OCPC X3 RGB DDR4 3200MHz 8GB Desktop RAM White. Category: OCPC. Subcategory: RAM (Desktop). Price: 3,800৳.
",160,164541,164701
1183,sentence,"Subcategory: RAM (Desktop). Price: 3,800৳.

Product: OCPC X3 RGB DDR4 3200MHz 16GB Desktop RAM. Category: OCPC. Subcategory: RAM (Desktop). Price: 5,300৳5,500৳.
",161,164658,164819
1184,sentence,"Price: 5,300৳5,500৳.

Product: OCPC X3 RGB DDR4 3200MHz 16GB Desktop RAM White. Category: OCPC. Subcategory: RAM (Desktop). Price: 5,200৳5,500৳.

Product: OCPC XT II DDR4 3200MHz 16GB Desktop RAM. ",197,164798,164995
1185,sentence,"Category: OCPC. Subcategory: RAM (Desktop). Price: 5,100৳5,500৳.

Product: OCPC PISTA 16GB DDR5 6000MHz CL38 RGB Desktop RAM. Category: OCPC. Subcategory: RAM (Desktop). Price: 6,900৳7,200৳.
",191,164995,165186
1186,sentence,"Price: 6,900৳7,200৳.

Product: OCPC PISTA 16GB 5600MHz DDR5 RGB Desktop RAM. Category: OCPC. Subcategory: RAM (Desktop). Price: Out Of Stock.

Product: OCPC PISTA 16GB 6000MHz DDR5 RGB Desktop RAM. ",198,165165,165363
1187,sentence,"Category: OCPC. Subcategory: RAM (Desktop). Price: Out Of Stock.

Product: OCPC PISTA DDR5 6200MHz 32GB (16GBx2) RGB RAM Kit. Category: OCPC. Subcategory: RAM (Desktop). Price: Out Of Stock.
",191,165363,165554
1188,sentence,"Price: Out Of Stock.

Product: Kimtigo WOLFRINE 8GB 3200MHz DDR4 UDIMM Desktop RAM. Category: Kimtigo. Subcategory: RAM (Desktop). Price: Out Of Stock.

Product: Adata 4GB DDR4 2400MHz Laptop Ram. ",197,165533,165730
1189,sentence,"
Product: Adata 4GB DDR4 2400MHz Laptop Ram. Category: Adata. Subcategory: RAM (Laptop). Price: Up Coming.

Product: TEAM ELITE 8GB 3200MHz Laptop RAM. Category: TEAM. Subcategory: RAM (Laptop). ",195,165685,165880
1190,sentence,"Category: TEAM. Subcategory: RAM (Laptop). Price: 3,450৳.

Product: TEAM ELITE 16GB 5600MHz DDR5 Laptop RAM. Category: TEAM. Subcategory: RAM (Laptop). Price: 5,600৳.
",167,165837,166004
1191,sentence,"Subcategory: RAM (Laptop). Price: 5,600৳.

Product: TEAM T-CREATE CLASSIC 16GB 5600MHz DDR5 Laptop RAM. Category: TEAM. Subcategory: RAM (Laptop). Price: 5,900৳.
",162,165962,166124
1192,sentence,"Subcategory: RAM (Laptop). Price: 5,900৳.

Product: TEAM ELITE 16GB 3200MHz Laptop RAM. Category: TEAM. Subcategory: RAM (Laptop). Price: 7,000৳.

Product: TEAM ELITE 16GB 4800MHz DDR5 Laptop RAM. ",197,166082,166279
1193,sentence,"Category: TEAM. Subcategory: RAM (Laptop). Price: Up Coming.

Product: TEAM ELITE 4GB 2666MHz Laptop RAM. Category: TEAM. Subcategory: RAM (Laptop). Price: Out Of Stock.
",170,166279,166449
1194,sentence,"Subcategory: RAM (Laptop). Price: Out Of Stock.

Product: TEAM ELITE SO-DIMM DDR4 4GB 2400MHz Laptop RAM. Category: TEAM. Subcategory: RAM (Laptop). Price: Out Of Stock.
",170,166401,166571
1195,sentence,"Subcategory: RAM (Laptop). Price: Out Of Stock.

Product: TEAM ELITE 8GB 2666MHz Laptop RAM. Category: TEAM. Subcategory: RAM (Laptop). Price: Out Of Stock.
",157,166523,166680
1196,sentence,"Subcategory: RAM (Laptop). Price: Out Of Stock.

Product: TEAM ELITE SO-DIMM DDR4 8GB 2400MHz Laptop RAM. Category: TEAM. Subcategory: RAM (Laptop). Price: Out Of Stock.
",170,166632,166802
1197,sentence,"Subcategory: RAM (Laptop). Price: Out Of Stock.

Product: TEAM ELITE 8GB 4800MHz DDR5 Laptop RAM. Category: TEAM. Subcategory: RAM (Laptop). Price: Out Of Stock.
",162,166754,166916
1198,sentence,"Subcategory: RAM (Laptop). Price: Out Of Stock.

Product: TEAM ELITE 8GB 5600MHz DDR5 Laptop RAM. Category: TEAM. Subcategory: RAM (Laptop). Price: Out Of Stock.
",162,166868,167030
1199,sentence,"Subcategory: RAM (Laptop). Price: Out Of Stock.

Product: TEAM ELITE 16GB 2666MHz Laptop RAM. Category: TEAM. Subcategory: RAM (Laptop). Price: Out Of Stock.
",158,166982,167140
1200,sentence,"Subcategory: RAM (Laptop). Price: Out Of Stock.

Product: TEAM ELITE SO-DIMM DDR4 16GB 2400MHz Laptop RAM. Category: TEAM. Subcategory: RAM (Laptop). Price: Out Of Stock.
",171,167092,167263
1201,sentence,"Subcategory: RAM (Laptop). Price: Out Of Stock.

Product: TEAM ELITE 32GB 3200MHz DDR4 LAPTOP RAM. Category: TEAM. Subcategory: RAM (Laptop). Price: Out Of Stock.
",163,167215,167378
1202,sentence,"Subcategory: RAM (Laptop). Price: Out Of Stock.

Product: TEAM T-CREATE CLASSIC 32GB 5600MHz DDR5 Laptop RAM. Category: TEAM. Subcategory: RAM (Laptop). Price: Out Of Stock.
",174,167330,167504
1203,sentence,"Subcategory: RAM (Laptop). Price: Out Of Stock.

Product: Crucial 8GB DDR4 2400MHz Laptop RAM. Category: Crucial. Subcategory: RAM (Laptop). Price: Out Of Stock.
",162,167456,167618
1204,sentence,"Subcategory: RAM (Laptop). Price: Out Of Stock.

Product: Crucial 4GB Single DDR4 2400MHz Laptop RAM. Category: Crucial. Subcategory: RAM (Laptop). Price: Out Of Stock.
",169,167570,167739
1205,sentence,"Subcategory: RAM (Laptop). Price: Out Of Stock.

Product: Crucial 4GB Single DDR4 2666MHz Laptop RAM. Category: Crucial. Subcategory: RAM (Laptop). Price: Out Of Stock.
",169,167691,167860
1206,sentence,"Subcategory: RAM (Laptop). Price: Out Of Stock.

Product: Crucial 8GB Single DDR4 3200MHz Laptop RAM. Category: Crucial. Subcategory: RAM (Laptop). Price: Out Of Stock.
",169,167812,167981
1207,sentence,"Subcategory: RAM (Laptop). Price: Out Of Stock.

Product: Crucial 8GB Single DDR4 2666MHz Laptop RAM. Category: Crucial. Subcategory: RAM (Laptop). Price: Out Of Stock.
",169,167933,168102
1208,sentence,"Subcategory: RAM (Laptop). Price: Out Of Stock.

Product: Crucial 16GB Single DDR4 3200MHz SODIMM Laptop RAM. Category: Crucial. Subcategory: RAM (Laptop). Price: Out Of Stock.
",177,168054,168231
1209,sentence,"Subcategory: RAM (Laptop). Price: Out Of Stock.

Product: Crucial 16GB Single DDR4 2666MHz Laptop RAM. Category: Crucial. Subcategory: RAM (Laptop). Price: Out Of Stock.
",170,168183,168353
1210,sentence,"Subcategory: RAM (Laptop). Price: Out Of Stock.

Product: Colorful Notebook 16GB DDR4 3200MHz SO-DIMM Laptop RAM. Category: Colorful. Subcategory: RAM (Laptop). Price: 5,800৳.
",176,168305,168481
1211,sentence,"Subcategory: RAM (Laptop). Price: 5,800৳.

Product: Colorful Notebook 16GB DDR5 4800MHz Laptop RAM. Category: Colorful. Subcategory: RAM (Laptop). Price: 5,800৳.
",162,168439,168601
1212,sentence,"Subcategory: RAM (Laptop). Price: 5,800৳.

Product: Colorful Notebook 8GB DDR4 2666MHz SO-DIMM Laptop RAM. Category: Colorful. Subcategory: RAM (Laptop). Price: Out Of Stock.
",175,168559,168734
1213,sentence,"Subcategory: RAM (Laptop). Price: Out Of Stock.

Product: Colorful Notebook 8GB DDR4 3200MHz SO-DIMM Laptop RAM. Category: Colorful. Subcategory: RAM (Laptop). Price: Out Of Stock.
",181,168686,168867
1214,sentence,"Subcategory: RAM (Laptop). Price: Out Of Stock.

Product: Kingston 16GB 2400MHz Laptop ram. Category: Kingston. Subcategory: RAM (Laptop). Price: Out Of Stock.
",160,168819,168979
1215,sentence,"Subcategory: RAM (Laptop). Price: Out Of Stock.

Product: Kingston Value RAM 4GB DDR4 2666MHz Laptop RAM. Category: Kingston. Subcategory: RAM (Laptop). Price: Out Of Stock.
",174,168931,169105
1216,sentence,"Subcategory: RAM (Laptop). Price: Out Of Stock.

Product: Kingston Value RAM 4GB DDR4 3200MHz Laptop RAM. Category: Kingston. Subcategory: RAM (Laptop). Price: Out Of Stock.
",174,169057,169231
1217,sentence,"Subcategory: RAM (Laptop). Price: Out Of Stock.

Product: Kingston Value RAM 8GB DDR4 2666MHz Laptop RAM. Category: Kingston. Subcategory: RAM (Laptop). Price: Out Of Stock.
",174,169183,169357
1218,sentence,"Subcategory: RAM (Laptop). Price: Out Of Stock.

Product: Kingston Value RAM 8GB DDR4 3200MHz Laptop RAM. Category: Kingston. Subcategory: RAM (Laptop). Price: Out Of Stock.
",174,169309,169483
1219,sentence,"Subcategory: RAM (Laptop). Price: Out Of Stock.

Product: Kingston Value RAM 16GB DDR4 3200MHz Laptop RAM. Category: Kingston. Subcategory: RAM (Laptop). Price: Out Of Stock.
",175,169435,169610
1220,sentence,"Subcategory: RAM (Laptop). Price: Out Of Stock.

Product: Kingston FURY Impact 16GB DDDR5 4800Mhz Laptop RAM. Category: Kingston. Subcategory: RAM (Laptop). Price: Out Of Stock.
",178,169562,169740
1221,sentence,"Subcategory: RAM (Laptop). Price: Out Of Stock.

Product: Transcend JetRAM 8GB DDR5 5600Mhz SO-DIMM Laptop RAM. Category: Transcend. Subcategory: RAM (Laptop). Price: 3,800৳4,000৳.
",181,169692,169873
1222,sentence,"Subcategory: RAM (Laptop). Price: 3,800৳4,000৳.

Product: Transcend JetRAM 16GB DDR5 4800Mhz SO-DIMM Laptop RAM. Category: Transcend. Subcategory: RAM (Laptop). Price: 6,200৳.
",176,169825,170001
1223,sentence,"Subcategory: RAM (Laptop). Price: 6,200৳.

Product: Transcend JetRAM 16GB DDR5 5600Mhz SO-DIMM Laptop RAM. Category: Transcend. Subcategory: RAM (Laptop). Price: 6,500৳6,700৳.
",176,169959,170135
1224,sentence,"Subcategory: RAM (Laptop). Price: 6,500৳6,700৳.

Product: Transcend 16GB DDR4 2666MHz SO-DIMM Laptop RAM. Category: Transcend. Subcategory: RAM (Laptop). Price: Out Of Stock.
",175,170087,170262
1225,sentence,"Subcategory: RAM (Laptop). Price: Out Of Stock.

Product: Transcend 4GB JM DDR4 3200Mhz SO-DIMM Laptop RAM. Category: Transcend. Subcategory: RAM (Laptop). Price: Out Of Stock.
",177,170214,170391
1226,sentence,"Subcategory: RAM (Laptop). Price: Out Of Stock.

Product: Transcend 4GB DDR4 2666MHz Bus SO-DIMM Laptop RAM. Category: Transcend. Subcategory: RAM (Laptop). Price: Out Of Stock.
",178,170343,170521
1227,sentence,"Subcategory: RAM (Laptop). Price: Out Of Stock.

Product: Transcend 8GB DDR4 2666MHz Bus SO-DIMM Laptop RAM. Category: Transcend. Subcategory: RAM (Laptop). Price: Out Of Stock.
",178,170473,170651
1228,sentence,"Subcategory: RAM (Laptop). Price: Out Of Stock.

Product: Transcend JetRAM 8GB DDR4 3200Mhz SO-DIMM Laptop RAM. Category: Transcend. Subcategory: RAM (Laptop). Price: Out Of Stock.
",181,170603,170784
1229,sentence,"Subcategory: RAM (Laptop). Price: Out Of Stock.

Product: Transcend JetRAM 8GB DDR5 4800Mhz SO-DIMM Laptop RAM. Category: Transcend. Subcategory: RAM (Laptop). Price: Out Of Stock.
",181,170736,170917
1230,sentence,"Subcategory: RAM (Laptop). Price: Out Of Stock.

Product: Transcend JetRAM 16GB DDR4 3200Mhz SO-DIMM Laptop RAM. Category: Transcend. Subcategory: RAM (Laptop). Price: Out Of Stock.
",182,170869,171051
1231,sentence,"Subcategory: RAM (Laptop). Price: Out Of Stock.

Product: Transcend JetRAM 32GB DDR4 3200Mhz SO-DIMM Laptop RAM. Category: Transcend. Subcategory: RAM (Laptop). Price: Out Of Stock.
",182,171003,171185
1232,sentence,"Subcategory: RAM (Laptop). Price: Out Of Stock.

Product: Transcend JetRAM 32GB DDR5 4800Mhz SO-DIMM Laptop RAM. Category: Transcend. Subcategory: RAM (Laptop). Price: Out Of Stock.
",182,171137,171319
1233,sentence,"Subcategory: RAM (Laptop). Price: Out Of Stock.

Product: Samsung 4GB 1600MHz DDR3 PC3L Laptop RAM. Category: RAM (Laptop). Subcategory: Component. Price: 1,500৳.
",163,171271,171434
1234,sentence,"Subcategory: Component. Price: 1,500৳.

Product: G.Skill Ripjaws 4GB DDR3 1600MHz SO-DIMM Laptop RAM. Category: RAM (Laptop). Subcategory: Component. Price: 1,400৳1,500৳.
",171,171395,171566
1235,sentence,"Subcategory: Component. Price: 1,400৳1,500৳.

Product: G.Skill Ripjaws 4GB DDR4-L 2400MHz SO-DIMM Laptop RAM. Category: RAM (Laptop). Subcategory: Component. Price: 1,900৳.
",173,171521,171694
1236,sentence,"Subcategory: Component. Price: 1,900৳.

Product: Lexar 4GB DDR4 3200MHz SODIMM Laptop RAM. Category: RAM (Laptop). Subcategory: Component. Price: 1,500৳2,000৳.
",160,171655,171815
1237,sentence,"Subcategory: Component. Price: 1,500৳2,000৳.

Product: G.Skill RipJaws 4GB 2666MHz Laptop RAM. Category: RAM (Laptop). Subcategory: Component. Price: 1,900৳2,200৳.
",164,171770,171934
1238,sentence,"Subcategory: Component. Price: 1,900৳2,200৳.

Product: Netac Basic SO DDR4 2666MHz 8GB Laptop RAM. Category: RAM (Laptop). Subcategory: Component. Price: 2,500৳.
",162,171889,172051
1239,sentence,"Subcategory: Component. Price: 2,500৳.

Product: Lexar 8GB DDR4 3200MHz SODIMM Laptop RAM. Category: RAM (Laptop). Subcategory: Component. Price: 3,000৳.
",154,172012,172166
1240,sentence,"Subcategory: Component. Price: 3,000৳.

Product: G.Skill Ripjaws 8GB DDR4 3200MHz C22 Laptop RAM. Category: RAM (Laptop). Subcategory: Component. Price: 3,100৳.
",161,172127,172288
1241,sentence,"Subcategory: Component. Price: 3,100৳.

Product: G.Skill RipJaws 8GB 2666MHz Laptop RAM. Category: RAM (Laptop). Subcategory: Component. Price: 3,200৳.
",152,172249,172401
1242,sentence,"Subcategory: Component. Price: 3,200৳.

Product: G.Skill Ripjaws 8GB DDR4-L 2400MHz SO-DIMM Laptop RAM. Category: RAM (Laptop). Subcategory: Component. Price: 3,100৳3,200৳.
",173,172362,172535
1243,sentence,"Subcategory: Component. Price: 3,100৳3,200৳.

Product: CORSAIR VENGEANCE 8GB DDR4 3200MHz SODIMM Laptop RAM. Category: RAM (Laptop). Subcategory: Component. Price: 3,300৳.
",172,172490,172662
1244,sentence,"Subcategory: Component. Price: 3,300৳.

Product: G.Skill Ripjaws 8GB DDR4 3200MHz SO-DIMM Laptop RAM. Category: RAM (Laptop). Subcategory: Component. Price: 3,600৳.
",165,172623,172788
1245,sentence,"Subcategory: Component. Price: 3,600৳.

Product: G.Skill Ripjaws 16GB DDR4 3200MHz C22 Laptop RAM. Category: RAM (Laptop). Subcategory: Component. Price: 5,300৳.
",162,172749,172911
1246,sentence,"Subcategory: Component. Price: 5,300৳.

Product: G.Skill Ripjaws 16GB DDR4 2666MHz SO-DIMM Laptop RAM. Category: RAM (Laptop). Subcategory: Component. Price: 5,500৳.
",166,172872,173038
1247,sentence,"Subcategory: Component. Price: 5,500৳.

Product: OCPC SODIMM VS 16GB DDR5 5600MHz Laptop RAM. Category: OCPC. Subcategory: RAM (Laptop). Price: 6,200৳.
",152,172999,173151
1248,sentence,"Subcategory: RAM (Laptop). Price: 6,200৳.

Product: OCPC SODIMM VS DDR4 3200MHz 8GB Laptop RAM. Category: OCPC. Subcategory: RAM (Laptop). Price: Out Of Stock.
",160,173109,173269
1249,sentence,"Subcategory: RAM (Laptop). Price: Out Of Stock.

Product: OCPC SODIMM VS 16GB DDR5 4800MHz Laptop RAM. Category: OCPC. Subcategory: RAM (Laptop). Price: Out Of Stock.
",167,173221,173388
1250,sentence,"Subcategory: RAM (Laptop). Price: Out Of Stock.

Product: Lexar 4GB DDR4 2666Mhz SODIMM Laptop RAM. Category: Lexar. Subcategory: RAM (Laptop). Price: Out Of Stock.
",165,173340,173505
1251,sentence,"Subcategory: RAM (Laptop). Price: Out Of Stock.

Product: Lexar 8GB DDR4 2666Mhz SODIMM Laptop RAM. Category: Lexar. Subcategory: RAM (Laptop). Price: Out Of Stock.
",165,173457,173622
1252,sentence,"Subcategory: RAM (Laptop). Price: Out Of Stock.

Product: Lexar 32GB DDR4 3200MHz SODIMM Laptop RAM. Category: Lexar. Subcategory: RAM (Laptop). Price: Out Of Stock.
",166,173574,173740
1253,sentence,"Subcategory: RAM (Laptop). Price: Out Of Stock.

Product: Lexar 16GB DDR4 3200MHz SODIMM Laptop RAM. Category: Lexar. Subcategory: RAM (Laptop). Price: Out Of Stock.
",166,173692,173858
1254,sentence,"Subcategory: RAM (Laptop). Price: Out Of Stock.

Product: Corsair VENGEANCE 16GB DDR5 5200MHz SODIMM Laptop RAM. Category: Corsair. Subcategory: RAM (Laptop). Price: 6,500৳.
",174,173810,173984
1255,sentence,"Subcategory: RAM (Laptop). Price: 6,500৳.

Product: CORSAIR VENGEANCE 16GB DDR4 3200MHz SODIMM Laptop RAM. Category: Corsair. Subcategory: RAM (Laptop). Price: Out Of Stock.
",174,173942,174116
1256,sentence,"Subcategory: RAM (Laptop). Price: Out Of Stock.

Product: CORSAIR VENGEANCE 16GB DDR5 4800MHz SODIMM Laptop RAM. Category: Corsair. Subcategory: RAM (Laptop). Price: Out Of Stock.
",180,174068,174248
1257,sentence,"Subcategory: RAM (Laptop). Price: Out Of Stock.

Product: CORSAIR VENGEANCE 16GB DDR5 5600MHz SODIMM Laptop RAM. Category: Corsair. Subcategory: RAM (Laptop). Price: Out Of Stock.
",180,174200,174380
1258,sentence,"Subcategory: RAM (Laptop). Price: Out Of Stock.

Product: G.Skill Ripjaws 16GB DDR4 3200MHz SO-DIMM Laptop RAM. Category: G.Skill. Subcategory: RAM (Laptop). Price: 8,000৳.
",173,174332,174505
1259,sentence,"Subcategory: RAM (Laptop). Price: 8,000৳.

Product: G.Skill Ripjaws 8GB DDR3 1600MHz SO-DIMM Laptop RAM. Category: G.Skill. Subcategory: RAM (Laptop). Price: Out Of Stock.
",172,174463,174635
1260,sentence,"Subcategory: RAM (Laptop). Price: Out Of Stock.

Product: G.Skill Ripjaws 16GB DDR4 2400MHz SO-DIMM Laptop RAM. Category: G.Skill. Subcategory: RAM (Laptop). Price: Out Of Stock.
",179,174587,174766
1261,sentence,"Subcategory: RAM (Laptop). Price: Out Of Stock.

Product: G.Skill Ripjaws 16GB DDR5 4800MHz SO-DIMM Laptop RAM. Category: G.Skill. Subcategory: RAM (Laptop). Price: Out Of Stock.
",179,174718,174897
1262,sentence,"Subcategory: RAM (Laptop). Price: Out Of Stock.

Product: G.Skill Ripjaws 32GB DDR4 3200MHz C22 Laptop RAM. Category: G.Skill. Subcategory: RAM (Laptop). Price: Out Of Stock.
",175,174849,175024
1263,sentence,"Subcategory: RAM (Laptop). Price: Out Of Stock.

Product: BORY 8GB DDR4 3200MHz SODIMM Laptop RAM. Category: Bory. Subcategory: RAM (Laptop). Price: Out Of Stock.
",163,174976,175139
1264,sentence,"Subcategory: RAM (Laptop). Price: Out Of Stock.

Product: BORY 16GB DDR4 3200MHz SODIMM Laptop RAM. Category: Bory. Subcategory: RAM (Laptop). Price: Out Of Stock.
",164,175091,175255
1265,sentence,"Subcategory: RAM (Laptop). Price: Out Of Stock.

Product: Toshiba P300 2TB 3.5-Inch SATA 7200RPM Desktop HDD. Category: Toshiba. Subcategory: Hard Disk Drive. Price: 7,800৳.
",174,175207,175381
1266,sentence,"Subcategory: Hard Disk Drive. Price: 7,800৳.

Product: Toshiba S300 4TB 3.5 Inch Surveillance HDD. Category: Toshiba. Subcategory: Hard Disk Drive. Price: 12,500৳.
",164,175336,175500
1267,sentence,"Subcategory: Hard Disk Drive. Price: 12,500৳.

Product: TOSHIBA X300 Performance 4TB 3.5"" 7200 RPM SATA Hard Disk Drive. Category: Toshiba. Subcategory: Hard Disk Drive. Price: 17,400৳17,500৳.
",193,175454,175647
1268,sentence,"Price: 17,400৳17,500৳.

Product: Toshiba S300 6TB 5400rpm 3.5"" Surveillance Hard Drive. Category: Toshiba. Subcategory: Hard Disk Drive. Price: 19,200৳.
",153,175624,175777
1269,sentence,"Subcategory: Hard Disk Drive. Price: 19,200৳.

Product: TOSHIBA Tomcat Nearline 4TB 3.5 Inch 7200RPM SATA NAS HDD. Category: Toshiba. Subcategory: Hard Disk Drive. Price: 20,500৳20,700৳.
",187,175731,175918
1270,sentence,"Price: 20,500৳20,700৳.

Product: Toshiba S300 Pro 10TB 7200rpm 3.5"" Surveillance Hard Drive. Category: Toshiba. Subcategory: Hard Disk Drive. Price: 36,000৳36,500৳.
",165,175895,176060
1271,sentence,"Price: 36,000৳36,500৳.

Product: Toshiba MG07ACA Enterprise 12TB 3.5 Inch SATA 7200RPM HDD. Category: Toshiba. Subcategory: Hard Disk Drive. Price: 38,900৳.
",157,176037,176194
1272,sentence,"Subcategory: Hard Disk Drive. Price: 38,900৳.

Product: Toshiba 1TB Sata Laptop Hard Disk. Category: Toshiba. Subcategory: Hard Disk Drive. Price: Out Of Stock.
",161,176148,176309
1273,sentence,"Price: Out Of Stock.

Product: Toshiba S300 1TB 5700rpm 3.5"" Surveillance Hard Drive. Category: Toshiba. Subcategory: Hard Disk Drive. Price: Out Of Stock.
",156,176288,176444
1274,sentence,"Price: Out Of Stock.

Product: Toshiba DT01ABA100V 1TB Surveillance Hard Drive. Category: Toshiba. Subcategory: Hard Disk Drive. Price: Out Of Stock.

Product: Toshiba 3TB SATA Desktop Hard Disk. ",196,176423,176619
1275,sentence,"
Product: Toshiba 3TB SATA Desktop Hard Disk. Category: Toshiba. Subcategory: Hard Disk Drive. Price: Out Of Stock.

Product: Toshiba P300 2TB 3.5-Inch SATA 5400RPM Desktop HDD. Category: Toshiba. ",197,176573,176770
1276,sentence,"Category: Toshiba. Subcategory: Hard Disk Drive. Price: Out Of Stock.

Product: Toshiba 2TB Sata Desktop Hard Disk. Category: Toshiba. Subcategory: Hard Disk Drive. Price: Out Of Stock.
",186,176751,176937
1277,sentence,"Price: Out Of Stock.

Product: Toshiba P300 1TB Desktop PC Internal Hard Drive. Category: Toshiba. Subcategory: Hard Disk Drive. Price: Out Of Stock.
",150,176916,177066
1278,sentence,"Price: Out Of Stock.

Product: Toshiba S300 2TB 5400rpm 3.5"" Surveillance Hard Drive. Category: Toshiba. Subcategory: Hard Disk Drive. Price: Out Of Stock.
",156,177045,177201
1279,sentence,"Price: Out Of Stock.

Product: Toshiba P300 4TB 3.5-Inch SATA 5400RPM Desktop HDD. Category: Toshiba. Subcategory: Hard Disk Drive. Price: Out Of Stock.

Product: Toshiba 4TB Sata Desktop Hard Disk. ",199,177180,177379
1280,sentence,"
Product: Toshiba 4TB Sata Desktop Hard Disk. Category: Toshiba. Subcategory: Hard Disk Drive. Price: Out Of Stock.

Product: Toshiba P300 6TB 3.5-Inch SATA 5400RPM Desktop HDD. Category: Toshiba. ",197,177333,177530
1281,sentence,"Category: Toshiba. Subcategory: Hard Disk Drive. Price: Out Of Stock.

Product: Toshiba S300 Pro 6TB 7200rpm 3.5"" Surveillance Hard Drive. Category: Toshiba. Subcategory: Hard Disk Drive. ",188,177511,177699
1282,sentence,"Subcategory: Hard Disk Drive. Price: Out Of Stock.

Product: TOSHIBA MG08-D Series 6TB 3.5"" 7200RPM Enterprise HDD. Category: Toshiba. Subcategory: Hard Disk Drive. Price: Out Of Stock.
",186,177669,177855
1283,sentence,"Price: Out Of Stock.

Product: Seagate SkyHawk 2TB 3.5"" Surveillance Hard Drive. Category: Seagate. Subcategory: Hard Disk Drive. Price: 8,700৳9,200৳.
",151,177834,177985
1284,sentence,"Price: 8,700৳9,200৳.

Product: Seagate Barracuda 2TB 7200RPM SATA 3.5-inch HDD. Category: Seagate. Subcategory: Hard Disk Drive. Price: 8,800৳9,200৳.
",150,177964,178114
1285,sentence,"Price: 8,800৳9,200৳.

Product: Seagate SkyHawk 4TB Surveillance Hard Drive. Category: Seagate. Subcategory: Hard Disk Drive. Price: 12,500৳14,000৳.

Product: Seagate Barracuda 4TB SATA 3.5 inch HDD. ",199,178093,178292
1286,sentence,"Category: Seagate. Subcategory: Hard Disk Drive. Price: 14,400৳14,700৳.

Product: Seagate Barracuda 6TB 3.5 Inch Desktop HDD. Category: Seagate. Subcategory: Hard Disk Drive. Price: 18,000৳.
",191,178292,178483
1287,sentence,"Subcategory: Hard Disk Drive. Price: 18,000৳.

Product: Seagate Skyhawk 6TB 3.5"" Surveillance Internal HDD. Category: Seagate. Subcategory: Hard Disk Drive. Price: 20,000৳.
",173,178437,178610
1288,sentence,"Subcategory: Hard Disk Drive. Price: 20,000৳.

Product: Seagate Skyhawk 6TB 3.5"" Surveillance HDD. Category: Seagate. Subcategory: Hard Disk Drive. Price: 20,500৳.
",164,178564,178728
1289,sentence,"Subcategory: Hard Disk Drive. Price: 20,500৳.

Product: Seagate Barracuda 8TB 3.5 Inch Desktop HDD. Category: Seagate. Subcategory: Hard Disk Drive. Price: 24,500৳.
",165,178682,178847
1290,sentence,"Subcategory: Hard Disk Drive. Price: 24,500৳.

Product: Seagate SkyHawk 8TB 3.5 inch SATA 7200RPM Surveillance HDD. Category: Seagate. Subcategory: Hard Disk Drive. Price: 25,000৳.
",181,178801,178982
1291,sentence,"Subcategory: Hard Disk Drive. Price: 25,000৳.

Product: Seagate Exos 7E10 4TB 3.5 Inch SATA 7200RPM Enterprise HDD #ST4000NM024B. Category: Seagate. Subcategory: Hard Disk Drive. ",179,178936,179115
1292,sentence,"Subcategory: Hard Disk Drive. Price: 24,500৳25,700৳.

Product: Seagate Exos 7E10 4TB 3.5 Inch SAS 7200RPM Enterprise Internal HDD #ST4000NM025B. Category: Seagate. Subcategory: Hard Disk Drive. ",194,179085,179279
1293,sentence,"Subcategory: Hard Disk Drive. Price: 25,500৳26,400৳.

Product: Seagate IronWolf 6TB 3.5 Inch SATA 5400RPM NAS HDD. Category: Seagate. Subcategory: Hard Disk Drive. Price: 26,400৳.
",180,179249,179429
1294,sentence,"Subcategory: Hard Disk Drive. Price: 26,400৳.

Product: Seagate IronWolf 10TB SATA 3.5"" 7200RPM NAS Hard Disk. Category: Seagate. Subcategory: Hard Disk Drive. Price: 38,400৳39,500৳.
",183,179383,179566
1295,sentence,"Price: 38,400৳39,500৳.

Product: Seagate Exos 7E10 10TB 7200RPM 3.5"" SATA Enterprise HDD. Category: Seagate. Subcategory: Hard Disk Drive. Price: 42,000৳43,000৳.
",162,179543,179705
1296,sentence,"Price: 42,000৳43,000৳.

Product: Seagate SkyHawk AI 12TB 3.5"" Surveillance HDD. Category: Seagate. Subcategory: Hard Disk Drive. Price: 45,500৳.
",145,179682,179827
1297,sentence,"Subcategory: Hard Disk Drive. Price: 45,500৳.

Product: Seagate IronWolf Pro 10TB 3.5-inch SATA 7200RPM NAS HDD. Category: Seagate. Subcategory: Hard Disk Drive. Price: 45,000৳46,000৳.
",185,179781,179966
1298,sentence,"Price: 45,000৳46,000৳.

Product: Seagate IronWolf 12TB 3.5 Inch SATA 7200RPM NAS HDD. Category: Seagate. Subcategory: Hard Disk Drive. Price: 47,000৳47,800৳.
",158,179943,180101
1299,sentence,"Price: 47,000৳47,800৳.

Product: Seagate Exos X18 12TB 7200rpm SATA III 3.5"" NAS HDD. Category: Seagate. Subcategory: Hard Disk Drive. Price: 58,000৳59,000৳.
",158,180078,180236
1300,sentence,"Price: 58,000৳59,000৳.

Product: Seagate IronWolf Pro 16TB 3.5 Inch SATA 7200RPM NAS HDD. Category: Seagate. Subcategory: Hard Disk Drive. Price: 62,500৳66,500৳.
",162,180213,180375
1301,sentence,"Price: 62,500৳66,500৳.

Product: Seagate Exos X18 18TB 7200rpm SATA III 3.5"" NAS HDD. Category: Seagate. Subcategory: Hard Disk Drive. Price: 63,500৳72,500৳.
",158,180352,180510
1302,sentence,"Price: 63,500৳72,500৳.

Product: Netac Basic SO DDR3L 1600MHz 4GB Laptop RAM. Category: Netac. Subcategory: RAM (Laptop). Price: Up Coming.

Product: Netac Basic SO DDR3L 1600MHz 8GB Laptop RAM. ",195,180487,180682
1303,sentence,"Category: Netac. Subcategory: RAM (Laptop). Price: Up Coming.

Product: Netac Basic SO DDR4 2666MHz 4GB Laptop RAM. Category: Netac. Subcategory: RAM (Laptop). Price: Up Coming.
",178,180682,180860
1304,sentence,"Subcategory: RAM (Laptop). Price: Up Coming.

Product: Netac Basic SO DDR4 3200MHz 8GB Laptop RAM. Category: Netac. Subcategory: RAM (Laptop). Price: 2,800৳.
",158,180815,180973
1305,sentence,"Subcategory: RAM (Laptop). Price: 2,800৳.

Product: Netac Basic SO DDR4 3200MHz 16GB Laptop RAM. Category: Netac. Subcategory: RAM (Laptop). Price: Up Coming.
",159,180931,181090
1306,sentence,"Subcategory: RAM (Laptop). Price: Up Coming.

Product: Xtreme XPS550N 200W ATX Power Supply. Category: Power Supply. Subcategory: Component. Price: 1,350৳1,700৳.
",162,181045,181207
1307,sentence,"Subcategory: Component. Price: 1,350৳1,700৳.

Product: Xtreme XJOGOS JPS300G 300W ATX Power Supply. Category: Power Supply. Subcategory: Component. Price: 1,900৳2,000৳.
",169,181162,181331
1308,sentence,"Subcategory: Component. Price: 1,900৳2,000৳.

Product: Huntkey CP3000 300W Power Supply. Category: Power Supply. Subcategory: Component. Price: 2,300৳2,500৳.
",158,181286,181444
1309,sentence,"Subcategory: Component. Price: 2,300৳2,500৳.

Product: Thermaltake W0422RE Litepower 350W Non Modular Power Supply. Category: Power Supply. Subcategory: Component. Price: 2,550৳2,750৳.
",185,181399,181584
1310,sentence,"Subcategory: Component. Price: 2,550৳2,750৳.

Product: MSI MAG A300N-H 300W 80 Plus Non Modular Power Supply. Category: Power Supply. Subcategory: Component. Price: 2,800৳.
",173,181539,181712
1311,sentence,"Subcategory: Component. Price: 2,800৳.

Product: Antec META V350 350W Power Supply. Category: Power Supply. Subcategory: Component. Price: 3,050৳.
",147,181673,181820
1312,sentence,"Subcategory: Component. Price: 3,050৳.

Product: Gamdias AURA GP450 PRO 450W 80 Plus White Certified ATX Power Supply Black. Category: Power Supply. Subcategory: Component. Price: 3,099৳.
",188,181781,181969
1313,sentence,"Subcategory: Component. Price: 3,099৳.

Product: Thermaltake Litepower 450W Non Modular Power Supply. Category: Power Supply. Subcategory: Component. Price: 3,100৳3,300৳.
",171,181930,182101
1314,sentence,"Subcategory: Component. Price: 3,100৳3,300৳.

Product: Gamdias AURA GP550 550W Power Supply. Category: Power Supply. Subcategory: Component. Price: 3,300৳.
",156,182056,182212
1315,sentence,"Subcategory: Component. Price: 3,300৳.

Product: Antec META V450 450W Power Supply. Category: Power Supply. Subcategory: Component. Price: 3,350৳.
",147,182173,182320
1316,sentence,"Subcategory: Component. Price: 3,350৳.

Product: 1STPLAYER FK 5.0 PS-500FK 500W Non-Modular ATX Power Supply. Category: Power Supply. Subcategory: Component. Price: 3,500৳.
",173,182281,182454
1317,sentence,"Subcategory: Component. Price: 3,500৳.

Product: Antec META V550 550W Power Supply. Category: Power Supply. Subcategory: Component. Price: 3,650৳.
",147,182415,182562
1318,sentence,"Subcategory: Component. Price: 3,650৳.

Product: Gamdias HELIOS M1-450B 450W 80 Plus Bronze Power Supply. Category: Power Supply. Subcategory: Component. Price: 4,400৳.
",169,182523,182692
1319,sentence,"Subcategory: Component. Price: 4,400৳.

Product: Huntkey CP5000 500W Power Supply. Category: Power Supply. Subcategory: Component. Price: 4,300৳4,500৳.
",152,182653,182805
1320,sentence,"Subcategory: Component. Price: 4,300৳4,500৳.

Product: MSI MAG A500DN 500W 80 Plus Standard Power Supply. Category: Power Supply. Subcategory: Component. Price: 4,300৳4,580৳.
",175,182760,182935
1321,sentence,"Subcategory: Component. Price: 4,300৳4,580৳.

Product: Xigmatek Odin 500W 80 Plus Power Supply. Category: Power Supply. Subcategory: Component. Price: 4,300৳4,500৳.
",165,182890,183055
1322,sentence,"Subcategory: Component. Price: 4,300৳4,500৳.

Product: Cougar STC550 550W 80+ White Non-Modular Power Supply. Category: Power Supply. Subcategory: Component. Price: 5,000৳.
",173,183010,183183
1323,sentence,"Subcategory: Component. Price: 5,000৳.

Product: Acer AC-550 550W 80 Plus Bronze Full Modular Power Supply. Category: Power Supply. Subcategory: Component. Price: 4,800৳5,100৳.
",177,183144,183321
1324,sentence,"Subcategory: Component. Price: 4,800৳5,100৳.

Product: Huntkey CP6000 600W Power Supply. Category: Power Supply. Subcategory: Component. Price: 4,800৳5,200৳.
",158,183276,183434
1325,sentence,"Subcategory: Component. Price: 4,800৳5,200৳.

Product: ADATA HD330 2TB USB 3.1 Durable External Hard Drive. Category: ADATA. Subcategory: Portable Hard Disk Drive. Price: Out Of Stock.
",185,183389,183574
1326,sentence,"Price: Out Of Stock.

Product: ADATA HD330 1TB USB 3.1 Durable External Hard Drive. Category: ADATA. Subcategory: Portable Hard Disk Drive. Price: Out Of Stock.
",161,183553,183714
1327,sentence,"Price: Out Of Stock.

Product: ADATA HD680 1TB USB 3.2 Durable External Hard Drive. Category: ADATA. Subcategory: Portable Hard Disk Drive. Price: Out Of Stock.
",161,183693,183854
1328,sentence,"Price: Out Of Stock.

Product: Adata HD720 2TB USB 3.2 External Hard Drive. Category: ADATA. Subcategory: Portable Hard Disk Drive. Price: Out Of Stock.
",153,183833,183986
1329,sentence,"Price: Out Of Stock.

Product: ADATA HD680 2TB External Hard Drive. Category: ADATA. Subcategory: Portable Hard Disk Drive. Price: Out Of Stock.

Product: ADATA HV 620 2TB USB 3.0 External HDD. ",194,183965,184159
1330,sentence,"
Product: ADATA HV 620 2TB USB 3.0 External HDD. Category: ADATA. Subcategory: Portable Hard Disk Drive. Price: Out Of Stock.

Product: Adata HD720 2TB USB 3.2 Blue External Hard Drive. ",186,184110,184296
1331,sentence,"Category: ADATA. Subcategory: Portable Hard Disk Drive. Price: Out Of Stock.

Product: Adata HD710 Pro 2TB USB 3.2 Blue External Hard Drive. Category: ADATA. Subcategory: Portable Hard Disk Drive. ",197,184296,184493
1332,sentence,"Subcategory: Portable Hard Disk Drive. Price: Out Of Stock.

Product: Adata HD710 Pro 2TB USB 3.2 Yellow External Hard Drive. Category: ADATA. Subcategory: Portable Hard Disk Drive. ",182,184454,184636
1333,sentence,"Subcategory: Portable Hard Disk Drive. Price: Out Of Stock.

Product: Adata HD710M Pro 2TB USB 3.2 Camouflage External Hard Drive. Category: ADATA. Subcategory: Portable Hard Disk Drive. ",187,184597,184784
1334,sentence,"Subcategory: Portable Hard Disk Drive. Price: Out Of Stock.

Product: Adata HD770G 2TB USB 3.2 RGB Black External Hard Drive. Category: ADATA. Subcategory: Portable Hard Disk Drive. ",182,184745,184927
1335,sentence,"Subcategory: Portable Hard Disk Drive. Price: Out Of Stock.

Product: ADATA HD330 4TB USB 3.1 Durable External Hard Drive. Category: ADATA. Subcategory: Portable Hard Disk Drive. ",179,184888,185067
1336,sentence,"Subcategory: Portable Hard Disk Drive. Price: Out Of Stock.

Product: ADATA HD330 5TB USB 3.1 Durable External Hard Drive. Category: ADATA. Subcategory: Portable Hard Disk Drive. ",179,185028,185207
1337,sentence,"Subcategory: Portable Hard Disk Drive. Price: Out Of Stock.

Product: ADATA 6TB HM800 3.5 External Hard Drive. Category: ADATA. Subcategory: Portable Hard Disk Drive. Price: Out Of Stock.
",188,185168,185356
1338,sentence,"Price: Out Of Stock.

Product: ADATA 8TB HM800 3.5 External Hard Drive. Category: ADATA. Subcategory: Portable Hard Disk Drive. Price: Out Of Stock.
",149,185335,185484
1339,sentence,"Price: Out Of Stock.

Product: Toshiba Canvio Basic 1TB External Hard Disk Drive. Category: Toshiba. Subcategory: Portable Hard Disk Drive. Price: Out Of Stock.
",161,185463,185624
1340,sentence,"Price: Out Of Stock.

Product: Toshiba Canvio Basic A5 1TB USB 3.2 External Hard Disk Drive. Category: Toshiba. Subcategory: Portable Hard Disk Drive. Price: Out Of Stock.
",172,185603,185775
1341,sentence,"Price: Out Of Stock.

Product: Toshiba Canvio Partner 1TB USB Type-C External Hard Disk Drive. Category: Toshiba. Subcategory: Portable Hard Disk Drive. Price: Out Of Stock.
",174,185754,185928
1342,sentence,"Price: Out Of Stock.

Product: Toshiba Canvio Basic 2TB External Hard Disk Drive. Category: Toshiba. Subcategory: Portable Hard Disk Drive. Price: Out Of Stock.
",161,185907,186068
1343,sentence,"Price: Out Of Stock.

Product: Toshiba Canvio Basic A5 2TB USB 3.2 External Hard Disk Drive. Category: Toshiba. Subcategory: Portable Hard Disk Drive. Price: Out Of Stock.
",172,186047,186219
1344,sentence,"Price: Out Of Stock.

Product: Toshiba Canvio Partner 2TB USB Type-C External Hard Disk Drive. Category: Toshiba. Subcategory: Portable Hard Disk Drive. Price: Out Of Stock.
",174,186198,186372
1345,sentence,"Price: Out Of Stock.

Product: Toshiba Canvio Gaming 4TB USB 3.2 External Hard Disk Drive. Category: Toshiba. Subcategory: Portable Hard Disk Drive. Price: Out Of Stock.
",170,186351,186521
1346,sentence,"Price: Out Of Stock.

Product: Toshiba Canvio Flex 4TB USB 3.2 Type-C External Hard Disk Drive. Category: Toshiba. Subcategory: Portable Hard Disk Drive. Price: Out Of Stock.
",175,186500,186675
1347,sentence,"Price: Out Of Stock.

Product: Transcend J25M3 1TB USB 3.1 Portable Hard Disk. Category: Portable Hard Disk Drive. Subcategory: Component. Price: 8,800৳.
",154,186654,186808
1348,sentence,"Subcategory: Component. Price: 8,800৳.

Product: Transcend 25H3 1TB USB 3.1 External HDD. Category: Portable Hard Disk Drive. Subcategory: Component. Price: 8,800৳.
",165,186769,186934
1349,sentence,"Subcategory: Component. Price: 8,800৳.

Product: Western Digital 2TB My Passport Portable HDD. Category: Portable Hard Disk Drive. Subcategory: Component. Price: 8,800৳8,999৳.
",176,186895,187071
1350,sentence,"Subcategory: Component. Price: 8,800৳8,999৳.

Product: Transcend J25H3 2TB USB 3.1 Portable Hard Disk. Category: Portable Hard Disk Drive. Subcategory: Component. Price: 11,500৳.
",179,187026,187205
1351,sentence,"Subcategory: Component. Price: 11,500৳.

Product: Transcend J25M3 2TB USB 3.1 Portable Hard Disk. Category: Portable Hard Disk Drive. Subcategory: Component. Price: 11,500৳.
",174,187165,187339
1352,sentence,"Subcategory: Component. Price: 11,500৳.

Product: Western Digital External 4TB My Passport Hard Disk Drive. Category: Portable Hard Disk Drive. Subcategory: Component. Price: 13,800৳.
",184,187299,187483
1353,sentence,"Subcategory: Component. Price: 13,800৳.

Product: Western Digital 5TB My Passport Portable HDD. Category: Portable Hard Disk Drive. Subcategory: Component. Price: 15,500৳.
",172,187443,187615
1354,sentence,"Subcategory: Component. Price: 15,500৳.

Product: Transcend StoreJet 25H3 4TB USB 3.1 External 2.5"" Portable Hard Disk. Category: Portable Hard Disk Drive. Subcategory: Component. Price: 17,400৳.
",196,187575,187771
1355,sentence,"Subcategory: Component. Price: 17,400৳.

Product: Transcend StoreJet 25M3 4TB USB 3.1 Portable Hard Disk. Category: Portable Hard Disk Drive. Subcategory: Component. Price: 17,400৳.
",182,187731,187913
1356,sentence,"Subcategory: Component. Price: 17,400৳.

Product: Seagate One Touch Hub 6TB External HDD. Category: Portable Hard Disk Drive. Subcategory: Component. Price: 22,900৳23,500৳.
",173,187873,188046
1357,sentence,"Subcategory: Component. Price: 22,900৳23,500৳.

Product: Seagate One Touch Hub 8TB External Hard Disk Drive. Category: Portable Hard Disk Drive. Subcategory: Component. Price: 31,999৳33,000৳.
",192,187999,188191
1358,sentence,"Subcategory: Component. Price: 31,999৳33,000৳.

Product: Seagate One Touch Hub 10TB External Hard Disk Drive. Category: Portable Hard Disk Drive. Subcategory: Component. Price: 36,000৳40,000৳.
",193,188144,188337
1359,sentence,"Subcategory: Component. Price: 36,000৳40,000৳.

Product: Seagate One Touch Hub 12TB External Hard Disk Drive. Category: Portable Hard Disk Drive. Subcategory: Component. Price: 37,720৳41,000৳.
",193,188290,188483
1360,sentence,"Subcategory: Component. Price: 37,720৳41,000৳.

Product: Western Digital My Book 12TB External Hard Drive. Category: Portable Hard Disk Drive. Subcategory: Component. Price: 40,255৳41,500৳.
",190,188436,188626
1361,sentence,"Subcategory: Component. Price: 40,255৳41,500৳.

Product: Seagate One Touch Hub 16TB Type-C External HDD. Category: Portable Hard Disk Drive. Subcategory: Component. Price: 56,000৳57,500৳.
",188,188579,188767
1362,sentence,"Subcategory: Component. Price: 56,000৳57,500৳.

Product: SanDisk Professional G-DRIVE PROJECT 6TB Thunderbolt 3 External Hard Drive. Category: Portable Hard Disk Drive. Subcategory: Component. ",193,188720,188913
1363,sentence,"Subcategory: Component. Price: 56,000৳60,000৳.

Product: Seagate One Touch Hub 20TB Type-C External HDD. Category: Portable Hard Disk Drive. Subcategory: Component. Price: 73,500৳75,000৳.
",188,188889,189077
1364,sentence,"Subcategory: Component. Price: 73,500৳75,000৳.

Product: SanDisk Professional G-DRIVE Enterprise-Class 12TB USB 3.2 Gen 2 External HDD. Category: Portable Hard Disk Drive. Subcategory: Component. ",196,189030,189226
1365,sentence,"Subcategory: Component. Price: 86,000৳.

Product: Asus FX 2TB 2.5"" Aura Sync RGB USB 3.1 External HDD. Category: Portable Hard Disk Drive. Subcategory: Component. Price: Up Coming.
",181,189202,189383
1366,sentence,"Subcategory: Component. Price: Up Coming.

Product: Western Digital Black 2TB SATA Hard Disk. Category: Western Digital. Subcategory: Hard Disk Drive. Price: Out Of Stock.
",172,189341,189513
1367,sentence,"Price: Out Of Stock.

Product: Western Digital 1TB Purple Surveillance HDD. Category: Western Digital. Subcategory: Hard Disk Drive. Price: Out Of Stock.
",154,189492,189646
1368,sentence,"Price: Out Of Stock.

Product: Western Digital 1TB Blue Desktop HDD. Category: Western Digital. Subcategory: Hard Disk Drive. Price: Out Of Stock.
",147,189625,189772
1369,sentence,"Price: Out Of Stock.

Product: Western Digital 2TB Purple Surveillance HDD. Category: Western Digital. Subcategory: Hard Disk Drive. Price: Out Of Stock.
",154,189751,189905
1370,sentence,"Price: Out Of Stock.

Product: Western Digital 2TB Blue Desktop HDD. Category: Western Digital. Subcategory: Hard Disk Drive. Price: Out Of Stock.
",147,189884,190031
1371,sentence,"Price: Out Of Stock.

Product: Western Digital 2TB Blue 7200RPM Desktop HDD. Category: Western Digital. Subcategory: Hard Disk Drive. Price: Out Of Stock.
",155,190010,190165
1372,sentence,"Price: Out Of Stock.

Product: Western Digital Red 2TB Nas Storage Hard Disk Drive.. Category: Western Digital. Subcategory: Hard Disk Drive. Price: Out Of Stock.
",163,190144,190307
1373,sentence,"Price: Out Of Stock.

Product: Western Digital 4TB Blue 5400RPM Desktop HDD. Category: Western Digital. Subcategory: Hard Disk Drive. Price: Out Of Stock.
",155,190286,190441
1374,sentence,"Price: Out Of Stock.

Product: Western Digital 4TB Purple Surveillance HDD. Category: Western Digital. Subcategory: Hard Disk Drive. Price: Out Of Stock.
",154,190420,190574
1375,sentence,"Price: Out Of Stock.

Product: Western Digital 4TB Red Nas Hard Disk. Category: Western Digital. Subcategory: Hard Disk Drive. Price: Out Of Stock.
",148,190553,190701
1376,sentence,"Price: Out Of Stock.

Product: Western Digital 6TB Blue 5400RPM Desktop HDD. Category: Western Digital. Subcategory: Hard Disk Drive. Price: Out Of Stock.
",155,190680,190835
1377,sentence,"Price: Out Of Stock.

Product: Western Digital 6TB 3.5"" RED NAS HDD WD60EFRX. Category: Western Digital. Subcategory: Hard Disk Drive. Price: Out Of Stock.
",156,190814,190970
1378,sentence,"Price: Out Of Stock.

Product: Western Digital 6TB 3.5"" Purple Surveillance HDD. Category: Western Digital. Subcategory: Hard Disk Drive. Price: Out Of Stock.
",159,190949,191108
1379,sentence,"Price: Out Of Stock.

Product: Western Digital Purple 6TB 3.5"" 5400RPM Surveillance HDD. Category: Western Digital. Subcategory: Hard Disk Drive. Price: Out Of Stock.
",167,191087,191254
1380,sentence,"Price: Out Of Stock.

Product: Western Digital 8TB 3.5"" PURPLE Surveillance HDD. Category: Western Digital. Subcategory: Hard Disk Drive. Price: Out Of Stock.
",159,191233,191392
1381,sentence,"Price: Out Of Stock.

Product: Western Digital Purple Pro 8TB Surveillance HDD. Category: Western Digital. Subcategory: Hard Disk Drive. Price: Out Of Stock.
",158,191371,191529
1382,sentence,"Price: Out Of Stock.

Product: Western Digital 10TB Purple Surveillance HDD. Category: Western Digital. Subcategory: Hard Disk Drive. Price: Out Of Stock.
",155,191508,191663
1383,sentence,"Price: Out Of Stock.

Product: Western Digital Purple Pro 10TB Surveillance HDD. Category: Western Digital. Subcategory: Hard Disk Drive. Price: Out Of Stock.
",159,191642,191801
1384,sentence,"Price: Out Of Stock.

Product: LaCie 2TB Rugged USB 3.0 Gen 1 USB-C External Hard Drive. Category: LaCie. Subcategory: Portable Hard Disk Drive. Price: Out Of Stock.
",166,191780,191946
1385,sentence,"Price: Out Of Stock.

Product: LaCie 4TB Rugged USB 3.0 Gen 1 USB-C External Hard Drive. Category: LaCie. Subcategory: Portable Hard Disk Drive. Price: Out Of Stock.
",166,191925,192091
1386,sentence,"Price: Out Of Stock.

Product: LaCie d2 Professional 8TB USB 3.2 Gen 2 Type-C External Hard Drive. Category: LaCie. Subcategory: Portable Hard Disk Drive. Price: Out Of Stock.
",176,192070,192246
1387,sentence,"Price: Out Of Stock.

Product: LaCie 10TB d2 Professional USB 3.2 Gen 2 Type-C External Hard Drive. Category: LaCie. Subcategory: Portable Hard Disk Drive. Price: Out Of Stock.
",177,192225,192402
1388,sentence,"Price: Out Of Stock.

Product: Transcend 8TB 2-Bay Storejet Cloud 210. Category: Transcend. Subcategory: Portable Hard Disk Drive. Price: Out Of Stock.
",152,192381,192533
1389,sentence,"Price: Out Of Stock.

Product: Transcend TS2TSJM100 StoreJet 100 Portable Hard Drive For Mac 2TB. Category: Transcend. Subcategory: Portable Hard Disk Drive. Price: Out Of Stock.
",179,192512,192691
1390,sentence,"Price: Out Of Stock.

Product: Transcend Thunderbolt TS2TSJM300 StoreJet 100 Portable Hard Drive For Mac 2TB. Category: Transcend. Subcategory: Portable Hard Disk Drive. Price: Out Of Stock.
",191,192670,192861
1391,sentence,"Price: Out Of Stock.

Product: Transcend J25A3K 1TB USB 3.0 Black External HDD. Category: Transcend. Subcategory: Portable Hard Disk Drive. Price: Out Of Stock.
",161,192840,193001
1392,sentence,"Price: Out Of Stock.

Product: Transcend StoreJet J25C3N 1TB External Hard Disk Drive (HDD). Category: Transcend. Subcategory: Portable Hard Disk Drive. Price: Out Of Stock.
",174,192980,193154
1393,sentence,"Price: Out Of Stock.

Product: Transcend StoreJet 25C3S 1TB USB 3.1 Gen 1 Type-C Silver External HDD. Category: Transcend. Subcategory: Portable Hard Disk Drive. Price: Out Of Stock.
",183,193133,193316
1394,sentence,"Price: Out Of Stock.

Product: Transcend J25A3K 2TB USB 3.0 Black External HDD. Category: Transcend. Subcategory: Portable Hard Disk Drive. Price: Out Of Stock.
",161,193295,193456
1395,sentence,"Price: Out Of Stock.

Product: Transcend TS2TSJ25C3N 2TB USB 3.0 Ultra Slim External HDD. Category: Transcend. Subcategory: Portable Hard Disk Drive. Price: Out Of Stock.
",171,193435,193606
1396,sentence,"Price: Out Of Stock.

Product: Transcend StoreJet 25C3S 2TB USB 3.1 Gen 1 Type-C Silver External HDD. Category: Transcend. Subcategory: Portable Hard Disk Drive. Price: Out Of Stock.
",183,193585,193768
1397,sentence,"Price: Out Of Stock.

Product: Transcend StoreJet 25M3C 2TB USB 3.1 Type-C Portable Hard Disk. Category: Transcend. Subcategory: Portable Hard Disk Drive. Price: Out Of Stock.
",176,193747,193923
1398,sentence,"Price: Out Of Stock.

Product: Transcend StoreJet 25M3C 4TB USB 3.1 Type-C Portable Hard Disk. Category: Transcend. Subcategory: Portable Hard Disk Drive. Price: Out Of Stock.
",176,193902,194078
1399,sentence,"Price: Out Of Stock.

Product: Transcend J35T3 8TB USB 3.1 External HDD. Category: Transcend. Subcategory: Portable Hard Disk Drive. Price: Out Of Stock.
",154,194057,194211
1400,sentence,"Price: Out Of Stock.

Product: SanDisk Professional G-DRIVE ArmorATD 2TB USB-C Portable External Hard Drive. Category: SanDisk. Subcategory: Portable Hard Disk Drive. Price: Out Of Stock.
",188,194190,194378
1401,sentence,"Price: Out Of Stock.

Product: SanDisk Professional G-DRIVE ArmorATD 4TB USB-C Portable External Hard Drive. Category: SanDisk. Subcategory: Portable Hard Disk Drive. Price: Out Of Stock.
",188,194357,194545
1402,sentence,"Price: Out Of Stock.

Product: SanDisk Professional G-DRIVE ArmorATD 5TB USB-C Portable External Hard Drive. Category: SanDisk. Subcategory: Portable Hard Disk Drive. Price: Out Of Stock.
",188,194524,194712
1403,sentence,"Price: Out Of Stock.

Product: SanDisk Professional G-DRIVE Enterprise-Class 4TB USB 3.2 Gen 2 External HDD. Category: SanDisk. Subcategory: Portable Hard Disk Drive. Price: Out Of Stock.
",188,194691,194879
1404,sentence,"Price: Out Of Stock.

Product: SanDisk Professional G-DRIVE Enterprise-Class 4TB External HDD. Category: SanDisk. Subcategory: Portable Hard Disk Drive. Price: Out Of Stock.
",174,194858,195032
1405,sentence,"Price: Out Of Stock.

Product: SanDisk Professional G-DRIVE Enterprise-Class 6TB USB 3.2 Gen 2 External HDD. Category: SanDisk. Subcategory: Portable Hard Disk Drive. Price: Out Of Stock.
",188,195011,195199
1406,sentence,"Price: Out Of Stock.

Product: SanDisk Professional G-DRIVE Enterprise-Class 6TB External HDD. Category: SanDisk. Subcategory: Portable Hard Disk Drive. Price: Out Of Stock.
",174,195178,195352
1407,sentence,"Price: Out Of Stock.

Product: SanDisk Professional G-DRIVE Pro 6TB Thunderbolt External HDD. Category: SanDisk. Subcategory: Portable Hard Disk Drive. Price: Out Of Stock.
",173,195331,195504
1408,sentence,"Price: Out Of Stock.

Product: SanDisk Professional G-DRIVE Enterprise-Class 12TB External HDD. Category: SanDisk. Subcategory: Portable Hard Disk Drive. Price: Out Of Stock.
",175,195483,195658
1409,sentence,"Price: Out Of Stock.

Product: SanDisk Professional G-RAID 2 12TB 2-Bay RAID Array External HDD. Category: SanDisk. Subcategory: Portable Hard Disk Drive. Price: Out Of Stock.
",176,195637,195813
1410,sentence,"Price: Out Of Stock.

Product: Western Digital Elements 2TB Portable HDD. Category: Western Digital. Subcategory: Portable Hard Disk Drive. Price: Out Of Stock.
",161,195792,195953
1411,sentence,"Price: Out Of Stock.

Product: Western Digital 1TB My Passport Portable HDD Sky. Category: Western Digital. Subcategory: Portable Hard Disk Drive. Price: Out Of Stock.
",168,195932,196100
1412,sentence,"Price: Out Of Stock.

Product: Western Digital 1TB My Passport Portable HDD Red. Category: Western Digital. Subcategory: Portable Hard Disk Drive. Price: Out Of Stock.
",168,196079,196247
1413,sentence,"Price: Out Of Stock.

Product: Western Digital 2TB My Passport Portable HDD Sky. Category: Western Digital. Subcategory: Portable Hard Disk Drive. Price: Out Of Stock.
",168,196226,196394
1414,sentence,"Price: Out Of Stock.

Product: Western Digital 2TB My Passport Type-C Portable HDD. Category: Western Digital. Subcategory: Portable Hard Disk Drive. Price: Out Of Stock.
",171,196373,196544
1415,sentence,"Price: Out Of Stock.

Product: Western Digital 2TB My Passport Type-C Portable HDD Grey. Category: Western Digital. Subcategory: Portable Hard Disk Drive. Price: Out Of Stock.
",176,196523,196699
1416,sentence,"Price: Out Of Stock.

Product: Western Digital Elements 4TB Portable HDD. Category: Western Digital. Subcategory: Portable Hard Disk Drive. Price: Out Of Stock.
",161,196678,196839
1417,sentence,"Price: Out Of Stock.

Product: Western Digital My Book 4TB External Hard Drive. Category: Western Digital. Subcategory: Portable Hard Disk Drive. Price: Out Of Stock.
",167,196818,196985
1418,sentence,"Price: Out Of Stock.

Product: Western Digital 4TB My Passport Portable HDD Red. Category: Western Digital. Subcategory: Portable Hard Disk Drive. Price: Out Of Stock.
",168,196964,197132
1419,sentence,"Price: Out Of Stock.

Product: Western Digital 5TB My Passport Type-C Portable HDD. Category: Western Digital. Subcategory: Portable Hard Disk Drive. Price: Out Of Stock.
",171,197111,197282
1420,sentence,"Price: Out Of Stock.

Product: Western Digital My Cloud Home 4TB HDD. Category: Western Digital. Subcategory: Portable Hard Disk Drive. Price: Out Of Stock.
",157,197261,197418
1421,sentence,"Price: Out Of Stock.

Product: Western Digital My Book 6TB External Hard Drive. Category: Western Digital. Subcategory: Portable Hard Disk Drive. Price: Out Of Stock.
",167,197397,197564
1422,sentence,"Price: Out Of Stock.

Product: Western Digital My Book 8TB External Hard Drive. Category: Western Digital. Subcategory: Portable Hard Disk Drive. Price: Out Of Stock.
",167,197543,197710
1423,sentence,"Price: Out Of Stock.

Product: Western Digital My Cloud Home 8TB HDD. Category: Western Digital. Subcategory: Portable Hard Disk Drive. Price: Out Of Stock.
",157,197689,197846
1424,sentence,"Price: Out Of Stock.

Product: Western Digital 2TB My Passport Portable HDD White. Category: Western Digital. Subcategory: Portable Hard Disk Drive. Price: 9,000৳.
",164,197825,197989
1425,sentence,"Price: 9,000৳.

Product: Western Digital 1TB My Passport Portable HDD. Category: Western Digital. Subcategory: Portable Hard Disk Drive. Price: Out Of Stock.
",158,197974,198132
1426,sentence,"Price: Out Of Stock.

Product: Netac K338 1TB USB 3.0 Portable External HDD. Category: Netac. Subcategory: Portable Hard Disk Drive. Price: Up Coming.
",151,198111,198262
1427,sentence,"Price: Up Coming.

Product: Netac K338 2TB USB 3.0 Portable External HDD. Category: Netac. Subcategory: Portable Hard Disk Drive. Price: Up Coming.
",148,198244,198392
1428,sentence,"Price: Up Coming.

Product: Netac K338 4TB USB 3.0 Portable External HDD. Category: Netac. Subcategory: Portable Hard Disk Drive. Price: Up Coming.
",148,198374,198522
1429,sentence,"Price: Up Coming.

Product: Seagate Basic 1TB Portable USB 3.0 External HDD. Category: Seagate. Subcategory: Portable Hard Disk Drive. Price: Out Of Stock.
",156,198504,198660
1430,sentence,"Price: Out Of Stock.

Product: Seagate Basic 2TB Portable USB 3.0 External HDD. Category: Seagate. Subcategory: Portable Hard Disk Drive. Price: Out Of Stock.
",159,198639,198798
1431,sentence,"Price: Out Of Stock.

Product: Seagate One Touch 4TB USB 3.0 Black External HDD. Category: Seagate. Subcategory: Portable Hard Disk Drive. Price: Out Of Stock.
",160,198777,198937
1432,sentence,"Price: Out Of Stock.

Product: Seagate STKZ5000400 One Touch 5TB External Hard Disk Drive. Category: Seagate. Subcategory: Portable Hard Disk Drive. Price: Out Of Stock.
",170,198916,199086
1433,sentence,"Price: Out Of Stock.

Product: Samsung T7 Shield 2TB USB 3.2 Type-C Portable SSD. Category: Samsung. Subcategory: Portable SSD. Price: 21,500৳22,700৳.
",151,199065,199216
1434,sentence,"Price: 21,500৳22,700৳.

Product: SAMSUNG T7 2TB USB 3.2 Gen Type-C Portable SSD. Category: Samsung. Subcategory: Portable SSD. Price: 20,500৳23,500৳.
",150,199193,199343
1435,sentence,"Price: 20,500৳23,500৳.

Product: Samsung T7 1TB USB 3.2 Type-C Portable SSD. Category: Samsung. Subcategory: Portable SSD. Price: Out Of Stock.
",144,199320,199464
1436,sentence,"Subcategory: Portable SSD. Price: Out Of Stock.

Product: Samsung T7 Shield 1TB USB 3.2 Type-C Portable SSD. Category: Samsung. Subcategory: Portable SSD. Price: Out Of Stock.
",176,199416,199592
1437,sentence,"Subcategory: Portable SSD. Price: Out Of Stock.

Product: SanDisk Extreme V2 1TB USB-C USB 3.2 Gen 2 Portable SSD. Category: SanDisk. Subcategory: Portable SSD. Price: 13,400৳.
",177,199544,199721
1438,sentence,"Subcategory: Portable SSD. Price: 13,400৳.

Product: SanDisk Extreme V2 2TB USB-C USB 3.2 Gen 2 Portable SSD. Category: SanDisk. Subcategory: Portable SSD. Price: 18,999৳20,500৳.
",179,199678,199857
1439,sentence,"Price: 18,999৳20,500৳.

Product: Sandisk Extreme PRO V2 2TB USB 3.2 Gen 2 Type-C Portable SSD. Category: SanDisk. Subcategory: Portable SSD. Price: 25,999৳27,000৳.
",164,199834,199998
1440,sentence,"Price: 25,999৳27,000৳.

Product: Sandisk Extreme PRO V2 1TB USB 3.2 Gen 2 Type-C Portable SSD. Category: SanDisk. Subcategory: Portable SSD. Price: 16,530৳19,000৳.
",164,199975,200139
1441,sentence,"Price: 16,530৳19,000৳.

Product: Sandisk 4TB USB 3.2 Gen 2 Type-C Portable SSD. Category: SanDisk. Subcategory: Portable SSD. Price: Up Coming.
",144,200116,200260
1442,sentence,"Subcategory: Portable SSD. Price: Up Coming.

Product: Sandisk 1TB USB 3.2 Gen 2 Type-C Portable SSD (Updated Firmware). Category: SanDisk. Subcategory: Portable SSD. Price: Out Of Stock.
",188,200215,200403
1443,sentence,"Subcategory: Portable SSD. Price: Out Of Stock.

Product: Sandisk 1TB USB 3.2 Gen 2 Type-C Portable SSD. Category: SanDisk. Subcategory: Portable SSD. Price: Out Of Stock.
",172,200355,200527
1444,sentence,"Subcategory: Portable SSD. Price: Out Of Stock.

Product: SanDisk Extreme 1TB Type-C Portable SSD. Category: SanDisk. Subcategory: Portable SSD. Price: Out Of Stock.
",166,200479,200645
1445,sentence,"Subcategory: Portable SSD. Price: Out Of Stock.

Product: Sandisk 2TB USB 3.2 Gen 2 Type-C Portable SSD (Updated Firmware). Category: SanDisk. Subcategory: Portable SSD. Price: Out Of Stock.
",191,200597,200788
1446,sentence,"Subcategory: Portable SSD. Price: Out Of Stock.

Product: Sandisk 2TB USB 3.2 Gen 2 Type-C Portable SSD. Category: SanDisk. Subcategory: Portable SSD. Price: Out Of Stock.
",172,200740,200912
1447,sentence,"Subcategory: Portable SSD. Price: Out Of Stock.

Product: Sandisk Extreme 2TB Portable SSD. Category: SanDisk. Subcategory: Portable SSD. Price: Out Of Stock.
",159,200864,201023
1448,sentence,"Subcategory: Portable SSD. Price: Out Of Stock.

Product: Sandisk Extreme PRO V2 4TB USB 3.2 Gen 2 Type-C Portable SSD. Category: SanDisk. Subcategory: Portable SSD. Price: Out Of Stock.
",187,200975,201162
1449,sentence,"Subcategory: Portable SSD. Price: Out Of Stock.

Product: SanDisk Extreme V2 4TB USB-C USB 3.2 Gen 2 Portable SSD. Category: SanDisk. Subcategory: Portable SSD. Price: Out Of Stock.
",182,201114,201296
1450,sentence,"Subcategory: Portable SSD. Price: Out Of Stock.

Product: Transcend ESD330C 512GB Type-C Portable SSD. Category: Transcend. Subcategory: Portable SSD. Price: 6,050৳6,300৳.
",172,201248,201420
1451,sentence,"Subcategory: Portable SSD. Price: 6,050৳6,300৳.

Product: Transcend ESD300S 512GB Type-C Portable SSD. Category: Transcend. Subcategory: Portable SSD. Price: 5,900৳6,500৳.
",172,201372,201544
1452,sentence,"Subcategory: Portable SSD. Price: 5,900৳6,500৳.

Product: Transcend ESD300C 512GB USB Type-C Portable SSD. Category: Transcend. Subcategory: Portable SSD. Price: 5,950৳6,800৳.
",176,201496,201672
1453,sentence,"Subcategory: Portable SSD. Price: 5,950৳6,800৳.

Product: Transcend ESD300C 1TB USB Type-C Portable SSD. Category: Transcend. Subcategory: Portable SSD. Price: 10,500৳10,700৳.
",176,201624,201800
1454,sentence,"Price: 10,500৳10,700৳.

Product: Transcend ESD320A 1TB Type-A Portable SSD. Category: Transcend. Subcategory: Portable SSD. Price: 10,500৳10,900৳.
",147,201777,201924
1455,sentence,"Price: 10,500৳10,900৳.

Product: Transcend ESD300P 1TB Type-C Portable SSD. Category: Transcend. Subcategory: Portable SSD. Price: 10,100৳11,000৳.
",147,201901,202048
1456,sentence,"Price: 10,100৳11,000৳.

Product: Transcend ESD265C 2TB Type-C Portable SSD. Category: Transcend. Subcategory: Portable SSD. Price: 21,800৳22,000৳.
",147,202025,202172
1457,sentence,"Price: 21,800৳22,000৳.

Product: Transcend ESD320A 2TB Type-A Portable SSD. Category: Transcend. Subcategory: Portable SSD. Price: 21,300৳22,000৳.
",147,202149,202296
1458,sentence,"Price: 21,300৳22,000৳.

Product: Transcend ESD330C 2TB Type-C Portable SSD. Category: Transcend. Subcategory: Portable SSD. Price: 21,300৳22,400৳.
",147,202273,202420
1459,sentence,"Price: 21,300৳22,400৳.

Product: Transcend ESD370C 250GB USB 3.1 Gen 2 Type-C Portable External SSD. Category: Transcend. Subcategory: Portable SSD. Price: Out Of Stock.
",170,202397,202567
1460,sentence,"Subcategory: Portable SSD. Price: Out Of Stock.

Product: Transcend ESD270C 250GB USB 3.1 Gen 2 Type-C External SSD. Category: Transcend. Subcategory: Portable SSD. Price: Out Of Stock.
",186,202519,202705
1461,sentence,"Subcategory: Portable SSD. Price: Out Of Stock.

Product: Transcend ESD260C 250GB Type-C Portable External SSD. Category: Transcend. Subcategory: Portable SSD. Price: Out Of Stock.
",181,202657,202838
1462,sentence,"Subcategory: Portable SSD. Price: Out Of Stock.

Product: Transcend ESD310C 256GB USB Type-C Portable SSD. Category: Transcend. Subcategory: Portable SSD. Price: Out Of Stock.
",176,202790,202966
1463,sentence,"Subcategory: Portable SSD. Price: Out Of Stock.

Product: Transcend ESD240C 240GB USB 3.1 Gen 2 Type-C Portable SSD. Category: Transcend. Subcategory: Portable SSD. Price: Out Of Stock.
",186,202918,203104
1464,sentence,"Subcategory: Portable SSD. Price: Out Of Stock.

Product: Transcend ESD270C 500GB USB 3.1 Gen 2 Type-C External SSD. Category: Transcend. Subcategory: Portable SSD. Price: Out Of Stock.
",186,203056,203242
1465,sentence,"Subcategory: Portable SSD. Price: Out Of Stock.

Product: Transcend ESD310S 512GB USB Type-C Portable SSD. Category: Transcend. Subcategory: Portable SSD. Price: Out Of Stock.
",176,203194,203370
1466,sentence,"Subcategory: Portable SSD. Price: Out Of Stock.

Product: Transcend ESD310P 512GB USB Type-A & Type-C Dual Port Portable SSD. Category: Transcend. Subcategory: Portable SSD. Price: Out Of Stock.
",195,203322,203517
1467,sentence,"Subcategory: Portable SSD. Price: Out Of Stock.

Product: Transcend ESD260C 500GB Type-C Portable External SSD. Category: Transcend. Subcategory: Portable SSD. Price: Out Of Stock.
",181,203469,203650
1468,sentence,"Subcategory: Portable SSD. Price: Out Of Stock.

Product: Transcend ESD370C 500GB USB 3.1 Portable External SSD. Category: Transcend. Subcategory: Portable SSD. Price: Out Of Stock.
",182,203602,203784
1469,sentence,"Subcategory: Portable SSD. Price: Out Of Stock.

Product: Transcend ESD310C 512GB USB Type-C Portable SSD. Category: Transcend. Subcategory: Portable SSD. Price: Out Of Stock.
",176,203736,203912
1470,sentence,"Subcategory: Portable SSD. Price: Out Of Stock.

Product: Crucial X8 2TB USB 3.2 Type-C Portable SSD. Category: Crucial. Subcategory: Portable SSD. Price: 36,000৳.
",164,203864,204028
1471,sentence,"Subcategory: Portable SSD. Price: 36,000৳.

Product: Crucial X8 1TB USB 3.2 Type-C Portable SSD. Category: Crucial. Subcategory: Portable SSD. Price: Out Of Stock.
",164,203985,204149
1472,sentence,"Subcategory: Portable SSD. Price: Out Of Stock.

Product: Netac Z Slim 128GB USB 3.2 Gen 2 Type-C Portable SSD. Category: Netac. Subcategory: Portable SSD. Price: Up Coming.
",174,204101,204275
1473,sentence,"Subcategory: Portable SSD. Price: Up Coming.

Product: Netac Z Slim 250GB USB 3.2 Gen 2 Type-C Portable SSD. Category: Netac. Subcategory: Portable SSD. Price: Up Coming.
",171,204230,204401
1474,sentence,"Subcategory: Portable SSD. Price: Up Coming.

Product: Netac Z Slim 500GB USB 3.2 Gen 2 Type-C Portable SSD. Category: Netac. Subcategory: Portable SSD. Price: Up Coming.
",171,204356,204527
1475,sentence,"Subcategory: Portable SSD. Price: Up Coming.

Product: Netac Z Slim 1TB USB 3.2 Gen 2 Type-C Portable SSD. Category: Netac. Subcategory: Portable SSD. Price: Up Coming.
",169,204482,204651
1476,sentence,"Subcategory: Portable SSD. Price: Up Coming.

Product: Netac Z Slim 2TB USB 3.2 Gen 2 Type-C Portable SSD. Category: Netac. Subcategory: Portable SSD. Price: Up Coming.
",169,204606,204775
1477,sentence,"Subcategory: Portable SSD. Price: Up Coming.

Product: Netac ZX 250GB USB 3.2 Gen 2 Type-C Portable SSD. Category: Netac. Subcategory: Portable SSD. Price: Up Coming.
",167,204730,204897
1478,sentence,"Subcategory: Portable SSD. Price: Up Coming.

Product: Netac ZX 500GB USB 3.2 Gen 2 Type-C Portable SSD. Category: Netac. Subcategory: Portable SSD. Price: Up Coming.
",167,204852,205019
1479,sentence,"Subcategory: Portable SSD. Price: Up Coming.

Product: Netac ZX 1TB USB 3.2 Gen 2 Type-C Portable SSD. Category: Netac. Subcategory: Portable SSD. Price: Up Coming.
",165,204974,205139
1480,sentence,"Subcategory: Portable SSD. Price: Up Coming.

Product: Netac Z11 250GB USB 3.2 Gen 2 Type-C Portable SSD. Category: Netac. Subcategory: Portable SSD. Price: Up Coming.
",168,205094,205262
1481,sentence,"Subcategory: Portable SSD. Price: Up Coming.

Product: Netac Z11 500GB USB 3.2 Gen 2 Type-C Portable SSD. Category: Netac. Subcategory: Portable SSD. Price: Up Coming.
",168,205217,205385
1482,sentence,"Subcategory: Portable SSD. Price: Up Coming.

Product: Netac Z11 1TB USB 3.2 Gen 2 Type-C Portable SSD. Category: Netac. Subcategory: Portable SSD. Price: Up Coming.
",166,205340,205506
1483,sentence,"Subcategory: Portable SSD. Price: Up Coming.

Product: Netac Z9 250GB USB 3.2 Gen 2 Type-C Portable SSD. Category: Netac. Subcategory: Portable SSD. Price: Up Coming.
",167,205461,205628
1484,sentence,"Subcategory: Portable SSD. Price: Up Coming.

Product: Netac Z9 500GB USB 3.2 Gen 2 Type-C Portable SSD. Category: Netac. Subcategory: Portable SSD. Price: Up Coming.
",167,205583,205750
1485,sentence,"Subcategory: Portable SSD. Price: Up Coming.

Product: Netac Z9 1TB USB 3.2 Gen 2 Type-C Portable SSD. Category: Netac. Subcategory: Portable SSD. Price: Up Coming.
",165,205705,205870
1486,sentence,"Subcategory: Portable SSD. Price: Up Coming.

Product: Netac Z9 2TB USB 3.2 Gen 2 Type-C Portable SSD. Category: Netac. Subcategory: Portable SSD. Price: Up Coming.
",165,205825,205990
1487,sentence,"Subcategory: Portable SSD. Price: Up Coming.

Product: Netac Z7S 120GB USB 3.2 Type-C Portable SSD. Category: Netac. Subcategory: Portable SSD. Price: Up Coming.
",162,205945,206107
1488,sentence,"Subcategory: Portable SSD. Price: Up Coming.

Product: Netac Z7S 240GB USB 3.2 Type-C Portable SSD. Category: Netac. Subcategory: Portable SSD. Price: Up Coming.
",162,206062,206224
1489,sentence,"Subcategory: Portable SSD. Price: Up Coming.

Product: Netac Z7S 480GB USB 3.2 Type-C Portable SSD. Category: Netac. Subcategory: Portable SSD. Price: Up Coming.
",162,206179,206341
1490,sentence,"Subcategory: Portable SSD. Price: Up Coming.

Product: Netac Z7S 960GB USB 3.2 Type-C Portable SSD. Category: Netac. Subcategory: Portable SSD. Price: Up Coming.
",162,206296,206458
1491,sentence,"Subcategory: Portable SSD. Price: Up Coming.

Product: Netac Z7S 2TB USB 3.2 Type-C Portable SSD. Category: Netac. Subcategory: Portable SSD. Price: Up Coming.
",160,206413,206573
1492,sentence,"Subcategory: Portable SSD. Price: Up Coming.

Product: TEAM PD1000 512GB USB3.2 Type-C Portable SSD. Category: TEAM. Subcategory: Portable SSD. Price: 8,599৳8,900৳.
",165,206528,206693
1493,sentence,"Subcategory: Portable SSD. Price: 8,599৳8,900৳.

Product: TEAM PD1000 1TB USB3.2 Type-C Portable SSD. Category: TEAM. Subcategory: Portable SSD. Price: 11,500৳12,999৳.
",168,206645,206813
1494,sentence,"Price: 11,500৳12,999৳.

Product: TEAM PD20 ECO Mini 1TB Type-C Portable SSD. Category: TEAM. Subcategory: Portable SSD. Price: 13,050৳.

Product: TEAM CinemaPr P31 1TB USB 3.2 Type-C External SSD. ",197,206790,206987
1495,sentence,"Category: TEAM. Subcategory: Portable SSD. Price: 19,999৳20,899৳.

Product: TEAM PD20 ECO Mini 2TB Type-C Portable SSD. Category: TEAM. Subcategory: Portable SSD. Price: 22,500৳.
",179,206987,207166
1496,sentence,"Subcategory: Portable SSD. Price: 22,500৳.

Product: TEAM PD20 Mini 2TB Type-C Portable SSD. Category: TEAM. Subcategory: Portable SSD. Price: 24,100৳.
",152,207123,207275
1497,sentence,"Subcategory: Portable SSD. Price: 24,100৳.

Product: Team PD20M 2TB MagSafe Type-C Portable SSD. Category: TEAM. Subcategory: Portable SSD. Price: 24,100৳24,999৳.
",163,207232,207395
1498,sentence,"Price: 24,100৳24,999৳.

Product: TEAM T-Force M200 250GB USB3.2 Type-C Portable SSD. Category: TEAM. Subcategory: Portable SSD. Price: Out Of Stock.
",149,207372,207521
1499,sentence,"Subcategory: Portable SSD. Price: Out Of Stock.

Product: TEAM T-Force Treasure Touch 1TB Type-C USB 3.2 RGB Portable External SSD. Category: TEAM. Subcategory: Portable SSD. Price: Out Of Stock.
",196,207473,207669
1500,sentence,"Subcategory: Portable SSD. Price: Out Of Stock.

Product: TEAM T-Force M200 500GB Portable SSD. Category: TEAM. Subcategory: Portable SSD. Price: Out Of Stock.
",160,207621,207781
1501,sentence,"Subcategory: Portable SSD. Price: Out Of Stock.

Product: Team PD20M 1TB MagSafe Type-C Portable SSD. Category: TEAM. Subcategory: Portable SSD. Price: Out Of Stock.
",166,207733,207899
1502,sentence,"Subcategory: Portable SSD. Price: Out Of Stock.

Product: TEAM T-Force M200 1TB Portable SSD. Category: TEAM. Subcategory: Portable SSD. Price: Out Of Stock.
",158,207851,208009
1503,sentence,"Subcategory: Portable SSD. Price: Out Of Stock.

Product: TEAM T-Force M200 2TB Portable SSD. Category: TEAM. Subcategory: Portable SSD. Price: Out Of Stock.
",158,207961,208119
1504,sentence,"Subcategory: Portable SSD. Price: Out Of Stock.

Product: TEAM PD20 Mini 1TB Type-C Portable SSD. Category: TEAM. Subcategory: Portable SSD. Price: Out Of Stock.
",162,208071,208233
1505,sentence,"Subcategory: Portable SSD. Price: Out Of Stock.

Product: Netac SA500 120GB 2.5-inch SATAIII SSD. Category: SSD. Subcategory: Component. Price: 1,350৳1,400৳.
",158,208185,208343
1506,sentence,"Subcategory: Component. Price: 1,350৳1,400৳.

Product: Netac N535S 120GB 2.5-inch SATAIII SSD. Category: SSD. Subcategory: Component. Price: 1,300৳.

Product: Netac SA500 128GB 2.5-inch SATAIII SSD. ",199,208298,208497
1507,sentence,"Category: SSD. Subcategory: Component. Price: 1,380৳1,490৳.

Product: Netac N535N 128GB M.2 2280 SSD. Category: SSD. Subcategory: Component. Price: 1,500৳1,600৳.
",162,208497,208659
1508,sentence,"Subcategory: Component. Price: 1,500৳1,600৳.

Product: ORICO Y20 128GB 2.5 Inch SATA III SSD. Category: SSD. Subcategory: Component. Price: 1,500৳1,600৳.

Product: OCPC XTL-200 128GB SATA III SSD. ",197,208614,208811
1509,sentence,"
Product: OCPC XTL-200 128GB SATA III SSD. Category: SSD. Subcategory: Component. Price: 1,650৳1,700৳.

Product: Patriot P210 128GB 2.5 inch SATA III SSD. Category: SSD. Subcategory: Component. ",194,208768,208962
1510,sentence,"Category: SSD. Subcategory: Component. Price: 1,800৳.

Product: Hikvision E1000 128GB M.2 2280 NVMe PCIe Gen 3 x 4 SSD. Category: SSD. Subcategory: Component. Price: 1,850৳1,890৳.
",180,208923,209103
1511,sentence,"Subcategory: Component. Price: 1,850৳1,890৳.

Product: Netac N930E Pro 128GB NVMe M.2 2280 SSD. Category: SSD. Subcategory: Component. Price: 1,600৳1,650৳.
",156,209058,209214
1512,sentence,"Subcategory: Component. Price: 1,600৳1,650৳.

Product: Colorful CN600 128gb M.2 Nvme SSD. Category: SSD. Subcategory: Component. Price: 1,900৳.

Product: Patriot P300 M.2 PCIe Gen 3 x4 128GB SSD. ",196,209169,209365
1513,sentence,"Category: SSD. Subcategory: Component. Price: 2,000৳.

Product: OCPC MFL-300 128GB M.2 NVMe SSD. Category: SSD. Subcategory: Component. Price: 2,000৳2,050৳.
",157,209365,209522
1514,sentence,"Subcategory: Component. Price: 2,000৳2,050৳.

Product: Netac SA500 240GB 2.5-inch SATAIII SSD. Category: SSD. Subcategory: Component. Price: 2,000৳2,075৳.

Product: Netac N535N 256GB M.2 2280 SSD. ",197,209477,209674
1515,sentence,"
Product: Netac N535N 256GB M.2 2280 SSD. Category: SSD. Subcategory: Component. Price: 2,150৳2,190৳.

Product: OCPC XTL-200 256GB SATA III SSD. Category: SSD. Subcategory: Component. Price: 2,250৳.
",199,209632,209831
1516,sentence,"Subcategory: Component. Price: 2,250৳.

Product: OSCOO OS002 256GB 2.5'' SATA III SSD. Category: SSD. Subcategory: Component. Price: 2,200৳2,300৳.

Product: MiPhi MP100 256GB 2.5'' SATA III SSD. ",195,209792,209987
1517,sentence,"
Product: MiPhi MP100 256GB 2.5'' SATA III SSD. Category: SSD. Subcategory: Component. Price: 2,250৳2,350৳.

Product: ORICO Y20 256GB 2.5 Inch SATA III SSD. Category: SSD. Subcategory: Component. ",196,209939,210135
1518,sentence,"Category: SSD. Subcategory: Component. Price: 2,399৳.

Product: COLORFUL SL500 256GB 2.5'' SATA III SSD. Category: SSD. Subcategory: Component. Price: 2,040৳2,400৳.
",165,210096,210261
1519,sentence,"Subcategory: Component. Price: 2,040৳2,400৳.

Product: AITC KINGSMAN SK350 256GB 2.5"" SATA III SSD. Category: SSD. Subcategory: Component. Price: 2,450৳.
",154,210216,210370
1520,sentence,"Subcategory: Component. Price: 2,450৳.

Product: Lexar SL600 512GB Blazing-fast USB 3.2 Gen2x2 Portable SSD. Category: Lexar. Subcategory: Portable SSD. Price: Out Of Stock.
",174,210331,210505
1521,sentence,"Subcategory: Portable SSD. Price: Out Of Stock.

Product: Lexar SL660 512GB Blazing-fast Portable SSD. Category: Lexar. Subcategory: Portable SSD. Price: Out Of Stock.
",168,210457,210625
1522,sentence,"Subcategory: Portable SSD. Price: Out Of Stock.

Product: Lexar SL600 1TB Blazing-fast USB 3.2 Gen2x2 Portable SSD. Category: Lexar. Subcategory: Portable SSD. Price: Out Of Stock.
",181,210577,210758
1523,sentence,"Subcategory: Portable SSD. Price: Out Of Stock.

Product: Seagate One Touch 1TB Portable USB Type-C Black External SSD. Category: Seagate. Subcategory: Portable SSD. Price: 17,300৳.
",182,210710,210892
1524,sentence,"Subcategory: Portable SSD. Price: 17,300৳.

Product: Seagate One Touch 1TB External Portable SSD. Category: Seagate. Subcategory: Portable SSD. Price: 17,000৳17,500৳.
",167,210849,211016
1525,sentence,"Price: 17,000৳17,500৳.

Product: Seagate Ultra Compact 1TB Type-C Portable SSD. Category: Seagate. Subcategory: Portable SSD. Price: 20,000৳.

Product: Seagate One Touch 2TB USB Type-C External SSD. ",199,210993,211192
1526,sentence,"Category: Seagate. Subcategory: Portable SSD. Price: 20,400৳20,800৳.

Product: Seagate Ultra Compact 2TB Type-C Portable SSD. Category: Seagate. Subcategory: Portable SSD. Price: 32,000৳.
",188,211192,211380
1527,sentence,"Subcategory: Portable SSD. Price: 32,000৳.

Product: Seagate Expansion 1TB Portable USB 3.0 External SSD. Category: Seagate. Subcategory: Portable SSD. Price: Out Of Stock.
",173,211337,211510
1528,sentence,"Subcategory: Portable SSD. Price: Out Of Stock.

Product: OSCOO MD008 512GB Magnetic Type-C Portable SSD. Category: Portable SSD. Subcategory: Component. Price: 6,000৳.
",169,211462,211631
1529,sentence,"Subcategory: Component. Price: 6,000৳.

Product: OSCOO T10 512GB Type-C Portable SSD. Category: Portable SSD. Subcategory: Component. Price: 6,700৳.

Product: OSCOO MD003 512GB Type-C Portable SSD. ",198,211592,211790
1530,sentence,"
Product: OSCOO MD003 512GB Type-C Portable SSD. Category: Portable SSD. Subcategory: Component. Price: 4,600৳.

Product: OSCOO MD003 256GB Type-C Portable SSD. Category: Portable SSD. ",185,211741,211926
1531,sentence,"Category: Portable SSD. Subcategory: Component. Price: 3,000৳.

Product: OSCOO MD005M 1TB Type-C Portable SSD. Category: Portable SSD. Subcategory: Component. Price: 7,600৳.
",174,211902,212076
1532,sentence,"Subcategory: Component. Price: 7,600৳.

Product: OSCOO MD005M 512GB Type-C Portable SSD. Category: Portable SSD. Subcategory: Component. Price: 4,700৳.
",152,212037,212189
1533,sentence,"Subcategory: Component. Price: 4,700৳.

Product: OSCOO MD005M 256GB Type-C Portable SSD. Category: Portable SSD. Subcategory: Component. Price: 3,150৳.

Product: OSCOO T10 1TB Type-C Portable SSD. ",197,212150,212347
1534,sentence,"
Product: OSCOO T10 1TB Type-C Portable SSD. Category: Portable SSD. Subcategory: Component. Price: 10,300৳.

Product: Patriot Transporter 1TB Type C Portable SSD. Category: Portable SSD. ",188,212302,212490
1535,sentence,"Category: Portable SSD. Subcategory: Component. Price: 10,500৳.

Product: Patriot VIPER Gaming PVP30 1TB USB Type-A & Type-C Portable SSD. Category: Portable SSD. Subcategory: Component. ",187,212466,212653
1536,sentence,"Category: Portable SSD. Subcategory: Component. Price: 10,000৳.

Product: Patriot Transporter 2TB Type C Portable SSD. Category: Portable SSD. Subcategory: Component. Price: 18,000৳.
",183,212605,212788
1537,sentence,"Subcategory: Component. Price: 18,000৳.

Product: Patriot VIPER Gaming PVP30 512GB USB Type-A & Type-C Portable SSD. Category: Portable SSD. Subcategory: Component. Price: 6,000৳.
",180,212748,212928
1538,sentence,"Subcategory: Component. Price: 6,000৳.

Product: Corsair EX100U 1TB Type-C Portable SSD. Category: Corsair. Subcategory: Portable SSD. Price: 11,700৳12,000৳.
",158,212889,213047
1539,sentence,"Price: 11,700৳12,000৳.

Product: Kingston SXS2000 500GB USB 3.2 Portable SSD. Category: Kingston. Subcategory: Portable SSD. Price: 7,800৳.
",140,213024,213164
1540,sentence,"Subcategory: Portable SSD. Price: 7,800৳.

Product: Kingston XS2000 1TB USB Type C 3.2 Gen 2 Portable SSD. Category: Kingston. Subcategory: Portable SSD. Price: 11,650৳11,800৳.
",177,213122,213299
1541,sentence,"Price: 11,650৳11,800৳.

Product: Kingston XS1000 2TB USB 3.2 Gen 2 Portable SSD. Category: Kingston. Subcategory: Portable SSD. Price: 17,250৳.
",144,213276,213420
1542,sentence,"Subcategory: Portable SSD. Price: 17,250৳.

Product: Kingston XS2000 2TB USB 3.2 Gen 2 Portable SSD. Category: Kingston. Subcategory: Portable SSD. Price: 19,600৳.
",164,213377,213541
1543,sentence,"Subcategory: Portable SSD. Price: 19,600৳.

Product: Adata SD600Q 240GB External SSD. Category: Adata. Subcategory: Portable SSD. Price: Out Of Stock.
",151,213498,213649
1544,sentence,"Subcategory: Portable SSD. Price: Out Of Stock.

Product: Adata SE880 500GB USB 3.2 Type-C Portable External SSD. Category: Adata. Subcategory: Portable SSD. Price: Out Of Stock.
",179,213601,213780
1545,sentence,"Subcategory: Portable SSD. Price: Out Of Stock.

Product: Adata SE760 512GB USB 3.2 Type-C Portable External SSD. Category: Adata. Subcategory: Portable SSD. Price: Out Of Stock.
",179,213732,213911
1546,sentence,"Subcategory: Portable SSD. Price: Out Of Stock.

Product: ADATA SC685 500GB External SSD. Category: Adata. Subcategory: Portable SSD. Price: Out Of Stock.

Product: Adata SD600Q 480GB External SSD. ",198,213863,214061
1547,sentence,"
Product: Adata SD600Q 480GB External SSD. Category: Adata. Subcategory: Portable SSD. Price: Out Of Stock.

Product: Adata SE880 1TB USB 3.2 Type-C Portable External SSD. Category: Adata. ",189,214018,214207
1548,sentence,"Category: Adata. Subcategory: Portable SSD. Price: Out Of Stock.

Product: Adata SE760 1TB USB 3.2 Type-C Portable External SSD. Category: Adata. Subcategory: Portable SSD. Price: Out Of Stock.
",194,214190,214384
1549,sentence,"Subcategory: Portable SSD. Price: Out Of Stock.

Product: Adata SD810 1TB USB 3.2 Type-C Portable External SSD. Category: Adata. Subcategory: Portable SSD. Price: Out Of Stock.
",177,214336,214513
1550,sentence,"Subcategory: Portable SSD. Price: Out Of Stock.

Product: ADATA SC685 1TB Type-C Portable External SSD. Category: Adata. Subcategory: Portable SSD. Price: Out Of Stock.
",169,214465,214634
1551,sentence,"Subcategory: Portable SSD. Price: Out Of Stock.

Product: Adata SE760 2TB USB 3.2 Type-C Portable External SSD. Category: Adata. Subcategory: Portable SSD. Price: Out Of Stock.
",177,214586,214763
1552,sentence,"Subcategory: Portable SSD. Price: Out Of Stock.

Product: Adata SD810 4TB USB 3.2 Type-C Portable External SSD. Category: Adata. Subcategory: Portable SSD. Price: Out Of Stock.
",177,214715,214892
1553,sentence,"Subcategory: Portable SSD. Price: Out Of Stock.

Product: Antec VX10M Micro-ATX Mini Tower Casing. Category: Casing. Subcategory: Component. Price: 1,450৳.

Product: Xtreme 950 Mid Tower ATX Casing. ",199,214844,215043
1554,sentence,"
Product: Xtreme 950 Mid Tower ATX Casing. Category: Casing. Subcategory: Component. Price: 1,450৳1,500৳.

Product: Xtreme 951 Mid Tower ATX Casing. Category: Casing. Subcategory: Component. ",191,215000,215191
1555,sentence,"Category: Casing. Subcategory: Component. Price: 1,550৳.

Product: Xtreme F01 RGB Mini Tower Casing. Category: Casing. Subcategory: Component. Price: 1,400৳1,599৳.
",164,215149,215313
1556,sentence,"Subcategory: Component. Price: 1,400৳1,599৳.

Product: Xtreme F03 Mini Tower Casing. Category: Casing. Subcategory: Component. Price: 1,450৳1,599৳.
",148,215268,215416
1557,sentence,"Subcategory: Component. Price: 1,450৳1,599৳.

Product: MaxGreen H2 M-ATX Case With 200W Power Supply. Category: Casing. Subcategory: Component. Price: 2,500৳.
",159,215371,215530
1558,sentence,"Subcategory: Component. Price: 2,500৳.

Product: Xtreme M111 RGB Mid Tower Casing With 2 RGB Fan. Category: Casing. Subcategory: Component. Price: 2,500৳.
",155,215491,215646
1559,sentence,"Subcategory: Component. Price: 2,500৳.

Product: MaxGreen H6 M-ATX Case with 200W Standard PSU. Category: Casing. Subcategory: Component. Price: 2,550৳.
",153,215607,215760
1560,sentence,"Subcategory: Component. Price: 2,550৳.

Product: PC Power 180B Mid-Tower ATX Desktop Casing. Category: Casing. Subcategory: Component. Price: 2,500৳2,600৳.
",156,215721,215877
1561,sentence,"Subcategory: Component. Price: 2,500৳2,600৳.

Product: Value-Top V200H Micro ATX Casing With PSU. Category: Casing. Subcategory: Component. Price: 2,400৳2,600৳.
",161,215832,215993
1562,sentence,"Subcategory: Component. Price: 2,400৳2,600৳.

Product: MaxGreen 17303 Mid-Tower M-ATX Casing With 200W PSU. Category: Casing. Subcategory: Component. Price: 2,600৳.
",165,215948,216113
1563,sentence,"Subcategory: Component. Price: 2,600৳.

Product: PC Power 180D-1U Mid Tower ATX Case. Category: Casing. Subcategory: Component. Price: 2,550৳2,750৳.
",149,216074,216223
1564,sentence,"Subcategory: Component. Price: 2,550৳2,750৳.

Product: PC Power 180O Mid-Tower ATX Desktop Casing. Category: Casing. Subcategory: Component. Price: 2,600৳2,800৳.
",162,216178,216340
1565,sentence,"Subcategory: Component. Price: 2,600৳2,800৳.

Product: PC Power 180J Mid-Tower ATX Desktop Casing. Category: Casing. Subcategory: Component. Price: 2,450৳2,800৳.
",162,216295,216457
1566,sentence,"Subcategory: Component. Price: 2,450৳2,800৳.

Product: PC Power PC404 Mid Tower ATX Casing With Power Supply. Category: Casing. Subcategory: Component. Price: 2,500৳2,800৳.
",173,216412,216585
1567,sentence,"Subcategory: Component. Price: 2,500৳2,800৳.

Product: PC Power 180D-2U Mid Tower ATX Case. Category: Casing. Subcategory: Component. Price: 2,600৳2,800৳.
",155,216540,216695
1568,sentence,"Subcategory: Component. Price: 2,600৳2,800৳.

Product: 1STPLAYER MC1 mATX Gaming Casing With 200W PSU. Category: Casing. Subcategory: Component. Price: 2,500৳2,800৳.
",166,216650,216816
1569,sentence,"Subcategory: Component. Price: 2,500৳2,800৳.

Product: PC Power Pulse Fire X2 m-ATX Mid Tower Casing with 200W PSU. Category: Casing. Subcategory: Component. Price: 2,700৳2,800৳.
",179,216771,216950
1570,sentence,"Subcategory: Component. Price: 2,700৳2,800৳.

Product: PC Power 180I Mid-Tower ATX Desktop Casing. Category: Casing. Subcategory: Component. Price: 2,850৳.
",156,216905,217061
1571,sentence,"Subcategory: Component. Price: 2,850৳.

Product: Gamdias MARS E4M mATX Micro Tower Casing With PSU. Category: Casing. Subcategory: Component. Price: 2,900৳.
",157,217022,217179
1572,sentence,"Subcategory: Component. Price: 2,900৳.

Product: Arctic P12 Silent 120 mm Low Noise Casing Fan. Category: Casing Cooler. Subcategory: Component. Price: 1,000৳1,100৳.
",166,217140,217306
1573,sentence,"Subcategory: Component. Price: 1,000৳1,100৳.

Product: Arctic F12 PWM PST 120 mm Casing Fan. Category: Casing Cooler. Subcategory: Component. Price: 1,300৳1,350৳.
",163,217261,217424
1574,sentence,"Subcategory: Component. Price: 1,300৳1,350৳.

Product: Xtreme XJOGOS CF31R 3 In 1 ARGB Casing Fan With Remote Controller. Category: Casing Cooler. Subcategory: Component. Price: 1,399৳1,500৳.
",192,217379,217571
1575,sentence,"Subcategory: Component. Price: 1,399৳1,500৳.

Product: MaxGreen M59 ARGB 3 in 1 120mm Casing Fan. Category: Casing Cooler. Subcategory: Component. Price: 1,500৳.
",162,217526,217688
1576,sentence,"Subcategory: Component. Price: 1,500৳.

Product: LITE-ON 8x Slim Internal Laptop DVD Burner. Category: Internal Optical Disk Drive. Subcategory: Optical Disk Drive. Price: Up Coming.
",183,217649,217832
1577,sentence,"Price: Up Coming.

Product: LITE-ON 24X SATA Internal DVD Burner. Category: Internal Optical Disk Drive. Subcategory: Optical Disk Drive. Price: Out Of Stock.
",159,217814,217973
1578,sentence,"Price: Out Of Stock.

Product: ASUS BW-16D1HT Ultra-fast 16X Blu-ray DVD Writer. Category: Internal Optical Disk Drive. Subcategory: Optical Disk Drive. Price: Out Of Stock.
",174,217952,218126
1579,sentence,"Price: Out Of Stock.

Product: Samsung Internal DVD RW. Category: Internal Optical Disk Drive. Subcategory: Optical Disk Drive. Price: Out Of Stock.

Product: Asus DRW-24D5MT 24x DVDRW SATA. ",191,218105,218296
1580,sentence,"
Product: Asus DRW-24D5MT 24x DVDRW SATA. Category: Internal Optical Disk Drive. Subcategory: Optical Disk Drive. Price: Out Of Stock.

Product: Asus DRW-24B1ST Internal SATA DVD Writer. ",187,218254,218441
1581,sentence,"Category: Internal Optical Disk Drive. Subcategory: Optical Disk Drive. Price: Out Of Stock.

Product: Transcend TS8XDVDS-K Slim External Black DVD Writer. Category: External Optical Disk Drive. ",195,218441,218636
1582,sentence,"Category: External Optical Disk Drive. Subcategory: Optical Disk Drive. Price: 4,200৳4,400৳.

Product: ASUS ZenDrive SDRW-08U8M-U External DVD Drive. Category: External Optical Disk Drive. ",189,218597,218786
1583,sentence,"Category: External Optical Disk Drive. Subcategory: Optical Disk Drive. Price: 4,900৳.

Product: ASUS ZenDrive V1M External DVD Writer. Category: External Optical Disk Drive. ",175,218747,218922
1584,sentence,"Category: External Optical Disk Drive. Subcategory: Optical Disk Drive. Price: 5,600৳.

Product: Orico XD007-BK-BP External CD Driver. Category: External Optical Disk Drive. ",174,218883,219057
1585,sentence,"Category: External Optical Disk Drive. Subcategory: Optical Disk Drive. Price: Out Of Stock.

Product: ORICO XD008 External DVD Writer with Hub. Category: External Optical Disk Drive. ",184,219018,219202
1586,sentence,"Category: External Optical Disk Drive. Subcategory: Optical Disk Drive. Price: Out Of Stock.

Product: ORICO XD010 External DVD Writer with Hub. Category: External Optical Disk Drive. ",184,219163,219347
1587,sentence,"Category: External Optical Disk Drive. Subcategory: Optical Disk Drive. Price: Out Of Stock.

Product: ASUS SDRW-08D2S-U LITE External Slim DVD Writer. Category: External Optical Disk Drive. ",191,219308,219499
1588,sentence,"Category: External Optical Disk Drive. Subcategory: Optical Disk Drive. Price: Out Of Stock.

Product: ASUS ZenDrive SDRW-08U9M-U External DVD Drive. Category: External Optical Disk Drive. ",189,219460,219649
1589,sentence,"Category: External Optical Disk Drive. Subcategory: Optical Disk Drive. Price: Out Of Stock.

Product: ASUS ZenDrive U7M Ultra-Slim Portable External DVD Writer. ",162,219610,219772
1590,sentence,"Category: External Optical Disk Drive. Subcategory: Optical Disk Drive. Price: Out Of Stock.

Product: ASUS ZenDrive SDRW-08U9M-U External DVD Drive Gold. Category: External Optical Disk Drive. ",194,219772,219966
1591,sentence,"Category: External Optical Disk Drive. Subcategory: Optical Disk Drive. Price: Out Of Stock.

Product: ASUS SBW-06D2X-U External Slim Blu-ray DVD Writer. Category: External Optical Disk Drive. ",193,219927,220120
1592,sentence,"Category: External Optical Disk Drive. Subcategory: Optical Disk Drive. Price: Out Of Stock.

Product: Antec AT-HGPUH-ARGB DAGGER ARGB GPU Holder. Category: Vertical Graphics Card Holder. ",188,220081,220269
1593,sentence,"Category: Vertical Graphics Card Holder. Subcategory: Component. Price: 2,500৳.

Product: Antec AT-GPUH-ARGB-TG-BK Tempered Glass ARGB GPU Holder. Category: Vertical Graphics Card Holder. ",188,220228,220416
1594,sentence,"Category: Vertical Graphics Card Holder. Subcategory: Component. Price: 2,600৳.

Product: Antec AT-GPUH-ARGB Aluminum ARGB GPU Holder. Category: Vertical Graphics Card Holder. ",176,220375,220551
1595,sentence,"Category: Vertical Graphics Card Holder. Subcategory: Component. Price: 2,800৳.

Product: DeepCool PCIe 4.0 Vertical GPU Bracket. Category: Vertical Graphics Card Holder. Subcategory: Component. ",195,220510,220705
1596,sentence,"Subcategory: Component. Price: 6,700৳.

Product: NZXT Vertical GPU Mounting Kit. Category: Vertical Graphics Card Holder. Subcategory: Component. Price: 10,000৳.
",162,220681,220843
1597,sentence,"Subcategory: Component. Price: 10,000৳.

Product: Cooler Master PCIe 4.0 x16 300mm Riser Cable. Category: Vertical Graphics Card Holder. Subcategory: Component. Price: Up Coming.
",179,220803,220982
1598,sentence,"Subcategory: Component. Price: Up Coming.

Product: Antec SHIFT White Vertical GPU Bracket With PCI-E 4.0 Riser Cable. Category: Vertical Graphics Card Holder. Subcategory: Component. ",184,220940,221124
1599,sentence,"Subcategory: Component. Price: Up Coming.

Product: Antec AT-IGPUH-BK I Shape GPU Holder. Category: Vertical Graphics Card Holder. Subcategory: Component. Price: Out Of Stock.
",176,221100,221276
1600,sentence,"Subcategory: Component. Price: Out Of Stock.

Product: DeepCool ST500 ARGB GPU Support Bracket. Category: Vertical Graphics Card Holder. Subcategory: Component. Price: Out Of Stock.
",182,221231,221413
1601,sentence,"Subcategory: Component. Price: Out Of Stock.

Product: Cooler Master ARGB GPU Support Bracket. Category: Vertical Graphics Card Holder. Subcategory: Component. Price: Out Of Stock.
",181,221368,221549
1602,sentence,"Subcategory: Component. Price: Out Of Stock.

Product: Antec RTX40 PCIe4.0 Riser Cable Vertical Bracket Kit. Category: Vertical Graphics Card Holder. Subcategory: Component. Price: Out Of Stock.
",195,221504,221699
1603,sentence,"Subcategory: Component. Price: Out Of Stock.

Product: Antec RTX40 PCIe4.0 Riser Cable Vertical Bracket Kit White. Category: Vertical Graphics Card Holder. Subcategory: Component. ",180,221654,221834
1604,sentence,"Subcategory: Component. Price: Out Of Stock.

Product: CORSAIR PREMIUM PCIE 3.0 X16 EXTENSION 300MM CABLE. Category: Vertical Graphics Card Holder. Subcategory: Component. Price: Out Of Stock.
",193,221810,222003
1605,sentence,"Subcategory: Component. Price: Out Of Stock.

Product: Asus RS200 ROG Strix Riser Cable. Category: Vertical Graphics Card Holder. Subcategory: Component. Price: Out Of Stock.
",175,221958,222133
1606,sentence,"Subcategory: Component. Price: Out Of Stock.

Product: Antec SHIFT Vertical GPU Bracket With PCI-E 4.0 Riser Cable. Category: Vertical Graphics Card Holder. Subcategory: Component. ",181,222088,222269
1607,sentence,"Subcategory: Component. Price: Out Of Stock.

Product: ASUS XH01 ROG Herculx Graphics Card Holder. Category: Vertical Graphics Card Holder. Subcategory: Component. Price: Out Of Stock.
",185,222245,222430
1608,sentence,"Subcategory: Component. Price: Out Of Stock.

Product: Cooler Master Universal Vertical Graphics Card Holder Kit V2 (PCIe 4.0). Category: Vertical Graphics Card Holder. Subcategory: Component. ",193,222385,222578
1609,sentence,"Subcategory: Component. Price: Out Of Stock.

Product: Cooler Master Vertical Graphics Card Holder Kit V3 (PCIe 4.0). Category: Vertical Graphics Card Holder. Subcategory: Component. ",183,222554,222737
1610,sentence,"Subcategory: Component. Price: Out Of Stock.

Product: Cooler Master White Vertical Graphics Card Holder Kit V3 (PCIe 4.0). Category: Vertical Graphics Card Holder. Subcategory: Component. ",189,222713,222902
1611,sentence,"Subcategory: Component. Price: Out Of Stock.

Product: SANTAK Robust R650 650VA Offline UPS. Category: SANTAK. Subcategory: UPS. Price: 4,500৳4,850৳.
",150,222878,223028
1612,sentence,"Subcategory: UPS. Price: 4,500৳4,850৳.

Product: SANTAK Robust R1200 1200VA Offline UPS. Category: SANTAK. Subcategory: UPS. Price: Out Of Stock.
",146,222989,223135
1613,sentence,"Subcategory: UPS. Price: Out Of Stock.

Product: PC Power PCMU1018P 8800mAh Mini UPS For Router. Category: Power. Price: 1,584৳1,800৳.
",135,223096,223231
1614,sentence,"Category: Power. Price: 1,584৳1,800৳.

Product: PC Power PCMU1018 8800mAh Multifunction Mini UPS For Router. Category: Power. Price: 1,760৳2,000৳.

Product: Marsriva KP1 EC 18W 8000mAh Mini DC UPS. ",198,223193,223391
1615,sentence,"Category: Power. Price: 1,892৳2,150৳.

Product: PC Power PCMU1018LCD 8800mAh Mini UPS For Router. Category: Power. Price: 2,300৳.

Product: PC Power PCMU1018LED 10400mAh Mini UPS For Router. ",191,223391,223582
1616,sentence,"Category: Power. Price: 2,075৳2,300৳.

Product: MARSRIVA KP3 10000mAh Smart Mini DC UPS for Router. Category: Power. Price: 2,050৳2,500৳.

Product: PC Power PCMU1018LCD 10400mAh Mini UPS For Router. ",199,223582,223781
1617,sentence,"Category: Power. Price: 2,600৳.

Product: PC Power PCMU1018LED 13200mAh Mini UPS For Router. Category: Power. Price: 2,288৳2,600৳.

Product: PC Power PCMU1018LCD 13200mAh Mini UPS For Router. ",192,223781,223973
1618,sentence,"Category: Power. Price: 2,800৳2,950৳.

Product: PC Power PCMU1018LL 20000mAh Mini UPS For Router. Category: Power. Price: 3,200৳.

Product: Digital X 650VA Offline UPS. Category: Power. ",186,223973,224159
1619,sentence,"Category: Power. Price: 3,250৳3,300৳.

Product: APOLLO 650VA 300W UPS. Category: Power. Price: 3,196৳3,499৳.

Product: Prolink 650VA Offline UPS. Category: Power. Price: 3,060৳3,600৳.
",184,224142,224326
1620,sentence,"Category: Power. Price: 3,060৳3,600৳.

Product: Dahua 650VA Offline UPS. Category: Power. Price: 3,250৳3,600৳.

Product: Vertiv ITON CX 650VA Offline UPS. Category: Power. Price: 3,600৳.
",187,224288,224475
1621,sentence,"Category: Power. Price: 3,600৳.

Product: Marsriva MR-UF650 650VA Offline UPS. Category: Power. Price: 3,600৳.

Product: MaxGreen MG-LI-EAP-650VA 650VA Offline UPS. Category: Power. Price: 3,700৳.
",197,224443,224640
1622,sentence,"Category: Power. Price: 3,700৳.

Product: Marsriva MR-UF750 750VA Smart Line-Interactive UPS. Category: Power. Price: 3,300৳3,800৳.

Product: Digital X 850VA Offline UPS. Category: Power. ",188,224608,224796
1623,sentence,"Category: Power. Price: 3,999৳4,300৳.

Product: Marsriva KP1 Ultra 30W 16000mAh Mini DC UPS. Category: Power. Price: 3,780৳4,500৳.

Product: MaxGreen MG-LI-EAP-1200VA 1200VA Offline UPS. ",187,224779,224966
1624,sentence,"Category: MaxGreen. Subcategory: UPS. Price: 6,900৳.

Product: MaxGreen MG-LI-EAP 1500VA Offline UPS. Category: MaxGreen. Subcategory: UPS. Price: 10,900৳.
",156,224966,225122
1625,sentence,"Subcategory: UPS. Price: 10,900৳.

Product: MaxGreen MG-LI-EAP-2000VA 2000VA UPS. Category: MaxGreen. Subcategory: UPS. Price: 13,500৳.

Product: MaxGreen MG-LI-KSP 850VA Offline UPS. ",184,225088,225272
1626,sentence,"
Product: MaxGreen MG-LI-KSP 850VA Offline UPS. Category: MaxGreen. Subcategory: UPS. Price: Out Of Stock.

Product: MaxGreen 850VA Offline UPS. Category: MaxGreen. Subcategory: UPS. ",183,225224,225407
1627,sentence,"Category: MaxGreen. Subcategory: UPS. Price: Out Of Stock.

Product: MaxGreen MG-LI-KSP 1200VA Offline UPS. Category: MaxGreen. Subcategory: UPS. Price: Out Of Stock.
",167,225369,225536
1628,sentence,"Subcategory: UPS. Price: Out Of Stock.

Product: MaxGreen MG-LI-KSP 1500VA Offline UPS. Category: MaxGreen. Subcategory: UPS. Price: Out Of Stock.

Product: MaxGreen MG-LI-KSP 2000VA Offline UPS. ",196,225497,225693
1629,sentence,"
Product: MaxGreen MG-LI-KSP 2000VA Offline UPS. Category: MaxGreen. Subcategory: UPS. Price: Out Of Stock.

Product: Prolink 1200VA Offline UPS. Category: Prolink. Subcategory: UPS. Price: 6,800৳.
",198,225644,225842
1630,sentence,"Subcategory: UPS. Price: 6,800৳.

Product: Prolink 1500VA Offline UPS. Category: Prolink. Subcategory: UPS. Price: 10,200৳11,000৳.

Product: Prolink 2000VA Offline UPS. Category: Prolink. ",188,225809,225997
1631,sentence,"Category: Prolink. Subcategory: UPS. Price: Out Of Stock.

Product: Prolink 3000VA Offline UPS. Category: Prolink. Subcategory: UPS. Price: Out Of Stock.
",154,225978,226132
1632,sentence,"Subcategory: UPS. Price: Out Of Stock.

Product: Gigasonic RDA-1705M 17 Inch HDMI LED Square Monitor. Category: Monitor. Price: 4,500৳4,800৳.

Product: Gigasonic RB-G19S-300C 19"" HD LED Monitor. ",195,226093,226288
1633,sentence,"Category: Monitor. Price: 5,800৳.

Product: Gigasonic RB-G195S-300C 19.5"" HD LED Monitor. Category: Monitor. Price: 5,900৳.

Product: Acer K202Q BI 19.5 Inch HD+ Monitor. Category: Monitor. ",190,226288,226478
1634,sentence,"Category: Monitor. Price: 8,200৳.

Product: Walton WDF13C22I 21.45"" 100Hz FHD IPS Monitor. Category: Monitor. Price: Up Coming.
",128,226459,226587
1635,sentence,"Category: Monitor. Price: Up Coming.

Product: Gigasonic GS-21.5FHD500S8 21.5"" 100Hz FHD IPS Gaming Monitor. Category: Monitor. Price: 8,600৳.

Product: Dahua DHI-LM19-A202Y 18.5"" HD Monitor. ",192,226550,226742
1636,sentence,"
Product: Dahua DHI-LM19-A202Y 18.5"" HD Monitor. Category: Monitor. Price: 8,800৳8,900৳.

Product: Viewsonic VA2025-H 20” WSXGA 60Hz LED Monitor. Category: Monitor. Price: 9,500৳.
",180,226693,226873
1637,sentence,"Category: Monitor. Price: 9,500৳.

Product: Hikvision DS-D5022F2-2P2/CBD 21.5"" 100Hz Full HD IPS Monitor. Category: Monitor. Price: 8,900৳10,300৳.
",147,226839,226986
1638,sentence,"Category: Monitor. Price: 8,900৳10,300৳.

Product: Dahua DHI-LM22-A201YFS 21.45"" IPS Full HD 100Hz Monitor. Category: Monitor. Price: 9,000৳10,900৳.
",149,226945,227094
1639,sentence,"Category: Monitor. Price: 9,000৳10,900৳.

Product: Walton WD215I10 21.45"" 100Hz FHD IPS Monitor. Category: Monitor. Price: 8,450৳9,750৳.

Product: PC Power PCGM-King22 21.45"" IPS FHD 100Hz Monitor. ",198,227053,227251
1640,sentence,"Category: Monitor. Price: 9,800৳.

Product: Lenovo D19-10 18.5 Inch HD HDMI VGA Monitor. Category: Monitor. Price: 9,500৳9,700৳.

Product: Xiaomi Redmi V22FAB-RA 21.45"" FHD Monitor. ",182,227251,227433
1641,sentence,"Category: Monitor. Price: 9,500৳.

Product: Aiwa MF2219-V 21.45"" IPS FHD 100Hz Monitor. Category: Monitor. Price: 9,000৳9,900৳.

Product: Samsung LS19A330NHW 19"" LED Monitor. Category: Monitor. ",194,227433,227627
1642,sentence,"Category: Monitor. Price: 9,100৳9,950৳.

Product: Dell 20 E2020H 19.5-inch 60Hz HD+ Monitor. Category: Monitor. Price: 10,900৳.

Product: PC Power PCGM22 21.45"" IPS FHD 100Hz Borderless Monitor. ",195,227608,227803
1643,sentence,"Category: Monitor. Price: 10,200৳.

Product: Lenovo D20-30 19.5 Inch HD+ HDMI VGA Monitor. Category: Monitor. Price: 9,900৳10,200৳.
",132,227803,227935
1644,sentence,"Category: Monitor. Price: 9,900৳10,200৳.

Product: PC Power PCGM22U 21.5"" IPS FHD 100Hz Borderless Gaming Monitor. Category: Monitor. Price: 10,600৳.
",150,227894,228044
1645,sentence,"Category: Monitor. Price: 10,600৳.

Product: Marsriva MR-UF800 800VA Smart Line-Interactive UPS. Category: UPS. Subcategory: Power. Price: 4,000৳4,500৳.

Product: Digital X 1200VA Offline UPS. ",193,228009,228202
1646,sentence,"
Product: Digital X 1200VA Offline UPS. Category: UPS. Subcategory: Power. Price: 6,080৳6,400৳.

Product: KSTAR 1200VA Offline UPS. Category: UPS. Subcategory: Power. Price: 6,600৳.
",182,228162,228344
1647,sentence,"Subcategory: Power. Price: 6,600৳.

Product: APOLLO 1120F/1120 1200VA Offline UPS. Category: UPS. Subcategory: Power. Price: 6,432৳6,700৳.

Product: Marsriva MR-UF1200 1200VA Offline UPS. ",188,228309,228497
1648,sentence,"
Product: Marsriva MR-UF1200 1200VA Offline UPS. Category: UPS. Subcategory: Power. Price: 6,900৳.

Product: Marsriva MR-UF1250 1250VA Smart Line-Interactive UPS. Category: UPS. Subcategory: Power. ",198,228448,228646
1649,sentence,"Category: UPS. Subcategory: Power. Price: 6,800৳7,000৳.

Product: Vertiv ITON CX 1000VA Offline UPS. Category: UPS. Subcategory: Power. Price: 7,600৳7,900৳.
",157,228611,228768
1650,sentence,"Subcategory: Power. Price: 7,600৳7,900৳.

Product: Marsriva MR-UF2000 2000VA Smart Line-Interactive UPS. Category: MARSRIVA. Subcategory: UPS. Price: 12,999৳14,000৳.
",166,228727,228893
1651,sentence,"Subcategory: UPS. Price: 12,999৳14,000৳.

Product: Marsriva MR-UF3000 3000VA Smart Line-Interactive UPS. Category: MARSRIVA. Subcategory: UPS. Price: 21,800৳24,000৳.
",166,228852,229018
1652,sentence,"Subcategory: UPS. Price: 21,800৳24,000৳.

Product: Apollo 1240 2000VA Offline UPS with Metal Body. Category: Apollo. Subcategory: UPS. Price: Out Of Stock.

Product: Apollo 2000VA Offline UPS. ",193,228977,229170
1653,sentence,"
Product: Apollo 2000VA Offline UPS. Category: Apollo. Subcategory: UPS. Price: Out Of Stock.

Product: KSTAR 650VA Offline UPS. Category: KSTAR. Subcategory: UPS. Price: Out Of Stock.
",185,229133,229318
1654,sentence,"Subcategory: UPS. Price: Out Of Stock.

Product: KSTAR 850VA Offline UPS. Category: KSTAR. Subcategory: UPS. Price: Out Of Stock.

Product: KSTAR UA120 1200VA Offline UPS. Category: KSTAR. ",189,229279,229468
1655,sentence,"Category: KSTAR. Subcategory: UPS. Price: Out Of Stock.

Product: KSTAR UA100 1000VA Offline UPS. Category: KSTAR. Subcategory: UPS. Price: Out Of Stock.

Product: KSTAR 2000VA Offline UPS. ",190,229451,229641
1656,sentence,"
Product: KSTAR 2000VA Offline UPS. Category: KSTAR. Subcategory: UPS. Price: Out Of Stock.

Product: KSTAR 3000VA Line Interactive Offline UPS. Category: KSTAR. Subcategory: UPS. ",180,229605,229785
1657,sentence,"Category: KSTAR. Subcategory: UPS. Price: Out Of Stock.

Product: KSTAR 1500VA Offline UPS. Category: KSTAR. Subcategory: UPS. Price: Out Of Stock.
",148,229750,229898
1658,sentence,"Subcategory: UPS. Price: Out Of Stock.

Product: Apollo 2300HS 3KVA Standard Backup Online UPS. Category: APOLLO. Subcategory: Online UPS. Price: 38,500৳.
",155,229859,230014
1659,sentence,"Subcategory: Online UPS. Price: 38,500৳.

Product: Apollo 2B6K-L 6KVA Long Backup Online UPS. Category: APOLLO. Subcategory: Online UPS. Price: 112,000৳.
",154,229973,230127
1660,sentence,"Subcategory: Online UPS. Price: 112,000৳.

Product: Apollo 2600HS 6KVA Standard Backup Online UPS. Category: APOLLO. Subcategory: Online UPS. Price: 120,000৳.
",159,230085,230244
1661,sentence,"Subcategory: Online UPS. Price: 120,000৳.

Product: Apollo 2B10K-L 10KVA Long Backup Online UPS. Category: APOLLO. Subcategory: Online UPS. Price: 135,500৳.
",157,230202,230359
1662,sentence,"Subcategory: Online UPS. Price: 135,500৳.

Product: Apollo 2B10K 10KVA Standard Backup Online UPS. Category: APOLLO. Subcategory: Online UPS. Price: 158,000৳.
",159,230317,230476
1663,sentence,"Subcategory: Online UPS. Price: 158,000৳.

Product: Apollo 2B15K-L 15KVA Long Backup Online UPS. Category: APOLLO. Subcategory: Online UPS. Price: 212,000৳220,000৳.
",165,230434,230599
1664,sentence,"Price: 212,000৳220,000৳.

Product: Apollo 3P10K 10KVA Long Backup Online UPS. Category: APOLLO. Subcategory: Online UPS. Price: 300,000৳.

Product: Apollo 3P20K-L 20KVA Long Backup Online UPS. ",193,230574,230767
1665,sentence,"Category: APOLLO. Subcategory: Online UPS. Price: 380,000৳.

Product: Apollo 2100HS 1KVA Standard Backup Online UPS. Category: APOLLO. Subcategory: Online UPS. Price: Up Coming.
",178,230767,230945
1666,sentence,"Subcategory: Online UPS. Price: Up Coming.

Product: Apollo 2B6K 6KVA Standard Backup Online UPS. Category: APOLLO. Subcategory: Online UPS. Price: Up Coming.
",159,230902,231061
1667,sentence,"Subcategory: Online UPS. Price: Up Coming.

Product: KSTAR HP930CH 3KVA Long Backup Online UPS (Without Battery). Category: KSTAR. Subcategory: Online UPS. Price: 29,500৳.
",172,231018,231190
1668,sentence,"Subcategory: Online UPS. Price: 29,500৳.

Product: KSTAR HP930CS 3KVA Standard Backup Online UPS. Category: KSTAR. Subcategory: Online UPS. Price: 35,500৳.
",156,231149,231305
1669,sentence,"Subcategory: Online UPS. Price: 35,500৳.

Product: KSTAR MEMO III 6K S 6KVA Standard Backup Online UPS. Category: KSTAR. Subcategory: Online UPS. Price: 87,000৳.
",162,231264,231426
1670,sentence,"Subcategory: Online UPS. Price: 87,000৳.

Product: KSTAR HP960C 6KVA Online UPS. Category: KSTAR. Subcategory: Online UPS. Price: Up Coming.

Product: Kstar Memo Series 6KVA Online Ups. ",186,231385,231571
1671,sentence,"
Product: Kstar Memo Series 6KVA Online Ups. Category: KSTAR. Subcategory: Online UPS. Price: Up Coming.

Product: KSTAR HP910CS 1KVA Standard Backup Online UPS. Category: KSTAR. ",179,231526,231705
1672,sentence,"Category: KSTAR. Subcategory: Online UPS. Price: Up Coming.

Product: KSTAR HP Series 1000VA Online UPS. Category: KSTAR. Subcategory: Online UPS. Price: Out Of Stock.
",168,231688,231856
1673,sentence,"Subcategory: Online UPS. Price: Out Of Stock.

Product: KSTAR MEMO S 2000VA Online UPS with Metal Body. Category: KSTAR. Subcategory: Online UPS. Price: Out Of Stock.
",167,231810,231977
1674,sentence,"Subcategory: Online UPS. Price: Out Of Stock.

Product: KSTAR HP920CS 2KVA Standard Backup Online UPS. Category: KSTAR. Subcategory: Online UPS. Price: Out Of Stock.
",166,231931,232097
1675,sentence,"Subcategory: Online UPS. Price: Out Of Stock.

Product: KSTAR HP Series 2000VA Online UPS. Category: KSTAR. Subcategory: Online UPS. Price: Out Of Stock.
",154,232051,232205
1676,sentence,"Subcategory: Online UPS. Price: Out Of Stock.

Product: Marsriva MR-US1K Energy Efficient 1kVA Online UPS. Category: MARSRIVA. Subcategory: Online UPS. Price: 18,700৳.
",168,232159,232327
1677,sentence,"Subcategory: Online UPS. Price: 18,700৳.

Product: Marsriva MR-US1KRT Energy Efficient 1kVA Online UPS. Category: MARSRIVA. Subcategory: Online UPS. Price: 26,000৳.
",165,232286,232451
1678,sentence,"Subcategory: Online UPS. Price: 26,000৳.

Product: Marsriva MR-US3K Energy Efficient 3kVA Online UPS. Category: MARSRIVA. Subcategory: Online UPS. Price: 35,500৳.
",163,232410,232573
1679,sentence,"Subcategory: Online UPS. Price: 35,500৳.

Product: Marsriva MR-US3KRT-H 3kVA Online UPS Long Backup. Category: MARSRIVA. Subcategory: Online UPS. Price: 38,000৳.
",162,232532,232694
1680,sentence,"Subcategory: Online UPS. Price: 38,000৳.

Product: Marsriva MR-US3KRT Energy Efficient 3kVA Online UPS. Category: MARSRIVA. Subcategory: Online UPS. Price: 45,000৳.
",165,232653,232818
1681,sentence,"Subcategory: Online UPS. Price: 45,000৳.

Product: Marsriva MR-US10KRT-H Energy Efficient 10kVA Online UPS. Category: MARSRIVA. Subcategory: Online UPS. Price: 67,000৳.
",169,232777,232946
1682,sentence,"Subcategory: Online UPS. Price: 67,000৳.

Product: Marsriva MR-US6K Energy Efficient 6kVA Online UPS. Category: MARSRIVA. Subcategory: Online UPS. Price: 88,000৳.
",163,232905,233068
1683,sentence,"Subcategory: Online UPS. Price: 88,000৳.

Product: Marsriva MR-US3320K-H Energy Efficient 20kVA Online UPS. Category: MARSRIVA. Subcategory: Online UPS. Price: 215,000৳220,000৳.
",178,233027,233205
1684,sentence,"Price: 215,000৳220,000৳.

Product: Marsriva MR-US6KRT-H Energy Efficient 6kVA Online UPS. Category: MARSRIVA. Subcategory: Online UPS. Price: Out Of Stock.
",156,233180,233336
1685,sentence,"Subcategory: Online UPS. Price: Out Of Stock.

Product: Marsriva MR-US10K-H Energy Efficient 10kVA Online UPS. Category: MARSRIVA. Subcategory: Online UPS. Price: Out Of Stock.
",177,233290,233467
1686,sentence,"Subcategory: Online UPS. Price: Out Of Stock.

Product: Marsriva MR-US10K Energy Efficient 10kVA Online UPS. Category: MARSRIVA. Subcategory: Online UPS. Price: Out Of Stock.
",175,233421,233596
1687,sentence,"Subcategory: Online UPS. Price: Out Of Stock.

Product: MaxGreen MGOE-W1KS 1KVA Standard Backup Online UPS. Category: MaxGreen. Subcategory: Online UPS. Price: 21,000৳.
",169,233550,233719
1688,sentence,"Subcategory: Online UPS. Price: 21,000৳.

Product: MaxGreen MGOE-W2KS 2KVA Standard Backup Online UPS. Category: MaxGreen. Subcategory: Online UPS. Price: 35,000৳.
",164,233678,233842
1689,sentence,"Subcategory: Online UPS. Price: 35,000৳.

Product: MaxGreen MGOE-W3KS 3KVA Standard Backup Online UPS. Category: MaxGreen. Subcategory: Online UPS. Price: 39,000৳.
",164,233801,233965
1690,sentence,"Subcategory: Online UPS. Price: 39,000৳.

Product: MaxGreen MGO-W6KS 6KVA Standard Backup High-Frequency Online UPS. Category: MaxGreen. Subcategory: Online UPS. Price: 93,000৳.
",178,233924,234102
1691,sentence,"Subcategory: Online UPS. Price: 93,000৳.

Product: MaxGreen B6KS/L 6kVA Low-Frequency Online UPS. Category: MaxGreen. Subcategory: Online UPS. Price: 120,000৳.
",160,234061,234221
1692,sentence,"Subcategory: Online UPS. Price: 120,000৳.

Product: MaxGreen MGO-W10KS 10 KVA Standard Backup High-Frequency Online UPS. Category: MaxGreen. Subcategory: Online UPS. Price: 120,500৳.
",183,234179,234362
1693,sentence,"Subcategory: Online UPS. Price: 120,500৳.

Product: MaxGreen B10KS/L 10kVA Low-Frequency Online UPS. Category: MaxGreen. Subcategory: Online UPS. Price: 165,000৳.
",163,234320,234483
1694,sentence,"Subcategory: Online UPS. Price: 165,000৳.

Product: MaxGreen 3KVA Online UPS Long Backup (96V). Category: MaxGreen. Subcategory: Online UPS. Price: Call for Price.
",164,234441,234605
1695,sentence,"Subcategory: Online UPS. Price: Call for Price.

Product: MaxGreen MGO-S1KS(PX1KL) Online UPS. Category: MaxGreen. Subcategory: Online UPS. Price: Call for Price.
",163,234557,234720
1696,sentence,"Subcategory: Online UPS. Price: Call for Price.

Product: MaxGreen 3B10K 20KVA Low frequency Transformer Base Online UPS. Category: MaxGreen. Subcategory: Online UPS. Price: Call for Price.
",190,234672,234862
1697,sentence,"Subcategory: Online UPS. Price: Call for Price.

Product: MaxGreen 3W20KL 20KVA Standard Backup Online UPS. Category: MaxGreen. Subcategory: Online UPS. Price: Call for Price.
",176,234814,234990
1698,sentence,"Subcategory: Online UPS. Price: Call for Price.

Product: MaxGreen 3W3RX10KL 10kVA Online UPS. Category: MaxGreen. Subcategory: Online UPS. Price: Call for Price.
",163,234942,235105
1699,sentence,"Subcategory: Online UPS. Price: Call for Price.

Product: MaxGreen 3B310-60KVA Low-frequency Transformer Base Online UPS. Category: MaxGreen. Subcategory: Online UPS. Price: Call for Price.
",190,235057,235247
1700,sentence,"Subcategory: Online UPS. Price: Call for Price.

Product: MaxGreen MGO-W1KL 1KVA Long Backup Online UPS. Category: MaxGreen. Subcategory: Online UPS. Price: Call for Price.
",173,235199,235372
1701,sentence,"Subcategory: Online UPS. Price: Call for Price.

Product: MaxGreen MGO-G2031-HF 20KVA High-Frequency Long Back-Up Online UPS. Category: MaxGreen. Subcategory: Online UPS. Price: Call for Price.
",194,235324,235518
1702,sentence,"Subcategory: Online UPS. Price: Call for Price.

Product: MaxGreen MGO-BG6033-LF 60KVA Long Backup Low-Frequency Transformer Base Online UPS. Category: MaxGreen. Subcategory: Online UPS. ",187,235470,235657
1703,sentence,"Category: MaxGreen. Subcategory: Online UPS. Price: Call for Price.

Product: MaxGreen B2033-LF 20KVA Low-Frequency Transformer Base Online UPS. Category: MaxGreen. Subcategory: Online UPS. ",190,235612,235802
1704,sentence,"Category: MaxGreen. Subcategory: Online UPS. Price: Call for Price.

Product: MaxGreen MGO-W3033-LF 30000VA Online UPS. Category: MaxGreen. Subcategory: Online UPS. Price: Call for Price.
",188,235757,235945
1705,sentence,"Subcategory: Online UPS. Price: Call for Price.

Product: MaxGreen W4033-LF 40KVA Online UPS. Category: MaxGreen. Subcategory: Online UPS. Price: Call for Price.
",162,235897,236059
1706,sentence,"Subcategory: Online UPS. Price: Call for Price.

Product: MaxGreen MGOE-W3KL 3KVA Long Backup Online UPS. Category: MaxGreen. Subcategory: Online UPS. Price: Call for Price.
",174,236011,236185
1707,sentence,"Subcategory: Online UPS. Price: Call for Price.

Product: Power Pac 650VA Offline UPS. Category: Power Pac. Subcategory: UPS. Price: Out Of Stock.
",147,236137,236284
1708,sentence,"Subcategory: UPS. Price: Out Of Stock.

Product: Power Pac 1200VA Offline UPS (Plastic Body). Category: Power Pac. Subcategory: UPS. Price: Out Of Stock.

Product: Power Pac 2000VA Offline UPS. ",194,236245,236439
1709,sentence,"
Product: Power Pac 2000VA Offline UPS. Category: Power Pac. Subcategory: UPS. Price: Out Of Stock.

Product: Power Pac 1500VA Offline UPS. Category: Power Pac. Subcategory: UPS. ",179,236399,236578
1710,sentence,"Category: Power Pac. Subcategory: UPS. Price: Out Of Stock.

Product: Vertiv Liebert GXT MT+CX 1KVA Standard Backup Online UPS. Category: Vertiv. Subcategory: Online UPS. Price: 31,500৳34,000৳.
",194,236539,236733
1711,sentence,"Subcategory: Online UPS. Price: 31,500৳34,000৳.

Product: Vertiv Liebert GXT MT+EX 3KVA Online UPS. Category: Vertiv. Subcategory: Online UPS. Price: 52,000৳.
",159,236685,236844
1712,sentence,"Subcategory: Online UPS. Price: 52,000৳.

Product: Vertiv Liebert GXT MT+EX 6KVA Online UPS. Category: Vertiv. Subcategory: Online UPS. Price: 190,000৳.
",153,236803,236956
1713,sentence,"Subcategory: Online UPS. Price: 190,000৳.

Product: Vertiv Liebert GXT MT+ 6KVA Online UPS. Category: Vertiv. Subcategory: Online UPS. Price: Call for Price.
",158,236914,237072
1714,sentence,"Subcategory: Online UPS. Price: Call for Price.

Product: Vertiv Liebert GXT MT+ 10KVA Online UPS. Category: Vertiv. Subcategory: Online UPS. Price: Call for Price.
",165,237024,237189
1715,sentence,"Subcategory: Online UPS. Price: Call for Price.

Product: Power Pac 1KVA Online UPS. Category: Online UPS. Subcategory: Power. Price: 24,500৳.

Product: Power Pac 3KVA Online UPS. ",180,237141,237321
1716,sentence,"
Product: Power Pac 3KVA Online UPS. Category: Online UPS. Subcategory: Power. Price: 40,500৳.

Product: Zigor Volga NG+3 3KVA Online UPS. Category: Online UPS. Subcategory: Power. Price: 51,000৳.
",197,237284,237481
1717,sentence,"Subcategory: Power. Price: 51,000৳.

Product: SANTAK Castle Rack 6K 6000VA Standard Backup Online UPS. Category: SANTAK. Subcategory: Online UPS. Price: 195,000৳.
",163,237445,237608
1718,sentence,"Subcategory: Online UPS. Price: 195,000৳.

Product: SANTAK Castle C2KS 2000VA Long Backup Online UPS. Category: SANTAK. Subcategory: Online UPS. Price: Call for Price.
",168,237566,237734
1719,sentence,"Subcategory: Online UPS. Price: Call for Price.

Product: SANTAK Castle C10KS 10000VA Long Backup Online UPS. Category: SANTAK. Subcategory: Online UPS. Price: Call for Price.
",176,237686,237862
1720,sentence,"Subcategory: Online UPS. Price: Call for Price.

Product: SANTAK Castle C2K 2000VA Standard Backup Online UPS. Category: SANTAK. Subcategory: Online UPS. Price: Out Of Stock.
",175,237814,237989
1721,sentence,"Subcategory: Online UPS. Price: Out Of Stock.

Product: SANTAK Castle C1K 1000VA Standard Backup Online UPS. Category: SANTAK. Subcategory: Online UPS. Price: 34,000৳.
",168,237943,238111
1722,sentence,"Subcategory: Online UPS. Price: 34,000৳.

Product: SANTAK Castle C3KS 3000VA Long Backup Online UPS. Category: SANTAK. Subcategory: Online UPS. Price: Call for Price.
",167,238070,238237
1723,sentence,"Subcategory: Online UPS. Price: Call for Price.

Product: SANTAK Castle C3K 3000VA Standard Backup Online UPS. Category: SANTAK. Subcategory: Online UPS. Price: 61,000৳.
",170,238189,238359
1724,sentence,"Subcategory: Online UPS. Price: 61,000৳.

Product: SANTAK Castle Rack 3K 3000VA Standard Backup Online UPS. Category: SANTAK. Subcategory: Online UPS. Price: 73,000৳.
",167,238318,238485
1725,sentence,"Subcategory: Online UPS. Price: 73,000৳.

Product: SANTAK Castle C6KS 6000VA Long Backup Online UPS. Category: SANTAK. Subcategory: Online UPS. Price: Call for Price.
",167,238444,238611
1726,sentence,"Subcategory: Online UPS. Price: Call for Price.

Product: SANTAK Castle C6K 6000VA Standard Backup Online UPS. Category: SANTAK. Subcategory: Online UPS. Price: 135,000৳.
",171,238563,238734
1727,sentence,"Subcategory: Online UPS. Price: 135,000৳.

Product: ZIGOR Ottawa Pro Online UPS. Category: ZIGOR. Subcategory: Online UPS. Price: Call for Price.

Product: Zigor Volga Ng 1KVA Online UPS. ",188,238692,238880
1728,sentence,"
Product: Zigor Volga Ng 1KVA Online UPS. Category: ZIGOR. Subcategory: Online UPS. Price: Out Of Stock.

Product: Zigor Volga NG+2 2KVA Online UPS. Category: ZIGOR. Subcategory: Online UPS. ",191,238838,239029
1729,sentence,"Category: ZIGOR. Subcategory: Online UPS. Price: Out Of Stock.

Product: APC E3SUPS20KH Easy UPS 3S 20kVA 400V 3:3 Online UPS. Category: APC. Subcategory: Online UPS. Price: Call for Price.
",190,238987,239177
1730,sentence,"Subcategory: Online UPS. Price: Call for Price.

Product: APC SRV3KUXI-IN Easy UPS 2U 3KVA 230V Online UPS. Category: APC. Subcategory: Online UPS. Price: Call for Price.
",171,239129,239300
1731,sentence,"Subcategory: Online UPS. Price: Call for Price.

Product: APC SRV10KUXI-IN 10KVA Online UPS. Category: APC. Subcategory: Online UPS. Price: Call for Price.
",156,239252,239408
1732,sentence,"Subcategory: Online UPS. Price: Call for Price.

Product: APC SRV6KUXI-IN 6kVA 2U Rackmount Online UPS. Category: APC. Subcategory: Online UPS. Price: Call for Price.
",167,239360,239527
1733,sentence,"Subcategory: Online UPS. Price: Call for Price.

Product: Kehua KR1000+ 1KVA Online UPS. Category: Kehua. Subcategory: Online UPS. Price: 22,500৳.
",147,239479,239626
1734,sentence,"Subcategory: Online UPS. Price: 22,500৳.

Product: Power Guard 1KVA PS Standard Backup Online UPS. Category: Power Guard. Subcategory: Online UPS. Price: Up Coming.
",165,239585,239750
1735,sentence,"Subcategory: Online UPS. Price: Up Coming.

Product: Power Guard 6KVA 6000VA 6000W Online UPS. Category: Power Guard. Subcategory: Online UPS. Price: Up Coming.
",161,239707,239868
1736,sentence,"Subcategory: Online UPS. Price: Up Coming.

Product: Power Guard 3KVA PS Standard Backup Online UPS. Category: Power Guard. Subcategory: Online UPS. Price: Out Of Stock.
",170,239825,239995
1737,sentence,"Subcategory: Online UPS. Price: Out Of Stock.

Product: Power Guard 10KVA 10000VA 10000W Online UPS. Category: Power Guard. Subcategory: Online UPS. Price: Out Of Stock.
",170,239949,240119
1738,sentence,"Subcategory: Online UPS. Price: Out Of Stock.

Product: EnSmart Smart BX 3:3 30kVA long-Run Backup Online UPS. Category: EnSmart. Subcategory: Online UPS. Price: Call for Price.
",178,240073,240251
1739,sentence,"Subcategory: Online UPS. Price: Call for Price.

Product: EnSmart Smart Pack RT 3KVA 2700W Standard Backup Online UPS. Category: EnSmart. Subcategory: Online UPS. Price: Call for Price.
",186,240203,240389
1740,sentence,"Subcategory: Online UPS. Price: Call for Price.

Product: EnSmart Smart Pack RT 1KVA 900W Standard Backup Online UPS. Category: EnSmart. Subcategory: Online UPS. Price: 30,000৳.
",178,240341,240519
1741,sentence,"Subcategory: Online UPS. Price: 30,000৳.

Product: MARSRIVA KP7 17600mAh Smart Mini DC UPS for Router. Category: Mini UPS. Subcategory: Power. Price: 6,750৳7,500৳.
",164,240478,240642
1742,sentence,"Subcategory: Power. Price: 6,750৳7,500৳.

Product: Solitine SOL-702Max 20000mAh Mini DC UPS. Category: Mini UPS. Subcategory: Power. Price: 2,500৳.

Product: Solitine SOL-702 12000mAh Mini DC UPS. ",197,240601,240798
1743,sentence,"
Product: Solitine SOL-702 12000mAh Mini DC UPS. Category: Mini UPS. Subcategory: Power. Price: 2,100৳.

Product: Solitine SOL-700BS 20000mAh Mini DC UPS. Category: Mini UPS. Subcategory: Power. ",195,240749,240944
1744,sentence,"Category: Mini UPS. Subcategory: Power. Price: 3,600৳.

Product: Solitine SOL-604 10000mAh Mini DC UPS. Category: Mini UPS. Subcategory: Power. Price: 1,600৳.
",159,240904,241063
1745,sentence,"Subcategory: Power. Price: 1,600৳.

Product: MARSRIVA KP7 Pro 24000mAh Smart Mini DC UPS. Category: Mini UPS. Subcategory: Power. Price: Out Of Stock.
",151,241028,241179
1746,sentence,"Subcategory: Power. Price: Out Of Stock.

Product: MARSRIVA KP7 Pro 84000mAh Smart Mini DC UPS. Category: Mini UPS. Subcategory: Power. Price: 7,458৳7,900৳.
",157,241138,241295
1747,sentence,"Subcategory: Power. Price: 7,458৳7,900৳.

Product: MARSRIVA KP9 20000mAh Smart Mini DC UPS for Router. Category: Mini UPS. Subcategory: Power. Price: Up Coming.
",161,241254,241415
1748,sentence,"Subcategory: Power. Price: Up Coming.

Product: MARSRIVA KP3 EC 8400mAh Smart Mini DC UPS for Router. Category: Mini UPS. Subcategory: Power. Price: Out Of Stock.
",163,241377,241540
1749,sentence,"Subcategory: Power. Price: Out Of Stock.

Product: Power Guard ECO-1825 10000mAh Mini DC UPS for Router. Category: Power Guard. Subcategory: Mini UPS. Price: Out Of Stock.
",172,241499,241671
1750,sentence,"Subcategory: Mini UPS. Price: Out Of Stock.

Product: Power Guard ECO-430-PRO 8000mAh Mini DC UPS for Router. Category: Power Guard. Subcategory: Mini UPS. Price: Out Of Stock.
",177,241627,241804
1751,sentence,"Subcategory: Mini UPS. Price: Out Of Stock.

Product: MARSRIVA KP4 10000mAh Smart Mini DC UPS for Router. Category: MARSRIVA. Subcategory: Mini UPS. Price: Out Of Stock.
",170,241760,241930
1752,sentence,"Subcategory: Mini UPS. Price: Out Of Stock.

Product: MARSRIVA KP2 10000mAh Smart Mini DC UPS for Router. Category: MARSRIVA. Subcategory: Mini UPS. Price: Out Of Stock.
",170,241886,242056
1753,sentence,"Subcategory: Mini UPS. Price: Out Of Stock.

Product: Marsriva KP1 Plus 18W 16000mAh Mini DC UPS. Category: MARSRIVA. Subcategory: Mini UPS. Price: Out Of Stock.
",162,242012,242174
1754,sentence,"Subcategory: Mini UPS. Price: Out Of Stock.

Product: MARSRIVA KP6 Max 20000mAh Smart Mini DC UPS for Router. Category: MARSRIVA. Subcategory: Mini UPS. Price: Out Of Stock.
",174,242130,242304
1755,sentence,"Subcategory: Mini UPS. Price: Out Of Stock.

Product: MARSRIVA KP3 Pro 8400mAh Smart Mini DC UPS for Router. Category: MARSRIVA. Subcategory: Mini UPS. Price: Out Of Stock.
",173,242260,242433
1756,sentence,"Subcategory: Mini UPS. Price: Out Of Stock.

Product: MARSRIVA KP5 8800mAh Smart Mini DC UPS for Router. Category: MARSRIVA. Subcategory: Mini UPS. Price: Out Of Stock.
",169,242389,242558
1757,sentence,"Subcategory: Mini UPS. Price: Out Of Stock.

Product: Marsriva KP2 Ultra 30W 16000mAh Mini DC UPS. Category: MARSRIVA. Subcategory: Mini UPS. Price: Out Of Stock.
",163,242514,242677
1758,sentence,"Subcategory: Mini UPS. Price: Out Of Stock.

Product: MARSRIVA KP9 Pro 24000mAh Smart Mini DC UPS for Router. Category: MARSRIVA. Subcategory: Mini UPS. Price: Out Of Stock.
",174,242633,242807
1759,sentence,"Subcategory: Mini UPS. Price: Out Of Stock.

Product: MARSRIVA KP6 EC 8400mAh Smart Mini DC UPS for Router. Category: MARSRIVA. Subcategory: Mini UPS. Price: Out Of Stock.
",172,242763,242935
1760,sentence,"Subcategory: Mini UPS. Price: Out Of Stock.

Product: EcoFlow RIVER 2 Portable Power Station. Category: Portable Power Station. Subcategory: Power. Price: 25,450৳26,500৳.
",171,242891,243062
1761,sentence,"Subcategory: Power. Price: 25,450৳26,500৳.

Product: EcoFlow River 3 UPS & Portable Power Station. Category: Portable Power Station. Subcategory: Power. Price: 28,450৳29,500৳.
",176,243019,243195
1762,sentence,"Subcategory: Power. Price: 28,450৳29,500৳.

Product: Ecoflow River 2 Max Portable Power Station. Category: Portable Power Station. Subcategory: Power. Price: 45,900৳.
",167,243152,243319
1763,sentence,"Subcategory: Power. Price: 45,900৳.

Product: EcoFlow RIVER 2 Pro Portable Power Station. Category: Portable Power Station. Subcategory: Power. Price: 53,900৳.
",160,243283,243443
1764,sentence,"Subcategory: Power. Price: 53,900৳.

Product: EcoFlow E980 Portable Power Station. Category: Portable Power Station. Subcategory: Power. Price: 54,500৳57,900৳.
",160,243407,243567
1765,sentence,"Subcategory: Power. Price: 54,500৳57,900৳.

Product: Ecoflow Delta 3 Portable Power Station. Category: Portable Power Station. Subcategory: Power. Price: 77,900৳.
",163,243524,243687
1766,sentence,"Subcategory: Power. Price: 77,900৳.

Product: EcoFlow E2000 Portable Power Station. Category: Portable Power Station. Subcategory: Power. Price: 114,900৳.
",155,243651,243806
1767,sentence,"Subcategory: Power. Price: 114,900৳.

Product: Ecoflow Delta 2 Max Portable Power Station. Category: Portable Power Station. Subcategory: Power. Price: 125,900৳.
",162,243769,243931
1768,sentence,"Subcategory: Power. Price: 125,900৳.

Product: EcoFlow DELTA Pro Portable Power Station. Category: Portable Power Station. Subcategory: Power. Price: 224,900৳.
",160,243894,244054
1769,sentence,"Subcategory: Power. Price: 224,900৳.

Product: Ecoflow Delta Pro 3 Portable Power Station. Category: Portable Power Station. Subcategory: Power. Price: 459,900৳.
",162,244017,244179
1770,sentence,"Subcategory: Power. Price: 459,900৳.

Product: Ecoflow Delta 2 Portable Power Station. Category: Portable Power Station. Subcategory: Power. Price: Out Of Stock.
",162,244142,244304
1771,sentence,"Subcategory: Power. Price: Out Of Stock.

Product: LONG WP12-12 12V 12Ah Rechargeable Sealed Lead Acid Battery. Category: UPS Battery. Subcategory: Power. Price: 4,500৳.
",170,244263,244433
1772,sentence,"Subcategory: Power. Price: 4,500৳.

Product: LONG WPS26-12N 12V 26Ah Rechargeable Sealed Lead Acid Battery. Category: UPS Battery. Subcategory: Power. Price: 9,500৳.
",166,244398,244564
1773,sentence,"Subcategory: Power. Price: 9,500৳.

Product: KENSON KS4 4V 4.5AH Rechargeable Sealed Lead Acid Battery. Category: UPS Battery. Subcategory: Power. Price: 400৳.
",160,244529,244689
1774,sentence,"Subcategory: Power. Price: 400৳.

Product: MaxGreen MG12-7.5 12V 7.5A UPS Battery. Category: UPS Battery. Subcategory: Power. Price: 1,300৳1,600৳.

Product: MaxGreen MG12-9 12V 9A UPS Battery. ",193,244656,244849
1775,sentence,"
Product: MaxGreen MG12-9 12V 9A UPS Battery. Category: UPS Battery. Subcategory: Power. Price: 1,500৳1,800৳.

Product: KENSON KS12-9AH 12V 9AH UPS Battery. Category: UPS Battery. ",180,244803,244983
1776,sentence,"Category: UPS Battery. Subcategory: Power. Price: 1,800৳.

Product: LONG LG7-12 12V 7Ah Rechargeable Sealed Lead Acid Battery. Category: UPS Battery. Subcategory: Power. Price: 2,250৳.
",185,244960,245145
1777,sentence,"Subcategory: Power. Price: 2,250৳.

Product: KENSON KS12 12V 12AH UPS Battery. Category: UPS Battery. Subcategory: Power. Price: 2,400৳.

Product: KENSON KS12 12V 18AH UPS Battery. ",181,245110,245291
1778,sentence,"
Product: KENSON KS12 12V 18AH UPS Battery. Category: UPS Battery. Subcategory: Power. Price: 4,000৳.

Product: MaxGreen MG12-18 12V 18A UPS Battery. Category: UPS Battery. Subcategory: Power. ",193,245247,245440
1779,sentence,"Category: UPS Battery. Subcategory: Power. Price: 4,800৳.

Product: Power Guard SS18-12 12V 18Ah UPS Battery. Category: UPS Battery. Subcategory: Power. Price: 4,000৳.
",168,245397,245565
1780,sentence,"Subcategory: Power. Price: 4,000৳.

Product: KENSON KS12-26AH 12V 26AH UPS Battery. Category: UPS Battery. Subcategory: Power. Price: 5,500৳.

Product: MaxGreen MG12-26 12V 26A UPS Battery. ",190,245530,245720
1781,sentence,"
Product: MaxGreen MG12-26 12V 26A UPS Battery. Category: UPS Battery. Subcategory: Power. Price: 5,500৳.

Product: Leoch LP12-18 (12V 18Ah) Sealed Lead Acid Battery. Category: UPS Battery. ",190,245672,245862
1782,sentence,"Category: UPS Battery. Subcategory: Power. Price: 6,000৳.

Product: LONG WP18-12SHR 12V 18Ah Rechargeable Sealed Lead Acid Battery. Category: UPS Battery. Subcategory: Power. Price: 6,700৳7,000৳.
",196,245839,246035
1783,sentence,"Subcategory: Power. Price: 6,700৳7,000৳.

Product: KENSON KS12 12V 40AH UPS Battery. Category: UPS Battery. Subcategory: Power. Price: 7,100৳.

Product: KENSON KS12 12V 65AH UPS Battery. ",187,245994,246181
1784,sentence,"
Product: KENSON KS12 12V 65AH UPS Battery. Category: UPS Battery. Subcategory: Power. Price: 12,000৳.

Product: Leoch LP12-40 (12V 40Ah) Sealed Lead Acid Battery. Category: UPS Battery. ",187,246137,246324
1785,sentence,"Category: UPS Battery. Subcategory: Power. Price: 14,000৳.

Product: MaxGreen MG12-65 12V 65Ah UPS Battery. Category: UPS Battery. Subcategory: Power. Price: 14,500৳.
",167,246301,246468
1786,sentence,"Subcategory: Power. Price: 14,500৳.

Product: KENSON KS12 12V 70AH UPS Battery. Category: UPS Battery. Subcategory: Power. Price: 15,000৳.
",139,246432,246571
1787,sentence,"Subcategory: Power. Price: 15,000৳.

Product: Tecnoware 18KVA Electronic Single Phase Stabilizer. Category: Voltage Stabilizer. Subcategory: Power. Price: 78,000৳.
",164,246535,246699
1788,sentence,"Subcategory: Power. Price: 78,000৳.

Product: Tecnoware 25KVA Electronic Three Phase Stabilizer (Origin Italy). Category: Voltage Stabilizer. Subcategory: Power. Price: 95,000৳.
",178,246663,246841
1789,sentence,"Subcategory: Power. Price: 95,000৳.

Product: Tecnoware FSTEL75KT 75KVA Electronic Three Phase Stabilizer (Origin Italy). Category: Voltage Stabilizer. Subcategory: Power. Price: Call for Price.
",195,246805,247000
1790,sentence,"Subcategory: Power. Price: Call for Price.

Product: Star 600VA Stabilizer. Category: Voltage Stabilizer. Subcategory: Power. Price: Out Of Stock.

Product: Star 600VA LED Display Stabilizer. ",192,246957,247149
1791,sentence,"
Product: Star 600VA LED Display Stabilizer. Category: Voltage Stabilizer. Subcategory: Power. Price: Out Of Stock.

Product: Star 1000VA Meter Display Stabilizer. Category: Voltage Stabilizer. ",194,247104,247298
1792,sentence,"Category: Voltage Stabilizer. Subcategory: Power. Price: Out Of Stock.

Product: Star 2000VA Meter Display Stabilizer. Category: Voltage Stabilizer. Subcategory: Power. Price: Out Of Stock.
",190,247268,247458
1793,sentence,"Subcategory: Power. Price: Out Of Stock.

Product: Tecnoware 3000VA Power Reg Stabilizer. Category: Voltage Stabilizer. Subcategory: Power. Price: Out Of Stock.
",161,247417,247578
1794,sentence,"Subcategory: Power. Price: Out Of Stock.

Product: Tecnoware 9KVA Electronic Single Phase Stabilizer. Category: Voltage Stabilizer. Subcategory: Power. Price: Out Of Stock.
",173,247537,247710
1795,sentence,"Subcategory: Power. Price: Out Of Stock.

Product: Tecnoware 12KVA Electronic Single Phase Stabilizer. Category: Voltage Stabilizer. Subcategory: Power. Price: Out Of Stock.
",174,247669,247843
1796,sentence,"Subcategory: Power. Price: Out Of Stock.

Product: Tecnoware 35KVA Electronic Three Phase Stabilizer (Origin Italy). Category: Voltage Stabilizer. Subcategory: Power. Price: Out Of Stock.
",188,247802,247990
1797,sentence,"Subcategory: Power. Price: Out Of Stock.

Product: Exide GQP 1125VA Pure Sine Wave IPS Without Battery. Category: IPS. Subcategory: Power. Price: 16,000৳.
",155,247949,248104
1798,sentence,"Subcategory: Power. Price: 16,000৳.

Product: NPTE 200VA Pure Sine Wave IPS With Battery. Category: IPS. Subcategory: Power. Price: 18,300৳.

Product: Exide 700VA Pure Sine Wave IPS With Battery. ",196,248068,248264
1799,sentence,"Category: IPS. Subcategory: Power. Price: 27,800৳.

Product: Exide Star 700VA Pure Sine Wave IPS With Battery. Category: IPS. Subcategory: Power. Price: 32,900৳.
",162,248264,248426
1800,sentence,"Subcategory: Power. Price: 32,900৳.

Product: Hithium HeroEE 1 1kWh Portable IPS. Category: IPS. Subcategory: Power. Price: 32,500৳37,800৳.
",140,248390,248530
1801,sentence,"Subcategory: Power. Price: 32,500৳37,800৳.

Product: Exide Star 900VA Pure Sine Wave IPS With Battery. Category: IPS. Subcategory: Power. Price: 37,950৳.
",154,248487,248641
1802,sentence,"Subcategory: Power. Price: 37,950৳.

Product: Exide GQP 1125VA Pure Sine Wave IPS With Battery. Category: IPS. Subcategory: Power. Price: 46,800৳.
",147,248605,248752
1803,sentence,"Subcategory: Power. Price: 46,800৳.

Product: Luminous Eco Volt Neo 1150VA Non Sine Wave IPS With Battery. Category: IPS. Subcategory: Power. Price: 46,800৳.
",158,248716,248874
1804,sentence,"Subcategory: Power. Price: 46,800৳.

Product: Exide Star 1225VA Pure Sine Wave IPS With Battery. Category: IPS. Subcategory: Power. Price: 48,000৳.
",148,248838,248986
1805,sentence,"Subcategory: Power. Price: 48,000৳.

Product: Exide Star 1625VA Pure Sine Wave IPS With Battery. Category: IPS. Subcategory: Power. Price: 63,250৳.
",148,248950,249098
1806,sentence,"Subcategory: Power. Price: 63,250৳.

Product: Exide Star 2550VA Pure Sine Wave IPS With Battery. Category: IPS. Subcategory: Power. Price: 78,400৳.

Product: Hithium HeroEE 2 2kWh Portable IPS. ",194,249062,249256
1807,sentence,"
Product: Hithium HeroEE 2 2kWh Portable IPS. Category: IPS. Subcategory: Power. Price: 76,500৳85,000৳.

Product: Luminous Eco Watt Neo 2300VA Pure Sine Wave IPS With Battery. Category: IPS. ",191,249210,249401
1808,sentence,"Category: IPS. Subcategory: Power. Price: 87,400৳.

Product: Luminous Eco Volt Neo 2800VA Pure Sine Wave IPS With Battery. Category: IPS. Subcategory: Power. Price: 139,000৳.
",175,249386,249561
1809,sentence,"Subcategory: Power. Price: 139,000৳.

Product: EcoFlow 45W Portable Solar Panel. Category: Solar Panel. Subcategory: Power. Price: 6,500৳.

Product: EcoFlow 60W Portable Solar Panel. ",183,249524,249707
1810,sentence,"
Product: EcoFlow 60W Portable Solar Panel. Category: Solar Panel. Subcategory: Power. Price: 9,500৳.

Product: EcoFlow 110W Portable Solar Panel. Category: Solar Panel. Subcategory: Power. ",190,249663,249853
1811,sentence,"Category: Solar Panel. Subcategory: Power. Price: 15,500৳.

Product: EcoFlow 125W Portable Solar Panel. Category: Solar Panel. Subcategory: Power. Price: 17,100৳.
",163,249810,249973
1812,sentence,"Subcategory: Power. Price: 17,100৳.

Product: EcoFlow 160W Portable Solar Panel. Category: Solar Panel. Subcategory: Power. Price: 24,300৳.

Product: EcoFlow 220W Portable Solar Panel. ",185,249937,250122
1813,sentence,"
Product: EcoFlow 220W Portable Solar Panel. Category: Solar Panel. Subcategory: Power. Price: 33,100৳.

Product: EcoFlow 400W Portable Solar Panel. Category: Solar Panel. Subcategory: Power. ",192,250077,250269
1814,sentence,"Category: Solar Panel. Subcategory: Power. Price: Out Of Stock.

Product: Symphony B80. Category: Phone. Price: 990৳.

Product: Symphony A30. Category: Phone. Price: 999৳.

Product: Symphony D89. ",196,250226,250422
1815,sentence,"Price: 999৳.

Product: Symphony D89. Category: Phone. Price: 1,290৳.

Product: Symphony L34. Category: Phone. Price: 1,350৳.

Product: Walton Olvio E100. Category: Phone. Price: 1,450৳.
",186,250385,250571
1816,sentence,"Category: Phone. Price: 1,450৳.

Product: Symphony D54 Pro. Category: Phone. Price: 1,499৳.

Product: Symphony T94. Category: Phone. Price: 1,550৳.

Product: Symphony L280. Category: Phone. ",190,250539,250729
1817,sentence,"
Product: Symphony L280. Category: Phone. Price: 1,599৳.

Product: TCL Onetouch 4021. Category: Phone. Price: 1,600৳.

Product: Symphony FiRE30. Category: Phone. Price: 1,699৳.
",177,250687,250864
1818,sentence,"Category: Phone. Price: 1,699৳.

Product: Symphony S75. Category: Phone. Price: 1,799৳.

Product: Symphony S72. Category: Phone. Price: 1,899৳.

Product: XTRA X10. Category: Phone. ",181,250832,251013
1819,sentence,"
Product: XTRA X10. Category: Phone. Price: 1,990৳2,199৳.

Product: Symphony S80. Category: Phone. Price: 2,199৳.

Product: Symphony EVO 10. Category: Phone. Price: 2,250৳.
",173,250976,251149
1820,sentence,"Category: Phone. Price: 2,250৳.

Product: Nokia 105 DS (2023). Category: Phone. Price: 2,350৳.

Product: Nokia 106 DS (2023). Category: Phone. Price: 2,440৳.

Product: XTRA R24. Category: Phone. ",195,251117,251312
1821,sentence,"
Product: XTRA R24. Category: Phone. Price: 2,499৳.

Product: Symphony G26 (2/32GB). Category: Phone. Price: 6,550৳6,699৳.

Product: Symphony Max 10. Category: Phone. Price: 6,650৳6,999৳.
",188,251275,251463
1822,sentence,"Category: Phone. Price: 6,650৳6,999৳.

Product: iPhone 16. Category: iPhone. Subcategory: Phone. Price: 142,000৳169,999৳.

Product: iPhone 15 Plus. Category: iPhone. Subcategory: Phone. ",186,251425,251611
1823,sentence,"Category: iPhone. Subcategory: Phone. Price: 151,000৳199,999৳.

Product: iPhone 16 Pro. Category: iPhone. Subcategory: Phone. Price: 183,000৳209,999৳.

Product: iPhone 15 Pro. Category: iPhone. ",194,251573,251767
1824,sentence,"
Product: iPhone 15 Pro. Category: iPhone. Subcategory: Phone. Price: 182,000৳219,999৳.

Product: iPhone 16 Pro Max. Category: iPhone. Subcategory: Phone. Price: 194,500৳249,999৳.
",180,251724,251904
1825,sentence,"Subcategory: Phone. Price: 194,500৳249,999৳.

Product: iPhone 15 Pro Max. Category: iPhone. Subcategory: Phone. Price: 178,000৳239,999৳.

Product: iPhone 15. Category: iPhone. Subcategory: Phone. ",196,251859,252055
1826,sentence,"Category: iPhone. Subcategory: Phone. Price: Out Of Stock.

Product: iPhone 16 Plus. Category: iPhone. Subcategory: Phone. Price: Out Of Stock.

Product: iPhone 14 Pro Max. Category: iPhone. ",191,252017,252208
1827,sentence,"
Product: iPhone 14 Pro Max. Category: iPhone. Subcategory: Phone. Price: Out Of Stock.

Product: iPhone 16e. Category: iPhone. Subcategory: Phone. Price: Out Of Stock.

Product: OPPO A5x. ",189,252161,252350
1828,sentence,"Price: Out Of Stock.

Product: OPPO A5x. Category: OPPO. Subcategory: Phone. Price: 13,990৳.

Product: OPPO A3. Category: OPPO. Subcategory: Phone. Price: 18,990৳.

Product: OPPO A5. Category: OPPO. ",199,252309,252508
1829,sentence,"
Product: OPPO A5. Category: OPPO. Subcategory: Phone. Price: 19,990৳.

Product: Oppo Reno 12 F 4G (8/256GB). Category: OPPO. Subcategory: Phone. Price: 24,990৳.

Product: OPPO Reno13 F. ",187,252473,252660
1830,sentence,"Price: 24,990৳.

Product: OPPO Reno13 F. Category: OPPO. Subcategory: Phone. Price: 30,990৳.

Product: OPPO Reno12 F 5G. Category: OPPO. Subcategory: Phone. Price: 32,990৳.
",173,252619,252792
1831,sentence,"Subcategory: Phone. Price: 32,990৳.

Product: OPPO Reno14 F 5G. Category: OPPO. Subcategory: Phone. Price: 42,990৳.

Product: OPPO Reno13. Category: OPPO. Subcategory: Phone. Price: Up Coming.
",193,252756,252949
1832,sentence,"Subcategory: Phone. Price: Up Coming.

Product: OPPO A18 (4/128GB). Category: OPPO. Subcategory: Phone. Price: Out Of Stock.

Product: OPPO A3x. Category: OPPO. Subcategory: Phone. ",181,252911,253092
1833,sentence,"Category: OPPO. Subcategory: Phone. Price: Out Of Stock.

Product: OPPO A38 (4/128GB). Category: OPPO. Subcategory: Phone. Price: Out Of Stock.

Product: OPPO A58. Category: OPPO. ",180,253056,253236
1834,sentence,"
Product: OPPO A58. Category: OPPO. Subcategory: Phone. Price: Out Of Stock.

Product: OPPO A60 (8/256GB). Category: OPPO. Subcategory: Phone. Price: Out Of Stock.

Product: OPPO A60 (8/128GB). ",194,253200,253394
1835,sentence,"
Product: OPPO A60 (8/128GB). Category: OPPO. Subcategory: Phone. Price: Out Of Stock.

Product: OPPO A5 Pro. Category: OPPO. Subcategory: Phone. Price: Out Of Stock.

Product: OPPO Reno14 5G. ",193,253364,253557
1836,sentence,"Price: Out Of Stock.

Product: OPPO Reno14 5G. Category: OPPO. Subcategory: Phone. Price: Out Of Stock.

Product: OPPO Reno12 5G (12/512GB). Category: OPPO. Subcategory: Phone. Price: Out Of Stock.
",198,253510,253708
1837,sentence,"Subcategory: Phone. Price: Out Of Stock.

Product: OnePlus Nord CE4 Lite 5G. Category: OnePlus. Subcategory: Phone. Price: 22,990৳23,999৳.

Product: OnePlus Nord CE5 5G. Category: OnePlus. ",189,253667,253856
1838,sentence,"Category: OnePlus. Subcategory: Phone. Price: 34,500৳35,999৳.

Product: OnePlus Nord 5 5G. Category: OnePlus. Subcategory: Phone. Price: 52,000৳53,999৳.

Product: OnePlus 13R. Category: OnePlus. ",195,253837,254032
1839,sentence,"
Product: OnePlus 13R. Category: OnePlus. Subcategory: Phone. Price: Up Coming.

Product: OnePlus 12. Category: OnePlus. Subcategory: Phone. Price: Up Coming.

Product: OnePlus 12R. ",182,253990,254172
1840,sentence,"Price: Up Coming.

Product: OnePlus 12R. Category: OnePlus. Subcategory: Phone. Price: Up Coming.

Product: OnePlus Nord N30 SE 5G. Category: OnePlus. Subcategory: Phone. Price: Out Of Stock.
",192,254131,254323
1841,sentence,"Subcategory: Phone. Price: Out Of Stock.

Product: OnePlus Nord 4. Category: OnePlus. Subcategory: Phone. Price: Out Of Stock.

Product: Google Pixel 7 Pro. Category: Google. Subcategory: Phone. ",195,254282,254477
1842,sentence,"Category: Google. Subcategory: Phone. Price: 57,390৳59,999৳.

Product: Google Pixel 8 Pro. Category: Google. Subcategory: Phone. Price: 76,200৳79,999৳.

Product: Google Pixel 10. Category: Google. ",197,254439,254636
1843,sentence,"
Product: Google Pixel 10. Category: Google. Subcategory: Phone. Price: Up Coming.

Product: Google Pixel 10 Pro Fold. Category: Google. Subcategory: Phone. Price: Up Coming.
",175,254591,254766
1844,sentence,"Subcategory: Phone. Price: Up Coming.

Product: Google Pixel 10 Pro. Category: Google. Subcategory: Phone. Price: Up Coming.

Product: Google Pixel 10 Pro XL. Category: Google. Subcategory: Phone. ",197,254728,254925
1845,sentence,"Category: Google. Subcategory: Phone. Price: Up Coming.

Product: Google Pixel 9a. Category: Google. Subcategory: Phone. Price: Out Of Stock.

Product: Google Pixel 9. Category: Google. ",186,254887,255073
1846,sentence,"
Product: Google Pixel 9. Category: Google. Subcategory: Phone. Price: Out Of Stock.

Product: HONOR X5b Plus. Category: HONOR. Subcategory: Phone. Price: 12,999৳.

Product: HONOR X6c. ",185,255029,255214
1847,sentence,"Price: 12,999৳.

Product: HONOR X6c. Category: HONOR. Subcategory: Phone. Price: 14,999৳.

Product: HONOR 400. Category: HONOR. Subcategory: Phone. Price: 59,999৳.

Product: Honor X7c. ",185,255177,255362
1848,sentence,"Price: 59,999৳.

Product: Honor X7c. Category: HONOR. Subcategory: Phone. Price: Up Coming.

Product: HONOR X9c. Category: HONOR. Subcategory: Phone. Price: Up Coming.

Product: HONOR 200 Pro 5G. ",196,255325,255521
1849,sentence,"Price: Up Coming.

Product: HONOR 200 Pro 5G. Category: HONOR. Subcategory: Phone. Price: Up Coming.

Product: HONOR 400 Pro. Category: HONOR. Subcategory: Phone. Price: Up Coming.
",181,255475,255656
1850,sentence,"Subcategory: Phone. Price: Up Coming.

Product: Honor X5 Plus (4/64GB). Category: HONOR. Subcategory: Phone. Price: Out Of Stock.

Product: Honor X6b (6/128GB). Category: HONOR. Subcategory: Phone. ",198,255618,255816
1851,sentence,"Category: HONOR. Subcategory: Phone. Price: Out Of Stock.

Product: Honor X8a (8/128GB). Category: HONOR. Subcategory: Phone. Price: Out Of Stock.

Product: Honor X8b (8/512GB). Category: HONOR. ",195,255779,255974
1852,sentence,"
Product: Honor X8b (8/512GB). Category: HONOR. Subcategory: Phone. Price: Out Of Stock.

Product: Honor X8c. Category: HONOR. Subcategory: Phone. Price: 29,999৳.

Product: Honor X9a 5G (8/256GB). ",197,255926,256123
1853,sentence,"
Product: Honor X9a 5G (8/256GB). Category: HONOR. Subcategory: Phone. Price: Out Of Stock.

Product: Honor X9b 5G. Category: HONOR. Subcategory: Phone. Price: Out Of Stock.

Product: Honor 200 5G. ",198,256089,256287
1854,sentence,"Price: Out Of Stock.

Product: Honor 200 5G. Category: HONOR. Subcategory: Phone. Price: Out Of Stock.

Product: Honor Magic V3. Category: HONOR. Subcategory: Phone. Price: Out Of Stock.
",187,256242,256429
1855,sentence,"Subcategory: Phone. Price: Out Of Stock.

Product: HONOR 400 Lite. Category: HONOR. Subcategory: Phone. Price: Up Coming.

Product: Honor Magic V5. Category: HONOR. Subcategory: Phone. ",185,256388,256573
1856,sentence,"Category: HONOR. Subcategory: Phone. Price: Up Coming.

Product: Xiaomi Redmi A5. Category: Xiaomi. Subcategory: Phone. Price: 10,850৳10,999৳.

Product: Xiaomi Redmi 15C. Category: Xiaomi. ",189,256536,256725
1857,sentence,"
Product: Xiaomi Redmi 15C. Category: Xiaomi. Subcategory: Phone. Price: 14,650৳14,999৳.

Product: Xiaomi Redmi 13 (6/128GB). Category: Xiaomi. Subcategory: Phone. Price: 16,490৳16,999৳.
",187,256679,256866
1858,sentence,"Subcategory: Phone. Price: 16,490৳16,999৳.

Product: Xiaomi Redmi Note 14. Category: Xiaomi. Subcategory: Phone. Price: 20,550৳20,999৳.

Product: Xiaomi Redmi Note 14 Pro. Category: Xiaomi. ",190,256823,257013
1859,sentence,"Category: Xiaomi. Subcategory: Phone. Price: 29,399৳29,999৳.

Product: Xiaomi Redmi 14C. Category: Xiaomi. Subcategory: Phone. Price: Out Of Stock.

Product: Xiaomi Redmi 13 (8/128GB). ",185,256995,257180
1860,sentence,"
Product: Xiaomi Redmi 13 (8/128GB). Category: Xiaomi. Subcategory: Phone. Price: Out Of Stock.

Product: Xiaomi Redmi Note 13 (6/128GB). Category: Xiaomi. Subcategory: Phone. Price: Out Of Stock.
",197,257143,257340
1861,sentence,"Subcategory: Phone. Price: Out Of Stock.

Product: Xiaomi Redmi Note 13 (8/256GB). Category: Xiaomi. Subcategory: Phone. Price: Out Of Stock.

Product: Samsung Galaxy A06. Category: Samsung. ",191,257299,257490
1862,sentence,"Category: Samsung. Subcategory: Phone. Price: 13,650৳14,399৳.

Product: Samsung Galaxy A05 (6/128GB). Category: Samsung. Subcategory: Phone. Price: 19,250৳20,299৳.

Product: Samsung Galaxy A16 5G. ",197,257471,257668
1863,sentence,"
Product: Samsung Galaxy A16 5G. Category: Samsung. Subcategory: Phone. Price: 22,900৳23,999৳.

Product: Samsung Galaxy A26 5G. Category: Samsung. Subcategory: Phone. Price: 35,450৳37,499৳.
",190,257635,257825
1864,sentence,"Subcategory: Phone. Price: 35,450৳37,499৳.

Product: Samsung Galaxy A36 5G. Category: Samsung. Subcategory: Phone. Price: 41,650৳43,999৳.

Product: Samsung Galaxy A56 5G. Category: Samsung. ",190,257782,257972
1865,sentence,"Category: Samsung. Subcategory: Phone. Price: 56,250৳59,499৳.

Product: Samsung Galaxy A35 5G. Category: Samsung. Subcategory: Phone. Price: 59,650৳62,199৳.

Product: Samsung Galaxy Z Flip7. ",191,257953,258144
1866,sentence,"
Product: Samsung Galaxy Z Flip7. Category: Samsung. Subcategory: Phone. Price: Up Coming.

Product: Samsung Galaxy Z Fold7. Category: Samsung. Subcategory: Phone. Price: Up Coming.
",182,258110,258292
1867,sentence,"Subcategory: Phone. Price: Up Coming.

Product: Samsung Galaxy S24 Ultra (12/512GB). Category: Samsung. Subcategory: Phone. Price: Out Of Stock.

Product: Samsung Galaxy S24 Ultra (12/1TB). ",190,258254,258444
1868,sentence,"
Product: Samsung Galaxy S24 Ultra (12/1TB). Category: Samsung. Subcategory: Phone. Price: Out Of Stock.

Product: Samsung Galaxy S25. Category: Samsung. Subcategory: Phone. Price: Out Of Stock.
",195,258399,258594
1869,sentence,"Subcategory: Phone. Price: Out Of Stock.

Product: Samsung Galaxy S25 Ultra. Category: Samsung. Subcategory: Phone. Price: Out Of Stock.

Product: Samsung Galaxy A03 Core (2/32GB). ",181,258553,258734
1870,sentence,"
Product: Samsung Galaxy A03 Core (2/32GB). Category: Samsung. Subcategory: Phone. Price: Out Of Stock.

Product: Samsung Galaxy A03 (3/32GB). Category: Samsung. Subcategory: Phone. ",182,258690,258872
1871,sentence,"Category: Samsung. Subcategory: Phone. Price: Out Of Stock.

Product: Samsung Galaxy A04 (4/64GB). Category: Samsung. Subcategory: Phone. Price: Out Of Stock.

Product: Samsung Galaxy A05 (4/64GB). ",198,258833,259031
1872,sentence,"
Product: Samsung Galaxy A05 (4/64GB). Category: Samsung. Subcategory: Phone. Price: Out Of Stock.

Product: Samsung Galaxy A04e (3/32GB). Category: Samsung. Subcategory: Phone. Price: Out Of Stock.
",199,258992,259191
1873,sentence,"Subcategory: Phone. Price: Out Of Stock.

Product: Samsung Galaxy A04 (3/32GB). Category: Samsung. Subcategory: Phone. Price: Out Of Stock.

Product: Samsung Galaxy F13 (4/64GB). Category: Samsung. ",198,259150,259348
1874,sentence,"Category: Samsung. Subcategory: Phone. Price: Out Of Stock.

Product: Vivo Y04. Category: Vivo. Subcategory: Phone. Price: 11,999৳.

Product: Vivo Y19s. Category: Vivo. Subcategory: Phone. ",189,259329,259518
1875,sentence,"Category: Vivo. Subcategory: Phone. Price: 14,999৳.

Product: Vivo Y19s Pro. Category: Vivo. Subcategory: Phone. Price: 16,999৳.

Product: Vivo Y29. Category: Vivo. Subcategory: Phone. ",185,259482,259667
1876,sentence,"Category: Vivo. Subcategory: Phone. Price: 19,999৳.

Product: Vivo Y400. Category: Vivo. Subcategory: Phone. Price: 27,999৳.

Product: Vivo V50 Lite. Category: Vivo. Subcategory: Phone. ",186,259631,259817
1877,sentence,"Category: Vivo. Subcategory: Phone. Price: 31,900৳32,999৳.

Product: Vivo V50 5G. Category: Vivo. Subcategory: Phone. Price: 62,999৳.

Product: Vivo V60 5G. Category: Vivo. Subcategory: Phone. ",193,259781,259974
1878,sentence,"Category: Vivo. Subcategory: Phone. Price: Up Coming.

Product: Vivo Y03t. Category: Vivo. Subcategory: Phone. Price: Out Of Stock.

Product: Vivo Y03. Category: Vivo. Subcategory: Phone. ",188,259938,260126
1879,sentence,"Category: Vivo. Subcategory: Phone. Price: Out Of Stock.

Product: Vivo Y17s. Category: Vivo. Subcategory: Phone. Price: Out Of Stock.

Product: Vivo Y18. Category: Vivo. Subcategory: Phone. ",191,260090,260281
1880,sentence,"Category: Vivo. Subcategory: Phone. Price: Out Of Stock.

Product: Vivo Y28. Category: Vivo. Subcategory: Phone. Price: Out Of Stock.

Product: Vivo Y27s (8/128GB). Category: Vivo. ",181,260245,260426
1881,sentence,"
Product: Vivo Y27s (8/128GB). Category: Vivo. Subcategory: Phone. Price: Out Of Stock.

Product: Vivo Y36. Category: Vivo. Subcategory: Phone. Price: Out Of Stock.
",165,260379,260544
1882,sentence,"Subcategory: Phone. Price: Out Of Stock.

Product: Vivo V30 Lite (8/128GB). Category: Vivo. Subcategory: Phone. Price: Out Of Stock.

Product: Vivo V40 Lite. Category: Vivo. Subcategory: Phone. ",194,260503,260697
1883,sentence,"Category: Vivo. Subcategory: Phone. Price: Out Of Stock.

Product: Vivo V30 Lite (8/256GB). Category: Vivo. Subcategory: Phone. Price: Out Of Stock.

Product: Vivo V30 5G (12/256GB). Category: Vivo. ",199,260661,260860
1884,sentence,"Category: Vivo. Subcategory: Phone. Price: Out Of Stock.

Product: Vivo V40 5G (12/256GB). Category: Vivo. Subcategory: Phone. Price: Out Of Stock.

Product: Realme Note 60x. Category: Realme. ",193,260844,261037
1885,sentence,"
Product: Realme Note 60x. Category: Realme. Subcategory: Phone. Price: 10,999৳.

Product: Realme Note 60. Category: Realme. Subcategory: Phone. Price: 11,499৳.

Product: Realme Note 70. ",187,260992,261179
1886,sentence,"Price: 11,499৳.

Product: Realme Note 70. Category: Realme. Subcategory: Phone. Price: 11,999৳.

Product: Realme C71. Category: Realme. Subcategory: Phone. Price: 14,999৳.

Product: Realme C75x. ",195,261137,261332
1887,sentence,"Price: 14,999৳.

Product: Realme C75x. Category: Realme. Subcategory: Phone. Price: 17,999৳.

Product: Realme 12. Category: Realme. Subcategory: Phone. Price: 24,999৳.

Product: Realme 14T 5G. ",193,261293,261486
1888,sentence,"Price: 24,999৳.

Product: Realme 14T 5G. Category: Realme. Subcategory: Phone. Price: 31,999৳.

Product: Realme 14. Category: Realme. Subcategory: Phone. Price: 41,999৳.

Product: Realme C75. ",192,261445,261637
1889,sentence,"Price: 41,999৳.

Product: Realme C75. Category: Realme. Subcategory: Phone. Price: Out Of Stock.

Product: Infinix SMART 10 Plus. Category: Infinix. Subcategory: Phone. Price: 11,499৳.
",185,261599,261784
1890,sentence,"Subcategory: Phone. Price: 11,499৳.

Product: Infinix Hot 60i. Category: Infinix. Subcategory: Phone. Price: 13,750৳13,999৳.

Product: Infinix Hot 60 Pro. Category: Infinix. Subcategory: Phone. ",194,261748,261942
1891,sentence,"Category: Infinix. Subcategory: Phone. Price: 18,750৳18,999৳.

Product: Infinix Hot 60 Pro+. Category: Infinix. Subcategory: Phone. Price: 21,750৳21,999৳.

Product: Infinix Note 50. ",182,261903,262085
1892,sentence,"
Product: Infinix Note 50. Category: Infinix. Subcategory: Phone. Price: 25,650৳25,999৳.

Product: Infinix GT 30 Pro. Category: Infinix. Subcategory: Phone. Price: 39,250৳39,999৳.
",180,262058,262238
1893,sentence,"Subcategory: Phone. Price: 39,250৳39,999৳.

Product: Infinix Zero Ultra. Category: Infinix. Subcategory: Phone. Price: Up Coming.

Product: Infinix Smart 9 HD. Category: Infinix. Subcategory: Phone. ",199,262195,262394
1894,sentence,"Category: Infinix. Subcategory: Phone. Price: Out Of Stock.

Product: Infinix SMART 10. Category: Infinix. Subcategory: Phone. Price: Out Of Stock.

Product: Infinix Smart 9. Category: Infinix. ",194,262355,262549
1895,sentence,"
Product: Infinix Smart 9. Category: Infinix. Subcategory: Phone. Price: Out Of Stock.

Product: Infinix Hot 50i. Category: Infinix. Subcategory: Phone. Price: Out Of Stock.
",174,262503,262677
1896,sentence,"Subcategory: Phone. Price: Out Of Stock.

Product: Infinix Hot 50. Category: Infinix. Subcategory: Phone. Price: Out Of Stock.

Product: Infinix Hot 50 Pro. Category: Infinix. Subcategory: Phone. ",196,262636,262832
1897,sentence,"Category: Infinix. Subcategory: Phone. Price: Out Of Stock.

Product: Infinix Hot 50 Pro Plus. Category: Infinix. Subcategory: Phone. Price: Out Of Stock.

Product: Infinix Note 50 Pro+. ",187,262793,262980
1898,sentence,"
Product: Infinix Note 50 Pro+. Category: Infinix. Subcategory: Phone. Price: 54,400৳54,999৳.

Product: Infinix Note 50 Pro. Category: Infinix. Subcategory: Phone. Price: Out Of Stock.
",185,262948,263133
1899,sentence,"Subcategory: Phone. Price: Out Of Stock.

Product: Nokia C32. Category: Nokia. Subcategory: Phone. Price: 13,100৳13,499৳.

Product: Nokia 150 DS (2023). Category: Nokia. Subcategory: Phone. ",190,263092,263282
1900,sentence,"Category: Nokia. Subcategory: Phone. Price: Out Of Stock.

Product: Nokia 3210 DS. Category: Nokia. Subcategory: Phone. Price: Out Of Stock.

Product: Nokia C12 Pro (4/64GB). Category: Nokia. ",192,263245,263437
1901,sentence,"Category: Nokia. Subcategory: Phone. Price: Out Of Stock.

Product: Nokia 110 DS (2023). Category: Nokia. Subcategory: Phone. Price: Out Of Stock.

Product: Nokia C22 (3/64GB). Category: Nokia. ",194,263420,263614
1902,sentence,"
Product: Nokia C22 (3/64GB). Category: Nokia. Subcategory: Phone. Price: Out Of Stock.

Product: Walton Primo GH11 (4/32GB). Category: Walton. Subcategory: Phone. Price: 8,990৳9,523৳.
",185,263567,263752
1903,sentence,"Subcategory: Phone. Price: 8,990৳9,523৳.

Product: Walton NEXG N73 (8/128GB). Category: Walton. Subcategory: Phone. Price: 13,299৳13,999৳.

Product: Walton NEXG N74 (8/128GB). Category: Walton. ",194,263711,263905
1904,sentence,"Category: Walton. Subcategory: Phone. Price: Up Coming.

Product: Walton XANON X21. Category: Walton. Subcategory: Phone. Price: Up Coming.

Product: Walton NEXG N10 Ultra. Category: Walton. ",191,263887,264078
1905,sentence,"Category: Walton. Subcategory: Phone. Price: Up Coming.

Product: Walton ZENX 1. Category: Walton. Subcategory: Phone. Price: Up Coming.

Product: Walton NEXG N27. Category: Walton. ",182,264060,264242
1906,sentence,"
Product: Walton NEXG N27. Category: Walton. Subcategory: Phone. Price: Up Coming.

Product: Walton Orbit Y71. Category: Walton. Subcategory: Phone. Price: Up Coming.

Product: Walton XANON X91. ",195,264197,264392
1907,sentence,"Price: Up Coming.

Product: Walton XANON X91. Category: Walton. Subcategory: Phone. Price: Up Coming.

Product: Walton ZENX 1T. Category: Walton. Subcategory: Phone. Price: Up Coming.
",184,264346,264530
1908,sentence,"Subcategory: Phone. Price: Up Coming.

Product: Walton ZENX 2. Category: Walton. Subcategory: Phone. Price: Up Coming.

Product: Walton NEXG N26 (8/128GB). Category: Walton. Subcategory: Phone. ",194,264492,264686
1909,sentence,"Category: Walton. Subcategory: Phone. Price: Up Coming.

Product: Walton Olvio M100. Category: Walton. Subcategory: Phone. Price: Out Of Stock.

Product: Walton Olvio M200. Category: Walton. ",191,264648,264839
1910,sentence,"
Product: Walton Olvio M200. Category: Walton. Subcategory: Phone. Price: Out Of Stock.

Product: Walton Orbit Y11 (2/16GB). Category: Walton. Subcategory: Phone. Price: Out Of Stock.
",184,264792,264976
1911,sentence,"Subcategory: Phone. Price: Out Of Stock.

Product: Walton Orbit Y70C (6/64GB). Category: Walton. Subcategory: Phone. Price: Out Of Stock.

Product: Walton Orbit Y50 (4/64GB). Category: Walton. ",193,264935,265128
1912,sentence,"Category: Walton. Subcategory: Phone. Price: Out Of Stock.

Product: Walton Primo S8 mini (4/64GB). Category: Walton. Subcategory: Phone. Price: Out Of Stock.

Product: Walton NEXG N25 (8/128GB). ",196,265110,265306
1913,sentence,"
Product: Walton NEXG N25 (8/128GB). Category: Walton. Subcategory: Phone. Price: Out Of Stock.

Product: Tecno Spark Go 2. Category: TECNO. Subcategory: Phone. Price: 10,700৳10,990৳.
",184,265269,265453
1914,sentence,"Subcategory: Phone. Price: 10,700৳10,990৳.

Product: Tecno SPARK 40C. Category: TECNO. Subcategory: Phone. Price: 12,100৳12,499৳.

Product: Tecno SPARK 30C. Category: TECNO. Subcategory: Phone. ",194,265410,265604
1915,sentence,"Category: TECNO. Subcategory: Phone. Price: 13,450৳13,999৳.

Product: Tecno SPARK 40. Category: TECNO. Subcategory: Phone. Price: 13,650৳13,999৳.

Product: Tecno SPARK 40 Pro. Category: TECNO. ",193,265567,265760
1916,sentence,"
Product: Tecno SPARK 40 Pro. Category: TECNO. Subcategory: Phone. Price: 19,690৳19,999৳.

Product: Tecno SPARK 40 Pro Plus. Category: TECNO. Subcategory: Phone. Price: 24,150৳24,999৳.
",185,265713,265898
1917,sentence,"Subcategory: Phone. Price: 24,150৳24,999৳.

Product: Tecno Camon 40 Pro. Category: TECNO. Subcategory: Phone. Price: 27,250৳27,999৳.

Product: Tecno PHANTOM V Fold2 5G. Category: TECNO. ",186,265855,266041
1918,sentence,"Category: TECNO. Subcategory: Phone. Price: Up Coming.

Product: Tecno Spark Go 1. Category: TECNO. Subcategory: Phone. Price: Out Of Stock.

Product: Tecno SPARK 30. Category: TECNO. ",184,266024,266208
1919,sentence,"
Product: Tecno SPARK 30. Category: TECNO. Subcategory: Phone. Price: Out Of Stock.

Product: Tecno SPARK 30 Pro. Category: TECNO. Subcategory: Phone. Price: Out Of Stock.

Product: Tecno Camon 30. ",198,266165,266363
1920,sentence,"Price: Out Of Stock.

Product: Tecno Camon 30. Category: TECNO. Subcategory: Phone. Price: Out Of Stock.

Product: Tecno Camon 40. Category: TECNO. Subcategory: Phone. Price: Out Of Stock.
",189,266316,266505
1921,sentence,"Subcategory: Phone. Price: Out Of Stock.

Product: Tecno Camon 30S. Category: TECNO. Subcategory: Phone. Price: Out Of Stock.

Product: Tecno Camon 40 Pro 5G. Category: TECNO. Subcategory: Phone. ",196,266464,266660
1922,sentence,"Category: TECNO. Subcategory: Phone. Price: Out Of Stock.

Product: Benco V90 Plus. Category: benco. Subcategory: Phone. Price: 8,590৳8,999৳.

Product: Benco V90i. Category: benco. ",181,266623,266804
1923,sentence,"
Product: Benco V90i. Category: benco. Subcategory: Phone. Price: 9,150৳9,499৳.

Product: Benco V91 Plus. Category: benco. Subcategory: Phone. Price: 12,100৳12,499৳.

Product: Benco C1. ",186,266765,266951
1924,sentence,"Price: 12,100৳12,499৳.

Product: Benco C1. Category: benco. Subcategory: Phone. Price: Out Of Stock.

Product: Benco E20. Category: benco. Subcategory: Phone. Price: Out Of Stock.
",180,266908,267088
1925,sentence,"Subcategory: Phone. Price: Out Of Stock.

Product: Benco P26. Category: benco. Subcategory: Phone. Price: Out Of Stock.

Product: Benco C27. Category: benco. Subcategory: Phone. Price: Out Of Stock.
",199,267047,267246
1926,sentence,"Subcategory: Phone. Price: Out Of Stock.

Product: Benco E21. Category: benco. Subcategory: Phone. Price: Out Of Stock.

Product: Benco P32. Category: benco. Subcategory: Phone. Price: Out Of Stock.
",199,267205,267404
1927,sentence,"Subcategory: Phone. Price: Out Of Stock.

Product: Benco V82 (3/64GB). Category: benco. Subcategory: Phone. Price: Out Of Stock.

Product: Benco V90 (4/64GB). Category: benco. Subcategory: Phone. ",196,267363,267559
1928,sentence,"Category: benco. Subcategory: Phone. Price: Out Of Stock.

Product: Benco V90 (4/128GB). Category: benco. Subcategory: Phone. Price: Out Of Stock.

Product: Benco V80 (4/64GB). Category: benco. ",194,267522,267716
1929,sentence,"
Product: Benco V80 (4/64GB). Category: benco. Subcategory: Phone. Price: Out Of Stock.

Product: Benco V91 (4/128GB). Category: benco. Subcategory: Phone. Price: Out Of Stock.

Product: Benco V91c. ",199,267669,267868
1930,sentence,"Price: Out Of Stock.

Product: Benco V91c. Category: benco. Subcategory: Phone. Price: 10,100৳10,499৳.

Product: Benco V91 (8/128GB). Category: benco. Subcategory: Phone. Price: Out Of Stock.
",192,267825,268017
1931,sentence,"Subcategory: Phone. Price: Out Of Stock.

Product: Benco S1 (6/128GB). Category: benco. Subcategory: Phone. Price: Out Of Stock.

Product: Benco S1 Plus. Category: benco. Subcategory: Phone. ",191,267976,268167
1932,sentence,"Category: benco. Subcategory: Phone. Price: 17,100৳17,499৳.

Product: Benco S1 (8/128GB). Category: benco. Subcategory: Phone. Price: Out Of Stock.

Product: Benco S1 Pro (6/128GB). Category: benco. ",199,268130,268329
1933,sentence,"Category: benco. Subcategory: Phone. Price: Out Of Stock.

Product: TCL 408 (4/128GB). Category: TCL. Subcategory: Phone. Price: Out Of Stock.

Product: TCL 40 SE (6/256GB). Category: TCL. ",189,268312,268501
1934,sentence,"
Product: TCL 40 SE (6/256GB). Category: TCL. Subcategory: Phone. Price: Out Of Stock.

Product: Symphony S100. Category: Feature Phone. Subcategory: Phone. Price: Up Coming.

Product: Symphony B70. ",199,268455,268654
1935,sentence,"Price: Up Coming.

Product: Symphony B70. Category: Feature Phone. Subcategory: Phone. Price: Out Of Stock.

Product: ZTE Blade A35 (4/64GB). Category: ZTE. Subcategory: Phone. Price: 7,690৳7,999৳.
",198,268612,268810
1936,sentence,"Subcategory: Phone. Price: 7,690৳7,999৳.

Product: ZTE Blade A36. Category: ZTE. Subcategory: Phone. Price: 8,150৳8,499৳.

Product: ZTE nubia A56. Category: ZTE. Subcategory: Phone. ",182,268769,268951
1937,sentence,"Category: ZTE. Subcategory: Phone. Price: 9,250৳9,499৳.

Product: ZTE nubia V70 Design. Category: ZTE. Subcategory: Phone. Price: 11,650৳11,999৳.

Product: ZTE nubia Neo 5G (8/256GB). Category: ZTE. ",199,268916,269115
1938,sentence,"Category: ZTE. Subcategory: Phone. Price: 18,200৳19,999৳.

Product: ZTE Blade A35e. Category: ZTE. Subcategory: Phone. Price: Up Coming.

Product: ZTE Blade A55 (4/128GB). Category: ZTE. ",187,269100,269287
1939,sentence,"Category: ZTE. Subcategory: Phone. Price: Out Of Stock.

Product: ZTE Blade A54 (4/128GB). Category: ZTE. Subcategory: Phone. Price: Out Of Stock.

Product: ZTE Blade V40 Smartphone (6/128GB). ",193,269272,269465
1940,sentence,"
Product: ZTE Blade V40 Smartphone (6/128GB). Category: ZTE. Subcategory: Phone. Price: Out Of Stock.

Product: ZTE Blade V50 Design (8/128GB). Category: ZTE. Subcategory: Phone. ",179,269419,269598
1941,sentence,"Category: ZTE. Subcategory: Phone. Price: Out Of Stock.

Product: ZTE Blade V50 Design (8/256GB). Category: ZTE. Subcategory: Phone. Price: Out Of Stock.
",154,269563,269717
1942,sentence,"Subcategory: Phone. Price: Out Of Stock.

Product: ZTE nubia REDMAGIC 8S Pro (12/256GB). Category: ZTE. Subcategory: Phone. Price: Out Of Stock.

Product: ZTE nubia Z60 Ultra (12/256GB). ",187,269676,269863
1943,sentence,"
Product: ZTE nubia Z60 Ultra (12/256GB). Category: ZTE. Subcategory: Phone. Price: Out Of Stock.

Product: ZTE nubia REDMAGIC 9 Pro (12/256GB). Category: ZTE. Subcategory: Phone. ",180,269821,270001
1944,sentence,"Category: ZTE. Subcategory: Phone. Price: Out Of Stock.

Product: ZTE nubia REDMAGIC 9 Pro (16/512GB). Category: ZTE. Subcategory: Phone. Price: Out Of Stock.

Product: Symphony ATOM 5 (4/64GB). ",195,269966,270161
1945,sentence,"
Product: Symphony ATOM 5 (4/64GB). Category: Symphony. Subcategory: Phone. Price: 7,850৳7,999৳.

Product: Symphony Z72. Category: Symphony. Subcategory: Phone. Price: 8,790৳8,999৳.
",182,270125,270307
1946,sentence,"Subcategory: Phone. Price: 8,790৳8,999৳.

Product: Symphony Innova 30 (8/128GB). Category: Symphony. Subcategory: Phone. Price: 12,290৳12,699৳.

Product: Symphony Helio 40 (8/128GB). ",183,270266,270449
1947,sentence,"
Product: Symphony Helio 40 (8/128GB). Category: Symphony. Subcategory: Phone. Price: 12,850৳13,199৳.

Product: Symphony Helio 100. Category: Symphony. Subcategory: Phone. Price: 19,400৳19,999৳.
",195,270410,270605
1948,sentence,"Subcategory: Phone. Price: 19,400৳19,999৳.

Product: Micropack WCP-315 15W 3 in 1 Magnetic Wireless Charger. Category: Charger & Adapter. Subcategory: Mobile Accessories. Price: 9,999৳.
",186,270562,270748
1949,sentence,"Subcategory: Mobile Accessories. Price: 9,999৳.

Product: Micropack MTA-5100 100W 5 Port Universal Travel Adapter. Category: Charger & Adapter. Subcategory: Mobile Accessories. Price: 7,500৳.
",192,270700,270892
1950,sentence,"Subcategory: Mobile Accessories. Price: 7,500৳.

Product: Micropack MTA-535 35W 5 Port Universal Travel Adapter. Category: Charger & Adapter. Subcategory: Mobile Accessories. Price: 3,299৳.
",190,270844,271034
1951,sentence,"Subcategory: Mobile Accessories. Price: 3,299৳.

Product: Micropack MWC-4100 100W 4 Port Universal Travel Adapter. Category: Charger & Adapter. Subcategory: Mobile Accessories. Price: 7,500৳.
",192,270986,271178
1952,sentence,"Subcategory: Mobile Accessories. Price: 7,500৳.

Product: Micropack MWC-265H 65W Type C Fast GaN Charger. Category: Charger & Adapter. Subcategory: Mobile Accessories. Price: 6,500৳.
",183,271130,271313
1953,sentence,"Subcategory: Mobile Accessories. Price: 6,500৳.

Product: Micropack MWC-233PD 33W Type C Charger Adapter. Category: Charger & Adapter. Subcategory: Mobile Accessories. Price: 2,250৳.
",183,271265,271448
1954,sentence,"Subcategory: Mobile Accessories. Price: 2,250৳.

Product: Anker Zolo 20W IQ & PD Type-C Charger Adapter. Category: Charger & Adapter. Subcategory: Mobile Accessories. Price: 1,050৳1,150৳.
",188,271400,271588
1955,sentence,"Price: 1,050৳1,150৳.

Product: Anker 312 30W Type-C Charger Adapter. Category: Charger & Adapter. Subcategory: Mobile Accessories. Price: 1,150৳1,250৳.
",152,271567,271719
1956,sentence,"Price: 1,150৳1,250৳.

Product: Micropack WCP-10PD AIR WAVE LITE Wireless Charger. Category: Charger & Adapter. Subcategory: Mobile Accessories. Price: 1,890৳.
",159,271698,271857
1957,sentence,"Subcategory: Mobile Accessories. Price: 1,890৳.

Product: Oraimo Firefly 3 10W USB Charger Adapter with Type C Cable (OCW-E66S+C53). Category: Charger & Adapter. Subcategory: Mobile Accessories. ",195,271809,272004
1958,sentence,"Subcategory: Mobile Accessories. Price: 230৳.

Product: Oraimo Firefly 3 10W USB Charger Adapter with Micro USB Cable (OCW-E66S+M53). Category: Charger & Adapter. Subcategory: Mobile Accessories. ",196,271971,272167
1959,sentence,"Subcategory: Mobile Accessories. Price: 215৳.

Product: Xiaomi MI 3A 1 Port USB 2 Pin Charging Adapter White. Category: Charger & Adapter. Subcategory: Mobile Accessories. Price: 340৳390৳.
",189,272134,272323
1960,sentence,"Price: 340৳390৳.

Product: Oraimo Cannon 18S 18W Charger Adapter with Micro USB Cable. Category: Charger & Adapter. Subcategory: Mobile Accessories. Price: 380৳415৳.
",166,272306,272472
1961,sentence,"Price: 380৳415৳.

Product: Oraimo Cannon 18S 18W Charger Adapter with Type-C Cable. Category: Charger & Adapter. Subcategory: Mobile Accessories. Price: 380৳415৳.
",163,272455,272618
1962,sentence,"Price: 380৳415৳.

Product: Oraimo Cannon 2 Pro 18W Charger Adapter with Lighting Cable. Category: Charger & Adapter. Subcategory: Mobile Accessories. Price: 390৳420৳.
",167,272601,272768
1963,sentence,"Price: 390৳420৳.

Product: Oraimo Cannon 18S USB 18W Charger Adapter with USB to Lightning Cable. Category: Charger & Adapter. Subcategory: Mobile Accessories. Price: 390৳420৳.
",177,272751,272928
1964,sentence,"Price: 390৳420৳.

Product: FONENG EU39 20W PD Charger Adapter With Type-C Cable. Category: Charger & Adapter. Subcategory: Mobile Accessories. Price: 440৳480৳.
",160,272911,273071
1965,sentence,"Price: 440৳480৳.

Product: FONENG EU46 QC3 18W Fast Charger with Type - C Cable. Category: Charger & Adapter. Subcategory: Mobile Accessories. Price: 450৳.
",156,273054,273210
1966,sentence,"Subcategory: Mobile Accessories. Price: 450৳.

Product: Oraimo Cannon 18D Dual Port 18W Charger Adapter with Micro USB Cable. Category: Charger & Adapter. Subcategory: Mobile Accessories. ",188,273164,273352
1967,sentence,"Subcategory: Mobile Accessories. Price: 450৳490৳.

Product: Oraimo Cannon Dual Port 18W Charger Adapter with Type-C Cable. Category: Charger & Adapter. Subcategory: Mobile Accessories. ",185,273319,273504
1968,sentence,"Subcategory: Mobile Accessories. Price: 460৳490৳.

Product: Baseus Folding Bracket Antiskid Pad. Category: Holder & Stand. Subcategory: Mobile Accessories. Price: 528৳.
",169,273471,273640
1969,sentence,"Subcategory: Mobile Accessories. Price: 528৳.

Product: WiWU ZM-014 360 Degree Rotating Desktop Phone Stand. Category: Holder & Stand. Subcategory: Mobile Accessories. Price: 600৳.
",181,273594,273775
1970,sentence,"Subcategory: Mobile Accessories. Price: 600৳.

Product: Baseus SUWY-A01 Desktop Phone Holder. Category: Holder & Stand. Subcategory: Mobile Accessories. Price: 1,050৳1,134৳.
",174,273729,273903
1971,sentence,"Price: 1,050৳1,134৳.

Product: UGREEN LP373 Desk Mount Foldable Phone Stand #20434. Category: Holder & Stand. Subcategory: Mobile Accessories. Price: 800৳.
",156,273882,274038
1972,sentence,"Subcategory: Mobile Accessories. Price: 800৳.

Product: Vention KCZH0 Portable Cell Phone Stand. Category: Holder & Stand. Subcategory: Mobile Accessories. Price: 690৳825৳.
",173,273992,274165
1973,sentence,"Price: 690৳825৳.

Product: Ugreen LP189 Car Mount Snap Clip Dashboard Phone Holder #60796. Category: Holder & Stand. Subcategory: Mobile Accessories. Price: 900৳.
",163,274148,274311
1974,sentence,"Subcategory: Mobile Accessories. Price: 900৳.

Product: Micropack MMW-01 Magnetic Card Wallet. Category: Holder & Stand. Subcategory: Mobile Accessories. Price: 4,500৳.
",169,274265,274434
1975,sentence,"Subcategory: Mobile Accessories. Price: 4,500৳.

Product: Vention FGHIF Wireless Charger Stand. Category: Holder & Stand. Subcategory: Mobile Accessories. Price: 2,750৳2,850৳.
",176,274386,274562
1976,sentence,"Price: 2,750৳2,850৳.

Product: Vention FGEI0 3-in-1 Wireless Charger Stand. Category: Holder & Stand. Subcategory: Mobile Accessories. Price: 5,650৳6,199৳.
",156,274541,274697
1977,sentence,"Price: 5,650৳6,199৳.

Product: Vention KSDH0 Articulating 360° Rotatable Desk Phone Stand. Category: Holder & Stand. Subcategory: Mobile Accessories. Price: 1,050৳1,150৳.
",171,274676,274847
1978,sentence,"Price: 1,050৳1,150৳.

Product: WiWU ZM100 Foldable Desktop Stand for Mobile & Tablet. Category: Holder & Stand. Subcategory: Mobile Accessories. Price: 1,250৳.
",160,274826,274986
1979,sentence,"Subcategory: Mobile Accessories. Price: 1,250৳.

Product: Vyvylabs VFBRS-01 Knight Smartphone Holder for Bicycle and Motorcycle. Category: Holder & Stand. Subcategory: Mobile Accessories. ",188,274938,275126
1980,sentence,"Subcategory: Mobile Accessories. Price: 1,490৳1,599৳.

Product: Baseus Energy Storage Backseat Holder Qi 15W Wireless Charger. Category: Holder & Stand. Subcategory: Mobile Accessories. ",186,275093,275279
1981,sentence,"Subcategory: Mobile Accessories. Price: 2,300৳2,600৳.

Product: Takstar ST-201 Cell Phone Stand. Category: Holder & Stand. Subcategory: Mobile Accessories. Price: 2,300৳3,000৳.
",177,275246,275423
1982,sentence,"Price: 2,300৳3,000৳.

Product: Baseus Wisdom Auto Alignment Car Mount Qi 15W Wireless Charger. Category: Holder & Stand. Subcategory: Mobile Accessories. Price: 2,490৳2,699৳.
",175,275402,275577
1983,sentence,"Price: 2,490৳2,699৳.

Product: Ugreen Adjustable Portable Multi-Angle Tablet Stand (White) #30485. Category: Holder & Stand. Subcategory: Mobile Accessories. Price: Up Coming.
",176,275556,275732
1984,sentence,"Price: Up Coming.

Product: Vyvylabs VFMFS-01 Wood OX Mini Smartphone Holder. Category: Holder & Stand. Subcategory: Mobile Accessories. Price: Up Coming.

Product: Ugreen Ring Phone Holder Silver. ",198,275714,275912
1985,sentence,"
Product: Ugreen Ring Phone Holder Silver. Category: Holder & Stand. Subcategory: Mobile Accessories. Price: Out Of Stock.
",123,275869,275992
1986,sentence,"Price: Out Of Stock.

Product: Ugreen LP106 Adjustable Portable Multi-Angle Mobile Holder Stand #50747. Category: Holder & Stand. Subcategory: Mobile Accessories. Price: Out Of Stock.
",184,275971,276155
1987,sentence,"Price: Out Of Stock.

Product: UGreen 30283 Air Vent Mount Phone Holder. Category: Holder & Stand. Subcategory: Mobile Accessories. Price: Out Of Stock.
",153,276134,276287
1988,sentence,"Price: Out Of Stock.

Product: WIWU Waltz Rotative Folio Protective Tablet Case For iPad 12.9 Inch. Category: Case & Cover. Subcategory: Mobile Accessories. Price: 1,700৳.
",172,276266,276438
1989,sentence,"Subcategory: Mobile Accessories. Price: 1,700৳.

Product: Ugreen Transparent Soft Phone Case for iPhone 7/8 #50796. Category: Case & Cover. Subcategory: Mobile Accessories. Price: Out Of Stock.
",194,276390,276584
1990,sentence,"Price: Out Of Stock.

Product: WIWU Smart Folio Protective Case for iPad. Category: Case & Cover. Subcategory: Mobile Accessories. Price: Out Of Stock.
",152,276563,276715
1991,sentence,"Price: Out Of Stock.

Product: UGreen 50580 iPhone X Battery Case with wireless charging treasure. Category: Case & Cover. Subcategory: Mobile Accessories. Price: Out Of Stock.
",177,276694,276871
1992,sentence,"Price: Out Of Stock.

Product: Anker iPhone 15 Pro Clear Magnetic Phone Case. Category: Case & Cover. Subcategory: Mobile Accessories. Price: Out Of Stock.
",156,276850,277006
1993,sentence,"Price: Out Of Stock.

Product: Fantech Gletser PC-10 Phone Cooler. Category: Mobile Phone Cooler. Subcategory: Mobile Accessories. Price: 1,090৳1,199৳.
",152,276985,277137
1994,sentence,"Price: 1,090৳1,199৳.

Product: Plextone UF1 RGB Magnetic Radiator Phone Cooler. Category: Mobile Phone Cooler. Subcategory: Mobile Accessories. Price: 1,250৳1,350৳.
",165,277116,277281
1995,sentence,"Price: 1,250৳1,350৳.

Product: Plextone EX2 Pro RGB Magnetic Radiator Phone Cooler. Category: Mobile Phone Cooler. Subcategory: Mobile Accessories. Price: 1,250৳1,350৳.
",169,277260,277429
1996,sentence,"Price: 1,250৳1,350৳.

Product: Plextone EX2 Ultra RGB Magnetic Radiator Phone Cooler. Category: Mobile Phone Cooler. Subcategory: Mobile Accessories. Price: 1,350৳1,450৳.
",171,277408,277579
1997,sentence,"Price: 1,350৳1,450৳.

Product: Plextone EX3 Pro RGB Magnetic Radiator Phone Cooler. Category: Mobile Phone Cooler. Subcategory: Mobile Accessories. Price: 2,450৳2,650৳.
",169,277558,277727
1998,sentence,"Price: 2,450৳2,650৳.

Product: Plextone EX2 GO RGB Magnetic Radiator Phone Cooler. Category: Mobile Phone Cooler. Subcategory: Mobile Accessories. Price: Up Coming.
",165,277706,277871
1999,sentence,"Price: Up Coming.

Product: Plextone EX2 RGB Magnetic Radiator Phone Cooler. Category: Mobile Phone Cooler. Subcategory: Mobile Accessories. Price: Up Coming.
",159,277853,278012
2000,sentence,"Price: Up Coming.

Product: Plextone EX2 Plus RGB Magnetic Radiator Phone Cooler. Category: Mobile Phone Cooler. Subcategory: Mobile Accessories. Price: Up Coming.

Product: OnePlus Gaming Triggers. ",199,277994,278193
2001,sentence,"
Product: OnePlus Gaming Triggers. Category: Mobile Phone Cooler. Subcategory: Mobile Accessories. Price: Out Of Stock.

Product: Realme Cooling Back Clip Neo Mobile Cooler. ",174,278158,278332
2002,sentence,"Category: Mobile Phone Cooler. Subcategory: Mobile Accessories. Price: Out Of Stock.

Product: OnePlus PCV02 18W Freezing Point Phone Cooler. Category: Mobile Phone Cooler. ",173,278332,278505
2003,sentence,"Category: Mobile Phone Cooler. Subcategory: Mobile Accessories. Price: Out Of Stock.

Product: Hoco GM26 Ambitious Mobile Phone Cooler. Category: Mobile Phone Cooler. ",167,278474,278641
2004,sentence,"Category: Mobile Phone Cooler. Subcategory: Mobile Accessories. Price: Out Of Stock.

Product: Black Shark FunCooler Pro BR20 Mobile Cooler. Category: Mobile Phone Cooler. ",172,278610,278782
2005,sentence,"Category: Mobile Phone Cooler. Subcategory: Mobile Accessories. Price: Out Of Stock.

Product: XP-Pen Star-G430S Ultra-Thin Digital Drawing Graphics Tablet. Category: XP-PEN. ",175,278751,278926
2006,sentence,"Category: XP-PEN. Subcategory: Graphics Tablet. Price: 2,300৳2,800৳.

Product: XP-Pen Deco Mini 7 V2 4.37"" Drawing Graphics Tablet. Category: XP-PEN. Subcategory: Graphics Tablet. ",180,278908,279088
2007,sentence,"Category: XP-PEN. Subcategory: Graphics Tablet. Price: 5,200৳5,400৳.

Product: XP-Pen Star-G960S Digital Drawing Graphics Tablet. Category: XP-PEN. Subcategory: Graphics Tablet. Price: 4,800৳5,000৳.
",199,279040,279239
2008,sentence,"Price: 4,800৳5,000৳.

Product: XP-Pen Star 03 V2 Drawing Graphics Tablet. Category: XP-PEN. Subcategory: Graphics Tablet. Price: 6,600৳6,700৳.
",143,279218,279361
2009,sentence,"Price: 6,600৳6,700৳.

Product: XP-Pen Deco 01 V3 Digital Drawing Graphics Tablet. Category: XP-PEN. Subcategory: Graphics Tablet. Price: 6,200৳6,700৳.
",151,279340,279491
2010,sentence,"Price: 6,200৳6,700৳.

Product: XP-Pen Deco M (Medium) IT850 8 Inch Drawing Graphic Tablet. Category: XP-PEN. Subcategory: Graphics Tablet. Price: 7,500৳7,900৳.
",160,279470,279630
2011,sentence,"Price: 7,500৳7,900৳.

Product: XP-Pen Star 06 Wireless Digital Painting Graphics Drawing Tablet. Category: XP-PEN. Subcategory: Graphics Tablet. Price: 7,000৳8,350৳.
",166,279609,279775
2012,sentence,"Price: 7,000৳8,350৳.

Product: XP-Pen Deco 02 Pen Digital Drawing Graphics Tablet. Category: XP-PEN. Subcategory: Graphics Tablet. Price: 8,200৳8,500৳.
",152,279754,279906
2013,sentence,"Price: 8,200৳8,500৳.

Product: XP-Pen Deco L Drawing Graphics Tablet. Category: XP-PEN. Subcategory: Graphics Tablet. Price: 8,900৳10,000৳.

Product: XP-Pen Deco Pro Small Drawing Graphics Tablet. ",197,279885,280082
2014,sentence,"Category: XP-PEN. Subcategory: Graphics Tablet. Price: 11,200৳11,800৳.

Product: XP-Pen Deco Pro Medium Digital Drawing Graphics Tablet. Category: XP-PEN. Subcategory: Graphics Tablet. ",185,280082,280267
2015,sentence,"Category: XP-PEN. Subcategory: Graphics Tablet. Price: 11,200৳11,800৳.

Product: XP-PEN Deco Fun LW Wireless Digital 10 inch Drawing Graphics Tablet. Category: XP-PEN. Subcategory: Graphics Tablet. ",198,280219,280417
2016,sentence,"Category: XP-PEN. Subcategory: Graphics Tablet. Price: 9,500৳10,000৳.

Product: XP-Pen Deco Pro SW Bluetooth Drawing Graphics Tablet. Category: XP-PEN. Subcategory: Graphics Tablet. Price: 12,000৳.
",198,280369,280567
2017,sentence,"Subcategory: Graphics Tablet. Price: 12,000৳.

Product: XP-Pen Deco Pro XLW Gen 2 Wireless Graphics Drawing Tablet. Category: XP-PEN. Subcategory: Graphics Tablet. Price: 22,800৳23,300৳.
",187,280521,280708
2018,sentence,"Price: 22,800৳23,300৳.

Product: XP-Pen Artist 10 (2nd Gen) Digital Graphics Drawing Tablet. Category: XP-PEN. Subcategory: Graphics Tablet. Price: 24,000৳.
",157,280685,280842
2019,sentence,"Subcategory: Graphics Tablet. Price: 24,000৳.

Product: XP-Pen Artist 13 2nd Gen 13.3"" IPS Drawing Tablet. Category: XP-PEN. Subcategory: Graphics Tablet. Price: 30,500৳.
",171,280796,280967
2020,sentence,"Subcategory: Graphics Tablet. Price: 30,500৳.

Product: XP-Pen Artist 15.6 Pro V2 Graphics Tablet. Category: XP-PEN. Subcategory: Graphics Tablet. Price: 48,000৳.
",163,280921,281084
2021,sentence,"Subcategory: Graphics Tablet. Price: 48,000৳.

Product: XP-Pen Artist 13.3 Pro V2 Graphics Tablet. Category: XP-PEN. Subcategory: Graphics Tablet. Price: 36,500৳.
",163,281038,281201
2022,sentence,"Subcategory: Graphics Tablet. Price: 36,500৳.

Product: XP-Pen Artist 15.6 Pro IPS Drawing Monitor Pen Display Digital Graphics Tablet. Category: XP-PEN. Subcategory: Graphics Tablet. ",184,281155,281339
2023,sentence,"Category: XP-PEN. Subcategory: Graphics Tablet. Price: 45,000৳48,000৳.

Product: XP-Pen Artist 24 2K QHD 23.8"" Digital Graphics Drawing Tablet. Category: XP-PEN. Subcategory: Graphics Tablet. ",192,281291,281483
2024,sentence,"Category: XP-PEN. Subcategory: Graphics Tablet. Price: 94,500৳.

Product: TECLAST P85T 4GB 64GB Storage 8 inch Android Kids Tablet. Category: Tablet. Price: 11,000৳.
",166,281435,281601
2025,sentence,"Category: Tablet. Price: 11,000৳.

Product: Teclast P30 4GB 64GB 10.1"" Tablet Wi-Fi Only. Category: Tablet. Price: 12,000৳.

Product: TECLAST P30T 4GB 64GB Storage 10.1 inch Android Kids Tablet. ",195,281567,281762
2026,sentence,"Category: Tablet. Price: 13,000৳.

Product: Walton Walpad 8G 4GB RAM 64GB Storage 8"" Tablet. Category: Tablet. Price: 8,999৳14,500৳.
",133,281762,281895
2027,sentence,"Category: Tablet. Price: 8,999৳14,500৳.

Product: Teclast P30T 10.1 Inch Unisoc T606 Tablet with All-in-one KIT. Category: Tablet. Price: 16,000৳.

Product: Teclast P50 2025 11"" Tablet. ",186,281855,282041
2028,sentence,"
Product: Teclast P50 2025 11"" Tablet. Category: Tablet. Price: 16,500৳.

Product: Walton Walpad 9G 4GB RAM 128GB Storage 8.68"" Tablet. Category: Tablet. Price: 16,500৳18,000৳.
",177,282002,282179
2029,sentence,"Category: Tablet. Price: 16,500৳18,000৳.

Product: HONOR Pad X8a 4GB RAM 128GB Storage 11"" Tablet. Category: Tablet. Price: 18,000৳19,900৳.

Product: Amazon Fire HD 8 12th Gen 8"" FHD Tablet. ",191,282138,282329
2030,sentence,"Category: Tablet. Price: 20,000৳.

Product: Teclast T60AI 12"" Tablet. Category: Tablet. Price: 20,600৳.

Product: Amazon Fire 7 Kids 12th Gen 7"" Display Tablet. Category: Tablet. Price: 21,000৳.
",195,282329,282524
2031,sentence,"Category: Tablet. Price: 21,000৳.

Product: Amazon Fire HD 10 11th Gen Octa-Core 10.1"" FHD Tablet with Alexa. Category: Tablet. Price: 22,000৳.
",144,282490,282634
2032,sentence,"Category: Tablet. Price: 22,000৳.

Product: Amazon Fire HD 8 Plus 10th Gen Quad Core 8"" Display Tablet. Category: Tablet. Price: 22,000৳.
",138,282600,282738
2033,sentence,"Category: Tablet. Price: 22,000৳.

Product: Lenovo Tab M8 3GB RAM 32GB Storage 8"" FHD Tablet (Sim Supported). Category: Tablet. Price: 19,500৳22,500৳.

Product: Honor Pad 10. Category: Tablet. ",193,282704,282897
2034,sentence,"
Product: Honor Pad 10. Category: Tablet. Price: 37,000৳38,990৳.

Product: HONOR Pad X9a 6GB RAM 128GB Storage 11.5-inch Tablet. Category: Tablet. Price: 21,500৳22,500৳.
",170,282855,283025
2035,sentence,"Category: Tablet. Price: 21,500৳22,500৳.

Product: Lenovo Tab M9 4GB RAM 64GB Storage 9"" Android Tablet  (Sim Supported). Category: Tablet. Price: 23,999৳.
",156,282984,283140
2036,sentence,"Category: Tablet. Price: 23,999৳.

Product: Amazon Fire HD 8 Kids Pro 12th Gen 8"" Display Tablet. Category: Tablet. Price: 24,000৳.
",132,283106,283238
2037,sentence,"Category: Tablet. Price: 24,000৳.

Product: Walton Walpad 10H Pro Max 8GB RAM 128GB Storage 10.36"" Tablet. Category: Tablet. Price: 23,000৳24,000৳.
",148,283204,283352
2038,sentence,"Category: Tablet. Price: 23,000৳24,000৳.

Product: Teclast T60 8GB RAM 256GB ROM 11.97"" 2K IPS Tablet (Sim Supported). Category: Tablet. Price: 24,300৳25,500৳.
",160,283311,283471
2039,sentence,"Category: Tablet. Price: 24,300৳25,500৳.

Product: Wacom One by CTL-472 Small 6-inch x 3.5-inch Graphic Tablet. Category: Wacom. Subcategory: Graphics Tablet. Price: 6,800৳7,400৳.
",180,283430,283610
2040,sentence,"Price: 6,800৳7,400৳.

Product: Wacom CTL-4100/K0-CX Intuos Small Dimensions 20 x 16 x 0.9 Cm Pen Tablet. Category: Wacom. Subcategory: Graphics Tablet. Price: 9,000৳.
",167,283589,283756
2041,sentence,"Subcategory: Graphics Tablet. Price: 9,000৳.

Product: Wacom One By CTL-672/K2/K0-F Medium Dimensions 18.9 x 27.7 x 0.9 Cm Pen Graphics Tablet. Category: Wacom. Subcategory: Graphics Tablet. ",191,283711,283902
2042,sentence,"Category: Wacom. Subcategory: Graphics Tablet. Price: 8,500৳9,500৳.

Product: Wacom One S 6"" Small Bluetooth Graphics Drawing Tablet. Category: Wacom. Subcategory: Graphics Tablet. ",181,283855,284036
2043,sentence,"Category: Wacom. Subcategory: Graphics Tablet. Price: 12,800৳13,500৳.

Product: Wacom CTL-6100WL/K0-CX Intuos Medium Dimensions 26.4 x 20 x 0.9 Cm Bluetooth Pen Graphics Tablet. Category: Wacom. ",195,283989,284184
2044,sentence,"Category: Wacom. Subcategory: Graphics Tablet. Price: 18,000৳.

Product: Wacom PTH-460/K0-CX Intuos Pro S 10.6 x 6.7 x 0.3 inch Graphics Tablet. Category: Wacom. Subcategory: Graphics Tablet. ",192,284167,284359
2045,sentence,"Category: Wacom. Subcategory: Graphics Tablet. Price: 25,500৳32,000৳.

Product: Wacom Cintiq DTK-1660 16 Inch FHD Pen Graphics Tablet. Category: Wacom. Subcategory: Graphics Tablet. Price: 87,000৳.
",198,284312,284510
2046,sentence,"Subcategory: Graphics Tablet. Price: 87,000৳.

Product: Wacom DTK 2260 K0-CA Cintiq 22 Inch FHD 22ms HDMI Pen Graphics Tablet. Category: Wacom. Subcategory: Graphics Tablet. Price: 155,000৳.
",191,284464,284655
2047,sentence,"Subcategory: Graphics Tablet. Price: 155,000৳.

Product: Wacom Cintiq Pro 16 Inch UHD 22ms Creative Pen & Touch Graphics Tablet. Category: Wacom. Subcategory: Graphics Tablet. Price: 165,000৳.
",193,284608,284801
2048,sentence,"Subcategory: Graphics Tablet. Price: 165,000৳.

Product: Wacom DTK-2420 CINTIQ PRO 24 PEN Graphic Tablet. Category: Wacom. Subcategory: Graphics Tablet. Price: Pre Order.
",171,284754,284925
2049,sentence,"Subcategory: Graphics Tablet. Price: Pre Order.

Product: Wacom Cintiq Pro 32 Inch 4K UHD 14ms Pen and Touch Graphics Tablet. Category: Wacom. Subcategory: Graphics Tablet. Price: Pre Order.
",191,284877,285068
2050,sentence,"Subcategory: Graphics Tablet. Price: Pre Order.

Product: Wacom CTL-4100WL/K0-CX Intuos Small Bluetooth Dimensions 20 x 16 x 0.9 cm Pen Graphics Tablet. Category: Wacom. ",170,285020,285190
2051,sentence,"Category: Wacom. Subcategory: Graphics Tablet. Price: Out Of Stock.

Product: Wacom CTL-6100/K0-CX Intuos Medium Dimensions 26.4 x 20 x 0.9 cm Pen Graphics Tablet. Category: Wacom. ",181,285173,285354
2052,sentence,"Category: Wacom. Subcategory: Graphics Tablet. Price: Out Of Stock.

Product: Wacom PTH-660/K1-CX Intuos Pro Medium Paper Edition Dimensions 33.4 x 21.7 x 0.8 cm Pen Graphics Tablet. ",183,285337,285520
2053,sentence,"Category: Wacom. Subcategory: Graphics Tablet. Price: Out Of Stock.

Product: Huion H430P Graphics Tablet. Category: Graphics Tablet. Subcategory: Tablet. Price: 2,800৳2,900৳.
",176,285520,285696
2054,sentence,"Subcategory: Tablet. Price: 2,800৳2,900৳.

Product: Huion Inspiroy RTE-100 Graphics Drawing Tablet. Category: Graphics Tablet. Subcategory: Tablet. Price: 3,200৳3,550৳.
",169,285654,285823
2055,sentence,"Subcategory: Tablet. Price: 3,200৳3,550৳.

Product: Huion H640P Graphics Tablet. Category: Graphics Tablet. Subcategory: Tablet. Price: 3,700৳4,000৳.
",150,285781,285931
2056,sentence,"Subcategory: Tablet. Price: 3,700৳4,000৳.

Product: VEIKK S640 Small Dimensions 8.6 x 5.2 x 0.8 inches Drawing Graphic Tablet. Category: Graphics Tablet. Subcategory: Tablet. Price: 4,200৳5,000৳.
",196,285889,286085
2057,sentence,"Subcategory: Tablet. Price: 4,200৳5,000৳.

Product: Huion Inspiroy RTS-300 Graphics Drawing Tablet. Category: Graphics Tablet. Subcategory: Tablet. Price: 5,000৳5,500৳.
",169,286043,286212
2058,sentence,"Subcategory: Tablet. Price: 5,000৳5,500৳.

Product: Huion H950P Graphics Tablet. Category: Graphics Tablet. Subcategory: Tablet. Price: 5,500৳5,700৳.

Product: Huion Inspiroy H580X Graphics Tablet. ",198,286170,286368
2059,sentence,"
Product: Huion Inspiroy H580X Graphics Tablet. Category: Graphics Tablet. Subcategory: Tablet. Price: 5,200৳5,900৳.

Product: Huion Inspiroy H610X Graphics Tablet. Category: Graphics Tablet. ",192,286320,286512
2060,sentence,"Category: Graphics Tablet. Subcategory: Tablet. Price: 6,700৳7,000৳.

Product: Huion Inspiroy RTM-500 Graphics Drawing Tablet. Category: Graphics Tablet. Subcategory: Tablet. Price: 7,000৳7,500৳.
",196,286485,286681
2061,sentence,"Subcategory: Tablet. Price: 7,000৳7,500৳.

Product: Huion Inspiroy H1060P Graphics Tablet. Category: Graphics Tablet. Subcategory: Tablet. Price: 8,200৳8,200৳.
",160,286639,286799
2062,sentence,"Subcategory: Tablet. Price: 8,200৳8,200৳.

Product: VEIKK A50 Medium Dimensions 38.1 x 21.8 x 4.3 cm Drawing Graphic Tablet. Category: Graphics Tablet. Subcategory: Tablet. Price: 7,500৳8,300৳.
",194,286757,286951
2063,sentence,"Subcategory: Tablet. Price: 7,500৳8,300৳.

Product: Huion Inspiroy H1161 Graphics Tablet. Category: Graphics Tablet. Subcategory: Tablet. Price: 7,800৳8,400৳.
",159,286909,287068
2064,sentence,"Subcategory: Tablet. Price: 7,800৳8,400৳.

Product: Huion HS611 Graphics Drawing Tablet. Category: Graphics Tablet. Subcategory: Tablet. Price: 8,000৳8,450৳.
",158,287026,287184
2065,sentence,"Subcategory: Tablet. Price: 8,000৳8,450৳.

Product: Veikk A30 Digital Drawing Graphic Tablet. Category: Graphics Tablet. Subcategory: Tablet. Price: 7,000৳8,500৳.
",163,287142,287305
2066,sentence,"Subcategory: Tablet. Price: 7,000৳8,500৳.

Product: Huion Inspiroy RTP-700 Graphics Drawing Tablet. Category: Huion. Subcategory: Graphics Tablet. Price: 8,500৳9,000৳.
",168,287263,287431
2067,sentence,"Price: 8,500৳9,000৳.

Product: Huion Inspiroy Dial Q620M Graphic Drawing Tablet. Category: Huion. Subcategory: Graphics Tablet. Price: 8,500৳9,200৳.

Product: Huion A3 LED Light Pad. ",183,287410,287593
2068,sentence,"
Product: Huion A3 LED Light Pad. Category: Huion. Subcategory: Graphics Tablet. Price: 10,200৳.

Product: Huion Inspiroy Q11K V2 Wireless Graphic Tablet. Category: Huion. ",172,287559,287731
2069,sentence,"Category: Huion. Subcategory: Graphics Tablet. Price: 9,500৳10,299৳.

Product: Huion Inspiroy Keydial KD200 Graphics Drawing Tablet. Category: Huion. Subcategory: Graphics Tablet. Price: 13,300৳.
",196,287714,287910
2070,sentence,"Subcategory: Graphics Tablet. Price: 13,300৳.

Product: Huion Inspiroy WH1409 V2 13.8 Inch Wireless Graphic Tablet. Category: Huion. Subcategory: Graphics Tablet. Price: 13,500৳13,700৳.
",186,287864,288050
2071,sentence,"Price: 13,500৳13,700৳.

Product: Huion Kamvas 12 Graphics Drawing Tablet. Category: Huion. Subcategory: Graphics Tablet. Price: 24,000৳25,000৳.

Product: Huion Kamvas Pro 12 Pen Display. ",187,288027,288214
2072,sentence,"
Product: Huion Kamvas Pro 12 Pen Display. Category: Huion. Subcategory: Graphics Tablet. Price: 29,000৳31,000৳.

Product: Huion KAMVAS Pro 13 13.3-Inch FHD Graphics Drawing Tablet. Category: Huion. ",199,288171,288370
2073,sentence,"Category: Huion. Subcategory: Graphics Tablet. Price: 34,000৳35,000৳.

Product: Black Shark Pad 6 8GB RAM 256GB Storage 11"" FHD+ Tablet With Flip Cover (Dual Sim Supported). Category: Black Shark. ",197,288353,288550
2074,sentence,"Category: Black Shark. Subcategory: Tablet. Price: 23,990৳26,000৳.

Product: HONOR Pad X8a LTE 4GB RAM 128GB Storage 11"" Tablet. Category: HONOR. Subcategory: Tablet. Price: 25,990৳.
",183,288527,288710
2075,sentence,"Subcategory: Tablet. Price: 25,990৳.

Product: HONOR Pad X9 LTE 4GB RAM 128GB Storage 11.5-inch Tablet (Sim Supported). Category: HONOR. Subcategory: Tablet. Price: 27,350৳27,850৳.
",181,288673,288854
2076,sentence,"Subcategory: Tablet. Price: 27,350৳27,850৳.

Product: HONOR Pad X8 4GB RAM 64GB Storage 10.1"" Tablet (SIM Supported). Category: HONOR. Subcategory: Tablet. Price: 21,500৳.
",172,288810,288982
2077,sentence,"Subcategory: Tablet. Price: 21,500৳.

Product: HONOR Pad X7 4GB RAM 64GB Storage 8.7"" Tablet With Case. Category: HONOR. Subcategory: Tablet. Price: 12,100৳13,500৳.
",165,288945,289110
2078,sentence,"Subcategory: Tablet. Price: 12,100৳13,500৳.

Product: HONOR Pad 9 Wi-Fi 8GB RAM 256GB Storage 12.1"" WQXGA Tablet. Category: HONOR. Subcategory: Tablet. Price: Out Of Stock.
",173,289066,289239
2079,sentence,"Subcategory: Tablet. Price: Out Of Stock.

Product: Lenovo Tab M10 Plus (3rd Gen) Snapdragon 4GB RAM 128GB ROM 10.61"" 2K Android Tablet. Category: Lenovo. Subcategory: Tablet. Price: 27,500৳29,000৳.
",199,289197,289396
2080,sentence,"Subcategory: Tablet. Price: 27,500৳29,000৳.

Product: Lenovo K10 Pro Snapdragon 680 6GB RAM 128GB ROM LTE (Nano-SIM) 10.6"" Android Tablet. Category: Lenovo. Subcategory: Tablet. ",178,289352,289530
2081,sentence,"Category: Lenovo. Subcategory: Tablet. Price: 28,500৳29,000৳.

Product: Lenovo Xiaoxin Pad 2024 Snapdragon 685 11"" Tablet (WiFi Only). Category: Lenovo. Subcategory: Tablet. Price: 30,000৳.
",190,289491,289681
2082,sentence,"Subcategory: Tablet. Price: 30,000৳.

Product: Lenovo Xiaoxin Pad 2024 Snapdragon 685 8GB RAM 128GB ROM 11"" Tablet (WiFi Only). Category: Lenovo. Subcategory: Tablet. Price: 31,000৳32,500৳.
",190,289644,289834
2083,sentence,"Subcategory: Tablet. Price: 31,000৳32,500৳.

Product: Lenovo Tab M10 Plus (3rd Gen) Snapdragon 6GB RAM 128GB ROM 10.61"" 2K Android Tablet. Category: Lenovo. Subcategory: Tablet. Price: 33,000৳.
",194,289790,289984
2084,sentence,"Subcategory: Tablet. Price: 33,000৳.

Product: Lenovo Xiaoxin Pad 2024 Snapdragon 685 8GB RAM 256GB ROM 11"" Tablet (WiFi Only). Category: Lenovo. Subcategory: Tablet. Price: 32,500৳33,500৳.
",190,289947,290137
2085,sentence,"Subcategory: Tablet. Price: 32,500৳33,500৳.

Product: Lenovo Xiaoxin Pad Pro Snapdragon 870 8GB RAM 256GB Storage 12.7"" Tablet (WiFi Only). Category: Lenovo. Subcategory: Tablet. ",179,290093,290272
2086,sentence,"Category: Lenovo. Subcategory: Tablet. Price: 45,000৳48,500৳.

Product: Lenovo Xiaoxin Pad Pro (2025) Dimensity 8300 12GB RAM 256GB Storage 12.7"" Tablet (Wi-Fi). Category: Lenovo. ",180,290233,290413
2087,sentence,"Category: Lenovo. Subcategory: Tablet. Price: 57,500৳.

Product: Lenovo Tab P11 Gen 2 4GB RAM 128GB Storage 11.5-Inch 2K Android Tablet with keyboard & Pen. Category: Lenovo. Subcategory: Tablet. ",196,290395,290591
2088,sentence,"Category: Lenovo. Subcategory: Tablet. Price: Up Coming.

Product: Lenovo Tab K11 4GB RAM 64GB Storage 11"" 2K Android Tablet (Sim Supported). Category: Lenovo. Subcategory: Tablet. Price: Up Coming.
",199,290552,290751
2089,sentence,"Subcategory: Tablet. Price: Up Coming.

Product: Lenovo Tab K11 / P11 J6C6F Plus Helio G90T 6GB RAM 128GB Storage 11"" 2K Android Tablet. Category: Lenovo. Subcategory: Tablet. Price: Up Coming.
",194,290712,290906
2090,sentence,"Subcategory: Tablet. Price: Up Coming.

Product: Veikk Creator A15 Pro Drawing Graphic Tablet. Category: VEIKK. Subcategory: Graphics Tablet. Price: 8,000৳9,500৳.
",163,290867,291030
2091,sentence,"Price: 8,000৳9,500৳.

Product: Apple iPad 11th Gen (2025). Category: iPad. Subcategory: Tablet. Price: 43,000৳45,500৳.

Product: Apple iPad Air 5 (WiFi). Category: iPad. Subcategory: Tablet. ",191,291009,291200
2092,sentence,"Category: iPad. Subcategory: Tablet. Price: 54,900৳61,000৳.

Product: Apple iPad Mini 7 (WiFi). Category: iPad. Subcategory: Tablet. Price: 55,000৳62,500৳.
",156,291163,291319
2093,sentence,"Subcategory: Tablet. Price: 55,000৳62,500৳.

Product: Apple iPad Air M3 11-inch (WiFi). Category: iPad. Subcategory: Tablet. Price: 68,000৳75,000৳.

Product: Apple iPad Air M2 11-inch (WiFi). ",192,291275,291467
2094,sentence,"
Product: Apple iPad Air M2 11-inch (WiFi). Category: iPad. Subcategory: Tablet. Price: 71,000৳84,900৳.

Product: Apple iPad Air M3 11-inch (WiFI+Cellular). Category: iPad. Subcategory: Tablet. ",194,291423,291617
2095,sentence,"Category: iPad. Subcategory: Tablet. Price: 96,500৳95,000৳.

Product: Apple iPad Air M2 13-inch (WiFi). Category: iPad. Subcategory: Tablet. Price: 96,500৳99,800৳.
",164,291580,291744
2096,sentence,"Subcategory: Tablet. Price: 96,500৳99,800৳.

Product: Apple iPad Air 5 (WiFi+Cellular). Category: iPad. Subcategory: Tablet. Price: 102,000৳.

Product: Apple iPad Air M2 11-inch (WiFi+Cellular). ",195,291700,291895
2097,sentence,"Category: iPad. Subcategory: Tablet. Price: 100,000৳104,900৳.

Product: Apple iPad Mini 7 (WiFi+Cellular). Category: iPad. Subcategory: Tablet. Price: 110,000৳114,500৳.
",169,291895,292064
2098,sentence,"Subcategory: Tablet. Price: 110,000৳114,500৳.

Product: Apple iPad Pro M4 11-inch (WiFi). Category: iPad. Subcategory: Tablet. Price: 113,800৳121,000৳.
",152,292018,292170
2099,sentence,"Subcategory: Tablet. Price: 113,800৳121,000৳.

Product: Apple iPad Pro M4 11-inch (WiFi+Cellular). Category: iPad. Subcategory: Tablet. Price: 155,000৳157,000৳.
",161,292124,292285
2100,sentence,"Subcategory: Tablet. Price: 155,000৳157,000৳.

Product: Apple iPad Pro M4 13-inch (WiFi). Category: iPad. Subcategory: Tablet. Price: 143,000৳157,000৳.
",152,292239,292391
2101,sentence,"Subcategory: Tablet. Price: 143,000৳157,000৳.

Product: Apple iPad Pro M4 13 inch (WiFi+Cellular). Category: iPad. Subcategory: Tablet. Price: 164,000৳173,000৳.

Product: Apple iPad 9th Gen. ",191,292345,292536
2102,sentence,"
Product: Apple iPad 9th Gen. Category: iPad. Subcategory: Tablet. Price: Out Of Stock.

Product: Apple iPad 10th Gen. Category: iPad. Subcategory: Tablet. Price: Out Of Stock.
",177,292506,292683
2103,sentence,"Subcategory: Tablet. Price: Out Of Stock.

Product: Xiaomi Redmi Pad 2. Category: Xiaomi. Subcategory: Tablet. Price: 27,400৳.
",127,292641,292768
2104,sentence,"Subcategory: Tablet. Price: 27,400৳.

Product: Xiaomi Redmi Pad SE Snapdragon 680 4GB RAM 128GB ROM 11"" FHD Tablet. Category: Xiaomi. Subcategory: Tablet. Price: 26,500৳27,500৳.
",178,292731,292909
2105,sentence,"Subcategory: Tablet. Price: 26,500৳27,500৳.

Product: Xiaomi Redmi Pad SE Snapdragon 680 6GB RAM 128GB ROM 11"" FHD Tablet. Category: Xiaomi. Subcategory: Tablet. Price: 28,000৳.
",178,292865,293043
2106,sentence,"Subcategory: Tablet. Price: 28,000৳.

Product: Xiaomi Redmi Pad SE Snapdragon 680 8GB RAM 256GB ROM 11"" FHD Tablet. Category: Xiaomi. Subcategory: Tablet. Price: 30,700৳33,000৳.
",178,293006,293184
2107,sentence,"Subcategory: Tablet. Price: 30,700৳33,000৳.

Product: Xiaomi Redmi Pad Pro Snapdragon 7s gen 2 8GB RAM 256GB Storage 12.1 Inch Tablet Only Wi-Fi. Category: Xiaomi. Subcategory: Tablet. ",185,293140,293325
2108,sentence,"Category: Xiaomi. Subcategory: Tablet. Price: 29,000৳34,500৳.

Product: Xiaomi Pad 6 Snapdragon 870 8GB RAM 256GB Storage 11"" WQHD+ Tablet. Category: Xiaomi. Subcategory: Tablet. ",179,293286,293465
2109,sentence,"Category: Xiaomi. Subcategory: Tablet. Price: 35,500৳36,500৳.

Product: Xiaomi POCO Pad 12.1"" 2.5K Tablet. Category: Xiaomi. Subcategory: Tablet. Price: 41,000৳.
",162,293426,293588
2110,sentence,"Subcategory: Tablet. Price: 41,000৳.

Product: Xiaomi Pad 7 11.2"" Tablet Snapdragon 7+ Gen 3, 256GB. Category: Xiaomi. Subcategory: Tablet. Price: 39,500৳44,000৳.
",163,293551,293714
2111,sentence,"Subcategory: Tablet. Price: 39,500৳44,000৳.

Product: Xiaomi Pad 7 Pro Snapdragon 8s Gen 3 12GB RAM 512GB Storage 11.2"" 3.2K Tablet. Category: Xiaomi. Subcategory: Tablet. Price: 60,500৳65,000৳.
",195,293670,293865
2112,sentence,"Subcategory: Tablet. Price: 60,500৳65,000৳.

Product: Xiaomi Pad 7 Ultra. Category: Xiaomi. Subcategory: Tablet. Price: 110,000৳.
",130,293821,293951
2113,sentence,"Subcategory: Tablet. Price: 110,000৳.

Product: Xiaomi Pad 6S Pro Snapdragon 8 Gen 2 8GB RAM 256GB Storage 12.4"" 3K Tablet. Category: Xiaomi. Subcategory: Tablet. Price: 69,000৳75,000৳.
",186,293913,294099
2114,sentence,"Subcategory: Tablet. Price: 69,000৳75,000৳.

Product: Xiaomi Redmi Pad SE Snapdragon 680 8GB RAM 128GB ROM 11"" FHD Tablet. Category: Xiaomi. Subcategory: Tablet. Price: Out Of Stock.
",183,294055,294238
2115,sentence,"Subcategory: Tablet. Price: Out Of Stock.

Product: Xiaomi Redmi Pad Pro Snapdragon 7s gen 2 8GB RAM 256GB Storage 12.1 Inch Tablet With 5G Sim Supported. Category: Xiaomi. Subcategory: Tablet. ",194,294196,294390
2116,sentence,"Category: Xiaomi. Subcategory: Tablet. Price: Out Of Stock.

Product: Samsung Galaxy Tab A9 LTE (Wi-Fi + SIM). Category: Samsung. Subcategory: Tablet. Price: 13,990৳14,500৳.
",174,294351,294525
2117,sentence,"Subcategory: Tablet. Price: 13,990৳14,500৳.

Product: Samsung Galaxy Tab A9+ (Wi-Fi + SIM). Category: Samsung. Subcategory: Tablet. Price: 24,990৳32,500৳.
",155,294481,294636
2118,sentence,"Subcategory: Tablet. Price: 24,990৳32,500৳.

Product: Samsung Galaxy Tab S6 Lite 2024 (Wi-Fi + SIM). Category: Samsung. Subcategory: Tablet. Price: 35,000৳36,000৳.
",164,294592,294756
2119,sentence,"Subcategory: Tablet. Price: 35,000৳36,000৳.

Product: Samsung Galaxy Tab S9 FE (Wi-Fi Only). Category: Samsung. Subcategory: Tablet. Price: 37,000৳40,000৳.
",156,294712,294868
2120,sentence,"Subcategory: Tablet. Price: 37,000৳40,000৳.

Product: Samsung Galaxy Tab S9 FE+ (Wi-Fi Only). Category: Samsung. Subcategory: Tablet. Price: 43,500৳51,000৳.

Product: Samsung Galaxy Tab S10 FE. ",194,294824,295018
2121,sentence,"
Product: Samsung Galaxy Tab S10 FE. Category: Samsung. Subcategory: Tablet. Price: 45,000৳52,000৳.

Product: Samsung Galaxy Tab S10 FE 12GB RAM 256GB Storage. Category: Samsung. ",179,294981,295160
2122,sentence,"Category: Samsung. Subcategory: Tablet. Price: 53,500৳56,500৳.

Product: Samsung Galaxy Tab S9 (Wi-Fi Only). Category: Samsung. Subcategory: Tablet. Price: 58,000৳60,000৳.
",172,295141,295313
2123,sentence,"Subcategory: Tablet. Price: 58,000৳60,000৳.

Product: Samsung Galaxy Tab S10 FE+. Category: Samsung. Subcategory: Tablet. Price: 73,500৳.

Product: Samsung Galaxy Tab S9 5G (Wi-Fi + SIM). ",188,295269,295457
2124,sentence,"Category: Samsung. Subcategory: Tablet. Price: 75,000৳82,000৳.

Product: Samsung Galaxy Tab S10+ With Keyboard. Category: Samsung. Subcategory: Tablet. Price: 92,500৳98,500৳.
",175,295457,295632
2125,sentence,"Subcategory: Tablet. Price: 92,500৳98,500৳.

Product: Samsung Galaxy Tab S10 Ultra Wi-Fi Tablet With Keyboard. Category: Samsung. Subcategory: Tablet. Price: 111,500৳115,000৳.
",176,295588,295764
2126,sentence,"Subcategory: Tablet. Price: 111,500৳115,000৳.

Product: Samsung Galaxy Tab S9+ (Wi-Fi Only). Category: Samsung. Subcategory: Tablet. Price: 120,000৳138,000৳.
",158,295718,295876
2127,sentence,"Subcategory: Tablet. Price: 120,000৳138,000৳.

Product: Samsung Galaxy Tab S9+ (Wi-Fi + SIM). Category: Samsung. Subcategory: Tablet. Price: 129,900৳145,000৳.
",159,295830,295989
2128,sentence,"Subcategory: Tablet. Price: 129,900৳145,000৳.

Product: Samsung Galaxy Tab S10 Ultra 5G (Wi-Fi + SIM). Category: Samsung. Subcategory: Tablet. Price: 137,000৳145,000৳.
",168,295943,296111
2129,sentence,"Subcategory: Tablet. Price: 137,000৳145,000৳.

Product: Samsung Galaxy Tab S10 Ultra 5G 512GB (Wi-Fi + SIM). Category: Samsung. Subcategory: Tablet. Price: 155,000৳.
",166,296065,296231
2130,sentence,"Subcategory: Tablet. Price: 155,000৳.

Product: Samsung Galaxy Tab S9 FE 5G (Wi-Fi + SIM). Category: Samsung. Subcategory: Tablet. Price: Out Of Stock.
",152,296193,296345
2131,sentence,"Subcategory: Tablet. Price: Out Of Stock.

Product: Samsung Galaxy Tab S9 FE+ (Wi-Fi + SIM). Category: Samsung. Subcategory: Tablet. Price: Out Of Stock.
",154,296303,296457
2132,sentence,"Subcategory: Tablet. Price: Out Of Stock.

Product: Samsung Galaxy Tab A9+ (Wi-Fi Only). Category: Samsung. Subcategory: Tablet. Price: Out Of Stock.
",150,296415,296565
2133,sentence,"Subcategory: Tablet. Price: Out Of Stock.

Product: Huawei MatePad 11 Wi-Fi 6GB RAM 128GB ROM IPS LCD Tablet. Category: HUAWEI. Subcategory: Tablet. Price: 52,500৳.

Product: Huawei MatePad 12 X. ",196,296523,296719
2134,sentence,"Price: 52,500৳.

Product: Huawei MatePad 12 X. Category: HUAWEI. Subcategory: Tablet. Price: Up Coming.

Product: Huion Kamvas Slate 10 10.1-Inch FHD+ Android Drawing Tablet. Category: Huion. ",192,296672,296864
2135,sentence,"Category: Huion. Subcategory: Tablet. Price: 21,000৳27,500৳.

Product: Chuwi Hi10 Max 12GB RAM 512GB ROM 12.96"" 3K Display Tablet. Category: Chuwi. Subcategory: Tablet. Price: 42,500৳44,900৳.
",192,296847,297039
2136,sentence,"Subcategory: Tablet. Price: 42,500৳44,900৳.

Product: Chuwi Hi10 XPro 4GB RAM 128GB Storage 10.1"" Android Tablet. Category: Chuwi. Subcategory: Tablet. Price: Up Coming.
",170,296995,297165
2137,sentence,"Subcategory: Tablet. Price: Up Coming.

Product: Amazon Fire MAX 11 13th Gen Octa-Core 11"" 2K Tablet with Alexa. Category: Amazon. Subcategory: Tablet. Price: 30,000৳.
",168,297126,297294
2138,sentence,"Subcategory: Tablet. Price: 30,000৳.

Product: Amazon Kindle Paperwhite 12th Gen 16GB 7"" Display with Built-in Light, WiFi. Category: Amazon. Subcategory: Tablet. Price: 26,500৳33,000৳.
",186,297257,297443
2139,sentence,"Subcategory: Tablet. Price: 26,500৳33,000৳.

Product: Amazon Kindle Scribe 16GB 10.2” Tablet. Category: Amazon. Subcategory: Tablet. Price: 60,000৳.
",149,297399,297548
2140,sentence,"Subcategory: Tablet. Price: 60,000৳.

Product: Amazon Fire 7 Quad Core 7"" Display Kids Tablet. Category: Amazon. Subcategory: Tablet. Price: Up Coming.
",152,297511,297663
2141,sentence,"Subcategory: Tablet. Price: Up Coming.

Product: Amazon Fire HD 8 Quad Core 8"" Display Kids Tablet. Category: Amazon. Subcategory: Tablet. Price: Up Coming.
",157,297624,297781
2142,sentence,"Subcategory: Tablet. Price: Up Coming.

Product: Amazon Fire HD 10 Kids 13th Gen 10.1"" FHD Tablet. Category: Amazon. Subcategory: Tablet. Price: Up Coming.
",156,297742,297898
2143,sentence,"Subcategory: Tablet. Price: Up Coming.

Product: Amazon Kindle Colorsoft Signature Edition 32GB 7"" E-Book Reader. Category: Amazon. Subcategory: Tablet. Price: 50,000৳.
",169,297859,298028
2144,sentence,"Subcategory: Tablet. Price: 50,000৳.

Product: Amazon Kindle Kids 11th Gen 16GB 6"" E-Book Reader. Category: Amazon. Subcategory: Tablet. Price: Up Coming.
",155,297991,298146
2145,sentence,"Subcategory: Tablet. Price: Up Coming.

Product: Amazon Fire HD 10 13th Gen Octa-Core 10.1"" FHD Tablet with Alexa. Category: Amazon. Subcategory: Tablet. Price: Out Of Stock.
",175,298107,298282
2146,sentence,"Subcategory: Tablet. Price: Out Of Stock.

Product: Infinix Xpad 20. Category: Infinix. Subcategory: Tablet. Price: 19,900৳.

Product: Motorola Moto Pad 60 Pro. Category: Motorola. ",181,298240,298421
2147,sentence,"Category: Motorola. Subcategory: Tablet. Price: Out Of Stock.

Product: OnePlus Pad 2 Snapdragon 8 Gen 3 12GB RAM 256GB Storage 12.1"" 3K Tablet. Category: OnePlus. Subcategory: Tablet. ",185,298401,298586
2148,sentence,"Category: OnePlus. Subcategory: Tablet. Price: 55,200৳57,500৳.

Product: OnePlus Pad Lite 6GB RAM 128GB Storage 11"" Tablet. Category: OnePlus. Subcategory: Tablet. Price: Up Coming.
",182,298546,298728
2149,sentence,"Subcategory: Tablet. Price: Up Coming.

Product: OnePlus Pad 3 Snapdragon 8 Elite 12GB RAM 256GB Storage 13.2"" 3.4K Tablet. Category: OnePlus. Subcategory: Tablet. Price: Up Coming.
",182,298689,298871
2150,sentence,"Subcategory: Tablet. Price: Up Coming.

Product: ZTE Nubia Pad 3D Snapdragon 888 12GB RAM 256GB Storage 12.4"" 2.5K Tablet. Category: ZTE. Subcategory: Tablet. Price: 95,000৳102,000৳.
",183,298832,299015
2151,sentence,"Subcategory: Tablet. Price: 95,000৳102,000৳.

Product: Teclast T65 Max 13"" Android Tablet 8GB 256GB (Sim Supported). Category: Teclast. Subcategory: Tablet. Price: 29,500৳.
",173,298970,299143
2152,sentence,"Subcategory: Tablet. Price: 29,500৳.

Product: Teclast T70 14"" Android Tablet. Category: Teclast. Subcategory: Tablet. Price: 32,000৳.

Product: Teclast M50 Plus 10.1"" Tablet. Category: Teclast. ",195,299106,299301
2153,sentence,"Category: Teclast. Subcategory: Tablet. Price: Out Of Stock.

Product: TECLAST T50 Plus 6GB 256GB Storage 11 inch Android Tablet. Category: Teclast. Subcategory: Tablet. Price: 20,000৳.
",186,299282,299468
2154,sentence,"Subcategory: Tablet. Price: 20,000৳.

Product: Teclast T60 Plus 12 inch Android Tablet With Sim Supported. Category: Teclast. Subcategory: Tablet. Price: Out Of Stock.
",168,299431,299599
2155,sentence,"Subcategory: Tablet. Price: Out Of Stock.

Product: Teclast T50 Mini 8GB RAM 128GB ROM 8.7"" WXGA+ IPS Tablet (Sim Supported). Category: Teclast. Subcategory: Tablet. Price: 20,000৳.
",182,299557,299739
2156,sentence,"Subcategory: Tablet. Price: 20,000৳.

Product: Google Pixel Tablet 8GB RAM 128GB Storage 10.95-inch Android Tablet. Category: Google. Subcategory: Tablet. Price: Up Coming.
",173,299702,299875
2157,sentence,"Subcategory: Tablet. Price: Up Coming.

Product: Google Pixel Tablet 8GB RAM 256GB Storage 10.95-inch Android Tablet. Category: Google. Subcategory: Tablet. Price: Up Coming.
",175,299836,300011
2158,sentence,"Subcategory: Tablet. Price: Up Coming.

Product: Hoco GM111 Cool Dynamic Series 3 in 1 Passive Universal Capacitive Stylus Pen. Category: Stylus. Subcategory: Tablet. Price: 500৳800৳.
",184,299972,300156
2159,sentence,"Subcategory: Tablet. Price: 500৳800৳.

Product: Wiwu Pencil One 2 in 1 Passive Style Stylus Pen (Universal). Category: Stylus. Subcategory: Tablet. Price: 950৳1,000৳.
",167,300118,300285
2160,sentence,"Subcategory: Tablet. Price: 950৳1,000৳.

Product: ESR Geo Digital Pencil for iPad. Category: Stylus. Subcategory: Tablet. Price: 5,278৳.

Product: ESR Digital Pencil for iPad. Category: Stylus. ",194,300245,300439
2161,sentence,"Category: Stylus. Subcategory: Tablet. Price: 3,958৳.

Product: Baseus Golden Cudgel Capacitive Stylus Pen Universal Android and Windows. Category: Stylus. Subcategory: Tablet. Price: 1,100৳1,200৳.
",198,300421,300619
2162,sentence,"Subcategory: Tablet. Price: 1,100৳1,200৳.

Product: Baseus Smooth Writing III 3-in-1 Multi-functional Passive Stylus Pen. Category: Stylus. Subcategory: Tablet. Price: 950৳1,100৳.
",180,300577,300757
2163,sentence,"Subcategory: Tablet. Price: 950৳1,100৳.

Product: Hoco GM109 Smart Stylus Pen. Category: Stylus. Subcategory: Tablet. Price: 1,850৳2,000৳.
",139,300717,300856
2164,sentence,"Subcategory: Tablet. Price: 1,850৳2,000৳.

Product: WiWU Pencil D Stylus Universal pencil for iPad, iPhone, & Android. Category: Stylus. Subcategory: Tablet. Price: 2,050৳2,100৳.
",179,300814,300993
2165,sentence,"Subcategory: Tablet. Price: 2,050৳2,100৳.

Product: WiWU Pencil W Stylus Pen For iPad. Category: Stylus. Subcategory: Tablet. Price: 2,950৳3,250৳.

Product: WiWU Pencil W Pro Stylus Pen. ",187,300951,301138
2166,sentence,"
Product: WiWU Pencil W Pro Stylus Pen. Category: Stylus. Subcategory: Tablet. Price: 2,250৳2,300৳.

Product: Xiaomi Focus Pen. Category: Stylus. Subcategory: Tablet. Price: 8,000৳8,300৳.
",188,301098,301286
2167,sentence,"Subcategory: Tablet. Price: 8,000৳8,300৳.

Product: WiWU Pencil L Stylus Pen (Palm Rejection). Category: Stylus. Subcategory: Tablet. Price: 2,300৳2,450৳.
",155,301244,301399
2168,sentence,"Subcategory: Tablet. Price: 2,300৳2,450৳.

Product: WIWU Picasso P339 Active Stylus Universal Capacities Touch Screen Stylus Pen for iOS & Android. Category: Stylus. Subcategory: Tablet. ",187,301357,301544
2169,sentence,"Category: Stylus. Subcategory: Tablet. Price: 2,200৳2,900৳.

Product: WiWU Pencil Pro For iPad (Palm Rejection). Category: Stylus. Subcategory: Tablet. Price: Out Of Stock.
",173,301505,301678
2170,sentence,"Subcategory: Tablet. Price: Out Of Stock.

Product: WiWU Touch Screen Stylus S Pen for Samsung Galaxy Z Fold 3 Rechargeable Mobile Phone Stylus Pencil. Category: Stylus. Subcategory: Tablet. ",191,301636,301827
2171,sentence,"Category: Stylus. Subcategory: Tablet. Price: 1,800৳3,200৳.

Product: Microsoft Surface Pen (Ice Blue). Category: Stylus. Subcategory: Tablet. Price: 11,000৳12,000৳.
",166,301788,301954
2172,sentence,"Subcategory: Tablet. Price: 11,000৳12,000৳.

Product: Apple Pencil USB Type-C. Category: Stylus. Subcategory: Tablet. Price: 11,000৳12,500৳.

Product: Apple Pencil (2nd generation). ",182,301910,302092
2173,sentence,"
Product: Apple Pencil (2nd generation). Category: Stylus. Subcategory: Tablet. Price: 14,500৳15,500৳.

Product: Apple Pencil (2nd generation). Category: Stylus. Subcategory: Tablet. ",183,302051,302234
2174,sentence,"Category: Stylus. Subcategory: Tablet. Price: 14,500৳16,500৳.

Product: Apple Pencil Pro. Category: Stylus. Subcategory: Tablet. Price: 14,500৳18,000৳.
",152,302195,302347
2175,sentence,"Subcategory: Tablet. Price: 14,500৳18,000৳.

Product: Epson S015639/S015634 Ribbon For LQ-310 Printer. Category: Office Equipment. Price: 420৳.

Product: Power Print TN-85 HP 85A /36A/35A/78A Toner. ",199,302303,302502
2176,sentence,"Category: Office Equipment. Price: 700৳.

Product: Epson 003 Black Ink Bottle. Category: Office Equipment. Price: 600৳.

Product: Starink 83A Black LaserJet Toner. Category: Office Equipment. ",192,302502,302694
2177,sentence,"Category: Office Equipment. Price: 700৳.

Product: Epson C13T6641 Black Ink Bottle. Category: Office Equipment. Price: 700৳.

Product: Epson C13T6642 Cyan Ink Bottle. Category: Office Equipment. ",195,302666,302861
2178,sentence,"Category: Office Equipment. Price: 700৳750৳.

Product: Epson C13T6643 Magenta Ink Bottle. Category: Office Equipment. Price: 720৳.

Product: Epson C13T6644 Yellow Ink Bottle. ",175,302833,303008
2179,sentence,"
Product: Epson C13T6644 Yellow Ink Bottle. Category: Office Equipment. Price: 700৳750৳.

Product: DELI E15130 Barcode Scanner Stand. Category: Office Equipment. Price: 750৳.
",175,302964,303139
2180,sentence,"Category: Office Equipment. Price: 750৳.

Product: Epson 001 T03Y2 70ml Cyan Ink Bottle (Bundle With Full Set). Category: Office Equipment. Price: 750৳.
",153,303098,303251
2181,sentence,"Category: Office Equipment. Price: 750৳.

Product: Epson 001 T03Y4 70ml Yellow Ink Bottle (Bundle With Full Set). Category: Office Equipment. Price: 750৳.
",155,303210,303365
2182,sentence,"Category: Office Equipment. Price: 750৳.

Product: Epson 001 T03Y3 70ml Magenta Ink Bottle (Bundle With Full Set). Category: Office Equipment. Price: 720৳.

Product: Epson 003 Cyan Ink Bottle. ",193,303324,303517
2183,sentence,"
Product: Epson 003 Cyan Ink Bottle. Category: Office Equipment. Price: 720৳.

Product: Epson 003 Magenta Ink Bottle. Category: Office Equipment. Price: 720৳.

Product: Epson 003 Yellow Ink Bottle. ",198,303480,303678
2184,sentence,"
Product: Epson 003 Yellow Ink Bottle. Category: Office Equipment. Price: 720৳.

Product: Power Print TN-79A Toner. Category: Office Equipment. Price: 750৳.
",157,303639,303796
2185,sentence,"Category: Office Equipment. Price: 750৳.

Product: Starink 79A Black LaserJet Toner. Category: Office Equipment. Price: 750৳.

Product: Starink 35A Black LaserJet Toner. Category: Office Equipment. ",198,303755,303953
2186,sentence,"Category: Office Equipment. Price: 800৳.

Product: MaxGreen 48A Black LaserJet Toner. Category: Office Equipment. Price: 700৳800৳.

Product: True Trust 85A Black Laser Toner. ",175,303925,304100
2187,sentence,"
Product: True Trust 85A Black Laser Toner. Category: Office Equipment. Price: 800৳.

Product: BenQ MX560C XGA 4000 ANSI Lumens Business Projector. Category: BenQ. Subcategory: Office Equipment. ",195,304056,304251
2188,sentence,"Category: BenQ. Subcategory: Office Equipment. Price: 42,000৳.

Product: Benq MX550 3600 Lumens XGA Multimedia Projector. Category: BenQ. Subcategory: Office Equipment. Price: 41,000৳44,000৳.
",192,304204,304396
2189,sentence,"Price: 41,000৳44,000৳.

Product: BenQ MS560 4000 ANSI Lumens SVGA Business Projector. Category: BenQ. Subcategory: Office Equipment. Price: 40,800৳44,000৳.
",156,304373,304529
2190,sentence,"Price: 40,800৳44,000৳.

Product: BenQ MX560 4000 ANSI Lumens XGA Business Projector. Category: BenQ. Subcategory: Office Equipment. Price: 41,500৳45,000৳.
",155,304506,304661
2191,sentence,"Price: 41,500৳45,000৳.

Product: BenQ MW560C WXGA 4000 ANSI Lumens Business Projector. Category: BenQ. Subcategory: Office Equipment. Price: 55,000৳.
",150,304638,304788
2192,sentence,"Subcategory: Office Equipment. Price: 55,000৳.

Product: BenQ MW560 4000 ANSI Lumens WXGA Business Projector. Category: BenQ. Subcategory: Office Equipment. Price: 55,000৳60,000৳.
",180,304741,304921
2193,sentence,"Price: 55,000৳60,000৳.

Product: BenQ MX808STH 3600 Lumens XGA Short Throw Projector. Category: BenQ. Subcategory: Office Equipment. Price: Out Of Stock.
",154,304898,305052
2194,sentence,"Price: Out Of Stock.

Product: BENQ EX600 3600 Lumens XGA Wireless Smart Projector for Business. Category: BenQ. Subcategory: Office Equipment. Price: 74,000৳75,000৳.
",167,305031,305198
2195,sentence,"Price: 74,000৳75,000৳.

Product: BenQ EX605 4000lms Android Smart Projector. Category: BenQ. Subcategory: Office Equipment. Price: 74,000৳80,000৳.
",147,305175,305322
2196,sentence,"Price: 74,000৳80,000৳.

Product: BenQ EW600 3600 Lumens WXGA Wireless Android Smart Projector. Category: BenQ. Subcategory: Office Equipment. Price: 81,000৳83,000৳.
",165,305299,305464
2197,sentence,"Price: 81,000৳83,000৳.

Product: BenQ MH560 3800 Lumen DLP Full Hd Business Projector. Category: BenQ. Subcategory: Office Equipment. Price: 85,000৳88,000৳.
",157,305441,305598
2198,sentence,"Price: 85,000৳88,000৳.

Product: BenQ EW805ST 3600lms Short Throw Smart Projector. Category: BenQ. Subcategory: Office Equipment. Price: 100,000৳.
",147,305575,305722
2199,sentence,"Subcategory: Office Equipment. Price: 100,000৳.

Product: BenQ LW650 4000 Lumens WXGA Laser Projector. Category: BenQ. Subcategory: Office Equipment. Price: 110,000৳.
",167,305674,305841
2200,sentence,"Subcategory: Office Equipment. Price: 110,000৳.

Product: BenQ LH750 5000 ANSI Lumens 1080p Conference Room Projector. Category: BenQ. Subcategory: Office Equipment. Price: 160,000৳.
",183,305793,305976
2201,sentence,"Subcategory: Office Equipment. Price: 160,000৳.

Product: BenQ LU9245 7000 Lumens BlueCore Large-Venue Laser Projector. Category: BenQ. Subcategory: Office Equipment. Price: Pre Order.
",185,305928,306113
2202,sentence,"Price: Pre Order.

Product: BenQ LU9715 8000 ANSI Lumens WUXGA Large-Venue BlueCore Laser Projector. Category: BenQ. Subcategory: Office Equipment. Price: Pre Order.
",166,306095,306261
2203,sentence,"Price: Pre Order.

Product: BenQ GP520 2600 ANSI Lumens 4K UHD DLP Projector. Category: BenQ. Subcategory: Office Equipment. Price: Up Coming.
",143,306243,306386
2204,sentence,"Price: Up Coming.

Product: BenQ GV50 500 ANSI Lumens 1080p DLP Projector. Category: BenQ. Subcategory: Office Equipment. Price: Up Coming.
",140,306368,306508
2205,sentence,"Price: Up Coming.

Product: BenQ TK710STi 3200 ANSI Lumens 4K UHD DLP Projector. Category: BenQ. Subcategory: Office Equipment. Price: Up Coming.
",146,306490,306636
2206,sentence,"Price: Up Coming.

Product: BenQ MH550 3500 Lumens DLP Full Hd Business Projector. Category: BenQ. Subcategory: Office Equipment. Price: Up Coming.
",148,306618,306766
2207,sentence,"Price: Up Coming.

Product: Boxlight ALX320 3200 Lumens XGA Standard Throw Projector. Category: Boxlight. Subcategory: Office Equipment. Price: Up Coming.
",155,306748,306903
2208,sentence,"Price: Up Coming.

Product: Boxlight ALX330 3300 Lumens XGA Standard Throw Projector. Category: Boxlight. Subcategory: Office Equipment. Price: Up Coming.
",155,306885,307040
2209,sentence,"Price: Up Coming.

Product: Boxlight ALX352 3500 Lumens XGA LCD Standard Throw Projector. Category: Boxlight. Subcategory: Office Equipment. Price: Up Coming.
",159,307022,307181
2210,sentence,"Price: Up Coming.

Product: Boxlight ALX462 4600 Lumes XGA Standard Throw Projector. Category: Boxlight. Subcategory: Office Equipment. Price: Up Coming.
",154,307163,307317
2211,sentence,"Price: Up Coming.

Product: Boxlight ALX502 5000 Lumens XGA Standard Throw Projector. Category: Boxlight. Subcategory: Office Equipment. Price: Up Coming.
",155,307299,307454
2212,sentence,"Price: Up Coming.

Product: Boxlight ALX402 4000 Lumes XGA Standard Throw Projector. Category: Boxlight. Subcategory: Office Equipment. Price: Out Of Stock.
",157,307436,307593
2213,sentence,"Price: Out Of Stock.

Product: Optoma SA520 4000 Lumens SVGA DLP Projector. Category: Optoma. Subcategory: Office Equipment. Price: 37,000৳.
",141,307572,307713
2214,sentence,"Subcategory: Office Equipment. Price: 37,000৳.

Product: Optoma X400LVe XGA 4000 Lumens Professional Projector. Category: Optoma. Subcategory: Office Equipment. Price: 39,500৳.
",177,307666,307843
2215,sentence,"Subcategory: Office Equipment. Price: 39,500৳.

Product: Optoma W400LVe 4000 Lumens WXGA DLP Projector. Category: Optoma. Subcategory: Office Equipment. Price: 46,000৳50,000৳.
",176,307796,307972
2216,sentence,"Price: 46,000৳50,000৳.

Product: Optoma X309ST 3700 Lumens Short Throw XGA DLP Projector. Category: Optoma. Subcategory: Office Equipment. Price: 56,500৳61,000৳.
",162,307949,308111
2217,sentence,"Price: 56,500৳61,000৳.

Product: Optoma HD30HDR 3800 Full HD DLP Home Cinema Projector. Category: Optoma. Subcategory: Office Equipment. Price: 72,300৳76,000৳.
",160,308088,308248
2218,sentence,"Price: 72,300৳76,000৳.

Product: Optoma ZX350e 3700 Lumens XGA DLP Laser Projector. Category: Optoma. Subcategory: Office Equipment. Price: 72,500৳78,000৳.
",156,308225,308381
2219,sentence,"Price: 72,500৳78,000৳.

Product: Optoma ZW350e 4000 Lumens WXGA DLP Laser Projector. Category: Optoma. Subcategory: Office Equipment. Price: 80,000৳.
",150,308358,308508
2220,sentence,"Subcategory: Office Equipment. Price: 80,000৳.

Product: Optoma AZW500 5200 Lumens WXGA DLP Laser Projector. Category: Optoma. Subcategory: Office Equipment. Price: 106,000৳115,000৳.
",183,308461,308644
2221,sentence,"Price: 106,000৳115,000৳.

Product: Optoma UHD55 3600 Lumens 4K UHD Gaming Projector. Category: Optoma. Subcategory: Office Equipment. Price: 162,000৳159,000৳.
",159,308619,308778
2222,sentence,"Price: 162,000৳159,000৳.

Product: Optoma L1 Plus 2500 lumens Ultra Short Throw 4K LED Home Projector. Category: Optoma. Subcategory: Office Equipment. Price: 187,000৳190,000৳.
",177,308753,308930
2223,sentence,"Price: 187,000৳190,000৳.

Product: Optoma CinemaX D2 3000 Lumens 4K Ultra Short Throw DLP Laser Projector. Category: Optoma. Subcategory: Office Equipment. Price: 267,000৳270,000৳.
",181,308905,309086
2224,sentence,"Price: 267,000৳270,000৳.

Product: Optoma ZU606T-W 6000 Lumens WUXGA 4K UHD HRD DLP Laser Projector. Category: Optoma. Subcategory: Office Equipment. Price: 440,000৳450,000৳.
",175,309061,309236
2225,sentence,"Price: 440,000৳450,000৳.

Product: Optoma S400LVe 4000 Lumens SVGA DLP Projector. Category: Optoma. Subcategory: Office Equipment. Price: Up Coming.
",149,309211,309360
2226,sentence,"Price: Up Coming.

Product: Optoma UHD35+ 4000 Lumens 4K UHD Gaming And Home Entertainment Projector. Category: Optoma. Subcategory: Office Equipment. Price: Up Coming.
",169,309342,309511
2227,sentence,"Price: Up Coming.

Product: Optoma ZH507 5500 Lumens DLP Full HD Laser Projector. Category: Optoma. Subcategory: Office Equipment. Price: Up Coming.
",149,309493,309642
2228,sentence,"Price: Up Coming.

Product: Optoma ZU500USTe 5000 lumens Ultra Short Throw WUXGA Laser Projector. Category: Optoma. Subcategory: Office Equipment. Price: 340,000৳.
",164,309624,309788
2229,sentence,"Subcategory: Office Equipment. Price: 340,000৳.

Product: Optoma X412 4200 Lumens XGA DLP Projector. Category: Optoma. Subcategory: Office Equipment. Price: Out Of Stock.
",171,309740,309911
2230,sentence,"Price: Out Of Stock.

Product: Optoma AZH500 5200 Lumens FHD DLP Laser Projector. Category: Optoma. Subcategory: Office Equipment. Price: Out Of Stock.
",152,309890,310042
2231,sentence,"Price: Out Of Stock.

Product: Optoma AZH430UST 4000 lumens Ultra Short Throw Laser Projector. Category: Optoma. Subcategory: Office Equipment. Price: 180,000৳.
",161,310021,310182
2232,sentence,"Subcategory: Office Equipment. Price: 180,000৳.

Product: Acer V60S 4000 lumens Projector. Category: Acer. Subcategory: Office Equipment. Price: 45,000৳.
",154,310134,310288
2233,sentence,"Subcategory: Office Equipment. Price: 45,000৳.

Product: AUN AKEY6 6800 Lumens Full HD Portable Projector. Category: AUN. Subcategory: Office Equipment. Price: 22,500৳23,000৳.
",176,310241,310417
2234,sentence,"Price: 22,500৳23,000৳.

Product: AUN AKEY8 6000 Lumens Full HD Portable Projector. Category: AUN. Subcategory: Office Equipment. Price: Out Of Stock.
",150,310394,310544
2235,sentence,"Price: Out Of Stock.

Product: AUN AKEY9 8200 Lumens Full HD Smart Android Portable Projector. Category: AUN. Subcategory: Office Equipment. Price: Out Of Stock.
",162,310523,310685
2236,sentence,"Price: Out Of Stock.

Product: Philips NeoPix Easy 2600 Lumen WVGA LCD Projector. Category: Philips. Subcategory: Office Equipment. Price: 18,000৳19,000৳.
",155,310664,310819
2237,sentence,"Price: 18,000৳19,000৳.

Product: Philips NeoPix Prime 2 HD LCD Projector. Category: Philips. Subcategory: Office Equipment. Price: Up Coming.

Product: Vivitek BS570 4200 Lumens SVGA Projector. ",194,310796,310990
2238,sentence,"Category: VIVItek. Subcategory: Office Equipment. Price: 45,500৳50,000৳.

Product: Vivitek DX330 4000 Lumens XGA DLP Projector. Category: VIVItek. Subcategory: Office Equipment. ",178,310990,311168
2239,sentence,"Subcategory: Office Equipment. Price: 45,000৳50,000৳.

Product: Vivitek DW350 4000 Lumens WXGA DLP Projector. Category: VIVItek. Subcategory: Office Equipment. Price: 56,000৳57,000৳.
",183,311137,311320
2240,sentence,"Price: 56,000৳57,000৳.

Product: Vivitek DW350BD 4200 Lumens WXGA DLP Projector. Category: VIVItek. Subcategory: Office Equipment. Price: 53,500৳60,000৳.
",154,311297,311451
2241,sentence,"Price: 53,500৳60,000৳.

Product: Vivitek DX331 4500 Lumens XGA DLP Projector. Category: VIVItek. Subcategory: Office Equipment. Price: 62,000৳67,000৳.
",151,311428,311579
2242,sentence,"Price: 62,000৳67,000৳.

Product: Vivitek DW351 4500 Lumens WXGA DLP Projector. Category: VIVItek. Subcategory: Office Equipment. Price: 73,500৳75,000৳.
",152,311556,311708
2243,sentence,"Price: 73,500৳75,000৳.

Product: Vivitek DW2650Z 4200 Lumens WXGA DLP Projector With Built-In Speaker. Category: VIVItek. Subcategory: Office Equipment. Price: Up Coming.
",171,311685,311856
2244,sentence,"Price: Up Coming.

Product: ViewSonic LS500WHE 3000 Lumens WXGA LED Classroom Projector. Category: ViewSonic. Subcategory: Office Equipment. Price: 45,500৳48,000৳.
",164,311838,312002
2245,sentence,"Price: 45,500৳48,000৳.

Product: Viewsonic M1X Smart LED Portable Projector. Category: ViewSonic. Subcategory: Office Equipment. Price: 46,500৳50,000৳.
",152,311979,312131
2246,sentence,"Price: 46,500৳50,000৳.

Product: ViewSonic PA503XE 4000 Lumens XGA Business Projector. Category: ViewSonic. Subcategory: Office Equipment. Price: Up Coming.
",157,312108,312265
2247,sentence,"Price: Up Coming.

Product: ViewSonic PA503SE 4000 Lumens SVGA Business Projector. Category: ViewSonic. Subcategory: Office Equipment. Price: 49,000৳53,000৳.
",158,312247,312405
2248,sentence,"Price: 49,000৳53,000৳.

Product: Viewsonic SP6 4800 Lumens Business Projector. Category: ViewSonic. Subcategory: Office Equipment. Price: 55,000৳.
",147,312382,312529
2249,sentence,"Subcategory: Office Equipment. Price: 55,000৳.

Product: Viewsonic SP7 4800 Lumens Business Projector. Category: ViewSonic. Subcategory: Office Equipment. Price: 58,000৳.
",171,312482,312653
2250,sentence,"Subcategory: Office Equipment. Price: 58,000৳.

Product: ViewSonic PS502X 4000 ANSI Lumens XGA Short Throw Projector. Category: ViewSonic. Subcategory: Office Equipment. Price: 68,000৳69,000৳.
",193,312606,312799
2251,sentence,"Price: 68,000৳69,000৳.

Product: ViewSonic LX60HD 630 Lumen Smart LED Projector. Category: ViewSonic. Subcategory: Office Equipment. Price: 75,000৳.
",149,312776,312925
2252,sentence,"Subcategory: Office Equipment. Price: 75,000৳.

Product: ViewSonic M2e 1000 Lumens Smart Built-in Wi-Fi 1080p Portable Android Mini Projector. Category: ViewSonic. Subcategory: Office Equipment. ",195,312878,313073
2253,sentence,"Subcategory: Office Equipment. Price: 77,000৳78,000৳.

Product: ViewSonic LS740W 5000 Lumens WXGA Laser Projector. Category: ViewSonic. Subcategory: Office Equipment. Price: 115,000৳120,000৳.
",192,313042,313234
2254,sentence,"Price: 115,000৳120,000৳.

Product: ViewSonic LS740HD 5000 Lumens Full HD Laser Projector. Category: ViewSonic. Subcategory: Office Equipment. Price: 124,000৳125,000৳.
",167,313209,313376
2255,sentence,"Price: 124,000৳125,000৳.

Product: ViewSonic LS700HD 3500 Lumens FHD Laser Projector. Category: ViewSonic. Subcategory: Office Equipment. Price: Pre Order.
",156,313351,313507
2256,sentence,"Price: Pre Order.

Product: ViewSonic M1 Mini Plus 120 LED Lumens Built-in Wi-Fi Ultra-portable LED Android Projector. Category: ViewSonic. Subcategory: Office Equipment. Price: Up Coming.
",189,313489,313678
2257,sentence,"Price: Up Coming.

Product: ViewSonic PA503X Bright 3800 Lumens XGA Multimedia Projector. Category: ViewSonic. Subcategory: Office Equipment. Price: Up Coming.
",160,313660,313820
2258,sentence,"Price: Up Coming.

Product: ViewSonic PG603W 3,600 Lumens WXGA Business DLP Projector. Category: ViewSonic. Subcategory: Office Equipment. Price: Up Coming.
",157,313802,313959
2259,sentence,"Price: Up Coming.

Product: ViewSonic PX747-4K ULTRA HD 3500 Lumens 4K DLP Projector. Category: ViewSonic. Subcategory: Office Equipment. Price: Out Of Stock.
",159,313941,314100
2260,sentence,"Price: Out Of Stock.

Product: ViewSonic PA503S 3800 Lumens SVGA Multimedia Projector. Category: ViewSonic. Subcategory: Office Equipment. Price: Out Of Stock.
",160,314079,314239
2261,sentence,"Price: Out Of Stock.

Product: ViewSonic M1+_G2 300 Lumens Smart LED Built-in Wi-Fi Portable Android Projector. Category: ViewSonic. Subcategory: Office Equipment. Price: Out Of Stock.
",185,314218,314403
2262,sentence,"Price: Out Of Stock.

Product: ViewSonic PG603X 3,800 Lumens XGA Business DLP Projector. Category: ViewSonic. Subcategory: Office Equipment. Price: Out Of Stock.
",162,314382,314544
2263,sentence,"Price: Out Of Stock.

Product: ViewSonic PG707W 4000 Lumens WXGA Business DLP Projector. Category: ViewSonic. Subcategory: Office Equipment. Price: Out Of Stock.
",162,314523,314685
2264,sentence,"Price: Out Of Stock.

Product: Epson EB-E01 3LCD XGA 3300 Lumens Projector. Category: Epson. Subcategory: Office Equipment. Price: 41,000৳42,000৳.
",147,314664,314811
2265,sentence,"Price: 41,000৳42,000৳.

Product: Epson CO-W01 3000 Lumens 3LCD WXGA Projector. Category: Epson. Subcategory: Office Equipment. Price: 46,000৳47,000৳.
",150,314788,314938
2266,sentence,"Price: 46,000৳47,000৳.

Product: Epson CB-X49 3600 Lumens XGA 3LCD Multimedia Projector. Category: Epson. Subcategory: Office Equipment. Price: 63,000৳64,000৳.
",160,314915,315075
2267,sentence,"Price: 63,000৳64,000৳.

Product: Epson EB-X06 XGA 3600 Lumens 3LCD Business Classroom Projector. Category: Epson. Subcategory: Office Equipment. Price: 64,000৳.
",161,315052,315213
2268,sentence,"Subcategory: Office Equipment. Price: 64,000৳.

Product: Epson EB-X49 3600 Lumens XGA 3LCD Multimedia Projector. Category: Epson. Subcategory: Office Equipment. Price: 66,000৳72,000৳.
",184,315166,315350
2269,sentence,"Price: 66,000৳72,000৳.

Product: Epson CO-FH02 3000 Lumens 3LCD Full HD Android Projector. Category: Epson. Subcategory: Office Equipment. Price: 66,000৳72,000৳.
",162,315327,315489
2270,sentence,"Price: 66,000৳72,000৳.

Product: Epson EB-W06 3700 Lumens WXGA 3LCD Office Projector. Category: Epson. Subcategory: Office Equipment. Price: 73,000৳76,000৳.
",157,315466,315623
2271,sentence,"Price: 73,000৳76,000৳.

Product: Epson EB-W49 3800 Lumens WXGA 3LCD Multimedia Projector. Category: Epson. Subcategory: Office Equipment. Price: 77,000৳.
",154,315600,315754
2272,sentence,"Subcategory: Office Equipment. Price: 77,000৳.

Product: Epson EB-972 4100 Lumens XGA 3LCD Projector. Category: Epson. Subcategory: Office Equipment. Price: 86,000৳.
",166,315707,315873
2273,sentence,"Subcategory: Office Equipment. Price: 86,000৳.

Product: Epson EB-982W PowerLite 4200-Lumen WXGA 3LCD Projector. Category: Epson. Subcategory: Office Equipment. Price: 93,000৳96,500৳.
",184,315826,316010
2274,sentence,"Price: 93,000৳96,500৳.

Product: Epson EB-992F 4000 Lumens Full HD 3LCD Projector. Category: Epson. Subcategory: Office Equipment. Price: 145,000৳152,000৳.
",156,315987,316143
2275,sentence,"Price: 145,000৳152,000৳.

Product: Epson EB-L210SW 4000 Lumens WXGA Wireless Short Throw Laser Projector. Category: Epson. Subcategory: Office Equipment. Price: 172,000৳.
",171,316118,316289
2276,sentence,"Subcategory: Office Equipment. Price: 172,000৳.

Product: Epson EB-2065 5500 Lumens 3LCD XGA Projector. Category: Epson. Subcategory: Office Equipment. Price: 191,000৳200,000৳.
",177,316241,316418
2277,sentence,"Price: 191,000৳200,000৳.

Product: Epson EB-2250U 5000 Lumens 3LCD WUXGA Projector. Category: Epson. Subcategory: Office Equipment. Price: 206,000৳210,000৳.
",157,316393,316550
2278,sentence,"Price: 206,000৳210,000৳.

Product: Epson EB-2155W 5000 Lumens LCD Projector. Category: Epson. Subcategory: Office Equipment. Price: 223,500৳225,000৳.
",150,316525,316675
2279,sentence,"Price: 223,500৳225,000৳.

Product: Epson EB-L530U 5200 Lumens FHD WUXGA Long-throw Laser Projector. Category: Epson. Subcategory: Office Equipment. Price: 280,000৳.
",165,316650,316815
2280,sentence,"Subcategory: Office Equipment. Price: 280,000৳.

Product: Epson EB-W52 4000 Lumens 3LCD WXGA Projector. Category: Epson. Subcategory: Office Equipment. Price: 83,000৳.
",168,316767,316935
2281,sentence,"Subcategory: Office Equipment. Price: 83,000৳.

Product: EPSON EB-L630U 6200 Lumens 3LCD WUXGA LASER Multimedia Projector. Category: Epson. Subcategory: Office Equipment. Price: 420,000৳.
",188,316888,317076
2282,sentence,"Subcategory: Office Equipment. Price: 420,000৳.

Product: Epson EB-770Fi 4100 Lumens FHD Business Wireless Laser Projector. Category: Epson. Subcategory: Office Equipment. Price: 445,000৳.
",189,317028,317217
2283,sentence,"Subcategory: Office Equipment. Price: 445,000৳.

Product: Epson EB-E10 3600 Lumens XGA 3LCD Projector. Category: Epson. Subcategory: Office Equipment. Price: Up Coming.
",169,317169,317338
2284,sentence,"Price: Up Coming.

Product: Xiaomi Wanbo X2 Max 450 ANSI Lumens Smart Portable Projector. Category: Xiaomi. Subcategory: Office Equipment. Price: 20,000৳.
",155,317320,317475
2285,sentence,"Subcategory: Office Equipment. Price: 20,000৳.

Product: Xiaomi Wanbo T2 Max 450 ANSI Lumens Smart Android Portable LED Projector. Category: Xiaomi. Subcategory: Office Equipment. ",180,317428,317608
2286,sentence,"Subcategory: Office Equipment. Price: 19,500৳21,000৳.

Product: Xiaomi Wanbo T6 Max 650 Lumens Smart Android Portable LED Projector. Category: Xiaomi. Subcategory: Office Equipment. ",182,317577,317759
2287,sentence,"Subcategory: Office Equipment. Price: 27,400৳28,000৳.

Product: Xiaomi Wanbo T2 Ultra 500 ANSI Lumens Android Portable Projector. Category: Xiaomi. Subcategory: Office Equipment. Price: 25,500৳.
",195,317728,317923
2288,sentence,"Subcategory: Office Equipment. Price: 25,500৳.

Product: Xiaomi Wanbo DaVinci 1 Pro 1100 ANSI Lumens Projector. Category: Xiaomi. Subcategory: Office Equipment. Price: 30,000৳.
",177,317876,318053
2289,sentence,"Subcategory: Office Equipment. Price: 30,000৳.

Product: Xiaomi Wanbo TT 650 Lumens Netflix Certified Projector. Category: Xiaomi. Subcategory: Office Equipment. Price: 28,800৳31,500৳.
",185,318006,318191
2290,sentence,"Price: 28,800৳31,500৳.

Product: Xiaomi Wanbo X5 1100 Lumens Smart Android Portable LED Projector. Category: Xiaomi. Subcategory: Office Equipment. Price: 31,000৳33,800৳.
",171,318168,318339
2291,sentence,"Price: 31,000৳33,800৳.

Product: Xiaomi Wanbo X5 Pro 1100 Lumens FHD LCD Projector. Category: Xiaomi. Subcategory: Office Equipment. Price: 36,500৳.
",149,318316,318465
2292,sentence,"Subcategory: Office Equipment. Price: 36,500৳.

Product: Xiaomi Wanbo Mozart 1 900 Lumens Smart Android Portable LED Projector. Category: Xiaomi. Subcategory: Office Equipment. ",177,318418,318595
2293,sentence,"Subcategory: Office Equipment. Price: 38,000৳40,000৳.

Product: Xiaomi Wanbo Mozart 1 Pro 1200 Lumens Smart Android Portable LED Projector. Category: Xiaomi. Subcategory: Office Equipment. ",189,318564,318753
2294,sentence,"Subcategory: Office Equipment. Price: 47,000৳49,000৳.

Product: Xiaomi Mi Smart Projector 2 Portable Android Smart Laser Projector (Global version). Category: Xiaomi. Subcategory: Office Equipment. ",198,318722,318920
2295,sentence,"Subcategory: Office Equipment. Price: 54,500৳.

Product: Xiaomi Fengmi Cinema 2 Formovie 4K Ultra 2200 Lumens Smart Android Laser Projector (China Version). Category: Xiaomi. ",175,318889,319064
2296,sentence,"Category: Xiaomi. Subcategory: Office Equipment. Price: 199,000৳205,000৳.

Product: Xiaomi Wanbo T2 Free 150 Lumens Smart Portable LED Projector. Category: Xiaomi. Subcategory: Office Equipment. ",195,319046,319241
2297,sentence,"Subcategory: Office Equipment. Price: Up Coming.

Product: Xiaomi Wanbo X1 Pro 300 Lumens Smart Android Portable LED Projector. Category: Xiaomi. Subcategory: Office Equipment. Price: Up Coming.
",195,319210,319405
2298,sentence,"Price: Up Coming.

Product: Xiaomi Wanbo T2R Max 250 Lumens Portable LCD Projector. Category: Xiaomi. Subcategory: Office Equipment. Price: Up Coming.
",151,319387,319538
2299,sentence,"Price: Up Coming.

Product: Xiaomi Wanbo T2 Max 150 Lumens Smart Android Portable LED Projector. Category: Xiaomi. Subcategory: Office Equipment. Price: Out Of Stock.
",167,319520,319687
2300,sentence,"Price: Out Of Stock.

Product: Xiaomi Wanbo T4 450 ANSI Lumens Auto Focus Android Portable Projector. Category: Xiaomi. Subcategory: Office Equipment. Price: Out Of Stock.
",172,319666,319838
2301,sentence,"Price: Out Of Stock.

Product: Xiaomi Wanbo T6R Max 650 ANSI Lumens Android Smart Portable Projector. Category: Xiaomi. Subcategory: Office Equipment. Price: Out Of Stock.
",172,319817,319989
2302,sentence,"Price: Out Of Stock.

Product: Xiaomi Mi Smart Projector 2 Pro 1300 Lumens Smart Android Portable DLP Laser Projector (Global Version). Category: Xiaomi. Subcategory: Office Equipment. ",185,319968,320153
2303,sentence,"Subcategory: Office Equipment. Price: Out Of Stock.

Product: Xiaomi Fengmi 4K Ultra 5000 Lumens Smart Android Laser Projector (Global Version). Category: Xiaomi. Subcategory: Office Equipment. ",194,320122,320316
2304,sentence,"Subcategory: Office Equipment. Price: Out Of Stock.

Product: Cheerlux C8 1800 Lumens Mini LCD Projector. Category: Cheerlux. Subcategory: Office Equipment. Price: 8,500৳9,000৳.
",178,320285,320463
2305,sentence,"Price: 8,500৳9,000৳.

Product: Cheerlux C9 2800 Lumens Mini Projector with Built-in TV Card. Category: Cheerlux. Subcategory: Office Equipment. Price: 9,200৳9,500৳.
",165,320442,320607
2306,sentence,"Price: 9,200৳9,500৳.

Product: Cheerlux C10 2600 Lumens FHD LED WiFi Projector. Category: Cheerlux. Subcategory: Office Equipment. Price: 9,200৳9,500৳.
",152,320586,320738
2307,sentence,"Price: 9,200৳9,500৳.

Product: Cheerlux C9 2800 Lumens Wi-Fi Mini LED Projector. Category: Cheerlux. Subcategory: Office Equipment. Price: 10,500৳11,000৳.
",155,320717,320872
2308,sentence,"Price: 10,500৳11,000৳.

Product: Cheerlux C9 Android Wifi Full HD 3600 Lumens LED Projector With TV Port. Category: Cheerlux. Subcategory: Office Equipment. Price: 13,500৳.
",173,320849,321022
2309,sentence,"Subcategory: Office Equipment. Price: 13,500৳.

Product: Cheerlux C9 Full HD 3600 Lumens LED Projector (New Edition). Category: Cheerlux. Subcategory: Office Equipment. Price: 13,500৳.
",185,320975,321160
2310,sentence,"Subcategory: Office Equipment. Price: 13,500৳.

Product: Cheerlux C12 3600 Lumens Full HD WiFi LED Projector. Category: Cheerlux. Subcategory: Office Equipment. Price: 16,000৳16,500৳.
",184,321113,321297
2311,sentence,"Price: 16,000৳16,500৳.

Product: Cheerlux CL770 4000 Lumens Android Full HD Multimedia Projector. Category: Cheerlux. Subcategory: Office Equipment. Price: 21,500৳22,500৳.
",172,321274,321446
2312,sentence,"Price: 21,500৳22,500৳.

Product: Cheerlux C16 4000 Lumens Full HD Android Multimedia Projector. Category: Cheerlux. Subcategory: Office Equipment. Price: Out Of Stock.
",168,321423,321591
2313,sentence,"Price: Out Of Stock.

Product: Cheerlux C7 1500 Lumens Mini LCD Projector. Category: Cheerlux. Subcategory: Office Equipment. Price: Up Coming.
",144,321570,321714
2314,sentence,"Price: Up Coming.

Product: Cheerlux CL760 3200 Lumens Projector with Built-In TV Card. Category: Cheerlux. Subcategory: Office Equipment. Price: Up Coming.
",157,321696,321853
2315,sentence,"Price: Up Coming.

Product: Cheerlux C8 2200 Lumens Wi-Fi Mini LED Projector. Category: Cheerlux. Subcategory: Office Equipment. Price: Out Of Stock.
",150,321835,321985
2316,sentence,"Price: Out Of Stock.

Product: Cheerlux C8 1800 Lumens Wi-Fi Mini LED Projector. Category: Cheerlux. Subcategory: Office Equipment. Price: Out Of Stock.
",153,321964,322117
2317,sentence,"Price: Out Of Stock.

Product: Cheerlux C9 2800 Lumens Android Wi-Fi Mini LED Projector. Category: Cheerlux. Subcategory: Office Equipment. Price: Out Of Stock.
",161,322096,322257
2318,sentence,"Price: Out Of Stock.

Product: Cheerlux C50 3800 Lumens Wi-Fi Mini LED Projector. Category: Cheerlux. Subcategory: Office Equipment. Price: Out Of Stock.
",154,322236,322390
2319,sentence,"Price: Out Of Stock.

Product: Cheerlux CL770 4000 Lumens Full HD With Built-In TV Card Multimedia Projector. Category: Cheerlux. Subcategory: Office Equipment. Price: Out Of Stock.
",182,322369,322551
2320,sentence,"Price: Out Of Stock.

Product: InFocus IN1004 3100 Lumens 3LCD XGA Projector. Category: InFocus. Subcategory: Office Equipment. Price: 40,500৳41,500৳.
",151,322530,322681
2321,sentence,"Price: 40,500৳41,500৳.

Product: InFocus IN114BB 3800 Lumens DLP Projector. Category: InFocus. Subcategory: Office Equipment. Price: Up Coming.
",144,322658,322802
2322,sentence,"Price: Up Coming.

Product: InFocus IN1014 3400 Lumens 3LCD XGA Projector. Category: InFocus. Subcategory: Office Equipment. Price: Up Coming.

Product: InFocus IN2134 4500-Lumen XGA DLP Projector. ",198,322784,322982
2323,sentence,"Category: InFocus. Subcategory: Office Equipment. Price: Up Coming.

Product: InFocus IN1034 5000 Lumens XGA 3LCD Multimedia Projector. Category: InFocus. Subcategory: Office Equipment. ",186,322982,323168
2324,sentence,"Subcategory: Office Equipment. Price: Up Coming.

Product: InFocus IN1036 5000 Lumens 3LCD WXGA Projector. Category: InFocus. Subcategory: Office Equipment. Price: Up Coming.
",175,323137,323312
2325,sentence,"Price: Up Coming.

Product: InFocus INL2156 4500 WXGA Lumens Laser Projector. Category: InFocus. Subcategory: Office Equipment. Price: Up Coming.
",146,323294,323440
2326,sentence,"Price: Up Coming.

Product: InFocus IN116xv WXGA 3800 LUMENS 16:10 Projector. Category: InFocus. Subcategory: Office Equipment. Price: Out Of Stock.
",149,323422,323571
2327,sentence,"Price: Out Of Stock.

Product: InFocus IN119HDG 3800 LUMENS Full HD Projector. Category: InFocus. Subcategory: Office Equipment. Price: Out Of Stock.
",150,323550,323700
2328,sentence,"Price: Out Of Stock.

Product: InFocus IN118BB 3400 Lumens Full HD Projector. Category: InFocus. Subcategory: Office Equipment. Price: Out Of Stock.
",149,323679,323828
2329,sentence,"Price: Out Of Stock.

Product: InFocus IN1024 4000 Lumens 3LCD XGA Projector. Category: InFocus. Subcategory: Office Equipment. Price: Out Of Stock.
",149,323807,323956
2330,sentence,"Price: Out Of Stock.

Product: XINJI PX1 100 ANSI Lumens LCD Portable Projector With Android OS. Category: XINJI. Subcategory: Office Equipment. Price: 16,000৳20,000৳.
",168,323935,324103
2331,sentence,"Price: 16,000৳20,000৳.

Product: Havit PJ207 110 Lumens HD 720p Wi-Fi Screen Mirroring Portable Projector. Category: Havit. Subcategory: Office Equipment. Price: 12,000৳13,500৳.
",178,324080,324258
2332,sentence,"Price: 12,000৳13,500৳.

Product: Havit PJ202 300 ANSI Lumens Full HD Wi-Fi Screen Mirroring Portable Projector. Category: Havit. Subcategory: Office Equipment. Price: 18,000৳.
",176,324235,324411
2333,sentence,"Subcategory: Office Equipment. Price: 18,000৳.

Product: Havit PJ215 Pro Prime Jasper Smart Portable Projector With Android TV 9.0. Category: Havit. Subcategory: Office Equipment. Price: 19,000৳.
",196,324364,324560
2334,sentence,"Subcategory: Office Equipment. Price: 19,000৳.

Product: Havit PJ300 Plus Google Licensed Projector. Category: Havit. Subcategory: Office Equipment. Price: 45,000৳.
",165,324513,324678
2335,sentence,"Subcategory: Office Equipment. Price: 45,000৳.

Product: Havit PJ201 120 Lumens HD 720p Portable Projector. Category: Havit. Subcategory: Office Equipment. Price: Up Coming.
",174,324631,324805
2336,sentence,"Price: Up Coming.

Product: Havit PJ206 Pro 350 Lumens Full HD Android Wi-Fi Screen Mirroring Portable Projector. Category: Havit. Subcategory: Office Equipment. Price: Up Coming.
",180,324787,324967
2337,sentence,"Price: Up Coming.

Product: Havit PJ205 Pro 200 Lumens Full HD 1080p Portable Projector. Category: Havit. Subcategory: Office Equipment. Price: Out Of Stock.
",158,324949,325107
2338,sentence,"Price: Out Of Stock.

Product: Havit PJ209 Pro 350 ANSI Lumens Android Portable Projector. Category: Havit. Subcategory: Office Equipment. Price: Out Of Stock.
",160,325086,325246
2339,sentence,"Price: Out Of Stock.

Product: Havit PJ219 PRO Smart Projector with Android TV 9.0. Category: Havit. Subcategory: Office Equipment. Price: Out Of Stock.
",153,325225,325378
2340,sentence,"Price: Out Of Stock.

Product: Blisbond Mirror 4K Gimbal Projector. Category: Blisbond. Subcategory: Office Equipment. Price: 22,690৳24,500৳.

Product: Apollo 60""x60"" Tripod Projection Screen. ",193,325357,325550
2341,sentence,"Category: Projection Screen. Subcategory: Office Equipment. Price: Out Of Stock.

Product: Apollo 70""x70"" Tripod Projection Screen. Category: Projection Screen. Subcategory: Office Equipment. ",192,325550,325742
2342,sentence,"Subcategory: Office Equipment. Price: 3,600৳.

Product: Super View 70 x 70 Inch Wall Projector Screen. Category: Projection Screen. Subcategory: Office Equipment. Price: 3,450৳3,700৳.
",184,325711,325895
2343,sentence,"Price: 3,450৳3,700৳.

Product: Apollo 70""x70"" Wall Projection Screen. Category: Projection Screen. Subcategory: Office Equipment. Price: 3,500৳3,900৳.
",151,325874,326025
2344,sentence,"Price: 3,500৳3,900৳.

Product: Apollo 84""x84"" Wall Projection Screen. Category: Projection Screen. Subcategory: Office Equipment. Price: 6,200৳.

Product: Dopah 84 x 84 Inch Wall Projection Screen. ",198,326004,326202
2345,sentence,"Category: Projection Screen. Subcategory: Office Equipment. Price: 6,200৳.

Product: Dopah 70""x70"" Tripod Projection Screen. Category: Projection Screen. Subcategory: Office Equipment. ",185,326202,326387
2346,sentence,"Subcategory: Office Equipment. Price: 3,600৳.

Product: Dopah 84""x 84"" Tripod Projection Screen. Category: Projection Screen. Subcategory: Office Equipment. Price: 7,200৳.
",172,326356,326528
2347,sentence,"Subcategory: Office Equipment. Price: 7,200৳.

Product: Apollo 60""x60"" Electric Projection Screen. Category: Projection Screen. Subcategory: Office Equipment. Price: 7,200৳.
",174,326482,326656
2348,sentence,"Subcategory: Office Equipment. Price: 7,200৳.

Product: Dopah 60""x60"" Electric Projection Screen. Category: Projection Screen. Subcategory: Office Equipment. Price: 7,300৳.
",173,326610,326783
2349,sentence,"Subcategory: Office Equipment. Price: 7,300৳.

Product: Magpie 70""x70"" Electric Projection System Screen. Category: Projection Screen. Subcategory: Office Equipment. Price: 7,800৳8,000৳.
",187,326737,326924
2350,sentence,"Price: 7,800৳8,000৳.

Product: Super View 96 x 96 Inch Wall Projector Screen. Category: Projection Screen. Subcategory: Office Equipment. Price: 7,500৳8,000৳.
",159,326903,327062
2351,sentence,"Price: 7,500৳8,000৳.

Product: Super View 70 x 70 Inch Electric Projector Screen. Category: Projection Screen. Subcategory: Office Equipment. Price: 8,000৳8,300৳.
",163,327041,327204
2352,sentence,"Price: 8,000৳8,300৳.

Product: Super View 96 x 96 Inch Tripod Projector Screen. Category: Projection Screen. Subcategory: Office Equipment. Price: 8,000৳8,300৳.
",161,327183,327344
2353,sentence,"Price: 8,000৳8,300৳.

Product: Apollo 96""x96"" Wall Projection Screen. Category: Projection Screen. Subcategory: Office Equipment. Price: 7,600৳8,600৳.
",151,327323,327474
2354,sentence,"Price: 7,600৳8,600৳.

Product: Apollo 70""x70"" Electric Projection Screen. Category: Projection Screen. Subcategory: Office Equipment. Price: 8,300৳.
",149,327453,327602
2355,sentence,"Subcategory: Office Equipment. Price: 8,300৳.

Product: Super View 96 Inch x 96 Inch Electric Wall Projector Screen. Category: Projection Screen. Subcategory: Office Equipment. Price: 9,900৳.
",192,327556,327748
2356,sentence,"Subcategory: Office Equipment. Price: 9,900৳.

Product: Apollo 84""x84"" Electric Projection Screen. Category: Projection Screen. Subcategory: Office Equipment. Price: 10,300৳.
",175,327702,327877
2357,sentence,"Subcategory: Office Equipment. Price: 10,300৳.

Product: Dopah 84""x84"" Electric Projection Screen. Category: Projection Screen. Subcategory: Office Equipment. Price: 10,500৳.
",175,327830,328005
2358,sentence,"Subcategory: Office Equipment. Price: 10,500৳.

Product: Apollo 96""x 96"" Electric Projection Screen. Category: Projection Screen. Subcategory: Office Equipment. Price: 11,500৳12,000৳.
",184,327958,328142
2359,sentence,"Price: 11,500৳12,000৳.

Product: Projector Ceiling Mount Kit 2 Feet. Category: Projector Mount. Subcategory: Office Equipment. Price: 1,500৳1,600৳.

Product: Projector Ceiling Mount Kit 3 Feet. ",194,328119,328313
2360,sentence,"
Product: Projector Ceiling Mount Kit 3 Feet. Category: Projector Mount. Subcategory: Office Equipment. Price: 2,000৳2,300৳.

Product: Lexin PM02 Projector Ceiling Mount Kit 3 Feet. ",182,328267,328449
2361,sentence,"Category: Projector Mount. Subcategory: Office Equipment. Price: 2,500৳3,000৳.

Product: Abtus AV815 Projector Ceiling Mount Kit 3 Feet. Category: Projector Mount. Subcategory: Office Equipment. ",195,328449,328644
2362,sentence,"Subcategory: Office Equipment. Price: 3,800৳4,000৳.

Product: Dopah DTT-04 Portable Multimedia Projector Tripod Trolley. Category: Projector Mount. Subcategory: Office Equipment. ",179,328613,328792
2363,sentence,"Subcategory: Office Equipment. Price: 4,700৳5,200৳.

Product: Dopah DTT-05 Multimedia Projector Trolley. Category: Projector Mount. Subcategory: Office Equipment. Price: 8,500৳.
",178,328761,328939
2364,sentence,"Subcategory: Office Equipment. Price: 8,500৳.

Product: Jabra Speak 510 Speakerphone Audio Conference Up to 5 People & Bluetooth Speaker. Category: Jabra. Subcategory: Conference System. ",187,328893,329080
2365,sentence,"Subcategory: Conference System. Price: 14,200৳.

Product: Jabra Speak2 55 Duplex Noise Reduction Speakerphone. Category: Jabra. Subcategory: Conference System. Price: 17,500৳.
",176,329048,329224
2366,sentence,"Subcategory: Conference System. Price: 17,500৳.

Product: Jabra Speak 710 Speakerphone HD Audio Conference Up to 6 People and Bluetooth Speaker. Category: Jabra. Subcategory: Conference System. ",194,329176,329370
2367,sentence,"Subcategory: Conference System. Price: 23,900৳.

Product: Jabra Panacast 20 4K Ultra HD Video Conference Camera. Category: Jabra. Subcategory: Conference System. Price: 26,900৳.
",178,329338,329516
2368,sentence,"Subcategory: Conference System. Price: 26,900৳.

Product: Jabra Speak 750 Speakerphone Audio Conference. Category: Jabra. Subcategory: Conference System. Price: 28,700৳.
",170,329468,329638
2369,sentence,"Subcategory: Conference System. Price: 28,700৳.

Product: Jabra Speak2 75 Full-Duplex Speakerphone With Type A Wireless Receiver. Category: Jabra. Subcategory: Conference System. Price: 34,900৳.
",195,329590,329785
2370,sentence,"Subcategory: Conference System. Price: 34,900৳.

Product: Jabra Speak 810 Conference Speakerphone. Category: Jabra. Subcategory: Conference System. Price: 54,900৳.
",164,329737,329901
2371,sentence,"Subcategory: Conference System. Price: 54,900৳.

Product: Jabra Panacast 20 Conference Camera & Speak 750 Bundle with Table Stand. Category: Jabra. Subcategory: Conference System. Price: 69,900৳.
",196,329853,330049
2372,sentence,"Subcategory: Conference System. Price: 69,900৳.

Product: Jabra PanaCast 50 Panoramic 4K USB Conference Videobar. Category: Jabra. Subcategory: Conference System. Price: 165,000৳.
",180,330001,330181
2373,sentence,"Price: 165,000৳.

Product: Jabra PanaCast Table Stand. Category: Jabra. Subcategory: Conference System. Price: Out Of Stock.
",125,330164,330289
2374,sentence,"Price: Out Of Stock.

Product: Jabra Speak2 75 Full-Duplex Speakerphone With Type-C Wireless Receiver. Category: Jabra. Subcategory: Conference System. Price: Out Of Stock.
",173,330268,330441
2375,sentence,"Price: Out Of Stock.

Product: Jabra PanaCast 50 Room System MTR. Category: Jabra. Subcategory: Conference System. Price: Out Of Stock.

Product: HTDZ HT-E2 Gooseneck Microphone. ",179,330420,330599
2376,sentence,"
Product: HTDZ HT-E2 Gooseneck Microphone. Category: Conference System. Price: 3,308৳.

Product: HTDZ HT-E4 Gooseneck Microphone. Category: Conference System. Price: 3,308৳.
",174,330556,330730
2377,sentence,"Category: Conference System. Price: 3,308৳.

Product: HTDZ HT-XLRM3 Microphone Base. Category: Conference System. Price: 3,780৳.

Product: HTDZ HT-E1 Gooseneck Microphone. ",172,330686,330858
2378,sentence,"
Product: HTDZ HT-E1 Gooseneck Microphone. Category: Conference System. Price: 4,410৳.

Product: HTDZ HT-XLRM2 Microphone Base. Category: Conference System. Price: 4,410৳.
",172,330815,330987
2379,sentence,"Category: Conference System. Price: 4,410৳.

Product: CMX DU-50 PA 100V Driver Unit (15W-30W-50W). Category: Conference System. Price: 4,680৳.
",143,330943,331086
2380,sentence,"Category: Conference System. Price: 4,680৳.

Product: HTDZ HT-801 Professional Conference Gooseneck Microphone. Category: Conference System. Price: 5,640৳.
",156,331042,331198
2381,sentence,"Category: Conference System. Price: 5,640৳.

Product: HTDZ HT-710A High Quality Professional Boundary Microphone. Category: Conference System. Price: 6,840৳.
",158,331154,331312
2382,sentence,"Category: Conference System. Price: 6,840৳.

Product: HTDZ HT-808 Professional Gooseneck Conference Microphone. Category: Conference System. Price: 7,560৳.
",156,331268,331424
2383,sentence,"Category: Conference System. Price: 7,560৳.

Product: CMX CS-702 Conference System Delegate Unit. Category: Conference System. Price: 8,160৳.

Product: CMX CS-701 Conference System Chairman Unit. ",196,331380,331576
2384,sentence,"Category: Conference System. Price: 8,760৳.

Product: HTDZ HB-350D Delegate Unit Audio Conference System (Single Unit). Category: Conference System. Price: 9,840৳.
",164,331576,331740
2385,sentence,"Category: Conference System. Price: 9,840৳.

Product: HTDZ HT-D38 Gooseneck Microphone. Category: Conference System. Price: 9,840৳.

Product: HTDZ HT-D48 Wired Cardioid Gooseneck Meeting Microphone. ",199,331696,331895
2386,sentence,"Category: Conference System. Price: 10,200৳.

Product: Logitech TV Mount for Meet Up Video Conference Cam. Category: Conference System. Price: 10,990৳.

Product: TEV TCS-3510 15W Column Speaker. ",195,331895,332090
2387,sentence,"
Product: TEV TCS-3510 15W Column Speaker. Category: Conference System. Price: 11,015৳.

Product: HTDZ HB-350C Chairman Unit Audio Conference System (Single Unit). Category: Conference System. ",193,332047,332240
2388,sentence,"Category: Conference System. Price: 12,600৳.

Product: HTDZ HT-7500D Table Top Delegate Unit Conference System. Category: Conference System. Price: 12,840৳.
",157,332211,332368
2389,sentence,"Category: Conference System. Price: 12,840৳.

Product: Logitech Wall Mount for Video Bar. Category: Conference System. Price: 20,000৳.
",135,332323,332458
2390,sentence,"Category: Conference System. Price: 20,000৳.

Product: AVerMedia BO317 Camera & Headphone Video Conference Kit. Category: AVerMedia. Subcategory: Conference System. Price: 6,099৳6,190৳.
",186,332413,332599
2391,sentence,"Price: 6,099৳6,190৳.

Product: AVerMedia PW313 2MP Fixed Focus USB Webcam. Category: AVerMedia. Subcategory: Conference System. Price: Out Of Stock.
",149,332578,332727
2392,sentence,"Price: Out Of Stock.

Product: HTDZ HT-7500C Table Top Chairman Unit Conference System. Category: HTDZ. Subcategory: Conference System. Price: 15,600৳.
",152,332706,332858
2393,sentence,"Subcategory: Conference System. Price: 15,600৳.

Product: HTDZ HT-580 UHF Wireless Microphone System (1 Hand + 1 Tie or 2 Hand). Category: HTDZ. Subcategory: Conference System. Price: 15,600৳.
",193,332810,333003
2394,sentence,"Subcategory: Conference System. Price: 15,600৳.

Product: HTDZ HT-F12/2 12 Channel Professional Mixing Console. Category: HTDZ. Subcategory: Conference System. Price: 29,400৳.
",176,332955,333131
2395,sentence,"Subcategory: Conference System. Price: 29,400৳.

Product: HTDZ HT-7000 Main Amplifier Unit Conference System. Category: HTDZ. Subcategory: Conference System. Price: 51,600৳.
",174,333083,333257
2396,sentence,"Subcategory: Conference System. Price: 51,600৳.

Product: HTDZ HT-F16/2 12 Channel Professional Mixing Console. Category: HTDZ. Subcategory: Conference System. Price: Up Coming.
",178,333209,333387
2397,sentence,"Price: Up Coming.

Product: HTDZ HT-F8/2 8 Channel Professional Mixing Console. Category: HTDZ. Subcategory: Conference System. Price: Out Of Stock.
",149,333369,333518
2398,sentence,"Price: Out Of Stock.

Product: HTDZ HT-3000 Central Amplifier Conference System. Category: HTDZ. Subcategory: Conference System. Price: Out Of Stock.
",150,333497,333647
2399,sentence,"Price: Out Of Stock.

Product: Rapoo CM600 Omnidirectional Conference Microphone. Category: Rapoo. Subcategory: Conference System. Price: 35,000৳.

Product: Rapoo C1612 FHD Video Conference Camera. ",198,333626,333824
2400,sentence,"Category: Rapoo. Subcategory: Conference System. Price: 65,000৳.

Product: Rapoo C5305 4K UHD ALL-IN-ONE USB Video Conference Webcam. Category: Rapoo. Subcategory: Conference System. Price: 98,500৳.
",199,333824,334023
2401,sentence,"Subcategory: Conference System. Price: 98,500৳.

Product: TEV TPA-6060U 60W PA Amplifier. Category: TEV. Subcategory: Conference System. Price: 21,410৳.
",153,333975,334128
2402,sentence,"Subcategory: Conference System. Price: 21,410৳.

Product: TEV PRO-II Handheld Wired Microphone. Category: TEV. Subcategory: Conference System. Price: 6,300৳.
",158,334080,334238
2403,sentence,"Subcategory: Conference System. Price: 6,300৳.

Product: Tev Tm-621 Handheld Wired Microphone. Category: TEV. Subcategory: Conference System. Price: Out Of Stock.
",163,334191,334354
2404,sentence,"Price: Out Of Stock.

Product: TEV TM-700 Handheld Wired Microphone. Category: TEV. Subcategory: Conference System. Price: Out Of Stock.

Product: TEV TR-8100TD 1H+1Tie Wireless Microphone. ",190,334333,334523
2405,sentence,"Category: TEV. Subcategory: Conference System. Price: Out Of Stock.

Product: Poly Studio P15 Video Conference Bar for Small Conferencing Room. Category: Poly. Subcategory: Conference System. ",192,334523,334715
2406,sentence,"Category: Poly. Subcategory: Conference System. Price: 70,000৳.

Product: Poly Studio USB Video Bar. Category: Poly. Subcategory: Conference System. Price: Out Of Stock.
",170,334667,334837
2407,sentence,"Price: Out Of Stock.

Product: CMX EA-30 30W PA Amplifier with USB/SD & FM & Bluetooth. Category: CMX. Subcategory: Conference System. Price: 16,920৳.
",151,334816,334967
2408,sentence,"Subcategory: Conference System. Price: 16,920৳.

Product: CMX EA-60 60W PA Amplifier with USB/SD & FM & Bluetooth. Category: CMX. Subcategory: Conference System. Price: 21,960৳.
",178,334919,335097
2409,sentence,"Subcategory: Conference System. Price: 21,960৳.

Product: CMX EA-120 120W PA Amplifier with USB/SD & FM & Bluetooth. Category: CMX. Subcategory: Conference System. Price: 23,880৳.
",180,335049,335229
2410,sentence,"Subcategory: Conference System. Price: 23,880৳.

Product: CMX CS-700 Conference System Amplifier Controller. Category: CMX. Subcategory: Conference System. Price: 27,600৳.
",172,335181,335353
2411,sentence,"Subcategory: Conference System. Price: 27,600৳.

Product: CMX EA-240A 240W PA Amplifier with USB/SD & FM & Bluetooth. Category: CMX. Subcategory: Conference System. Price: 36,600৳.
",181,335305,335486
2412,sentence,"Subcategory: Conference System. Price: 36,600৳.

Product: CMX TS-12 180W Portable PA System (1 Hand + 1 Head Mic). Category: CMX. Subcategory: Conference System. Price: 40,800৳.
",178,335438,335616
2413,sentence,"Subcategory: Conference System. Price: 40,800৳.

Product: CMX EA-350A 350W PA Amplifier with USB/SD & FM & Bluetooth. Category: CMX. Subcategory: Conference System. Price: 43,920৳.
",181,335568,335749
2414,sentence,"Subcategory: Conference System. Price: 43,920৳.

Product: CMX EA-500A USB/SD & FM & Bluetooth Mixer Amplifier. Category: CMX. Subcategory: Conference System. Price: 46,080৳.
",174,335701,335875
2415,sentence,"Subcategory: Conference System. Price: 46,080৳.

Product: CMX UHF-300BC Battery Charger. Category: CMX. Subcategory: Conference System. Price: 82,500৳.
",152,335827,335979
2416,sentence,"Subcategory: Conference System. Price: 82,500৳.

Product: CMX CLSK-10C 10W Outdoor Column Speaker. Category: CMX. Subcategory: Conference System. Price: Up Coming.
",164,335931,336095
2417,sentence,"Price: Up Coming.

Product: CMX CSK-610Q 6"" Coaxial Ceiling Speaker (3W-6W-10W). Category: CMX. Subcategory: Conference System. Price: Out Of Stock.
",149,336077,336226
2418,sentence,"Price: Out Of Stock.

Product: CMX TS-12 180W Portable PA System (2 Hand Mic). Category: CMX. Subcategory: Conference System. Price: Out Of Stock.

Product: CMX UHF-300DU UHF Wireless Delegate Unit. ",199,336205,336404
2419,sentence,"Category: CMX. Subcategory: Conference System. Price: Out Of Stock.

Product: CMX UHF-300CU UHF Wireless Chairman Unit. Category: CMX. Subcategory: Conference System. Price: Out Of Stock.
",188,336404,336592
2420,sentence,"Price: Out Of Stock.

Product: CMX UHF-300MC UHF Wireless Conference System Master Controller. Category: CMX. Subcategory: Conference System. Price: Out Of Stock.
",163,336571,336734
2421,sentence,"Price: Out Of Stock.

Product: Benq DVY23 Full HD 1080P PTZ Video Conference Camera Balck. Category: BenQ. Subcategory: Conference System. Price: 120,500৳.
",156,336713,336869
2422,sentence,"Price: 120,500৳.

Product: Benq DVY32 4K UHD AI Auto Framing Video Conference Webcam. Category: BenQ. Subcategory: Conference System. Price: Out Of Stock.
",155,336852,337007
2423,sentence,"Price: Out Of Stock.

Product: AVer VC520 Pro Expansion Speakerphone and Microphone. Category: AVer. Subcategory: Conference System. Price: 53,500৳.

Product: AVer FONE540 Conference Speakerphone. ",197,336986,337183
2424,sentence,"
Product: AVer FONE540 Conference Speakerphone. Category: AVer. Subcategory: Conference System. Price: 58,000৳.
",112,337135,337247
2425,sentence,"Subcategory: Conference System. Price: 58,000৳.

Product: AVer VC520 Pro2 USB Full HD Video Conference Camera with Speaker Microphone Set. Category: AVer. Subcategory: Conference System. ",187,337199,337386
2426,sentence,"Category: AVer. Subcategory: Conference System. Price: 134,990৳.

Product: AVer VC520 Pro3 USB Full HD Video Conference Camera with Speaker Microphone Set. Category: AVer. ",172,337338,337510
2427,sentence,"Category: AVer. Subcategory: Conference System. Price: Up Coming.

Product: Logitech BCC950 HD 1080p Camera Video Conference Webcam. Category: Logitech. Subcategory: Conference System. ",185,337494,337679
2428,sentence,"Subcategory: Conference System. Price: 25,000৳.

Product: Logitech Rally Mounting Kit. Category: Logitech. Subcategory: Conference System. Price: 25,000৳.

Product: Logitech Rally Mic Pod HUB. ",193,337647,337840
2429,sentence,"
Product: Logitech Rally Mic Pod HUB. Category: Logitech. Subcategory: Conference System. Price: 30,000৳.

Product: Logitech Expantion Mic for Meetup Cam (989-000405). Category: Logitech. ",188,337802,337990
2430,sentence,"Category: Logitech. Subcategory: Conference System. Price: 35,000৳.

Product: Logitech SmartDock (Used with Microsoft Surface Pro). Category: Logitech. Subcategory: Conference System. ",184,337970,338154
2431,sentence,"Subcategory: Conference System. Price: 85,000৳.

Product: Logitech SmartDock Flex Expansion Kit (960-001213). Category: Logitech. Subcategory: Conference System. Price: 95,000৳.
",178,338122,338300
2432,sentence,"Subcategory: Conference System. Price: 95,000৳.

Product: Logitech Meetup Video Conference Camera (960-001101). Category: Logitech. Subcategory: Conference System. Price: Out Of Stock.
",185,338252,338437
2433,sentence,"Price: Out Of Stock.

Product: Logitech Tap for one Touch Video Conference Controlling. Category: Logitech. Subcategory: Conference System. Price: 125,000৳.
",157,338416,338573
2434,sentence,"Price: 125,000৳.

Product: Logitech Video Conference Group (960-001054). Category: Logitech. Subcategory: Conference System. Price: 135,000৳.
",142,338556,338698
2435,sentence,"Price: 135,000৳.

Product: Logitech Meetup 2 Video Conference Camera (960-001681). Category: Logitech. Subcategory: Conference System. Price: 155,000৳.
",152,338681,338833
2436,sentence,"Price: 155,000৳.

Product: Logitech Rally System Video Conferencing Cam Set (6 Pcs Set/Audio Coverage 10 Feet). Category: Logitech. Subcategory: Conference System. Price: 300,000৳.
",181,338816,338997
2437,sentence,"Price: 300,000৳.

Product: Logitech Tap IP Meeting Room Touch Controller (952-000085). Category: Logitech. Subcategory: Conference System. Price: 140,000৳.
",156,338980,339136
2438,sentence,"Price: 140,000৳.

Product: Logitech Sight Video Conference Camera (960-001510). Category: Logitech. Subcategory: Conference System. Price: 350,000৳.
",149,339119,339268
2439,sentence,"Price: 350,000৳.

Product: Logitech Rally Plus Video Conferencing Set (8 Pcs Set/Audio Coverage 24 Feet). Category: Logitech. Subcategory: Conference System. Price: 390,000৳.
",175,339251,339426
2440,sentence,"Price: 390,000৳.

Product: Logitech Rally Bar Mini 4K All-In-One Video Conferencing System. Category: Logitech. Subcategory: Conference System. Price: 390,000৳.
",161,339409,339570
2441,sentence,"Price: 390,000৳.

Product: Logitech Rally Bar 4K All-In-One Video Conferencing System. Category: Logitech. Subcategory: Conference System. Price: 520,000৳.
",156,339553,339709
2442,sentence,"Price: 520,000৳.

Product: Logitech Brio 505 Full HD Business Conferencing Webcam. Category: Logitech. Subcategory: Conference System. Price: Up Coming.
",153,339692,339845
2443,sentence,"Price: Up Coming.

Product: Logitech C920E Pro Full HD Video Conferencing Webcam. Category: Logitech. Subcategory: Conference System. Price: Out Of Stock.
",155,339827,339982
2444,sentence,"Price: Out Of Stock.

Product: Grandstream GAC2500 Networks Android Enterprise Conference Phone. Category: Grandstream. Subcategory: Conference System. Price: 44,990৳.
",168,339961,340129
2445,sentence,"Subcategory: Conference System. Price: 44,990৳.

Product: Grandstream GVC3210 Video Conferencing Endpoint. Category: Grandstream. Subcategory: Conference System. Price: 68,000৳.
",178,340081,340259
2446,sentence,"Subcategory: Conference System. Price: 68,000৳.

Product: Grandstream GAC2570 Enterprise Conference Phone. Category: Grandstream. Subcategory: Conference System. Price: Up Coming.
",180,340211,340391
2447,sentence,"Price: Up Coming.

Product: Grandstream GMD1208 Wireless Desktop Microphone. Category: Grandstream. Subcategory: Conference System. Price: Up Coming.
",150,340373,340523
2448,sentence,"Price: Up Coming.

Product: Grandstream GVC3202 Video Conference System. Category: Grandstream. Subcategory: Conference System. Price: Up Coming.
",146,340505,340651
2449,sentence,"Price: Up Coming.

Product: Grandstream GVC3200 Video Conference System. Category: Grandstream. Subcategory: Conference System. Price: Up Coming.
",146,340633,340779
2450,sentence,"Price: Up Coming.

Product: Grandstream GVC3220 Video Conference System. Category: Grandstream. Subcategory: Conference System. Price: Up Coming.
",146,340761,340907
2451,sentence,"Price: Up Coming.

Product: Maxhub UC P25 4K UHD Video Conference Camera. Category: MAXHUB. Subcategory: Conference System. Price: 85,000৳.

Product: Maxhub SL22MC Smart Lectern. Category: MAXHUB. ",197,340889,341086
2452,sentence,"Category: MAXHUB. Subcategory: Conference System. Price: 495,000৳.

Product: Maxhub WT13M 4K Wireless Sharing Dongle. Category: MAXHUB. Subcategory: Conference System. Price: Up Coming.
",186,341068,341254
2453,sentence,"Price: Up Coming.

Product: Maxhub WB05 4K Professional Screen Sharing Box. Category: MAXHUB. Subcategory: Conference System. Price: Up Coming.
",144,341236,341380
2454,sentence,"Price: Up Coming.

Product: Maxhub UC BM35 Bluetooth Teleconference Speakerphone. Category: MAXHUB. Subcategory: Conference System. Price: Out Of Stock.

Product: TEV TCS-610 10W Ceiling Speaker. ",196,341362,341558
2455,sentence,"
Product: TEV TCS-610 10W Ceiling Speaker. Category: TEV. Subcategory: PA System. Price: 5,870৳.

Product: TEV TA-120II 35W Portable PA System. Category: TEV. Subcategory: PA System. Price: 11,800৳.
",199,341515,341714
2456,sentence,"Subcategory: PA System. Price: 11,800৳.

Product: TEV TCS-3520 30W Column Speaker. Category: TEV. Subcategory: PA System. Price: 16,000৳.
",138,341674,341812
2457,sentence,"Subcategory: PA System. Price: 16,000৳.

Product: TEV TA-380 80W Portable PA System (1 Hand + 1 Head Mic). Category: TEV. Subcategory: PA System. Price: 63,960৳.
",162,341772,341934
2458,sentence,"Subcategory: PA System. Price: 63,960৳.

Product: TEV TA-780D 300W Portable PA System (1 Hand Mic). Category: TEV. Subcategory: PA System. Price: Up Coming.
",157,341894,342051
2459,sentence,"Subcategory: PA System. Price: Up Coming.

Product: TEV TB-700II Wireless Microphone Bodypack Transmitter. Category: TEV. Subcategory: PA System. Price: Out Of Stock.
",167,342009,342176
2460,sentence,"Subcategory: PA System. Price: Out Of Stock.

Product: TEV TA-680D 220W Portable PA System (1 Hand Mic). Category: TEV. Subcategory: PA System. Price: Out Of Stock.
",165,342131,342296
2461,sentence,"Subcategory: PA System. Price: Out Of Stock.

Product: ScreenBeam SBUSBSW4 USB Pro Switch for Content Sharing. Category: ScreenBeam. Subcategory: Conference System. Price: 15,900৳.
",181,342251,342432
2462,sentence,"Subcategory: Conference System. Price: 15,900৳.

Product: ScreenBeam 1100 Plus Wireless Display Receiver. Category: ScreenBeam. Subcategory: Conference System. Price: 145,000৳.
",177,342384,342561
2463,sentence,"Price: 145,000৳.

Product: CMX CSK-66E 6"" Ceiling Speaker (1.5-3-6W). Category: CMX. Subcategory: PA System. Price: 4,080৳.

Product: CMX WSK-610P 10W Wall Mount Speaker. Category: CMX. ",186,342544,342730
2464,sentence,"Category: CMX. Subcategory: PA System. Price: 4,440৳.

Product: CMX HSK-15T 15W Outdoor Horn Speaker. Category: CMX. Subcategory: PA System. Price: 5,520৳.
",156,342715,342871
2465,sentence,"Subcategory: PA System. Price: 5,520৳.

Product: CMX CLSK-20C 20W Outdoor Column Speaker. Category: CMX. Subcategory: PA System. Price: 6,300৳.

Product: CMX WSK-640C 40W Wall Mount Speaker. ",191,342832,343023
2466,sentence,"
Product: CMX WSK-640C 40W Wall Mount Speaker. Category: CMX. Subcategory: PA System. Price: 9,000৳.

Product: CMX WM-U200C UHF Wireless Microphone System. Category: CMX. Subcategory: PA System. ",195,342976,343171
2467,sentence,"Category: CMX. Subcategory: PA System. Price: 28,800৳.

Product: JBL IRX108BT 8"" Powered Portable Bluetooth PA Speaker. Category: PA System. Price: 52,000৳.
",157,343132,343289
2468,sentence,"Category: PA System. Price: 52,000৳.

Product: JBL EON710 10"" Powered Portable Bluetooth PA Speaker. Category: PA System. Price: 68,000৳.
",138,343252,343390
2469,sentence,"Category: PA System. Price: 68,000৳.

Product: JBL IRX112BT 12"" Powered Portable Bluetooth PA Speaker. Category: PA System. Price: 72,000৳.
",140,343353,343493
2470,sentence,"Category: PA System. Price: 72,000৳.

Product: JBL EON712 12"" Powered Portable PA Speaker with Bluetooth. Category: PA System. Price: 80,000৳.
",143,343456,343599
2471,sentence,"Category: PA System. Price: 80,000৳.

Product: JBL EON715 15"" Powered Portable Bluetooth PA Speaker. Category: PA System. Price: 85,000৳.

Product: JBL IRX115S 15"" Powered Portable PA Speaker. ",193,343562,343755
2472,sentence,"Category: PA System. Price: 95,000৳.

Product: JBL EON208P Portable All-In-One 2-Way PA System. Category: PA System. Price: 98,500৳102,000৳.
",141,343755,343896
2473,sentence,"Category: PA System. Price: 98,500৳102,000৳.

Product: JBL EON ONE MK2 Battery-powered Column PA System. Category: PA System. Price: 125,000৳130,000৳.
",151,343851,344002
2474,sentence,"Category: PA System. Price: 125,000৳130,000৳.

Product: JBL PRX ONE All-In-One Powered Column PA System. Category: PA System. Price: 160,000৳170,000৳.
",151,343956,344107
2475,sentence,"Category: PA System. Price: 160,000৳170,000৳.

Product: Grandstream GSC3505 1-Way Public Address SIP Speaker. Category: Grandstream. Subcategory: PA System. Price: Up Coming.
",175,344061,344236
2476,sentence,"Subcategory: PA System. Price: Up Coming.

Product: Grandstream GSC3510 2-Way SIP Intercom Speaker. Category: Grandstream. Subcategory: PA System. Price: Up Coming.
",165,344194,344359
2477,sentence,"Subcategory: PA System. Price: Up Coming.

Product: Grandstream GSC3516 2-Way SIP Multicast Speaker. Category: Grandstream. Subcategory: PA System. Price: Up Coming.
",166,344317,344483
2478,sentence,"Subcategory: PA System. Price: Up Coming.

Product: Grandstream GSC3506 1-Way Public Address SIP Speaker. Category: Grandstream. Subcategory: PA System. Price: Up Coming.
",171,344441,344612
2479,sentence,"Subcategory: PA System. Price: Up Coming.

Product: Optoma 3653RK 65"" 4K Creative Touch 3 Series Interactive Flat Panel Display. Category: Optoma. Subcategory: Interactive Flat Panel. ",184,344570,344754
2480,sentence,"Subcategory: Interactive Flat Panel. Price: 240,000৳.

Product: Optoma 5653RK 65"" 4K UHD Premium Interactive Flat Panel Display. Category: Optoma. Subcategory: Interactive Flat Panel. ",184,344717,344901
2481,sentence,"Subcategory: Interactive Flat Panel. Price: 280,000৳.

Product: Optoma 5752RK+ 75 Inch 4K UHD Touch Interactive Flat Panel Display. Category: Optoma. Subcategory: Interactive Flat Panel. ",187,344864,345051
2482,sentence,"Subcategory: Interactive Flat Panel. Price: 305,000৳.

Product: Optoma 5753RK 75"" 4K UHD Premium Interactive Flat Panel Display. Category: Optoma. Subcategory: Interactive Flat Panel. ",184,345014,345198
2483,sentence,"Subcategory: Interactive Flat Panel. Price: 330,000৳.

Product: Optoma 3863RK 86"" 4K Creative Touch 3 Series Interactive Flat Panel Display. Category: Optoma. Subcategory: Interactive Flat Panel. ",196,345161,345357
2484,sentence,"Subcategory: Interactive Flat Panel. Price: 360,000৳.

Product: Optoma 5863RK 86"" 4K UHD Premium Interactive Flat Panel Display. Category: Optoma. Subcategory: Interactive Flat Panel. ",184,345320,345504
2485,sentence,"Subcategory: Interactive Flat Panel. Price: 380,000৳.

Product: Optoma 3753RK 75"" 4K Creative Touch 3 Series Interactive Flat Panel Display. Category: Optoma. Subcategory: Interactive Flat Panel. ",196,345467,345663
2486,sentence,"Subcategory: Interactive Flat Panel. Price: Up Coming.

Product: Trolley for Interactive Flat Panel Display. Category: Interactive Flat Panel. Price: 25,000৳.
",159,345626,345785
2487,sentence,"Price: 25,000৳.

Product: Maxhub ST41B Stand For Interactive Flat Panel. Category: Interactive Flat Panel. Price: 41,000৳.

Product: OPS Core i5 PC Module for Interactive Flat Panel Display. ",191,345769,345960
2488,sentence,"Category: Interactive Flat Panel. Price: 50,000৳.

Product: METZ S084 Core i5 12th Gen OPS PC Module for Interactive Flat Panel. Category: Interactive Flat Panel. Price: 65,000৳.
",179,345960,346139
2489,sentence,"Price: 65,000৳.

Product: OPS PC Module for interactive Flat Panel. Category: Interactive Flat Panel. Price: 65,000৳.

Product: BenQ Core i5 12th Gen OPS PC Module For Interactive Flat Panel. ",192,346123,346315
2490,sentence,"Category: Interactive Flat Panel. Price: 60,000৳65,000৳.

Product: METZ S084 Core i7 12th Gen OPS PC Module for Interactive Flat Panel. Category: Interactive Flat Panel. Price: 80,000৳.
",186,346315,346501
2491,sentence,"Price: 80,000৳.

Product: Maxhub OPS62A Core i5 11th Gen OPS PC Module For Interactive Flat Panel. Category: Interactive Flat Panel. Price: 83,000৳.
",149,346485,346634
2492,sentence,"Price: 83,000৳.

Product: Hikvision DS-D5AC12T5-8S2 Core i5 12th Gen OPS Module for Interactive Flat Panel. Category: Interactive Flat Panel. Price: 85,000৳.
",158,346618,346776
2493,sentence,"Price: 85,000৳.

Product: Maxhub OPS62A Core i7 11th Gen OPS PC Module For Interactive Flat Panel. Category: Interactive Flat Panel. Price: 88,000৳.
",149,346760,346909
2494,sentence,"Price: 88,000৳.

Product: Hikvision DS-D5B65RB/EL 65"" 4K UHD Interactive Flat Panel Display. Category: Interactive Flat Panel. Price: 210,000৳.
",144,346893,347037
2495,sentence,"Price: 210,000৳.

Product: Hikvision DS-D5B65RB/EL 65"" 4K UHD 128GB Storage Interactive Flat Panel. Category: Interactive Flat Panel. Price: 220,000৳.
",151,347020,347171
2496,sentence,"Price: 220,000৳.

Product: Boxlight ProColor 654U 65"" 4K Interactive Flat Panel Display. Category: Interactive Flat Panel. Price: 225,000৳.
",140,347154,347294
2497,sentence,"Price: 225,000৳.

Product: Armor ARM6505 65"" 4K Android Interactive Flat Panel. Category: Interactive Flat Panel. Price: 230,000৳.
",131,347277,347408
2498,sentence,"Price: 230,000৳.

Product: Dahua LPH65-ST420 65'' 4K Smart Interactive Flat Panel Display. Category: Interactive Flat Panel. Price: 235,000৳.
",142,347391,347533
2499,sentence,"Price: 235,000৳.

Product: iBoard TE-QS-65 65-inch 4K Interactive Flat Panel Display. Category: Interactive Flat Panel. Price: 240,000৳.
",137,347516,347653
2500,sentence,"Price: 240,000৳.

Product: Maxhub E6520 65"" 4K UHD Interactive Flat Panel Display. Category: Interactive Flat Panel. Price: 245,000৳.
",134,347636,347770
2501,sentence,"Price: 245,000৳.

Product: METZ 65KD1 65"" K Series Interactive Flat Panel Display. Category: Interactive Flat Panel. Price: 240,000৳250,000৳.
",142,347753,347895
2502,sentence,"Price: 240,000৳250,000৳.

Product: InFocus INF6513 65"" 4K Interactive Touch Display Inbuilt Camera. Category: Interactive Flat Panel. Price: 250,000৳.
",151,347870,348021
2503,sentence,"Price: 250,000৳.

Product: Viewsonic ViewBoard IFP6533-G 65"" 4K UHD Interactive Flat Panel Display. Category: ViewSonic. Subcategory: Interactive Flat Panel. Price: 280,000৳.
",175,348004,348179
2504,sentence,"Price: 280,000৳.

Product: Viewsonic ViewBoard IFP8633-G 86"" 4K UHD Interactive Flat Panel Display. Category: ViewSonic. Subcategory: Interactive Flat Panel. Price: 500,000৳.
",175,348162,348337
2505,sentence,"Price: 500,000৳.

Product: Viewsonic ViewBoard IFP7533-G 75"" 4K UHD Interactive Flat Panel Display. Category: ViewSonic. Subcategory: Interactive Flat Panel. Price: Up Coming.
",176,348320,348496
2506,sentence,"Price: Up Coming.

Product: ViewSonic VPC16-WP-3 Windows Slot-in PC for interactive displays. Category: ViewSonic. Subcategory: Interactive Flat Panel. Price: Out Of Stock.
",173,348478,348651
2507,sentence,"Price: Out Of Stock.

Product: ViewSonic VPC25-W33-O1-1B Slot-in PC Module for Interactive Displays. Category: ViewSonic. Subcategory: Interactive Flat Panel. Price: Out Of Stock.
",180,348630,348810
2508,sentence,"Price: Out Of Stock.

Product: Viewsonic ViewBoard 7550-5 75 Inch 4K UHD Interactive Flat Panel Display. Category: ViewSonic. Subcategory: Interactive Flat Panel. Price: Out Of Stock.
",184,348789,348973
2509,sentence,"Price: Out Of Stock.

Product: InFocus INF7513 75"" 4K Interactive Touch Display Inbuilt Camera. Category: InFocus. Subcategory: Interactive Flat Panel. Price: 295,000৳.
",169,348952,349121
2510,sentence,"Price: 295,000৳.

Product: InFocus INF9855 98"" 4K Interactive Touch Display Inbuilt Camera. Category: InFocus. Subcategory: Interactive Flat Panel. Price: Pre Order.
",166,349104,349270
2511,sentence,"Price: Pre Order.

Product: InFocus INF6540e 65"" 4K Interactive Touch Display. Category: InFocus. Subcategory: Interactive Flat Panel. Price: Up Coming.
",153,349252,349405
2512,sentence,"Price: Up Coming.

Product: InFocus INF6510 65"" 4K Interactive Touch Display. Category: InFocus. Subcategory: Interactive Flat Panel. Price: Up Coming.
",152,349387,349539
2513,sentence,"Price: Up Coming.

Product: InFocus INF7510 75"" 4K Interactive Touch Display. Category: InFocus. Subcategory: Interactive Flat Panel. Price: Up Coming.
",152,349521,349673
2514,sentence,"Price: Up Coming.

Product: InFocus INF7550 75"" 4K Interactive Touch Display. Category: InFocus. Subcategory: Interactive Flat Panel. Price: Up Coming.
",152,349655,349807
2515,sentence,"Price: Up Coming.

Product: InFocus INF8613 86"" 4K Interactive Touch Display Inbuilt Camera. Category: InFocus. Subcategory: Interactive Flat Panel. Price: Up Coming.
",167,349789,349956
2516,sentence,"Price: Up Coming.

Product: InFocus INF8650 86"" 4K Interactive Touch Display. Category: InFocus. Subcategory: Interactive Flat Panel. Price: Up Coming.
",152,349938,350090
2517,sentence,"Price: Up Coming.

Product: InFocus JTouch 50 Series INF9850 98"" 4K UHD Interactive Touch Display. Category: InFocus. Subcategory: Interactive Flat Panel. Price: Out Of Stock.
",176,350072,350248
2518,sentence,"Price: Out Of Stock.

Product: InFocus INF5510 55"" 4K Interactive Touch Display. Category: InFocus. Subcategory: Interactive Flat Panel. Price: Out Of Stock.
",158,350227,350385
2519,sentence,"Price: Out Of Stock.

Product: InFocus INF6550 65"" 4K Interactive Touch Display. Category: InFocus. Subcategory: Interactive Flat Panel. Price: Out Of Stock.
",158,350364,350522
2520,sentence,"Price: Out Of Stock.

Product: InFocus INF7540e 75"" 4K Interactive Touch Display. Category: InFocus. Subcategory: Interactive Flat Panel. Price: Out Of Stock.
",159,350501,350660
2521,sentence,"Price: Out Of Stock.

Product: InFocus INF8610 86"" 4K Interactive Touch Display. Category: InFocus. Subcategory: Interactive Flat Panel. Price: Out Of Stock.
",158,350639,350797
2522,sentence,"Price: Out Of Stock.

Product: InFocus INF8640e 86"" 4K Interactive Touch Display. Category: InFocus. Subcategory: Interactive Flat Panel. Price: Out Of Stock.
",159,350776,350935
2523,sentence,"Price: Out Of Stock.

Product: InFocus JTouch INF9800 98"" 4K Interactive Touch Display. Category: InFocus. Subcategory: Interactive Flat Panel. Price: Out Of Stock.
",165,350914,351079
2524,sentence,"Price: Out Of Stock.

Product: Dahua DHI-LPH75-ST420-L 75'' 4K Smart Interactive Flat Panel Display. Category: Dahua. Subcategory: Interactive Flat Panel. Price: 300,000৳.
",172,351058,351230
2525,sentence,"Price: 300,000৳.

Product: Dahua LPH86-MC470-P 86'' 4K Smart Interactive Flat Panel Display with 48MP Camera. Category: Dahua. Subcategory: Interactive Flat Panel. Price: 350,000৳430,000৳.
",189,351213,351402
2526,sentence,"Price: 350,000৳430,000৳.

Product: Dahua LPH98-MC470-P 98'' 4K Smart Interactive Flat Panel Display with 48MP Camera. Category: Dahua. Subcategory: Interactive Flat Panel. Price: 975,000৳.
",189,351377,351566
2527,sentence,"Price: 975,000৳.

Product: Dahua LPH75-MC470-P 75'' 4K Smart Interactive Flat Panel Display with 48MP Camera. Category: Dahua. Subcategory: Interactive Flat Panel. Price: Up Coming.
",182,351549,351731
2528,sentence,"Price: Up Coming.

Product: Dahua LPH65-MC470-P 65'' 4K Smart Interactive Flat Panel Display with 48MP Camera. Category: Dahua. Subcategory: Interactive Flat Panel. Price: Out Of Stock.
",186,351713,351899
2529,sentence,"Price: Out Of Stock.

Product: BenQ RE6504 65 Inch 4K UHD Education Interactive Flat Panel Display With Camera & Microphone. Category: BenQ. Subcategory: Interactive Flat Panel. ",178,351878,352056
2530,sentence,"Subcategory: Interactive Flat Panel. Price: 260,000৳270,000৳.

Product: BenQ RM7504 75 Inch 4K UHD Education Interactive Flat Panel Display. Category: BenQ. Subcategory: Interactive Flat Panel. ",194,352019,352213
2531,sentence,"Subcategory: Interactive Flat Panel. Price: 395,000৳400,000৳.

Product: BenQ RE8604 86 Inch 4K UHD Education Interactive Flat Panel Display With Camera & Microphone. Category: BenQ. ",182,352176,352358
2532,sentence,"Category: BenQ. Subcategory: Interactive Flat Panel. Price: 460,000৳470,000৳.

Product: BenQ RM6504 65 Inch 4K UHD Education Interactive Flat Panel Display. Category: BenQ. ",173,352342,352515
2533,sentence,"Category: BenQ. Subcategory: Interactive Flat Panel. Price: Up Coming.

Product: BenQ RE7504 75 Inch 4K UHD Education Interactive Flat Panel Display With Camera & Microphone. Category: BenQ. ",191,352499,352690
2534,sentence,"Category: BenQ. Subcategory: Interactive Flat Panel. Price: 360,000৳370,000৳.

Product: BenQ RM8604 86 Inch 4K UHD Education Interactive Flat Panel Display. Category: BenQ. ",173,352674,352847
2535,sentence,"Category: BenQ. Subcategory: Interactive Flat Panel. Price: Up Coming.

Product: Armor ARM7505 75"" 4K Android Interactive Flat Panel. Category: ARMOR. Subcategory: Interactive Flat Panel. ",188,352831,353019
2536,sentence,"Subcategory: Interactive Flat Panel. Price: 300,000৳.

Product: Armor ARM8605 86"" 4K Android Interactive Flat Panel. Category: ARMOR. Subcategory: Interactive Flat Panel. Price: 390,000৳.
",188,352982,353170
2537,sentence,"Price: 390,000৳.

Product: LG 75TR3DK-BM 75 Inch 4K UHD Touch Interactive Flat Panel Display. Category: LG. Subcategory: Interactive Flat Panel. Price: 370,000৳.
",162,353153,353315
2538,sentence,"Price: 370,000৳.

Product: LG 86TR3DK-BM 86 Inch 4K UHD Touch Interactive Flat Panel Display. Category: LG. Subcategory: Interactive Flat Panel. Price: 515,000৳.
",162,353298,353460
2539,sentence,"Price: 515,000৳.

Product: LG 86TR3DQ 86 Inch 4K UHD Interactive Flat Panel Display. Category: LG. Subcategory: Interactive Flat Panel. Price: 440,000৳.
",153,353443,353596
2540,sentence,"Price: 440,000৳.

Product: LG 98TR3PJ 98 inch 4K UHD Education Interactive Flat Panel Display. Category: LG. Subcategory: Interactive Flat Panel. Price: 1,500,000৳.
",165,353579,353744
2541,sentence,"Price: 1,500,000৳.

Product: LG 65TR3DK-BG 65 inch 4K UHD Interactive Flat Panel Display. Category: LG. Subcategory: Interactive Flat Panel. Price: 300,000৳.
",158,353725,353883
2542,sentence,"Price: 300,000৳.

Product: LG 65TR3DJ 65 inch 4K UHD Education Interactive Flat Panel Display. Category: LG. Subcategory: Interactive Flat Panel. Price: Out Of Stock.
",167,353866,354033
2543,sentence,"Price: Out Of Stock.

Product: LG One:Quick Flex 43HT3WJ 43"" 4K UHD All-in-One Commercial Touch Display. Category: LG. Subcategory: Interactive Flat Panel. Price: Out Of Stock.
",177,354012,354189
2544,sentence,"Price: Out Of Stock.

Product: Hikvision DS-D5B65RB/FL 65"" 4K UHD Interactive Flat Panel Display. Category: Hikvision. Subcategory: Interactive Flat Panel. Price: 250,000৳.
",173,354168,354341
2545,sentence,"Price: 250,000৳.

Product: Hikvision DS-D5B75RB/EL 75"" 4K UHD Interactive Flat Panel Display. Category: Hikvision. Subcategory: Interactive Flat Panel. Price: 270,000৳.
",169,354324,354493
2546,sentence,"Price: 270,000৳.

Product: Hikvision DS-D5C65RB-B 65 Inch 4K UHD Interactive Flat Panel Display with 8MP AI Camera & 8 Array Mic (For Android). Category: Hikvision. ",165,354476,354641
2547,sentence,"Category: Hikvision. Subcategory: Interactive Flat Panel. Price: 280,000৳.

Product: Hikvision DS-D5B75RB/D 75"" 4K UHD Interactive Flat Panel Display With 8MP WebCam. Category: Hikvision. ",188,354620,354808
2548,sentence,"Category: Hikvision. Subcategory: Interactive Flat Panel. Price: 290,000৳.

Product: Hikvision DS-D5C75RB/A 75 Inch 4K UHD Interactive Flat Panel Display (For Android). Category: Hikvision. ",190,354787,354977
2549,sentence,"Category: Hikvision. Subcategory: Interactive Flat Panel. Price: Up Coming.

Product: Hikvision DS-D5B86RB/EL 86"" 4K UHD Interactive Flat Panel Display. Category: Hikvision. ",174,354956,355130
2550,sentence,"Category: Hikvision. Subcategory: Interactive Flat Panel. Price: 330,000৳.

Product: Hikvision DS-D5B86RB/EL 86"" 4K UHD 128GB Storage Interactive Flat Panel. Category: Hikvision. ",179,355109,355288
2551,sentence,"Category: Hikvision. Subcategory: Interactive Flat Panel. Price: 350,000৳.

Product: Hikvision DS-D5B75RB/FL 75"" 4K UHD Interactive Flat Panel Display. Category: Hikvision. ",173,355267,355440
2552,sentence,"Category: Hikvision. Subcategory: Interactive Flat Panel. Price: 350,000৳.
",75,355419,355494
2553,sentence,"Price: 350,000৳.

Product: Hikvision DS-D5C75RB/B 75 Inch 4K UHD Interactive Flat Panel Display with 8MP AI Camera & 8 Array Mic (For Android). Category: Hikvision. ",165,355477,355642
2554,sentence,"Category: Hikvision. Subcategory: Interactive Flat Panel. Price: 360,000৳.

Product: Hikvision DS-D5B86RB/D 86"" 4K UHD Interactive Flat Panel Display With 8MP WebCam. Category: Hikvision. ",188,355621,355809
2555,sentence,"Category: Hikvision. Subcategory: Interactive Flat Panel. Price: 370,000৳.

Product: Hikvision DS-D5B86RB/FL 86"" 4K UHD Interactive Flat Panel Display. Category: Hikvision. ",173,355788,355961
2556,sentence,"Category: Hikvision. Subcategory: Interactive Flat Panel. Price: 400,000৳.
",75,355940,356015
2557,sentence,"Price: 400,000৳.

Product: Hikvision DS-D5C86RB-B 86 Inch 4K UHD Interactive Flat Panel Display with 8MP AI Camera & 8 Array Mic (For Android). Category: Hikvision. ",165,355998,356163
2558,sentence,"Category: Hikvision. Subcategory: Interactive Flat Panel. Price: 420,000৳.

Product: Hikvision DS-D5C86RB/A 86 Inch 4K UHD Interactive Flat Panel Display (For Android). Category: Hikvision. ",190,356142,356332
2559,sentence,"Category: Hikvision. Subcategory: Interactive Flat Panel. Price: 430,000৳.

Product: Hikvision DS-D5B75RB/EL 75"" 4K UHD 128GB Storage Interactive Flat Panel. Category: Hikvision. ",179,356311,356490
2560,sentence,"Category: Hikvision. Subcategory: Interactive Flat Panel. Price: Up Coming.

Product: Hikvision DS-D5C65RB/A 65 Inch 4K UHD Interactive Flat Panel Display (For Android). Category: Hikvision. ",191,356469,356660
2561,sentence,"Category: Hikvision. Subcategory: Interactive Flat Panel. Price: Out Of Stock.

Product: Hitachi HILS65205 65"" UHD Interactive Flat Panel Display. Category: Hitachi. ",166,356639,356805
2562,sentence,"Category: Hitachi. Subcategory: Interactive Flat Panel. Price: Out Of Stock.

Product: Hitachi HILS75205 75"" UHD Interactive Flat Panel Display. Category: Hitachi. ",164,356786,356950
2563,sentence,"Category: Hitachi. Subcategory: Interactive Flat Panel. Price: Out Of Stock.

Product: Hitachi HILS86205 86"" UHD Interactive Flat Panel Display. Category: Hitachi. ",164,356931,357095
2564,sentence,"Category: Hitachi. Subcategory: Interactive Flat Panel. Price: Out Of Stock.

Product: METZ 65SG1 65"" S Series 4K Interactive Flat Panel Display AI Camera. Category: METZ. ",172,357076,357248
2565,sentence,"Category: METZ. Subcategory: Interactive Flat Panel. Price: 270,000৳.

Product: METZ 75KD1 75"" K Series Interactive Flat Panel Display. Category: METZ. Subcategory: Interactive Flat Panel. ",189,357232,357421
2566,sentence,"Subcategory: Interactive Flat Panel. Price: 320,000৳.

Product: METZ 75SG1 75"" S Series 4K Interactive Flat Panel Display AI Camera. Category: METZ. Subcategory: Interactive Flat Panel. ",186,357384,357570
2567,sentence,"Subcategory: Interactive Flat Panel. Price: 360,000৳.

Product: METZ 86HD1 86"" H Series Interactive Flat Panel Display. Category: METZ. Subcategory: Interactive Flat Panel. Price: 370,000৳.
",190,357533,357723
2568,sentence,"Price: 370,000৳.

Product: METZ 86KD1 86"" K Series Interactive Flat Panel Display. Category: METZ. Subcategory: Interactive Flat Panel. Price: 410,000৳.
",153,357706,357859
2569,sentence,"Price: 410,000৳.

Product: METZ 86SG1 86"" S Series 4K Interactive Flat Panel Display AI Camera. Category: METZ. Subcategory: Interactive Flat Panel. Price: 420,000৳.
",166,357842,358008
2570,sentence,"Price: 420,000৳.

Product: METZ 65HD1 65"" H Series Interactive Flat Panel Display. Category: METZ. Subcategory: Interactive Flat Panel. Price: Up Coming.
",154,357991,358145
2571,sentence,"Price: Up Coming.

Product: METZ 75HD1 75"" H Series Interactive Flat Panel Display. Category: METZ. Subcategory: Interactive Flat Panel. Price: Up Coming.
",155,358127,358282
2572,sentence,"Price: Up Coming.

Product: Boxlight ProColor P565UC 65"" 4K Interactive Flat Panel Display. Category: BoxLight. Subcategory: Interactive Flat Panel. Price: Up Coming.
",167,358264,358431
2573,sentence,"Price: Up Coming.

Product: Boxlight ProColor P575UC 75"" 4K Interactive Flat Panel Display. Category: BoxLight. Subcategory: Interactive Flat Panel. Price: Up Coming.
",167,358413,358580
2574,sentence,"Price: Up Coming.

Product: Boxlight ProColor P586UC 86"" 4K Interactive Flat Panel Display. Category: BoxLight. Subcategory: Interactive Flat Panel. Price: Up Coming.
",167,358562,358729
2575,sentence,"Price: Up Coming.

Product: Boxlight ProColor 984UC 98"" 4K Interactive Flat Panel Display. Category: BoxLight. Subcategory: Interactive Flat Panel. Price: Up Coming.
",166,358711,358877
2576,sentence,"Price: Up Coming.

Product: Boxlight ProColor 754U 75"" 4K Interactive Flat Panel Display. Category: BoxLight. Subcategory: Interactive Flat Panel. Price: Up Coming.
",165,358859,359024
2577,sentence,"Price: Up Coming.

Product: Panasonic LH-65TD3VS 65-inch Touch Commercial Display. Category: Panasonic. Subcategory: Interactive Flat Panel. Price: 290,000৳.
",158,359006,359164
2578,sentence,"Price: 290,000৳.

Product: Panasonic LH-75TD3VS 75-inch Touch Commercial Display. Category: Panasonic. Subcategory: Interactive Flat Panel. Price: 420,000৳.
",157,359147,359304
2579,sentence,"Price: 420,000৳.

Product: Panasonic LH-86TD3VS 86-inch Touch Commercial Display. Category: Panasonic. Subcategory: Interactive Flat Panel. Price: 520,000৳.
",157,359287,359444
2580,sentence,"Price: 520,000৳.

Product: Panasonic LH-55TD3VS 55-inch Touch Commercial Display. Category: Panasonic. Subcategory: Interactive Flat Panel. Price: Out Of Stock.
",161,359427,359588
2581,sentence,"Price: Out Of Stock.

Product: Maxhub E7520 75"" 4K UHD Interactive Flat Panel Display. Category: MAXHUB. Subcategory: Interactive Flat Panel. Price: 305,000৳.
",159,359567,359726
2582,sentence,"Price: 305,000৳.

Product: Maxhub E7521 75"" 4K UHD Interactive Flat Panel Display. Category: MAXHUB. Subcategory: Interactive Flat Panel. Price: 340,000৳.
",155,359709,359864
2583,sentence,"Price: 340,000৳.

Product: Maxhub C5530 55"" 4K UHD Interactive Flat Panel With Camera, Microphone & OPS. Category: MAXHUB. Subcategory: Interactive Flat Panel. Price: 340,000৳.
",177,359847,360024
2584,sentence,"Price: 340,000৳.

Product: Maxhub C6530 65"" 4K UHD Interactive Flat Panel With Camera, Microphone & OPS. Category: MAXHUB. Subcategory: Interactive Flat Panel. Price: 390,000৳.
",177,360007,360184
2585,sentence,"Price: 390,000৳.

Product: Maxhub E8621 86"" 4K UHD Interactive Flat Panel Display. Category: MAXHUB. Subcategory: Interactive Flat Panel. Price: 405,000৳.
",155,360167,360322
2586,sentence,"Price: 405,000৳.

Product: Maxhub C7530 75"" 4K UHD Interactive Flat Panel With Camera, Microphone & OPS. Category: MAXHUB. Subcategory: Interactive Flat Panel. Price: Up Coming.
",178,360305,360483
2587,sentence,"Price: Up Coming.

Product: Maxhub C8630 86"" 4K UHD Interactive Flat Panel With Camera, Microphone & OPS. Category: MAXHUB. Subcategory: Interactive Flat Panel. Price: 615,000৳.
",178,360465,360643
2588,sentence,"Price: 615,000৳.

Product: ZKTeco SC02-I365A 65 Inch 4K UHD Interactive Flat Panel Display. Category: ZKTeco. Subcategory: Interactive Flat Panel. Price: 260,000৳.
",164,360626,360790
2589,sentence,"Price: 260,000৳.

Product: ZKTeco SC02-I386A 86 Inch 4K UHD Interactive Flat Panel Display. Category: ZKTeco. Subcategory: Interactive Flat Panel. Price: 380,000৳.
",164,360773,360937
2590,sentence,"Price: 380,000৳.

Product: ZKTeco ZK-IWB65BM 65 Inch 4K UHD Interactive Flat Panel Display. Category: ZKTeco. Subcategory: Interactive Flat Panel. Price: Up Coming.
",165,360920,361085
2591,sentence,"Price: Up Coming.

Product: ZKTeco ZK-IWB86BP 86 Inch 4K UHD Interactive Flat Panel Display. Category: ZKTeco. Subcategory: Interactive Flat Panel. Price: Out Of Stock.
",169,361067,361236
2592,sentence,"Price: Out Of Stock.

Product: ZKTeco SC02-I375A 75 Inch 4K UHD Interactive Flat Panel Display. Category: ZKTeco. Subcategory: Interactive Flat Panel. Price: Up Coming.
",169,361215,361384
2593,sentence,"Price: Up Coming.

Product: Newline S Series 86-inch 4K Interactive Flat Panel Display. Category: Newline. Subcategory: Interactive Flat Panel. Price: 440,000৳.
",161,361366,361527
2594,sentence,"Price: 440,000৳.

Product: Horion 65M6APro 65"" 4K UHD Interactive Flat Panel With 48MP WebCam & Microphone. Category: Horion. Subcategory: Interactive Flat Panel. Price: 286,000৳.
",180,361510,361690
2595,sentence,"Price: 286,000৳.

Product: Horion 75M6APro 75"" 4K UHD Interactive Flat Panel With 48MP WebCam & Microphone. Category: Horion. Subcategory: Interactive Flat Panel. Price: 366,000৳.
",180,361673,361853
2596,sentence,"Price: 366,000৳.

Product: Horion 86M6APro 86"" 4K UHD Interactive Flat Panel With 48MP WebCam & Microphone. Category: Horion. Subcategory: Interactive Flat Panel. Price: 435,000৳.
",180,361836,362016
2597,sentence,"Price: 435,000৳.

Product: Horion 98M6APro 98"" 4K UHD Interactive Flat Panel With 48MP WebCam & Microphone. Category: Horion. Subcategory: Interactive Flat Panel. Price: Call for Price.
",186,361999,362185
2598,sentence,"Price: Call for Price.

Product: ViewSonic CDE5520 55"" 4K UHD Wireless Commercial Display. Category: ViewSonic. Subcategory: Signage. Price: 140,000৳149,000৳.
",159,362162,362321
2599,sentence,"Subcategory: Signage. Price: 140,000৳149,000৳.

Product: ViewSonic CDE6520 65 inch 4K UHD Wireless Commercial Display. Category: ViewSonic. Subcategory: Signage. Price: 165,000৳190,000৳.
",187,362274,362461
2600,sentence,"Subcategory: Signage. Price: 165,000৳190,000৳.

Product: ViewSonic CDE7520 75"" 4K UHD Wireless Commercial Display. Category: ViewSonic. Subcategory: Signage. Price: Up Coming.
",176,362414,362590
2601,sentence,"Subcategory: Signage. Price: Up Coming.

Product: BenQ ST5502 55 Inch Android 4K Professional Smart Signage. Category: BenQ. Subcategory: Signage. Price: Up Coming.
",165,362550,362715
2602,sentence,"Subcategory: Signage. Price: Up Coming.

Product: BenQ ST6502 65"" Android 4K Professional Smart Signage. Category: BenQ. Subcategory: Signage. Price: Up Coming.
",161,362675,362836
2603,sentence,"Subcategory: Signage. Price: Up Coming.

Product: BenQ ST7502 75"" Android 4K Professional Smart Signage. Category: BenQ. Subcategory: Signage. Price: Out Of Stock.
",164,362796,362960
2604,sentence,"Subcategory: Signage. Price: Out Of Stock.

Product: Panasonic LH-55QM3VS 55-inch Pro Commercial Display. Category: Signage. Price: 110,000৳120,000৳.
",150,362917,363067
2605,sentence,"Category: Signage. Price: 110,000৳120,000৳.

Product: Panasonic LH-55AN3ND 55-inch Android Commercial Display. Category: Signage. Price: 127,700৳.
",147,363023,363170
2606,sentence,"Category: Signage. Price: 127,700৳.

Product: Hikvision DS-D6055UH 55"" 4K UHD Android Signage Display. Category: Signage. Price: 170,000৳.
",139,363134,363273
2607,sentence,"Category: Signage. Price: 170,000৳.

Product: Maxhub ND75CMA 75"" 4K UHD Android Signage Display. Category: Signage. Price: 245,000৳.

Product: Panasonic LH-75QM3VS 75-inch Pro Commercial Display. ",196,363237,363433
2608,sentence,"Category: Signage. Price: 445,000৳.

Product: Maxhub ND98CMA  98"" 4K UHD Android Signage Display. Category: Signage. Price: 550,000৳.

Product: LG 98UM5K 98 Inch 4K UHD Signage Display. ",186,363433,363619
2609,sentence,"Category: Signage. Price: 1,000,000৳.

Product: Panasonic LH-98QM3HVS 98-inch Pro Commercial Display. Category: Signage. Price: 1,731,400৳.
",140,363619,363759
2610,sentence,"Category: Signage. Price: 1,731,400৳.

Product: Panasonic LH-43AN 43-inch Android Commercial Display. Category: Signage. Price: Out Of Stock.
",142,363721,363863
2611,sentence,"Category: Signage. Price: Out Of Stock.

Product: Panasonic LH-65AN3ND 65-inch Android Commercial Display. Category: Signage. Price: Out Of Stock.
",147,363823,363970
2612,sentence,"Category: Signage. Price: Out Of Stock.

Product: Panasonic LH-65QM3VS 65-inch Pro Commercial Display. Category: Signage. Price: Out Of Stock.
",143,363930,364073
2613,sentence,"Category: Signage. Price: Out Of Stock.

Product: Panasonic LH-86QM3VS 86-inch Pro Commercial Display. Category: Signage. Price: Out Of Stock.
",143,364033,364176
2614,sentence,"Category: Signage. Price: Out Of Stock.

Product: ViewSonic EP5542T 55"" 4K Multi-Touch Digital ePoster Kiosk. Category: ViewSonic. Subcategory: Kiosk. Price: 310,000৳.
",168,364136,364304
2615,sentence,"Subcategory: Kiosk. Price: 310,000৳.

Product: Canon Pixma IP 2770 Inkjet Printer with Original PG 810 & PG 811 Ink. Category: Printer. Price: 8,500৳8,700৳.
",157,364267,364424
2616,sentence,"Category: Printer. Price: 8,500৳8,700৳.

Product: HP DeskJet Ink Advantage 2336 All-in-One Color Printer. Category: Printer. Price: 9,500৳10,000৳.
",147,364384,364531
2617,sentence,"Category: Printer. Price: 9,500৳10,000৳.

Product: Pantum P2500 Single Function Mono Laser Printer. Category: Printer. Price: 9,900৳10,500৳.
",141,364490,364631
2618,sentence,"Category: Printer. Price: 9,900৳10,500৳.

Product: Pantum P2506 Single Function Mono Laser Printer (22 PPM). Category: Printer. Price: 10,000৳.
",144,364590,364734
2619,sentence,"Category: Printer. Price: 10,000৳.

Product: Pantum P2506W Single Function Mono Laser Printer With Wi-Fi (22 PPM). Category: Printer. Price: 10,800৳11,000৳.
",157,364699,364856
2620,sentence,"Category: Printer. Price: 10,800৳11,000৳.

Product: HP DeskJet Ink Advantage 2875 All-in-One Wi-Fi Color Printer. Category: Printer. Price: 10,500৳11,000৳.
",156,364814,364970
2621,sentence,"Category: Printer. Price: 10,500৳11,000৳.

Product: Pantum P2500W Single Function Mono Laser Printer. Category: Printer. Price: 10,300৳12,000৳.
",144,364928,365072
2622,sentence,"Category: Printer. Price: 10,300৳12,000৳.

Product: HP Laser 1008a Single Function Mono Laser Printer. Category: Printer. Price: 12,300৳13,500৳.
",145,365030,365175
2623,sentence,"Category: Printer. Price: 12,300৳13,500৳.

Product: Pantum BP2310W Single Function Mono Laser Printer. Category: Printer. Price: 13,500৳.
",138,365133,365271
2624,sentence,"Category: Printer. Price: 13,500৳.

Product: Pantum BP2310NW Single Function Mono Laser Printer. Category: Printer. Price: 15,500৳.
",132,365236,365368
2625,sentence,"Category: Printer. Price: 15,500৳.

Product: Epson EcoTank L130 Single Function InkTank Printer (Unofficial). Category: Printer. Price: 13,800৳14,000৳.
",152,365333,365485
2626,sentence,"Category: Printer. Price: 13,800৳14,000৳.

Product: Canon Pixma G1010 Refillable Ink Tank Printer. Category: Printer. Price: 14,500৳14,700৳.
",141,365443,365584
2627,sentence,"Category: Printer. Price: 14,500৳14,700৳.

Product: Brother HL-L2320D Auto Duplex Laser Printer (30 PPM). Category: Printer. Price: 15,300৳.
",141,365542,365683
2628,sentence,"Category: Printer. Price: 15,300৳.

Product: Epson EcoTank L130 Single Function InkTank Printer (Official). Category: Printer. Price: 14,000৳15,500৳.
",150,365648,365798
2629,sentence,"Category: Printer. Price: 14,000৳15,500৳.

Product: HP Laser 1008w Single Function Mono Laser Printer. Category: Printer. Price: 15,500৳.
",138,365756,365894
2630,sentence,"Category: Printer. Price: 15,500৳.

Product: HP Smart Tank 210 Single Function Color Ink Printer. Category: Printer. Price: 15,300৳15,500৳.
",140,365859,365999
2631,sentence,"Category: Printer. Price: 15,300৳15,500৳.

Product: Pantum P3010DW Single Function Mono Laser Printer (30 PPM). Category: Printer. Price: 15,500৳16,000৳.
",154,365957,366111
2632,sentence,"Category: Printer. Price: 15,500৳16,000৳.

Product: Canon Pixma G1020 Ink Tank Color Printer. Category: Printer. Price: 15,000৳16,000৳.

Product: Pantum M6500NW Multifunction Mono Laser Printer. ",195,366069,366264
2633,sentence,"Category: Printer. Price: 16,000৳.

Product: Canon imageCLASS LBP6030B Mono Laser Printer. Category: Printer. Price: 15,800৳.

Product: Innovtech 43 inch E-Poster Non-Touch Floor Standing Kiosk. ",195,366264,366459
2634,sentence,"Category: Kiosk. Price: 125,000৳150,000৳.

Product: Armor ATFSD-A430 43"" Android Floor Standing Touch Kiosk. Category: Kiosk. Price: 150,000৳155,000৳.
",151,366459,366610
2635,sentence,"Category: Kiosk. Price: 150,000৳155,000৳.

Product: Innovtech 55-inch E-Poster Non-Touch Floor Standing Kiosk. Category: Kiosk. Price: 145,000৳170,000৳.
",153,366568,366721
2636,sentence,"Category: Kiosk. Price: 145,000৳170,000৳.

Product: Hikvision DS-D6055UL-B/S 55"" 4K UHD Floor Standing Digital Signage Kiosk (Non-Touch). Category: Kiosk. Price: 170,000৳185,000৳.
",180,366679,366859
2637,sentence,"Category: Kiosk. Price: 170,000৳185,000৳.

Product: Armor ATFSD-A550 55"" Android Floor Standing Touch Kiosk. Category: Kiosk. Price: 195,000৳200,000৳.
",151,366817,366968
2638,sentence,"Category: Kiosk. Price: 195,000৳200,000৳.

Product: Armor ANTSD-A430 43"" Android Floor Standing Kiosk. Category: Kiosk. Price: Up Coming.
",138,366926,367064
2639,sentence,"Category: Kiosk. Price: Up Coming.

Product: Armor ATFSD-A650 65"" Android Floor Standing Touch Kiosk. Category: Kiosk. Price: Out Of Stock.
",140,367029,367169
2640,sentence,"Category: Kiosk. Price: Out Of Stock.

Product: Armor ATFSD-W550 55"" Windows Floor Standing Touch Kiosk. Category: Kiosk. Price: Out Of Stock.
",143,367131,367274
2641,sentence,"Category: Kiosk. Price: Out Of Stock.

Product: Brother DCP-T220 Multi-Function Color Inktank Printer (Black/Color: 28/11 PPM). Category: Brother. Subcategory: Printer. Price: 16,000৳17,000৳.
",192,367236,367428
2642,sentence,"Subcategory: Printer. Price: 16,000৳17,000৳.

Product: Brother HL-B2100D Single Function Laser Printer. Category: Brother. Subcategory: Printer. Price: 17,200৳17,500৳.
",168,367383,367551
2643,sentence,"Subcategory: Printer. Price: 17,200৳17,500৳.

Product: Brother HL-L2365DW Auto Duplex Mono Laser Printer with Wifi (30 PPM). Category: Brother. Subcategory: Printer. Price: 18,300৳18,700৳.
",189,367506,367695
2644,sentence,"Subcategory: Printer. Price: 18,300৳18,700৳.

Product: Brother DCP-T420W Multi-Function Color Inktank Printer with Wifi(Black/Color: 28/11 PPM). Category: Brother. Subcategory: Printer. ",186,367650,367836
2645,sentence,"Category: Brother. Subcategory: Printer. Price: 18,000৳19,500৳.

Product: Brother HL-B2150W Single Function Laser Printer. Category: Brother. Subcategory: Printer. Price: 20,500৳.
",180,367795,367975
2646,sentence,"Subcategory: Printer. Price: 20,500৳.

Product: Brother DCP-T530DW Multifunction Color Inkjet Printer. Category: Brother. Subcategory: Printer. Price: 22,300৳23,000৳.
",167,367937,368104
2647,sentence,"Subcategory: Printer. Price: 22,300৳23,000৳.

Product: Brother HL-B2180DW Mono Laser Duplex Printer. Category: Brother. Subcategory: Printer. Price: 22,000৳.
",158,368059,368217
2648,sentence,"Subcategory: Printer. Price: 22,000৳.

Product: Brother DCP-L2540DW Laser Multi-Function Wireless Duplex Printer (30 PPM). Category: Brother. Subcategory: Printer. Price: 26,400৳.
",180,368179,368359
2649,sentence,"Subcategory: Printer. Price: 26,400৳.

Product: Brother DCP-B7620DW Multifunctional Duplex Mono Laser Printer. Category: Brother. Subcategory: Printer. Price: 25,500৳.
",168,368321,368489
2650,sentence,"Subcategory: Printer. Price: 25,500৳.

Product: Brother HL-L5210DN Mono Laser Printer. Category: Brother. Subcategory: Printer. Price: 27,000৳.
",144,368451,368595
2651,sentence,"Subcategory: Printer. Price: 27,000৳.

Product: Brother DCP-B7640DW Multifunctional Duplex Laser Printer. Category: Brother. Subcategory: Printer. Price: 29,500৳30,000৳.
",170,368557,368727
2652,sentence,"Subcategory: Printer. Price: 29,500৳30,000৳.

Product: Brother DCP-T720DW Multi-Function Color Inktank Printer with Wifi (Black/Color: 17/16.5 PPM). Category: Brother. Subcategory: Printer. ",190,368682,368872
2653,sentence,"Category: Brother. Subcategory: Printer. Price: 30,500৳31,000৳.

Product: Brother DCP-T730DW Multifunction Color Inkjet Printer. Category: Brother. Subcategory: Printer. Price: 30,500৳31,500৳.
",193,368831,369024
2654,sentence,"Subcategory: Printer. Price: 30,500৳31,500৳.

Product: Brother MFC-L2700DW Multifunction Laser Printer with Wifi (30 PPM). Category: Brother. Subcategory: Printer. Price: 29,200৳30,000৳.
",187,368979,369166
2655,sentence,"Subcategory: Printer. Price: 29,200৳30,000৳.

Product: Brother MFC-J2340DW A3 Inkjet Printer. Category: Brother. Subcategory: Printer. Price: 32,000৳33,000৳.
",158,369121,369279
2656,sentence,"Subcategory: Printer. Price: 32,000৳33,000৳.

Product: Brother DCP-T820DW Multi Function Inkjet Printer. Category: Brother. Subcategory: Printer. Price: Out Of Stock.
",167,369234,369401
2657,sentence,"Subcategory: Printer. Price: Out Of Stock.

Product: Brother HL-L5210DW Professional Mono Laser Printer. Category: Brother. Subcategory: Printer. Price: 32,000৳33,500৳.
",169,369358,369527
2658,sentence,"Subcategory: Printer. Price: 32,000৳33,500৳.

Product: Brother MFP MFC-B7810DW Multifunctional Mono Laser Printer. Category: Brother. Subcategory: Printer. Price: 34,500৳.
",172,369482,369654
2659,sentence,"Subcategory: Printer. Price: 34,500৳.

Product: Brother DCP-T830DW Multifunction Color Inkjet Printer. Category: Brother. Subcategory: Printer. Price: 33,500৳35,000৳.
",167,369616,369783
2660,sentence,"Subcategory: Printer. Price: 33,500৳35,000৳.

Product: Fujifilm Apeos C325dw Color Laser Printer. Category: Fujifilm. Subcategory: Printer. Price: 56,000৳55,000৳.
",163,369738,369901
2661,sentence,"Subcategory: Printer. Price: 56,000৳55,000৳.

Product: Fujifilm Apeos C325dw 3-in-1 Multifunction Color Laser Printer. Category: Fujifilm. Subcategory: Printer. Price: 67,400৳68,000৳.
",184,369856,370040
2662,sentence,"Subcategory: Printer. Price: 67,400৳68,000৳.

Product: Fujifilm Apeos C325z 4-in-1 Multifunction Color Laser Printer. Category: Fujifilm. Subcategory: Printer. Price: 72,000৳73,000৳.
",183,369995,370178
2663,sentence,"Subcategory: Printer. Price: 72,000৳73,000৳.

Product: Canon LBP 6030 Single Function Mono Laser Printer. Category: Canon. Subcategory: Printer. Price: 15,800৳16,500৳.
",168,370133,370301
2664,sentence,"Subcategory: Printer. Price: 15,800৳16,500৳.

Product: Canon Pixma G2010 Ink Tank All-In-One Printer. Category: Canon. Subcategory: Printer. Price: 17,000৳17,500৳.
",164,370256,370420
2665,sentence,"Subcategory: Printer. Price: 17,000৳17,500৳.

Product: Canon Pixma G2020 Ink Tank Color Printer. Category: Canon. Subcategory: Printer. Price: 17,700৳.
",152,370375,370527
2666,sentence,"Subcategory: Printer. Price: 17,700৳.

Product: Canon imageCLASS LBP6030W Wi-Fi Mono Laser Printer. Category: Canon. Subcategory: Printer. Price: 17,200৳17,500৳.
",162,370489,370651
2667,sentence,"Subcategory: Printer. Price: 17,200৳17,500৳.

Product: Canon Pixma G3010 Refillable Ink Tank Wireless All-In-One Printer. Category: Canon. Subcategory: Printer. Price: 20,000৳21,000৳.
",184,370606,370790
2668,sentence,"Subcategory: Printer. Price: 20,000৳21,000৳.

Product: Canon Pixma G3020 Wi-Fi Multifunction Color InkTank Printer. Category: Canon. Subcategory: Printer. Price: 22,500৳23,500৳.
",178,370745,370923
2669,sentence,"Subcategory: Printer. Price: 22,500৳23,500৳.

Product: Canon imageCLASS LBP121dn Single Function Mono Laser Printer. Category: Canon. Subcategory: Printer. Price: 23,500৳.
",172,370878,371050
2670,sentence,"Subcategory: Printer. Price: 23,500৳.

Product: Canon imageCLASS LBP122dw Single Function Duplex Mono Laser Printer. Category: Canon. Subcategory: Printer. Price: 24,500৳25,000৳.
",179,371012,371191
2671,sentence,"Subcategory: Printer. Price: 24,500৳25,000৳.

Product: Canon Pixma G4010 All in One Wireless Ink Tank Printer. Category: Canon. Subcategory: Printer. Price: 29,000৳29,500৳.
",173,371146,371319
2672,sentence,"Subcategory: Printer. Price: 29,000৳29,500৳.

Product: Canon i-SENSYS LBP631Cw Color Laser Printer. Category: Canon. Subcategory: Printer. Price: Out Of Stock.
",160,371274,371434
2673,sentence,"Subcategory: Printer. Price: Out Of Stock.

Product: Canon i-SENSYS LBP246dw Single Function Laser Printer. Category: Canon. Subcategory: Printer. Price: Up Coming.
",165,371391,371556
2674,sentence,"Subcategory: Printer. Price: Up Coming.

Product: Canon Color imageCLASS LBP633Cdw Laser Printer. Category: Canon. Subcategory: Printer. Price: 39,000৳.
",153,371516,371669
2675,sentence,"Subcategory: Printer. Price: 39,000৳.

Product: Canon LBP-623Cdw Wireless Color Laser Printer. Category: Canon. Subcategory: Printer. Price: 82,000৳.
",150,371631,371781
2676,sentence,"Subcategory: Printer. Price: 82,000৳.

Product: Canon imageCLASS MF275dw Wi-Fi Multifunction Mono Laser Printer. Category: Canon. Subcategory: Printer. Price: 44,000৳45,000৳.
",175,371743,371918
2677,sentence,"Subcategory: Printer. Price: 44,000৳45,000৳.

Product: Canon i-SENSYS MF651Cw All-In-One Multifunction Color Laser Printer. Category: Canon. Subcategory: Printer. Price: 50,000৳51,000৳.
",186,371873,372059
2678,sentence,"Subcategory: Printer. Price: 50,000৳51,000৳.

Product: Canon LBP-325X Single-Function Mono Laser Printer. Category: Canon. Subcategory: Printer. Price: 97,000৳.
",161,372014,372175
2679,sentence,"Subcategory: Printer. Price: 97,000৳.

Product: HID FARGO DTC1250E FD AP Dual Side Plastic Card Printer. Category: HID. Subcategory: ID Card Printer. Price: 220,000৳.
",167,372137,372304
2680,sentence,"Subcategory: ID Card Printer. Price: 220,000৳.

Product: Pantum M6550NW Mono Lase Multifunction Printer with WiFi & ADF. Category: Pantum. Subcategory: Printer. Price: 16,300৳18,000৳.
",184,372257,372441
2681,sentence,"Subcategory: Printer. Price: 16,300৳18,000৳.

Product: Pantum M6556NW Mono Laser Printer With ADF, LAN & Wi-fi (22 PPM). Category: Pantum. Subcategory: Printer. Price: Out Of Stock.
",182,372396,372578
2682,sentence,"Subcategory: Printer. Price: Out Of Stock.

Product: Pantum M6700DW Mono Laser Multifunction Printer. Category: Pantum. Subcategory: Printer. Price: 19,300৳20,000৳.
",165,372535,372700
2683,sentence,"Subcategory: Printer. Price: 19,300৳20,000৳.

Product: Pantum P3305DW Mono Laser Single Function Printer (33 PPM). Category: Pantum. Subcategory: Printer. Price: 21,500৳22,000৳.
",178,372655,372833
2684,sentence,"Subcategory: Printer. Price: 21,500৳22,000৳.

Product: Pantum BP5100DN Single Function Mono Laser Printer With Duplex & Network (40 PPM). Category: Pantum. Subcategory: Printer. ",178,372788,372966
2685,sentence,"Category: Pantum. Subcategory: Printer. Price: 21,700৳24,000৳.

Product: Pantum BP5130DN Single Function Mono Laser Printer. Category: Pantum. Subcategory: Printer. Price: 23,500৳24,500৳.
",188,372926,373114
2686,sentence,"Subcategory: Printer. Price: 23,500৳24,500৳.

Product: Pantum M7100DW Multifunction Mono Laser Printer. Category: Pantum. Subcategory: Printer. Price: 26,500৳.
",160,373069,373229
2687,sentence,"Subcategory: Printer. Price: 26,500৳.

Product: Pantum BP5100DW Mono Laser Printer with Duplex & Wi-Fi (40 PPM). Category: Pantum. Subcategory: Printer. Price: 26,500৳27,500৳.
",176,373191,373367
2688,sentence,"Subcategory: Printer. Price: 26,500৳27,500৳.

Product: Pantum M7105DW Mono Laser Multifunction Printer. Category: Pantum. Subcategory: Printer. Price: 28,000৳.
",160,373322,373482
2689,sentence,"Subcategory: Printer. Price: 28,000৳.

Product: Pantum CP1100DW Color Laser Printer (18 ppm). Category: Pantum. Subcategory: Printer. Price: 38,500৳39,200৳.
",157,373444,373601
2690,sentence,"Subcategory: Printer. Price: 38,500৳39,200৳.

Product: Pantum CP2100DW Color Laser Printer. Category: Pantum. Subcategory: Printer. Price: 45,000৳.
",148,373556,373704
2691,sentence,"Subcategory: Printer. Price: 45,000৳.

Product: Pantum CM1100ADW Multifunction Color Laser Printer. Category: Pantum. Subcategory: Printer. Price: 64,000৳.

Product: EVOLIS Badgy200 card printer. ",196,373666,373862
2692,sentence,"
Product: EVOLIS Badgy200 card printer. Category: Evolis. Subcategory: ID Card Printer. Price: 85,000৳.

Product: Evolis Zenius Classic Card Printer. Category: Evolis. Subcategory: ID Card Printer. ",198,373822,374020
2693,sentence,"Category: Evolis. Subcategory: ID Card Printer. Price: 115,000৳.

Product: Evolis Primacy 2 Simplex Expert ID Card Printer. Category: Evolis. Subcategory: ID Card Printer. Price: 145,000৳150,000৳.
",197,373972,374169
2694,sentence,"Price: 145,000৳150,000৳.

Product: Evolis Primacy 2 Duplex Expert ID Card Printer. Category: Evolis. Subcategory: ID Card Printer. Price: 175,000৳.
",148,374144,374292
2695,sentence,"Subcategory: ID Card Printer. Price: 175,000৳.

Product: Evolis Avansia Dual-Sided ID Card Printer. Category: Evolis. Subcategory: ID Card Printer. Price: 600,000৳.
",165,374245,374410
2696,sentence,"Subcategory: ID Card Printer. Price: 600,000৳.

Product: Evolis Primacy Simplex Expert Card Printer. Category: Evolis. Subcategory: ID Card Printer. Price: Out Of Stock.
",170,374363,374533
2697,sentence,"Price: Out Of Stock.

Product: Zebra ZC300 Single-Sided ID Card Printer (Without Ribbon & Card). Category: Zebra. Subcategory: ID Card Printer. Price: Up Coming.
",162,374512,374674
2698,sentence,"Subcategory: ID Card Printer. Price: Up Coming.

Product: Zebra ZC300 Dual-Sided ID Card Printer (Without Ribbon & Card). Category: Zebra. Subcategory: ID Card Printer. Price: 97,000৳98,000৳.
",192,374626,374818
2699,sentence,"Price: 97,000৳98,000৳.

Product: Zebra ZC100 Single-Sided Card Printer (Without Ribbon & Card). Category: Zebra. Subcategory: ID Card Printer. Price: Up Coming.
",161,374795,374956
2700,sentence,"Subcategory: ID Card Printer. Price: Up Coming.

Product: Zebra ZXP Series 3 Single Sided ID Card Printer Without Ribbon & Card. Category: Zebra. Subcategory: ID Card Printer. Price: Out Of Stock.
",197,374908,375105
2701,sentence,"Price: Out Of Stock.

Product: Zebra ZXP Series 7 Card Printer (Single -Sided Printing, without Ribbon & Card). Category: Zebra. Subcategory: ID Card Printer. Price: Out Of Stock.
",180,375084,375264
2702,sentence,"Price: Out Of Stock.

Product: Epson EcoTank L3210 Multifunction InkTank Printer (Unofficial). Category: Epson. Subcategory: Printer. Price: 16,800৳17,000৳.
",157,375243,375400
2703,sentence,"Subcategory: Printer. Price: 16,800৳17,000৳.

Product: Epson EcoTank L3210 Multifunction InkTank Printer (Official). Category: Epson. Subcategory: Printer. Price: 17,000৳18,000৳.
",179,375355,375534
2704,sentence,"Subcategory: Printer. Price: 17,000৳18,000৳.

Product: Epson EcoTank M1120 Monochrome Wi-Fi Ink Tank Printer. Category: Epson. Subcategory: Printer. Price: 18,300৳19,500৳.
",172,375489,375661
2705,sentence,"Subcategory: Printer. Price: 18,300৳19,500৳.

Product: Epson EcoTank M1050 Monochrome Wi-Fi Ink Tank Printer. Category: Epson. Subcategory: Printer. Price: 19,500৳20,000৳.
",172,375616,375788
2706,sentence,"Subcategory: Printer. Price: 19,500৳20,000৳.

Product: Epson EcoTank L3250 A4 Wi-Fi Multifunction InkTank Printer (Unofficial). Category: Epson. Subcategory: Printer. Price: 19,800৳20,000৳.
",190,375743,375933
2707,sentence,"Subcategory: Printer. Price: 19,800৳20,000৳.

Product: Epson EcoTank L1250 A4 Wi-Fi Ink Tank Printer. Category: Epson. Subcategory: Printer. Price: 20,700৳21,000৳.
",164,375888,376052
2708,sentence,"Subcategory: Printer. Price: 20,700৳21,000৳.

Product: Epson EcoTank L3250 A4 Wi-Fi Multifunction InkTank Printer (Official). Category: Epson. Subcategory: Printer. Price: 21,000৳22,500৳.
",188,376007,376195
2709,sentence,"Subcategory: Printer. Price: 21,000৳22,500৳.

Product: Epson EcoTank M2050 Multifunction Monochrome Ink Tank Printer. Category: Epson. Subcategory: Printer. Price: 24,500৳27,500৳.
",180,376150,376330
2710,sentence,"Subcategory: Printer. Price: 24,500৳27,500৳.

Product: Epson EcoTank Monochrome M1170 Wi-Fi Inkjet Printer. Category: Epson. Subcategory: Printer. Price: 32,500৳33,000৳.
",170,376285,376455
2711,sentence,"Subcategory: Printer. Price: 32,500৳33,000৳.

Product: EPSON EcoTank Monochrome M2170 All-in-One Wi-Fi Duplex InkTank Printer. Category: Epson. Subcategory: Printer. Price: 32,500৳34,000৳.
",189,376410,376599
2712,sentence,"Subcategory: Printer. Price: 32,500৳34,000৳.

Product: Epson EcoTank L4260 A4 Wi-Fi Duplex All-in-One Ink Tank Printer. Category: Epson. Subcategory: Printer. Price: 39,500৳41,000৳.
",182,376554,376736
2713,sentence,"Subcategory: Printer. Price: 39,500৳41,000৳.

Product: Epson EcoTank L5290 A4 Wi-Fi All-in-One Ink Tank Printer with ADF. Category: Epson. Subcategory: Printer. Price: 44,000৳.
",177,376691,376868
2714,sentence,"Subcategory: Printer. Price: 44,000৳.

Product: Epson EcoTank L8050 WiFi Color Ink Tank Printer. Category: Epson. Subcategory: Printer. Price: 44,000৳.
",152,376830,376982
2715,sentence,"Subcategory: Printer. Price: 44,000৳.

Product: Epson EcoTank L6460 A4 All-in-One Ink Tank Printer. Category: Epson. Subcategory: Printer. Price: 45,000৳.
",155,376944,377099
2716,sentence,"Subcategory: Printer. Price: 45,000৳.

Product: Epson EcoTank L6490 A4 All-in-One Ink Tank Printer. Category: Epson. Subcategory: Printer. Price: Out Of Stock.
",160,377061,377221
2717,sentence,"Subcategory: Printer. Price: Out Of Stock.

Product: Epson EcoTank L6270 A4 Wi-Fi All-in-One Ink Tank Printer with ADF. Category: Epson. Subcategory: Printer. Price: 50,000৳52,000৳.
",182,377178,377360
2718,sentence,"Subcategory: Printer. Price: 50,000৳52,000৳.

Product: Epson EcoTank L11050 A3 Wi-Fi Ink Tank Printer. Category: Epson. Subcategory: Printer. Price: 59,000৳62,000৳.
",165,377315,377480
2719,sentence,"Subcategory: Printer. Price: 59,000৳62,000৳.

Product: Epson EcoTank L14150 (A3) Multifunction Ink Tank Printer with Duplex & Wi-Fi. Category: Epson. Subcategory: Printer. Price: 67,000৳71,000৳.
",195,377435,377630
2720,sentence,"Subcategory: Printer. Price: 67,000৳71,000৳.

Product: Deli ES421 Thermal POS Receipt Printer. Category: Deli. Subcategory: POS Printer. Price: 3,000৳.
",152,377585,377737
2721,sentence,"Subcategory: POS Printer. Price: 3,000৳.

Product: Deli ES420 Thermal POS Receipt Printer. Category: Deli. Subcategory: POS Printer. Price: 3,100৳.

Product: Deli ES302 Thermal Receipt POS Printer. ",198,377696,377894
2722,sentence,"Category: Deli. Subcategory: POS Printer. Price: 9,500৳.

Product: Deli E801PN Direct Thermal Receipt Printer. Category: Deli. Subcategory: POS Printer. Price: 9,000৳12,000৳.
",175,377894,378069
2723,sentence,"Subcategory: POS Printer. Price: 9,000৳12,000৳.

Product: Deli DL-801PS Thermal Receipt Printer. Category: Deli. Subcategory: POS Printer. Price: Up Coming.
",157,378021,378178
2724,sentence,"Subcategory: POS Printer. Price: Up Coming.

Product: Deli DL-581PS Thermal Receipt Printer. Category: Deli. Subcategory: POS Printer. Price: Out Of Stock.

Product: Deli DL-581WPS Receipt Printer. ",198,378134,378332
2725,sentence,"
Product: Deli DL-581WPS Receipt Printer. Category: Deli. Subcategory: POS Printer. Price: Out Of Stock.

Product: Epson TM-U220IIB Dot Matrix Receipt Printer. Category: Epson. ",177,378290,378467
2726,sentence,"Category: Epson. Subcategory: POS Printer. Price: 30,500৳.

Product: Epson TM-T81III POS Printer With USB Port. Category: Epson. Subcategory: POS Printer. Price: 14,500৳15,000৳.
",178,378450,378628
2727,sentence,"Price: 14,500৳15,000৳.

Product: Epson TM-T81III POS Printer with Ethernet Port. Category: Epson. Subcategory: POS Printer. Price: 14,800৳15,000৳.

Product: EPSON TM-U220A IMPACT POS PRINTER. ",192,378605,378797
2728,sentence,"
Product: EPSON TM-U220A IMPACT POS PRINTER. Category: Epson. Subcategory: POS Printer. Price: Up Coming.

Product: Epson TM U220B USB POS Printer. Category: Epson. Subcategory: POS Printer. ",191,378752,378943
2729,sentence,"Category: Epson. Subcategory: POS Printer. Price: 27,000৳27,500৳.

Product: Epson TM-T82 Thermal POS Receipt Printer. Category: Epson. Subcategory: POS Printer. Price: Out Of Stock.
",182,378900,379082
2730,sentence,"Subcategory: POS Printer. Price: Out Of Stock.

Product: Rongta RPP02C 58mm Mobile POS Printer. Category: RONGTA. Subcategory: POS Printer. Price: 3,500৳4,000৳.
",161,379035,379196
2731,sentence,"Subcategory: POS Printer. Price: 3,500৳4,000৳.

Product: Rongta RP582 58mm Thermal Receipt Printer. Category: RONGTA. Subcategory: POS Printer. Price: 3,500৳4,000৳.
",165,379149,379314
2732,sentence,"Subcategory: POS Printer. Price: 3,500৳4,000৳.

Product: Rongta RP58E-U POS Thermal Receipt Printer. Category: RONGTA. Subcategory: POS Printer. Price: 4,000৳4,200৳.
",166,379267,379433
2733,sentence,"Subcategory: POS Printer. Price: 4,000৳4,200৳.

Product: Rongta RP335 Thermal POS Printer. Category: RONGTA. Subcategory: POS Printer. Price: 5,800৳6,500৳.
",156,379386,379542
2734,sentence,"Subcategory: POS Printer. Price: 5,800৳6,500৳.

Product: Rongta RP336-U Thermal POS Receipt Printer. Category: RONGTA. Subcategory: POS Printer. Price: 6,200৳7,000৳.
",166,379495,379661
2735,sentence,"Subcategory: POS Printer. Price: 6,200৳7,000৳.

Product: Rongta RPP300BU 80mm Thermal POS Printer. Category: RONGTA. Subcategory: POS Printer. Price: 7,000৳7,200৳.
",164,379614,379778
2736,sentence,"Subcategory: POS Printer. Price: 7,000৳7,200৳.

Product: Rongta RP328-USE Thermal Receipt Printer. Category: RONGTA. Subcategory: POS Printer. Price: 7,000৳7,500৳.
",164,379731,379895
2737,sentence,"Subcategory: POS Printer. Price: 7,000৳7,500৳.

Product: Rongta RP336-UE Thermal POS Receipt Printer. Category: RONGTA. Subcategory: POS Printer. Price: 6,700৳7,500৳.
",167,379848,380015
2738,sentence,"Subcategory: POS Printer. Price: 6,700৳7,500৳.

Product: Rongta RP328-BU Thermal Receipt Printer (Bluetooth + USB). Category: RONGTA. Subcategory: POS Printer. Price: 8,500৳.
",175,379968,380143
2739,sentence,"Subcategory: POS Printer. Price: 8,500৳.

Product: Rongta RP330-USE Thermal Pos Printer. Category: RONGTA. Subcategory: POS Printer. Price: 9,000৳9,500৳.
",154,380102,380256
2740,sentence,"Subcategory: POS Printer. Price: 9,000৳9,500৳.

Product: Rongta RP80 IV-USE-G / RP804-USE POS Printer. Category: RONGTA. Subcategory: POS Printer. Price: 10,000৳10,500৳.
",170,380209,380379
2741,sentence,"Price: 10,000৳10,500৳.

Product: Rongta RP850-USE 300mm/s Thermal Receipt Printer. Category: RONGTA. Subcategory: POS Printer. Price: 9,800৳11,500৳.
",149,380356,380505
2742,sentence,"Subcategory: POS Printer. Price: 9,800৳11,500৳.

Product: Rongta RP327-UP Thermal Receipt Printer. Category: RONGTA. Subcategory: POS Printer. Price: 8,000৳8,200৳.
",164,380457,380621
2743,sentence,"Subcategory: POS Printer. Price: 8,000৳8,200৳.

Product: Rongta RP327-USE Thermal Receipt Printer. Category: RONGTA. Subcategory: POS Printer. Price: Up Coming.
",161,380574,380735
2744,sentence,"Subcategory: POS Printer. Price: Up Coming.

Product: Rongta RPP200BU 56mm Thermal POS Printer. Category: RONGTA. Subcategory: POS Printer. Price: Up Coming.
",158,380691,380849
2745,sentence,"Subcategory: POS Printer. Price: Up Coming.

Product: Rongta RP80 (USEB-Version) Thermal Pos Printer Black (USB/Serial/Ethernet/Bluetooth). Category: RONGTA. Subcategory: POS Printer. ",184,380805,380989
2746,sentence,"Category: RONGTA. Subcategory: POS Printer. Price: Out Of Stock.

Product: Rongta RP80IV Thermal POS Printer. Category: RONGTA. Subcategory: POS Printer. Price: Out Of Stock.
",175,380945,381120
2747,sentence,"Subcategory: POS Printer. Price: Out Of Stock.

Product: HP Smart Tank 520 All-in-One Color Ink Printer. Category: HP. Subcategory: Printer. Price: 17,000৳18,300৳.
",164,381073,381237
2748,sentence,"Subcategory: Printer. Price: 17,000৳18,300৳.

Product: HP Laserjet MFP 1188a Multifunction Mono Laser Printer. Category: HP. Subcategory: Printer. Price: 18,700৳19,500৳.
",170,381192,381362
2749,sentence,"Subcategory: Printer. Price: 18,700৳19,500৳.

Product: HP Smart Tank 580 Multifunction Wi-Fi All-in-One Color Ink Printer. Category: HP. Subcategory: Printer. Price: 18,700৳20,000৳.
",182,381317,381499
2750,sentence,"Subcategory: Printer. Price: 18,700৳20,000৳.

Product: HP LaserJet M211d Single Function Mono Laser Printer. Category: HP. Subcategory: Printer. Price: 22,500৳23,500৳.
",168,381454,381622
2751,sentence,"Subcategory: Printer. Price: 22,500৳23,500৳.

Product: HP Laserjet MFP 1188w Multifunction Mono Laser Printer. Category: HP. Subcategory: Printer. Price: 22,500৳.
",163,381577,381740
2752,sentence,"Subcategory: Printer. Price: 22,500৳.

Product: HP Laser MFP 135w Multifunction Mono Laser Printer. Category: HP. Subcategory: Printer. Price: 28,300৳28,500৳.
",159,381702,381861
2753,sentence,"Subcategory: Printer. Price: 28,300৳28,500৳.

Product: HP LaserJet Pro 4003dn Single Function Mono Laser Printer. Category: HP. Subcategory: Printer. Price: 26,800৳27,000৳.
",173,381816,381989
2754,sentence,"Subcategory: Printer. Price: 26,800৳27,000৳.

Product: HP Smart Tank 670 Wi-Fi Duplexer All-in-One Color Printer. Category: HP. Subcategory: Printer. Price: 29,000৳30,500৳.
",173,381944,382117
2755,sentence,"Subcategory: Printer. Price: 29,000৳30,500৳.

Product: HP Laser MFP 137fnw Multifunction Mono Laser Printer. Category: HP. Subcategory: Printer. Price: 29,000৳.
",161,382072,382233
2756,sentence,"Subcategory: Printer. Price: 29,000৳.

Product: HP LaserJet Pro 4003dw Single Function Mono Laser Printer. Category: HP. Subcategory: Printer. Price: 34,000৳35,000৳.
",166,382195,382361
2757,sentence,"Subcategory: Printer. Price: 34,000৳35,000৳.

Product: HP Smart Tank 750 Wi-Fi Duplexer All-in-One Color Printer. Category: HP. Subcategory: Printer. Price: 35,000৳36,000৳.
",173,382316,382489
2758,sentence,"Subcategory: Printer. Price: 35,000৳36,000৳.

Product: HP Color Laser 150a Single Function Color Laser Printer. Category: HP. Subcategory: Printer. Price: 36,800৳38,000৳.
",171,382444,382615
2759,sentence,"Subcategory: Printer. Price: 36,800৳38,000৳.

Product: HP Color LaserJet Pro M255nw Single Function A4 Color Laser Printer. Category: HP. Subcategory: Printer. Price: 37,000৳40,000৳.
",183,382570,382753
2760,sentence,"Subcategory: Printer. Price: 37,000৳40,000৳.

Product: HP Color LaserJet Pro M255DW Single Function A4 Color Laser Printer. Category: HP. Subcategory: Printer. Price: 47,000৳48,000৳.
",183,382708,382891
2761,sentence,"Subcategory: Printer. Price: 47,000৳48,000৳.

Product: HP LaserJet Pro MFP M227fdw Multifunction Mono Laser Printer. Category: HP. Subcategory: Printer. Price: 48,000৳49,000৳.
",176,382846,383022
2762,sentence,"Subcategory: Printer. Price: 48,000৳49,000৳.

Product: BM58E Portable Bluetooth Thermal POS Printer. Category: POS Printer. Price: 4,500৳.

Product: Xprinter XP-Q890K Thermal Receipt Printer. ",192,382977,383169
2763,sentence,"Category: POS Printer. Price: Up Coming.

Product: Xprinter XP-E260L Thermal POS Printer. Category: POS Printer. Price: Up Coming.

Product: Xprinter XP-P502A Wireless Thermal Receipt Printer. ",193,383169,383362
2764,sentence,"Category: POS Printer. Price: Up Coming.

Product: Xprinter XP-58IIL Mini Thermal Direct Receipt POS Printer. Category: POS Printer. Price: 4,500৳.

Product: Xprinter XP80T Thermal Receipt Printer. ",198,383362,383560
2765,sentence,"Category: POS Printer. Price: 6,500৳.

Product: Xprinter XP-P210 Mobile Receipt Direct Thermal Label & POS Printer. Category: POS Printer. Price: 7,000৳.
",154,383560,383714
2766,sentence,"Category: POS Printer. Price: 7,000৳.

Product: Xprinter XP-K200L Thermal POS Printer. Category: POS Printer. Price: 7,500৳.

Product: Xprinter XP-A160H 80mm Thermal POS Printer. ",179,383676,383855
2767,sentence,"Category: POS Printer. Price: 7,000৳.

Product: G-Printer GP-C80180II 80mm Thermal Receipt Printer. Category: POS Printer. Price: 7,500৳.
",138,383855,383993
2768,sentence,"Category: POS Printer. Price: 7,500৳.

Product: Sewoo SLK-TS400 POS Thermal Receipt Printer (With Lan). Category: Sewoo. Subcategory: POS Printer. Price: 17,500৳.
",163,383955,384118
2769,sentence,"Subcategory: POS Printer. Price: 17,500৳.

Product: Sewoo SLK-TE213 3-inch Direct Thermal POS Printer. Category: Sewoo. Subcategory: POS Printer. Price: 22,000৳.
",162,384076,384238
2770,sentence,"Subcategory: POS Printer. Price: 22,000৳.

Product: Sewoo LKP21 Wireless POS Printer. Category: Sewoo. Subcategory: POS Printer. Price: 27,000৳.

Product: Sewoo LK-Tl200 Thermal POS Printer. ",191,384196,384387
2771,sentence,"
Product: Sewoo LK-Tl200 Thermal POS Printer. Category: Sewoo. Subcategory: POS Printer. Price: Up Coming.

Product: Sewoo SLK-TL210 POS Printer. Category: Sewoo. Subcategory: POS Printer. ",189,384341,384530
2772,sentence,"Category: Sewoo. Subcategory: POS Printer. Price: Up Coming.

Product: Sewoo SLK-TE212 3-inch Direct Thermal POS Printer. Category: Sewoo. Subcategory: POS Printer. Price: Out Of Stock.
",186,384487,384673
2773,sentence,"Subcategory: POS Printer. Price: Out Of Stock.

Product: SEWOO SLK-TS100 Direct Thermal POS Printer. Category: Sewoo. Subcategory: POS Printer. Price: Out Of Stock.
",165,384626,384791
2774,sentence,"Subcategory: POS Printer. Price: Out Of Stock.

Product: Sewoo SLK-TS400 POS Thermal Receipt Printer (With out Lan). Category: Sewoo. Subcategory: POS Printer. Price: Out Of Stock.
",181,384744,384925
2775,sentence,"Subcategory: POS Printer. Price: Out Of Stock.

Product: Xprinter XP-P810 Direct Thermal Portable POS Printer. Category: Xprinter. Subcategory: POS Printer. Price: 8,350৳8,500৳.
",178,384878,385056
2776,sentence,"Subcategory: POS Printer. Price: 8,350৳8,500৳.

Product: Xprinter XP-365B Thermal Label & POS Printer. Category: Xprinter. Subcategory: POS Printer. Price: 7,800৳8,500৳.
",170,385009,385179
2777,sentence,"Subcategory: POS Printer. Price: 7,800৳8,500৳.

Product: Xprinter XP-E260M Thermal POS Printer. Category: Xprinter. Subcategory: POS Printer. Price: 8,500৳8,800৳.
",163,385132,385295
2778,sentence,"Subcategory: POS Printer. Price: 8,500৳8,800৳.

Product: Xprinter XP-P3301B Direct Thermal Portable Mobile POS & Label Printer. Category: Xprinter. Subcategory: POS Printer. Price: 8,850৳.
",189,385248,385437
2779,sentence,"Subcategory: POS Printer. Price: 8,850৳.

Product: Xprinter XP-E300M Thermal POS Printer. Category: Xprinter. Subcategory: POS Printer. Price: 10,000৳.
",152,385396,385548
2780,sentence,"Subcategory: POS Printer. Price: 10,000৳.

Product: Xprinter XP-350BM Direct Thermal Barcode Label & POS Printer. Category: Xprinter. Subcategory: POS Printer. Price: 11,000৳11,300৳.
",183,385506,385689
2781,sentence,"Price: 11,000৳11,300৳.

Product: Xprinter XP-V330N Thermal Receipt Printer. Category: Xprinter. Subcategory: POS Printer. Price: Out Of Stock.

Product: Xprinter XP-E200M Thermal POS Printer. ",192,385666,385858
2782,sentence,"
Product: Xprinter XP-E200M Thermal POS Printer. Category: Xprinter. Subcategory: POS Printer. Price: Out Of Stock.

Product: SPRT SP-POS891 POS Printer. Category: SPRT. Subcategory: POS Printer. ",196,385809,386005
2783,sentence,"Category: SPRT. Subcategory: POS Printer. Price: 12,000৳.

Product: SPRT SP-POS890W Thermal POS Printer. Category: SPRT. Subcategory: POS Printer. Price: 14,500৳.
",163,385963,386126
2784,sentence,"Subcategory: POS Printer. Price: 14,500৳.

Product: SPRT SP-TL51 Low Cost Label Printer. Category: SPRT. Subcategory: POS Printer. Price: Out Of Stock.
",152,386084,386236
2785,sentence,"Subcategory: POS Printer. Price: Out Of Stock.

Product: Sunmi V2s POS Terminal (2GB+16GB+NFC+Label). Category: Sunmi. Subcategory: POS Printer. Price: 28,000৳.
",161,386189,386350
2786,sentence,"Subcategory: POS Printer. Price: 28,000৳.

Product: Sunmi V3 MIX Smart Android POS Terminal. Category: Sunmi. Subcategory: POS Printer. Price: 45,000৳.
",152,386308,386460
2787,sentence,"Subcategory: POS Printer. Price: 45,000৳.

Product: Sunmi V2s POS Terminal WIth NFC (2GB +16GB). Category: Sunmi. Subcategory: POS Printer. Price: 30,000৳.
",156,386418,386574
2788,sentence,"Subcategory: POS Printer. Price: 30,000৳.

Product: Sunmi V3 Family Smart Android POS Terminal. Category: Sunmi. Subcategory: POS Printer. Price: 30,000৳.
",155,386532,386687
2789,sentence,"Subcategory: POS Printer. Price: 30,000৳.

Product: Sunmi L2s Pro T8920 5.5"" HD+ Smart Mobile POS Terminal. Category: Sunmi. Subcategory: POS Printer. Price: 34,500৳.
",167,386645,386812
2790,sentence,"Subcategory: POS Printer. Price: 34,500৳.

Product: Sunmi V2s Plus T5F01 GMS (NFC + Label) Handheld POS Terminal. Category: Sunmi. Subcategory: POS Printer. Price: 38,000৳.
",173,386770,386943
2791,sentence,"Subcategory: POS Printer. Price: 38,000৳.

Product: Sunmi V2s Plus NFC Android POS Terminal with Scanner. Category: Sunmi. Subcategory: POS Printer. Price: 39,500৳.
",165,386901,387066
2792,sentence,"Subcategory: POS Printer. Price: 39,500৳.

Product: Sunmi D2s 15.6"" FHD Display POS Terminal. Category: Sunmi. Subcategory: POS Printer. Price: 45,000৳.
",153,387024,387177
2793,sentence,"Subcategory: POS Printer. Price: 45,000৳.

Product: Sunmi L2H T8911 5.5"" HD Touch Smart Mobile POS Terminal. Category: Sunmi. Subcategory: POS Printer. Price: 50,500৳.
",168,387135,387303
2794,sentence,"Subcategory: POS Printer. Price: 50,500৳.

Product: Sunmi T2s Lite 15.6"" FHD and 10.1"" HD Touch POS Terminal. Category: Sunmi. Subcategory: POS Printer. Price: 62,000৳.
",169,387261,387430
2795,sentence,"Subcategory: POS Printer. Price: 62,000৳.

Product: Sunmi T2 15.6""+10.1"" FHD Touch POS terminal with Printer. Category: Sunmi. Subcategory: POS Printer. Price: 67,000৳.
",169,387388,387557
2796,sentence,"Subcategory: POS Printer. Price: 67,000৳.

Product: Sunmi T2 15.6""+15.6"" FHD Touch POS terminal with Printer. Category: Sunmi. Subcategory: POS Printer. Price: 77,000৳.
",169,387515,387684
2797,sentence,"Subcategory: POS Printer. Price: 77,000৳.

Product: Sunmi D2s Plus Combo 15.6"" FHD and 10.1 Inch HD Touch Display POS Terminal. Category: Sunmi. Subcategory: POS Printer. Price: 82,000৳.
",187,387642,387829
2798,sentence,"Subcategory: POS Printer. Price: 82,000৳.

Product: SUNMI L2Ks T8A10 4 Inch Smart Mobile POS Terminal (4+32+Scanner). Category: Sunmi. Subcategory: POS Printer. Price: Call for Price.
",184,387787,387971
2799,sentence,"Price: Call for Price.

Product: Sunmi V2 Pro Android Handheld POS Terminal with Printer 2GB+16GB. Category: Sunmi. Subcategory: POS Printer. Price: Up Coming.
",160,387948,388108
2800,sentence,"Subcategory: POS Printer. Price: Up Coming.

Product: Sunmi V2 T5930 Android Handheld POS Terminal. Category: Sunmi. Subcategory: POS Printer. Price: Up Coming.
",161,388064,388225
2801,sentence,"Subcategory: POS Printer. Price: Up Coming.

Product: Sunmi V2s T5940 Label & Scanner 5.5 Inch HD+ Touch Handheld POS Terminal. Category: Sunmi. Subcategory: POS Printer. Price: Up Coming.
",189,388181,388370
2802,sentence,"Subcategory: POS Printer. Price: Up Coming.

Product: Sunmi V2s T5940 Label & NFC 3GB RAM 16GB ROM POS Terminal. Category: Sunmi. Subcategory: POS Printer. Price: Up Coming.
",174,388326,388500
2803,sentence,"Subcategory: POS Printer. Price: Up Coming.

Product: Sunmi T2 L1523 EPOS 15.6 Inch FHD Touch Display Dual POS Terminal. Category: Sunmi. Subcategory: POS Printer. Price: Up Coming.
",182,388456,388638
2804,sentence,"Subcategory: POS Printer. Price: Up Coming.

Product: Sunmi V2 Pro Android Handheld POS Terminal with Printer 1GB+8GB. Category: Sunmi. Subcategory: POS Printer. Price: Out Of Stock.
",183,388594,388777
2805,sentence,"Subcategory: POS Printer. Price: Out Of Stock.

Product: G-Printer GP-3120TU Barcode Thermal Label & POS Printer. Category: G-Printer. Subcategory: Label Printer. Price: 7,800৳.
",178,388730,388908
2806,sentence,"Subcategory: Label Printer. Price: 7,800৳.

Product: G-Printer GP-1324D Direct Barcode Thermal Label Printer. Category: G-Printer. Subcategory: Label Printer. Price: 14,000৳15,000৳.
",182,388865,389047
2807,sentence,"Price: 14,000৳15,000৳.

Product: G-printer GP-1224T Barcode Label Printer. Category: G-Printer. Subcategory: Label Printer. Price: 18,500৳20,000৳.
",147,389024,389171
2808,sentence,"Price: 18,500৳20,000৳.

Product: Citizen CT-D150 Thermal Receipt POS Printer. Category: Citizen. Subcategory: POS Printer. Price: 15,000৳.

Product: Citizen CL-E321XUBNNA Barcode Label Printer. ",194,389148,389342
2809,sentence,"Category: Citizen. Subcategory: POS Printer. Price: 37,000৳.

Product: Zebra ZD230TA Desktop Label Printer With 4 Inch, 203dpi. Category: Zebra. Subcategory: Label Printer. Price: Up Coming.
",191,389342,389533
2810,sentence,"Subcategory: Label Printer. Price: Up Coming.

Product: Zebra GK888T Desktop Label Printer. Category: Zebra. Subcategory: Label Printer. Price: 21,000৳.

Product: Zebra GT820 Barcode Label Printer. ",198,389487,389685
2811,sentence,"
Product: Zebra GT820 Barcode Label Printer. Category: Zebra. Subcategory: Label Printer. Price: Out Of Stock.

Product: Zebra ZT230 Barcode Label Printer. Category: Zebra. ",173,389640,389813
2812,sentence,"Category: Zebra. Subcategory: Label Printer. Price: 75,000৳80,000৳.

Product: Zebra ZT231 300 dpi Industrial Barcode Label Printer. Category: Zebra. Subcategory: Label Printer. Price: 103,000৳.
",194,389796,389990
2813,sentence,"Subcategory: Label Printer. Price: 103,000৳.

Product: Zebra ZT411 Industrial Barcode Label Printer. Category: Zebra. Subcategory: Label Printer. Price: 155,000৳.
",163,389945,390108
2814,sentence,"Subcategory: Label Printer. Price: 155,000৳.

Product: Zebra ZT421 203 dpi Industrial Barcode Label Printer. Category: Zebra. Subcategory: Label Printer. Price: Up Coming.
",172,390063,390235
2815,sentence,"Subcategory: Label Printer. Price: Up Coming.

Product: Zebra ZT421 300 dpi Industrial Barcode Label Printer. Category: Zebra. Subcategory: Label Printer. Price: Up Coming.
",173,390189,390362
2816,sentence,"Subcategory: Label Printer. Price: Up Coming.

Product: Zebra ZT231 203 dpi Industrial Barcode Label Printer. Category: Zebra. Subcategory: Label Printer. Price: Up Coming.
",173,390316,390489
2817,sentence,"Subcategory: Label Printer. Price: Up Coming.

Product: Zebra ZT230 Barcode Label Printer (300 DPI). Category: Zebra. Subcategory: Label Printer. Price: Out Of Stock.
",167,390443,390610
2818,sentence,"Price: Out Of Stock.

Product: Zebra ZT411 Industrial Barcode Label Printer(203 DPI). Category: Zebra. Subcategory: Label Printer. Price: Out Of Stock.
",152,390589,390741
2819,sentence,"Price: Out Of Stock.

Product: Zebra ZT510 300 dpi Industrial Label Printer. Category: Zebra. Subcategory: Label Printer. Price: 195,000৳.

Product: Zebra ZT420 Industrial Label Printer. ",187,390720,390907
2820,sentence,"
Product: Zebra ZT420 Industrial Label Printer. Category: Zebra. Subcategory: Label Printer. Price: Out Of Stock.

Product: TSC TTP-384MT A4 Barcode Label Printer. Category: TSC. ",179,390859,391038
2821,sentence,"Category: TSC. Subcategory: Label Printer. Price: 375,000৳.

Product: Sewoo LK-B24 Label Printer. Category: Sewoo. Subcategory: Label Printer. Price: 32,500৳.

Product: Sewoo LK-B20 Label Printer. ",197,391023,391220
2822,sentence,"
Product: Sewoo LK-B20 Label Printer. Category: Sewoo. Subcategory: Label Printer. Price: 38,000৳.

Product: G-Printer GP-D802 80mm Thermal Receipt Printer. Category: G-Printer. ",178,391182,391360
2823,sentence,"Category: G-Printer. Subcategory: POS Printer. Price: 12,000৳.

Product: Deli E581PW Thermal Receipt Printer. Category: Deli. Subcategory: Label Printer. Price: 4,300৳.
",169,391339,391508
2824,sentence,"Subcategory: Label Printer. Price: 4,300৳.

Product: Deli E886BW Receipt & Label Printer. Category: Deli. Subcategory: Label Printer. Price: 9,500৳.
",149,391465,391614
2825,sentence,"Subcategory: Label Printer. Price: 9,500৳.

Product: Deli ES351 Direct Thermal Transfer Label Printer. Category: Deli. Subcategory: Label Printer. Price: 17,500৳.
",163,391571,391734
2826,sentence,"Subcategory: Label Printer. Price: 17,500৳.

Product: Deli E720C Thermal Transfer Label Printer. Category: Deli. Subcategory: Label Printer. Price: Out Of Stock.
",162,391690,391852
2827,sentence,"Price: Out Of Stock.

Product: Deli E740C Thermal Label Printer. Category: Deli. Subcategory: Label Printer. Price: Out Of Stock.
",130,391831,391961
2828,sentence,"Price: Out Of Stock.

Product: Rongta RP80VI/RP80VI-USE 6 inch/sec High Printing Speed Label Barcode Printer. Category: Rongta. Subcategory: Label Printer. Price: 10,900৳11,200৳.
",179,391940,392119
2829,sentence,"Price: 10,900৳11,200৳.

Product: Rongta RP400H 4-inch Thermal Transfer Barcode Label Printer. Category: Rongta. Subcategory: Label Printer. Price: 12,300৳13,000৳.
",163,392096,392259
2830,sentence,"Price: 12,300৳13,000৳.

Product: Rongta RPW215 Commercial Label Wristband Printer. Category: Rongta. Subcategory: Label Printer. Price: 29,000৳.

Product: Brother PT-E110VP Handheld Label Printer. ",197,392236,392433
2831,sentence,"Category: Brother. Subcategory: Label Printer. Price: 8,500৳8,800৳.

Product: Brother PT-D410 Desktop Label Printer. Category: Brother. Subcategory: Label Printer. Price: 10,000৳10,500৳.
",187,392433,392620
2832,sentence,"Price: 10,000৳10,500৳.

Product: Brother QL-800 Professional Label Printer. Category: Brother. Subcategory: Label Printer. Price: Up Coming.
",141,392597,392738
2833,sentence,"Subcategory: Label Printer. Price: Up Coming.

Product: Brother QL-820NWB Ultra Flexible Professional Label Printer. Category: Brother. Subcategory: Label Printer. Price: Out Of Stock.
",185,392692,392877
2834,sentence,"Price: Out Of Stock.

Product: Brother PT-P900W Lebel Printer. Category: Brother. Subcategory: Label Printer. Price: Out Of Stock.

Product: Bixolon SRP-E302 Thermal Receipt Printer. ",183,392856,393039
2835,sentence,"Category: Bixolon. Subcategory: POS Printer. Price: 13,500৳.

Product: Bixolon SRP-350II Thermal POS Printer. Category: Bixolon. Subcategory: POS Printer. Price: Up Coming.
",173,393039,393212
2836,sentence,"Subcategory: POS Printer. Price: Up Coming.

Product: Xprinter XP-420B Thermal Barcode Printer. Category: Label Printer. Price: 10,000৳.
",137,393168,393305
2837,sentence,"Category: Label Printer. Price: 10,000৳.

Product: Xprinter XP-TT424B Thermal Transfer Barcode Label Printer. Category: Label Printer. Price: 15,000৳15,500৳.
",158,393264,393422
2838,sentence,"Category: Label Printer. Price: 15,000৳15,500৳.

Product: Xprinter XP-T451B Thermal Transfer Label Printer. Category: Label Printer. Price: 14,000৳.
",149,393374,393523
2839,sentence,"Category: Label Printer. Price: 14,000৳.

Product: Xprinter XP-T261B 2 Inch Wristband Label Printer. Category: Label Printer. Price: 23,000৳25,000৳.
",149,393482,393631
2840,sentence,"Category: Label Printer. Price: 23,000৳25,000৳.

Product: Xprinter XP-G480E 4-Inch Industrial Label Printer. Category: Xprinter. Subcategory: Label Printer. Price: 90,000৳.
",173,393583,393756
2841,sentence,"Subcategory: Label Printer. Price: 90,000৳.

Product: M10 Inkjet Handheld Printer. Category: Others. Subcategory: Label Printer. Price: 28,500৳.
",145,393712,393857
2842,sentence,"Subcategory: Label Printer. Price: 28,500৳.

Product: Toshiba MR-3032 Automatic Document Feeder (RADF). Category: Toshiba. Subcategory: Photocopier. Price: 32,000৳33,000৳.
",172,393813,393985
2843,sentence,"Price: 32,000৳33,000৳.

Product: Toshiba e-Studio 2523A A3 Multifunction Digital Photocopier. Category: Toshiba. Subcategory: Photocopier. Price: 44,000৳46,000৳.
",162,393962,394124
2844,sentence,"Price: 44,000৳46,000৳.

Product: Toshiba MR-3033C Automatic Document Feeder (RADF). Category: Toshiba. Subcategory: Photocopier. Price: 49,000৳52,000৳.
",152,394101,394253
2845,sentence,"Price: 49,000৳52,000৳.

Product: Toshiba e-Studio 2323AMW Multifunction Monochrome Photocopier. Category: Toshiba. Subcategory: Photocopier. Price: 55,500৳58,500৳.
",164,394230,394394
2846,sentence,"Price: 55,500৳58,500৳.

Product: Toshiba e-Studio 2523AD Duplex Multifunction Photocopier. Category: Toshiba. Subcategory: Photocopier. Price: 55,000৳59,000৳.
",159,394371,394530
2847,sentence,"Price: 55,000৳59,000৳.

Product: Toshiba e-Studio 2020AC Multifunction Digital Color Photocopier. Category: Toshiba. Subcategory: Photocopier. Price: 106,000৳110,000৳.
",168,394507,394675
2848,sentence,"Price: 106,000৳110,000৳.

Product: Toshiba e-Studio 2021AC Multifunctional A3 Color Photocopier. Category: Toshiba. Subcategory: Photocopier. Price: 110,000৳115,000৳.
",167,394650,394817
2849,sentence,"Price: 110,000৳115,000৳.

Product: Toshiba e-Studio 2528A Multifunction Digital Photocopier. Category: Toshiba. Subcategory: Photocopier. Price: 149,000৳157,000৳.
",163,394792,394955
2850,sentence,"Price: 149,000৳157,000৳.

Product: Toshiba e-Studio 3028A Multifunction Digital Photocopier. Category: Toshiba. Subcategory: Photocopier. Price: 190,000৳195,000৳.
",163,394930,395093
2851,sentence,"Price: 190,000৳195,000৳.

Product: Toshiba e-studio 4528A Multifunction Photocopier with RADF. Category: Toshiba. Subcategory: Photocopier. Price: 365,000৳370,000৳.
",165,395068,395233
2852,sentence,"Price: 365,000৳370,000৳.

Product: Toshiba e-Studio 2323AMS Multifunctional Monochrome Photocopier. Category: Toshiba. Subcategory: Photocopier. Price: Up Coming.
",163,395208,395371
2853,sentence,"Subcategory: Photocopier. Price: Up Coming.

Product: Toshiba e-Studio 2823AM Photocopier. Category: Toshiba. Subcategory: Photocopier. Price: Up Coming.
",154,395327,395481
2854,sentence,"Subcategory: Photocopier. Price: Up Coming.

Product: Toshiba e-Studio 2520AC Multifunction Digital Color Photocopier. Category: Toshiba. Subcategory: Photocopier. Price: Up Coming.
",182,395437,395619
2855,sentence,"Subcategory: Photocopier. Price: Up Coming.

Product: Toshiba e-Studio 3528A Multifunction Digital Photocopier. Category: Toshiba. Subcategory: Photocopier. Price: Up Coming.
",175,395575,395750
2856,sentence,"Subcategory: Photocopier. Price: Up Coming.

Product: Toshiba e-studio 4618a Multifunction Photocopier. Category: Toshiba. Subcategory: Photocopier. Price: Up Coming.
",167,395706,395873
2857,sentence,"Subcategory: Photocopier. Price: Up Coming.

Product: Toshiba e-Studio 3025AC Multifunction Digital Color Photocopier. Category: Toshiba. Subcategory: Photocopier. Price: Up Coming.
",182,395829,396011
2858,sentence,"Subcategory: Photocopier. Price: Up Coming.

Product: Toshiba e-Studio 5528A Multifunctional Monochrome Photocopier With RADF. Category: Toshiba. Subcategory: Photocopier. Price: Up Coming.
",190,395967,396157
2859,sentence,"Subcategory: Photocopier. Price: Up Coming.

Product: Toshiba e-Studio 2323AM Multi-Function Duplex Copier. Category: Toshiba. Subcategory: Photocopier. Price: Out Of Stock.
",174,396113,396287
2860,sentence,"Subcategory: Photocopier. Price: Out Of Stock.

Product: Toshiba e-Studio 2823AMW Multifunction Monochrome Photocopier. Category: Toshiba. Subcategory: Photocopier. Price: Out Of Stock.
",186,396240,396426
2861,sentence,"Subcategory: Photocopier. Price: Out Of Stock.

Product: Toshiba e-Studio 6528A Duplex Photocopier Machine With RADF. Category: Toshiba. Subcategory: Photocopier. Price: Out Of Stock.
",184,396379,396563
2862,sentence,"Subcategory: Photocopier. Price: Out Of Stock.

Product: GoDEX G500 Thermal Transfer Label Printer. Category: GoDEX. Subcategory: Label Printer. Price: 28,000৳29,000৳.
",168,396516,396684
2863,sentence,"Price: 28,000৳29,000৳.

Product: GoDEX G530 Thermal Transfer Label Printer. Category: GoDEX. Subcategory: Label Printer. Price: 43,000৳.

Product: RICOH MP 2014 Multifunction Copier. ",183,396661,396844
2864,sentence,"
Product: RICOH MP 2014 Multifunction Copier. Category: Photocopier. Price: 56,000৳60,500৳.

Product: Sharp AR-7024 Multifunctional Photocopier. Category: Photocopier. Price: 63,500৳67,000৳.
",191,396798,396989
2865,sentence,"Category: Photocopier. Price: 63,500৳67,000৳.

Product: HP LaserJet MFP M438dn Multifunction Mono Laser Printer. Category: Photocopier. Price: 74,000৳79,000৳.
",159,396943,397102
2866,sentence,"Category: Photocopier. Price: 74,000৳79,000৳.

Product: RICOH MP 2014D Multifunction Copier. Category: Photocopier. Price: 71,500৳.
",132,397056,397188
2867,sentence,"Category: Photocopier. Price: 71,500৳.

Product: Canon ImageRUNNER 2224 A3 Monochrome Laser Multifunctional Photocopier. Category: Photocopier. Price: 90,000৳.
",160,397149,397309
2868,sentence,"Category: Photocopier. Price: 90,000৳.

Product: Sharp BP-20M24L Digital Multifunction Photocopier. Category: Photocopier. Price: 95,000৳.
",139,397270,397409
2869,sentence,"Category: Photocopier. Price: 95,000৳.

Product: Canon imageRUNNER Advance iR1643i Monochrome Laser Photocopier. Category: Photocopier. Price: 125,000৳130,000৳.
",161,397370,397531
2870,sentence,"Category: Photocopier. Price: 125,000৳130,000৳.

Product: Canon ImageRUNNER 2224N A3 Monochrome Laser Multifunctional Photocopier. Category: Photocopier. Price: 135,000৳.
",171,397483,397654
2871,sentence,"Category: Photocopier. Price: 135,000৳.

Product: HP LaserJet MFP M443nda Multifunction Mono Laser Photocopier. Category: Photocopier. Price: 130,000৳.
",152,397614,397766
2872,sentence,"Category: Photocopier. Price: 130,000৳.

Product: Canon imageRUNNER 2425 A3 Monochrome Laser Multifunctional Photocopier. Category: Photocopier. Price: 145,000৳.
",162,397726,397888
2873,sentence,"Category: Photocopier. Price: 145,000৳.

Product: RICOH M 2701 Black and White Multifunctional Photocopier. Category: Photocopier. Price: 180,000৳190,000৳.
",156,397848,398004
2874,sentence,"Category: Photocopier. Price: 180,000৳190,000৳.

Product: HP LaserJet Pro MFP M438n Mono Laser Printer. Category: HP. Subcategory: Photocopier. Price: Up Coming.
",162,397956,398118
2875,sentence,"Subcategory: Photocopier. Price: Up Coming.

Product: HP LaserJet MFP M438nda Multifunction Mono Laser Printer. Category: HP. Subcategory: Photocopier. Price: Up Coming.
",170,398074,398244
2876,sentence,"Subcategory: Photocopier. Price: Up Coming.

Product: RICOH M2702 Black and White Multifunctional Photocopier. Category: Ricoh. Subcategory: Photocopier. Price: 230,000৳235,000৳.
",179,398200,398379
2877,sentence,"Price: 230,000৳235,000৳.

Product: RICOH IM 2500 A3 Black and White Multifunction Printer. Category: Ricoh. Subcategory: Photocopier. Price: 245,000৳.
",151,398354,398505
2878,sentence,"Subcategory: Photocopier. Price: 245,000৳.

Product: Ricoh DX 2430 Color Digital Duplicator Photocopier. Category: Ricoh. Subcategory: Photocopier. Price: 280,000৳295,000৳.
",173,398462,398635
2879,sentence,"Price: 280,000৳295,000৳.

Product: RICOH IM 5000 Black and White Multifunction Photocopier. Category: Ricoh. Subcategory: Photocopier. Price: 560,000৳565,000৳.
",160,398610,398770
2880,sentence,"Price: 560,000৳565,000৳.

Product: RICOH IM 6000 Black and White Multifunction Photocopier. Category: Ricoh. Subcategory: Photocopier. Price: 740,000৳.
",152,398745,398897
2881,sentence,"Subcategory: Photocopier. Price: 740,000৳.

Product: RICOH MP 2555SP Multifunction Copier. Category: Ricoh. Subcategory: Photocopier. Price: Out Of Stock.
",155,398854,399009
2882,sentence,"Subcategory: Photocopier. Price: Out Of Stock.

Product: RICOH M2700 Black and White Photocopier. Category: Ricoh. Subcategory: Photocopier. Price: Out Of Stock.
",162,398962,399124
2883,sentence,"Subcategory: Photocopier. Price: Out Of Stock.

Product: RICOH MP 3055SP Black and White Multifunction Photocopier. Category: Ricoh. Subcategory: Photocopier. Price: Out Of Stock.
",180,399077,399257
2884,sentence,"Subcategory: Photocopier. Price: Out Of Stock.

Product: RICOH IM 3000 A3 Black and White Multifunction Printer. Category: Ricoh. Subcategory: Photocopier. Price: Out Of Stock.
",177,399210,399387
2885,sentence,"Subcategory: Photocopier. Price: Out Of Stock.

Product: RICOH M C2000 Full Colour Multifunction Photocopier. Category: Ricoh. Subcategory: Photocopier. Price: Out Of Stock.
",174,399340,399514
2886,sentence,"Subcategory: Photocopier. Price: Out Of Stock.

Product: RICOH MP 4055SP Black and White Multifunction Photocopier. Category: Ricoh. Subcategory: Photocopier. Price: Out Of Stock.
",180,399467,399647
2887,sentence,"Subcategory: Photocopier. Price: Out Of Stock.

Product: RICOH IM 4000 Black and White Multifunction Photocopier. Category: Ricoh. Subcategory: Photocopier. Price: Out Of Stock.
",178,399600,399778
2888,sentence,"Subcategory: Photocopier. Price: Out Of Stock.

Product: RICOH MP 5055SP A3 Black and White Multifunction Photocopier. Category: Ricoh. Subcategory: Photocopier. Price: Out Of Stock.
",183,399731,399914
2889,sentence,"Subcategory: Photocopier. Price: Out Of Stock.

Product: RICOH IM C2500 Color Laser Multifunction Photocopier. Category: Ricoh. Subcategory: Photocopier. Price: Out Of Stock.
",175,399867,400042
2890,sentence,"Subcategory: Photocopier. Price: Out Of Stock.

Product: RICOH MP 6055SP A3 Black and White Multifunction Photocopier. Category: Ricoh. Subcategory: Photocopier. Price: Out Of Stock.
",183,399995,400178
2891,sentence,"Subcategory: Photocopier. Price: Out Of Stock.

Product: Sharp BP-30M28 Digital Photocopier. Category: Sharp. Subcategory: Photocopier. Price: 220,000৳.
",153,400131,400284
2892,sentence,"Subcategory: Photocopier. Price: 220,000৳.

Product: Sharp BP-30M31 Digital Multifunction Photocopier. Category: Sharp. Subcategory: Photocopier. Price: 260,000৳.
",163,400241,400404
2893,sentence,"Subcategory: Photocopier. Price: 260,000৳.

Product: Sharp BP-30M35 Digital Multifunction Photocopier. Category: Sharp. Subcategory: Photocopier. Price: 355,000৳.
",163,400361,400524
2894,sentence,"Subcategory: Photocopier. Price: 355,000৳.

Product: Sharp BP-30C25 Digital Color Multifunctional Photocopier. Category: Sharp. Subcategory: Photocopier. Price: 360,000৳.
",171,400481,400652
2895,sentence,"Subcategory: Photocopier. Price: 360,000৳.

Product: Sharp BP-50M45 Multifunction Monochrome Photocopier. Category: Sharp. Subcategory: Photocopier. Price: 565,000৳.
",166,400609,400775
2896,sentence,"Subcategory: Photocopier. Price: 565,000৳.

Product: Sharp BP-50M55 Multifunction Monochrome Photocopier. Category: Sharp. Subcategory: Photocopier. Price: 620,000৳.
",166,400732,400898
2897,sentence,"Subcategory: Photocopier. Price: 620,000৳.

Product: Sharp MX-3561 A3 Multifunction Color Photocopier. Category: Sharp. Subcategory: Photocopier. Price: Up Coming.
",164,400855,401019
2898,sentence,"Subcategory: Photocopier. Price: Up Coming.

Product: Sharp MX-B350Z Multifunctional Photocopier. Category: Sharp. Subcategory: Photocopier. Price: Up Coming.
",159,400975,401134
2899,sentence,"Subcategory: Photocopier. Price: Up Coming.

Product: SHARP MX-M5050 DIGITAL PHOTOCOPIER WITH DUPLEX FEEDER. Category: Sharp. Subcategory: Photocopier. Price: Out Of Stock.
",173,401090,401263
2900,sentence,"Subcategory: Photocopier. Price: Out Of Stock.

Product: Sharp MX M356NV Digital Photocopier. Category: Sharp. Subcategory: Photocopier. Price: Out Of Stock.
",158,401216,401374
2901,sentence,"Subcategory: Photocopier. Price: Out Of Stock.

Product: Sharp AR 6031N Digital Photocopier with Duplex and Network. Category: Sharp. Subcategory: Photocopier. Price: Out Of Stock.
",181,401327,401508
2902,sentence,"Subcategory: Photocopier. Price: Out Of Stock.

Product: Sharp MX-M315NV A3 Multifunctional Desktop Photocopier. Category: Sharp. Subcategory: Photocopier. Price: Out Of Stock.
",177,401461,401638
2903,sentence,"Subcategory: Photocopier. Price: Out Of Stock.

Product: Sharp MX-M265NV A3 Multifunctional Desktop Photocopier. Category: Sharp. Subcategory: Photocopier. Price: Out Of Stock.
",177,401591,401768
2904,sentence,"Subcategory: Photocopier. Price: Out Of Stock.

Product: SHARP AR-6020NV Multifunction Copier. Category: Sharp. Subcategory: Photocopier. Price: Out Of Stock.
",159,401721,401880
2905,sentence,"Subcategory: Photocopier. Price: Out Of Stock.

Product: Sharp AR-7024D Multifunctional Duplex Photocopier. Category: Sharp. Subcategory: Photocopier. Price: Out Of Stock.
",172,401833,402005
2906,sentence,"Subcategory: Photocopier. Price: Out Of Stock.

Product: Sharp DX-2000U A3 Color Digital Multifunction Photocopier. Category: Sharp. Subcategory: Photocopier. Price: Out Of Stock.
",180,401958,402138
2907,sentence,"Subcategory: Photocopier. Price: Out Of Stock.

Product: Sharp BP-20C25 Color Digital Photocopier. Category: Sharp. Subcategory: Photocopier. Price: Out Of Stock.
",163,402091,402254
2908,sentence,"Subcategory: Photocopier. Price: Out Of Stock.

Product: Sharp MX-M5051 Digital Multifunction Photocopier. Category: Sharp. Subcategory: Photocopier. Price: Out Of Stock.
",171,402207,402378
2909,sentence,"Subcategory: Photocopier. Price: Out Of Stock.

Product: HP 17A Black Original LaserJet Toner Cartridge (For P102A, 130a). Category: HP. Subcategory: Toner. Price: 8,000৳.
",172,402331,402503
2910,sentence,"Subcategory: Toner. Price: 8,000৳.

Product: HP 103AD Dual Pack Black Original Neverstop Laser Toner Reload Kit. Category: HP. Subcategory: Toner. Price: 2,600৳2,700৳.
",168,402468,402636
2911,sentence,"Subcategory: Toner. Price: 2,600৳2,700৳.

Product: HP 90A Black Original LaserJet Toner (For LJ M601N, D, DN, 602N, D, DN). Category: HP. Subcategory: Toner. Price: 23,000৳23,500৳.
",181,402595,402776
2912,sentence,"Subcategory: Toner. Price: 23,000৳23,500৳.

Product: HP 304A Black Original LaserJet Toner Cartridge (Bundle With Full Set). Category: HP. Subcategory: Toner. Price: 5,500৳.
",174,402733,402907
2913,sentence,"Subcategory: Toner. Price: 5,500৳.

Product: HP 304A Cyan Original LaserJet Toner Cartridge (Bundle With Full Set). Category: HP. Subcategory: Toner. Price: 5,500৳.
",165,402872,403037
2914,sentence,"Subcategory: Toner. Price: 5,500৳.

Product: HP 304A Yellow Original LaserJet Toner Cartridge (Bundle With Full Set). Category: HP. Subcategory: Toner. Price: 5,500৳.
",167,403002,403169
2915,sentence,"Subcategory: Toner. Price: 5,500৳.

Product: HP 304A Magenta Original LaserJet Toner Cartridge (Bundle With Full Set). Category: HP. Subcategory: Toner. Price: 5,500৳.
",168,403134,403302
2916,sentence,"Subcategory: Toner. Price: 5,500৳.

Product: HP 335X High Yield Black Original LaserJet Toner Cartridge. Category: HP. Subcategory: Toner. Price: 6,200৳.
",154,403267,403421
2917,sentence,"Subcategory: Toner. Price: 6,200৳.

Product: HP 107A Black Original Laser Toner Cartridge. Category: HP. Subcategory: Toner. Price: 6,500৳.
",140,403386,403526
2918,sentence,"Subcategory: Toner. Price: 6,500৳.

Product: HP 215A Black LaserJet Toner (Bundle With Full Set). Category: HP. Subcategory: Toner. Price: 7,000৳.
",147,403491,403638
2919,sentence,"Subcategory: Toner. Price: 7,000৳.

Product: HP 166A Black Original Laser Toner Cartridge. Category: HP. Subcategory: Toner. Price: 6,500৳7,000৳.

Product: HP 136A Black Original LaserJet Toner. ",195,403603,403798
2920,sentence,"
Product: HP 136A Black Original LaserJet Toner. Category: HP. Subcategory: Toner. Price: 7,300৳.

Product: HP 215A Cyan LaserJet Toner (Bundle With Full Set). Category: HP. Subcategory: Toner. ",194,403749,403943
2921,sentence,"Category: HP. Subcategory: Toner. Price: 7,400৳.

Product: HP 215A Magenta LaserJet Toner (Bundle With Full Set). Category: HP. Subcategory: Toner. Price: 7,400৳.
",163,403909,404072
2922,sentence,"Subcategory: Toner. Price: 7,400৳.

Product: HP 215A Yellow LaserJet Toner (Bundle With Full Set). Category: HP. Subcategory: Toner. Price: 7,400৳.
",148,404037,404185
2923,sentence,"Subcategory: Toner. Price: 7,400৳.

Product: HP 56X Black Toner for M436N, DN, NDA Laserjet. Category: HP. Subcategory: Toner. Price: 7,500৳.
",142,404150,404292
2924,sentence,"Subcategory: Toner. Price: 7,500৳.

Product: HP 26A Black Original LaserJet Toner Cartridge (For M402DN). Category: HP. Subcategory: Toner. Price: 15,900৳.
",156,404257,404413
2925,sentence,"Subcategory: Toner. Price: 15,900৳.

Product: HP 87A Black Original LaserJet Toner (CF287A). Category: HP. Subcategory: Toner. Price: 31,000৳32,000৳.
",150,404377,404527
2926,sentence,"Subcategory: Toner. Price: 31,000৳32,000৳.

Product: HP 128A-C Cyan Original LaserJet Toner Cartridge For CP 1525, M1415 Printer. Category: HP. Subcategory: Toner. Price: 4,000৳5,000৳.
",185,404484,404669
2927,sentence,"Subcategory: Toner. Price: 4,000৳5,000৳.

Product: HP 44A Black Original Laser Toner Cartridge. Category: HP. Subcategory: Toner. Price: 7,200৳7,500৳.
",151,404628,404779
2928,sentence,"Subcategory: Toner. Price: 7,200৳7,500৳.

Product: Canon imageRUNNER 2925i A3 Multifunctional Monochrome Laser Photocopier. Category: Canon. Subcategory: Photocopier. Price: 350,000৳.
",184,404738,404922
2929,sentence,"Subcategory: Photocopier. Price: 350,000৳.

Product: Canon imageRUNNER ADVANCE DX C3922i A3 Multifunctional Laser Photocopier. Category: Canon. Subcategory: Photocopier. Price: 485,000৳490,000৳.
",195,404879,405074
2930,sentence,"Price: 485,000৳490,000৳.

Product: Canon imageRUNNER ADVANCE DX C3830i A3 Color Laser Multifunctional Photocopier. Category: Canon. Subcategory: Photocopier. Price: 550,000৳.
",175,405049,405224
2931,sentence,"Subcategory: Photocopier. Price: 550,000৳.

Product: Canon imageRUNNER ADVANCE DX C3926i A3 Multifunctional Laser Photocopier. Category: Canon. Subcategory: Photocopier. Price: 560,000৳.
",187,405181,405368
2932,sentence,"Subcategory: Photocopier. Price: 560,000৳.

Product: Canon imageRUNNER ADVANCE DX C3930i A3 Multifunctional Laser Photocopier. Category: Canon. Subcategory: Photocopier. Price: 595,000৳.
",187,405325,405512
2933,sentence,"Subcategory: Photocopier. Price: 595,000৳.

Product: Canon imageRUNNER ADVANCE DX C3935i A3 Multifunctional Laser Photocopier. Category: Canon. Subcategory: Photocopier. Price: 890,000৳.
",187,405469,405656
2934,sentence,"Subcategory: Photocopier. Price: 890,000৳.

Product: Canon imageRUNNER ADVANCE DX 6855i Multifunctional Photocopier. Category: Canon. Subcategory: Photocopier. Price: 1,050,000৳.
",179,405613,405792
2935,sentence,"Subcategory: Photocopier. Price: 1,050,000৳.

Product: Canon imageRUNNER ADVANCE DX 6860i A3 Multifunctional Monochrome Laser Photocopier. Category: Canon. Subcategory: Photocopier. ",182,405747,405929
2936,sentence,"Category: Canon. Subcategory: Photocopier. Price: 1,350,000৳.

Product: Canon imageRUNNER ADVANCE DX C5840i A3 Color Laser Multifunctional Photocopier. Category: Canon. Subcategory: Photocopier. ",195,405886,406081
2937,sentence,"Category: Canon. Subcategory: Photocopier. Price: 1,420,000৳.

Product: Canon imageRUNNER ADVANCE DX C5860i A3 Multifunction Laser Photocopier. Category: Canon. Subcategory: Photocopier. ",187,406038,406225
2938,sentence,"Category: Canon. Subcategory: Photocopier. Price: 1,930,000৳.

Product: Canon imageRUNNER ADVANCE DX C5870i A3 Multifunction Color Laser Photocopier. Category: Canon. Subcategory: Photocopier. ",193,406182,406375
2939,sentence,"Category: Canon. Subcategory: Photocopier. Price: 2,150,000৳.

Product: Canon imageRUNNER 2935i A3 Multifunctional Monochrome Laser Photocopier. Category: Canon. Subcategory: Photocopier. ",188,406332,406520
2940,sentence,"Category: Canon. Subcategory: Photocopier. Price: Pre Order.

Product: Canon Metal Pedestal/Trolley Model-45/25. Category: Canon. Subcategory: Photocopier. Price: Out Of Stock.
",177,406477,406654
2941,sentence,"Subcategory: Photocopier. Price: Out Of Stock.

Product: Canon iR 2006N Digital Copier. Category: Canon. Subcategory: Photocopier. Price: Out Of Stock.
",152,406607,406759
2942,sentence,"Subcategory: Photocopier. Price: Out Of Stock.

Product: Canon imageRUNNER C3120 Color Multi functional Photocopier. Category: Canon. Subcategory: Photocopier. Price: Out Of Stock.
",181,406712,406893
2943,sentence,"Subcategory: Photocopier. Price: Out Of Stock.

Product: Canon imageRUNNER Advance DX 4735i Monochrome Multi-Functional Laser Photocopier. Category: Canon. Subcategory: Photocopier. ",182,406846,407028
2944,sentence,"Category: Canon. Subcategory: Photocopier. Price: Out Of Stock.

Product: FujiFilm Waste Toner Box for FujiFilm Laser Printer. Category: Fujifilm. Subcategory: Toner. Price: 3,000৳.
",182,406985,407167
2945,sentence,"Subcategory: Toner. Price: 3,000৳.

Product: Fujifilm CT203491 Cyan Original LaserJet Toner Cartridge. Category: Fujifilm. Subcategory: Toner. Price: 8,500৳.
",158,407132,407290
2946,sentence,"Subcategory: Toner. Price: 8,500৳.

Product: Fujifilm CT203492 Magenta Original LaserJet Toner Cartridge. Category: Fujifilm. Subcategory: Toner. Price: 8,500৳.
",161,407255,407416
2947,sentence,"Subcategory: Toner. Price: 8,500৳.

Product: Fujifilm CT203493 Yellow Original LaserJet Toner Cartridge. Category: Fujifilm. Subcategory: Toner. Price: 8,500৳.
",160,407381,407541
2948,sentence,"Subcategory: Toner. Price: 8,500৳.

Product: Fujifilm CT203490 Black Original LaserJet Toner Cartridge. Category: Fujifilm. Subcategory: Toner. Price: 8,500৳.

Product: Pantum TL-C2310H Black Toner. ",199,407506,407705
2949,sentence,"
Product: Pantum TL-C2310H Black Toner. Category: Pantum. Subcategory: Toner. Price: 1,400৳.

Product: Pantum TL-2310H Black Toner for BP2300 Series. Category: Pantum. Subcategory: Toner. ",188,407665,407853
2950,sentence,"Category: Pantum. Subcategory: Toner. Price: 1,400৳.

Product: Pantum PC-216RB Refill Kit. Category: Pantum. Subcategory: Toner. Price: 1,300৳1,500৳.

Product: Pantum TN-411H Black Refill Kit. ",193,407815,408008
2951,sentence,"
Product: Pantum TN-411H Black Refill Kit. Category: Pantum. Subcategory: Toner. Price: 1,500৳.

Product: Pantum TN-411X Black Refill Kit. Category: Pantum. Subcategory: Toner. Price: 1,750৳.
",192,407965,408157
2952,sentence,"Subcategory: Toner. Price: 1,750৳.

Product: Pantum PC-211EV Toner. Category: Pantum. Subcategory: Toner. Price: 2,100৳.

Product: Pantum NT-C216B High-capacity Toner. Category: Pantum. ",186,408122,408308
2953,sentence,"Category: Pantum. Subcategory: Toner. Price: 2,350৳.

Product: Pantum TL-411H Black Toner. Category: Pantum. Subcategory: Toner. Price: 4,700৳.

Product: Pantum TL-5120 Black Toner. ",182,408290,408472
2954,sentence,"
Product: Pantum TL-5120 Black Toner. Category: Pantum. Subcategory: Toner. Price: 5,000৳.

Product: Pantum PC-310 Toner Black. Category: Pantum. Subcategory: Toner. Price: 5,500৳.
",181,408434,408615
2955,sentence,"Subcategory: Toner. Price: 5,500৳.

Product: Pantum TL-411X Black Toner. Category: Pantum. Subcategory: Toner. Price: 5,800৳.

Product: Pantum TL-425X High-capacity Toner Cartridge Black. ",188,408580,408768
2956,sentence,"Category: Pantum. Subcategory: Toner. Price: 5,900৳.

Product: Pantum DL-410 Drum Unit. Category: Pantum. Subcategory: Toner. Price: 6,000৳.
",141,408768,408909
2957,sentence,"Subcategory: Toner. Price: 6,000৳.

Product: Pantum CTL-1100M Magenta Color Toner (Bundle With Full Set). Category: Pantum. Subcategory: Toner. Price: 6,000৳.
",159,408874,409033
2958,sentence,"Subcategory: Toner. Price: 6,000৳.

Product: Pantum CTL-1100Y Yellow Color Toner (Bundle With Full Set). Category: Pantum. Subcategory: Toner. Price: 6,000৳.
",158,408998,409156
2959,sentence,"Subcategory: Toner. Price: 6,000৳.

Product: Pantum CTL-1100C Cyan Color Toner (Bundle With Full Set). Category: Pantum. Subcategory: Toner. Price: 6,000৳.
",156,409121,409277
2960,sentence,"Subcategory: Toner. Price: 6,000৳.

Product: Pantum PD-219 Toner Cartridge Black. Category: Pantum. Subcategory: Toner. Price: 4,500৳6,000৳.
",141,409242,409383
2961,sentence,"Subcategory: Toner. Price: 4,500৳6,000৳.

Product: Pantum CTL-1100K Black Color Toner (Bundle With Full Set). Category: Pantum. Subcategory: Toner. Price: 5,700৳.
",163,409342,409505
2962,sentence,"Subcategory: Toner. Price: 5,700৳.

Product: Pantum TL-5130T Black Toner. Category: Pantum. Subcategory: Toner. Price: 7,000৳.

Product: Pantum TL-5130HT Black Toner. Category: Pantum. ",185,409470,409655
2963,sentence,"Category: Pantum. Subcategory: Toner. Price: 8,500৳.

Product: G&G CB435A/85A Black Universal Toner. Category: Toner. Price: 800৳.

Product: Print-Rite 80A / 505A LaserJet Toner. Category: Toner. ",196,409637,409833
2964,sentence,"Category: Toner. Price: 850৳.

Product: True Trust 76A Black Toner Without Chip. Category: Toner. Price: 850৳.

Product: True Trust 79A Black Toner With Chip. Category: Toner. Price: 750৳.
",189,409816,410005
2965,sentence,"Category: Toner. Price: 750৳.

Product: Starink 85A Black LaserJet Toner. Category: Toner. Price: 900৳.

Product: Starink 26A Black LaserJet Toner. Category: Toner. Price: 900৳.
",178,409975,410153
2966,sentence,"Category: Toner. Price: 900৳.

Product: Print-Rite TN-630 Black LaserJet Toner. Category: Toner. Price: 900৳.

Product: Print-Rite 83A Black LaserJet Toner. Category: Toner. Price: 900৳.
",187,410123,410310
2967,sentence,"Category: Toner. Price: 900৳.

Product: Power Print TN-107A Toner Without Chip. Category: Toner. Price: 880৳900৳.

Product: Starink 17A Black LaserJet Toner. Category: Toner. Price: 900৳.
",188,410280,410468
2968,sentence,"Category: Toner. Price: 900৳.

Product: Starink 80A Black LaserJet Toner. Category: Toner. Price: 900৳.

Product: True Trust 26A Black Toner. Category: Toner. Price: 900৳.
",172,410438,410610
2969,sentence,"Category: Toner. Price: 900৳.

Product: G&G W1107A Black Toner Without Chip. Category: Toner. Price: 900৳.

Product: Brother TN-B028 Black Toner Cartridge. Category: Brother. Subcategory: Toner. ",195,410580,410775
2970,sentence,"Category: Brother. Subcategory: Toner. Price: 2,000৳.

Product: Brother TN-2305 Toner. Category: Brother. Subcategory: Toner. Price: Out Of Stock.

Product: Brother TN-273M Magenta Toner. ",188,410736,410924
2971,sentence,"
Product: Brother TN-273M Magenta Toner. Category: Brother. Subcategory: Toner. Price: 7,300৳.

Product: Brother TN-273C Cyan Toner. Category: Brother. Subcategory: Toner. Price: 7,300৳.
",187,410883,411070
2972,sentence,"Subcategory: Toner. Price: 7,300৳.

Product: Brother TN-273Y Yellow Toner. Category: Brother. Subcategory: Toner. Price: 7,300৳.

Product: Brother TN-2355 Toner. Category: Brother. ",181,411035,411216
2973,sentence,"Category: Brother. Subcategory: Toner. Price: 7,600৳8,000৳.

Product: Brother TN-2455 Toner. Category: Brother. Subcategory: Toner. Price: 8,500৳.

Product: Brother TN-3607 Black Toner Cartridge. ",196,411197,411393
2974,sentence,"
Product: Brother TN-3607 Black Toner Cartridge. Category: Brother. Subcategory: Toner. Price: 8,200৳8,500৳.

Product: Brother TN-461 Black Toner. Category: Brother. Subcategory: Toner. ",186,411344,411530
2975,sentence,"Category: Brother. Subcategory: Toner. Price: 8,600৳8,900৳.

Product: Brother TN-273BK Black Toner. Category: Brother. Subcategory: Toner. Price: 9,300৳.

Product: Brother TN-461 Cyan Toner. ",191,411491,411682
2976,sentence,"
Product: Brother TN-461 Cyan Toner. Category: Brother. Subcategory: Toner. Price: 9,600৳9,800৳.

Product: Brother TN-461 Magenta Toner. Category: Brother. Subcategory: Toner. Price: 9,600৳9,800৳.
",197,411645,411842
2977,sentence,"Subcategory: Toner. Price: 9,600৳9,800৳.

Product: Brother TN-461 Yellow Toner. Category: Brother. Subcategory: Toner. Price: 9,600৳9,800৳.

Product: Brother TN-3487 Toner. Category: Brother. ",192,411801,411993
2978,sentence,"Category: Brother. Subcategory: Toner. Price: Up Coming.

Product: Brother TN-2405 Toner. Category: Brother. Subcategory: Toner. Price: Out Of Stock.

Product: Brother TN-3417 Toner. ",183,411974,412157
2979,sentence,"
Product: Brother TN-3417 Toner. Category: Brother. Subcategory: Toner. Price: Out Of Stock.

Product: Brother TN-3467 Toner. Category: Brother. Subcategory: Toner. Price: Out Of Stock.
",186,412124,412310
2980,sentence,"Subcategory: Toner. Price: Out Of Stock.

Product: Brother TN-3607XXL Black Toner Cartridge. Category: Brother. Subcategory: Toner. Price: Out Of Stock.

Product: Brother TN-2280 Toner. ",186,412269,412455
2981,sentence,"
Product: Brother TN-2280 Toner. Category: Brother. Subcategory: Toner. Price: Out Of Stock.

Product: Power Print TN-2331 Toner Black. Category: Power Print. Subcategory: Toner. Price: 1,000৳.
",194,412422,412616
2982,sentence,"Subcategory: Toner. Price: 1,000৳.

Product: Power Print TN-26 Toner. Category: Power Print. Subcategory: Toner. Price: 950৳1,000৳.

Product: Power Print TN-1035 Toner. Category: Power Print. ",192,412581,412773
2983,sentence,"Category: Power Print. Subcategory: Toner. Price: 900৳1,000৳.

Product: Power Print TN-166A Toner with Chip. Category: Power Print. Subcategory: Toner. Price: 1,000৳.
",167,412750,412917
2984,sentence,"Subcategory: Toner. Price: 1,000৳.

Product: Power Print TN-410 Black Toner Without Chip. Category: Power Print. Subcategory: Toner. Price: 1,000৳.

Product: Power Print TN-2345 Toner Black. ",191,412882,413073
2985,sentence,"
Product: Power Print TN-2345 Toner Black. Category: Power Print. Subcategory: Toner. Price: 1,200৳.

Product: Power Print TN-76A Black LaserJet Toner without Chip. Category: Power Print. ",188,413030,413218
2986,sentence,"Category: Power Print. Subcategory: Toner. Price: 1,200৳.

Product: Power Print TN-33/308 Toner Cartridge. Category: Power Print. Subcategory: Toner. Price: 1,200৳.
",165,413195,413360
2987,sentence,"Subcategory: Toner. Price: 1,200৳.

Product: Power Print TN-211EV Black Toner. Category: Power Print. Subcategory: Toner. Price: 1,250৳.

Product: Power Print TN-216 Black Toner With Chip. ",189,413325,413514
2988,sentence,"Category: Power Print. Subcategory: Toner. Price: 1,300৳.

Product: Power Print TN-107A Toner With Chip. Category: Power Print. Subcategory: Toner. Price: 1,400৳.
",163,413514,413677
2989,sentence,"Subcategory: Toner. Price: 1,400৳.

Product: Power Print TN-26X Black Toner. Category: Power Print. Subcategory: Toner. Price: 1,400৳.

Product: Power Print TN-136A Black Toner Without Chip. ",191,413642,413833
2990,sentence,"Category: Power Print. Subcategory: Toner. Price: 1,450৳.

Product: Power Print TN-87A Black LaserJet Toner. Category: Power Print. Subcategory: Toner. Price: 1,500৳.
",167,413833,414000
2991,sentence,"Subcategory: Toner. Price: 1,500৳.

Product: Power Print TN-3487 Toner With Chip. Category: Power Print. Subcategory: Toner. Price: 2,200৳.

Product: Power Print TN-5120 Black Toner. ",183,413965,414148
2992,sentence,"
Product: Power Print TN-5120 Black Toner. Category: Power Print. Subcategory: Toner. Price: 2,600৳.

Product: Power Print TN-76A Black LaserJet Toner with Chip. Category: Power Print. ",185,414105,414290
2993,sentence,"Category: Power Print. Subcategory: Toner. Price: 3,200৳.

Product: MaxGreen NPG-51 Black Toner Canon Photocopier. Category: Canon. Subcategory: Toner. Price: 1,600৳1,700৳.
",173,414267,414440
2994,sentence,"Subcategory: Toner. Price: 1,600৳1,700৳.

Product: Prime Print CRG-071 Black Toner Cartridge. Category: Canon. Subcategory: Toner. Price: 1,800৳.
",146,414399,414545
2995,sentence,"Subcategory: Toner. Price: 1,800৳.

Product: Canon 325 Toner Cartridge for 6030 printer. Category: Canon. Subcategory: Toner. Price: 2,800৳.
",141,414510,414651
2996,sentence,"Subcategory: Toner. Price: 2,800৳.

Product: Canon NPG-59 Toner For Canon Photocopier (Black). Category: Canon. Subcategory: Toner. Price: 2,800৳.
",147,414616,414763
2997,sentence,"Subcategory: Toner. Price: 2,800৳.

Product: Canon NPG-51 Toner for Canon Photocopier (Black). Category: Canon. Subcategory: Toner. Price: 3,800৳.

Product: Canon 326 Toner For LBP 6200 Printer. ",195,414728,414923
2998,sentence,"
Product: Canon 326 Toner For LBP 6200 Printer. Category: Canon. Subcategory: Toner. Price: 6,000৳.

Product: Canon NPG-57 Black Toner For Canon Photocopier. Category: Canon. Subcategory: Toner. ",195,414875,415070
2999,sentence,"Category: Canon. Subcategory: Toner. Price: 6,800৳.

Product: Canon 071 Black Toner Cartridge. Category: Canon. Subcategory: Toner. Price: 7,000৳.

Product: Canon 337 Black Genuine Toner Cartridge. ",198,415033,415231
3000,sentence,"Category: Canon. Subcategory: Toner. Price: 7,700৳8,000৳.

Product: Canon 308 Toner for LBP-3300 Printer. Category: Canon. Subcategory: Toner. Price: 8,300৳9,000৳.
",164,415231,415395
3001,sentence,"Subcategory: Toner. Price: 8,300৳9,000৳.

Product: Canon NPG-68 Toner For Photocopier (Black). Category: Canon. Subcategory: Toner. Price: 9,700৳.

Product: Canon EP-319 Toner (Black). ",185,415354,415539
3002,sentence,"
Product: Canon EP-319 Toner (Black). Category: Canon. Subcategory: Toner. Price: 10,500৳.

Product: Canon NPG-84 Black Toner Cartridge. Category: Canon. Subcategory: Toner. Price: 10,500৳.
",190,415501,415691
3003,sentence,"Subcategory: Toner. Price: 10,500৳.

Product: Canon NPG-67 Black Toner Cartridge. Category: Canon. Subcategory: Toner. Price: 12,000৳.

Product: Canon NPG-68 Black Drum Unit. Category: Canon. ",192,415655,415847
3004,sentence,"Category: Canon. Subcategory: Toner. Price: 13,000৳.

Product: Canon NPG-90 Black Toner. Category: Canon. Subcategory: Toner. Price: 13,200৳13,500৳.
",149,415830,415979
3005,sentence,"Subcategory: Toner. Price: 13,200৳13,500৳.

Product: Canon 070 Black Original LaserJet Toner. Category: Canon. Subcategory: Toner. Price: 14,900৳.

Product: Canon T06 Toner for Photocopier (Black). ",198,415936,416134
3006,sentence,"Category: Canon. Subcategory: Toner. Price: 15,500৳.

Product: Canon NPG-67 Yellow Toner Cartridge. Category: Canon. Subcategory: Toner. Price: 16,000৳.

Product: Canon NPG-67 Cyan Toner Cartridge. ",198,416134,416332
3007,sentence,"
Product: Canon NPG-67 Cyan Toner Cartridge. Category: Canon. Subcategory: Toner. Price: 16,000৳.

Product: Toshiba T-2323C e-studio Compatible Toner (A-Grade). Category: Toshiba. ",180,416287,416467
3008,sentence,"Category: Toshiba. Subcategory: Toner. Price: 3,800৳.

Product: Toshiba T-2309E E-Studio Toner. Category: Toshiba. Subcategory: Toner. Price: 4,000৳.
",150,416448,416598
3009,sentence,"Subcategory: Toner. Price: 4,000৳.

Product: Toshiba T-2323C e-studio Original Toner. Category: Toshiba. Subcategory: Toner. Price: 5,000৳.

Product: Toshiba T-3008C e-studio Original Toner. ",191,416563,416754
3010,sentence,"Category: Toshiba. Subcategory: Toner. Price: 7,500৳7,900৳.

Product: Toshiba T-3028C e-studio Original Toner Cartridge. Category: Toshiba. Subcategory: Toner. Price: 7,900৳.
",175,416754,416929
3011,sentence,"Subcategory: Toner. Price: 7,900৳.

Product: Toshiba T-5018C e-studio Original Toner. Category: Toshiba. Subcategory: Toner. Price: 8,000৳8,300৳.
",146,416894,417040
3012,sentence,"Subcategory: Toner. Price: 8,000৳8,300৳.

Product: Toshiba T-3028p e-studio Original Toner Cartridge. Category: Toshiba. Subcategory: Toner. Price: Out Of Stock.
",162,416999,417161
3013,sentence,"Subcategory: Toner. Price: Out Of Stock.

Product: Toshiba T-FC415C-K Black Original Toner (Bundle With Full Set). Category: Toshiba. Subcategory: Toner. Price: 10,500৳.
",170,417120,417290
3014,sentence,"Subcategory: Toner. Price: 10,500৳.

Product: Toshiba T-FC425C-K Black Original Toner (Bundle With Full Set). Category: Toshiba. Subcategory: Toner. Price: 11,700৳.
",165,417254,417419
3015,sentence,"Subcategory: Toner. Price: 11,700৳.

Product: Toshiba T-FC425C-C Cyan Original Toner (Bundle With Full Set). Category: Toshiba. Subcategory: Toner. Price: 11,700৳.
",164,417383,417547
3016,sentence,"Subcategory: Toner. Price: 11,700৳.

Product: Toshiba T-FC425C-M Magenta Original Toner (Bundle With Full Set). Category: Toshiba. Subcategory: Toner. Price: 11,700৳.
",167,417511,417678
3017,sentence,"Subcategory: Toner. Price: 11,700৳.

Product: Toshiba T-FC425C-Y Yellow Original Toner (Bundle With Full Set). Category: Toshiba. Subcategory: Toner. Price: 11,700৳.
",166,417642,417808
3018,sentence,"Subcategory: Toner. Price: 11,700৳.

Product: Toshiba T-FC415C-M Magenta Original Toner (Bundle With Full Set). Category: Toshiba. Subcategory: Toner. Price: 13,000৳.
",167,417772,417939
3019,sentence,"Subcategory: Toner. Price: 13,000৳.

Product: Toshiba T-FC415C-Y Yellow Toner (Bundle With Full Set). Category: Toshiba. Subcategory: Toner. Price: 13,000৳.
",157,417903,418060
3020,sentence,"Subcategory: Toner. Price: 13,000৳.

Product: Toshiba T-FC415C-C Cyan Original Toner (Bundle With Full Set). Category: Toshiba. Subcategory: Toner. Price: 13,000৳.
",164,418024,418188
3021,sentence,"Subcategory: Toner. Price: 13,000৳.

Product: Toshiba T-FC415C-YMCK e-studio Color Original Toner Full Set (4 pcs). Category: Toshiba. Subcategory: Toner. Price: 49,000৳.
",171,418152,418323
3022,sentence,"Subcategory: Toner. Price: 49,000৳.

Product: Toshiba T-2309C e-studio Toner. Category: Toshiba. Subcategory: Toner. Price: Out Of Stock.

Product: Toshiba T-2309P Black LaserJet Toner. ",186,418287,418473
3023,sentence,"
Product: Toshiba T-2309P Black LaserJet Toner. Category: Toshiba. Subcategory: Toner. Price: Out Of Stock.

Product: Toshiba T-5018P Original Black Toner. Category: Toshiba. Subcategory: Toner. ",195,418425,418620
3024,sentence,"Category: Toshiba. Subcategory: Toner. Price: Out Of Stock.

Product: True Trust 166A Black Laser Toner Cartridge. Category: True Trust. Subcategory: Toner. Price: 1,000৳.
",172,418581,418753
3025,sentence,"Subcategory: Toner. Price: 1,000৳.

Product: True Trust 107A Toner With Chip. Category: True Trust. Subcategory: Toner. Price: 1,250৳.

Product: True Trust 151A Black Toner Without Chip. ",187,418718,418905
3026,sentence,"Category: True Trust. Subcategory: Toner. Price: 1,300৳.

Product: True Trust 151A Toner with Chip for 4003DN/4003DW. Category: True Trust. Subcategory: Toner. Price: 3,500৳.
",175,418905,419080
3027,sentence,"Subcategory: Toner. Price: 3,500৳.

Product: Starink TN-630 Black Toner. Category: Starink. Subcategory: Toner. Price: 1,000৳.

Product: Starink 49A Black LaserJet Toner. Category: Starink. ",190,419045,419235
3028,sentence,"Category: Starink. Subcategory: Toner. Price: 1,000৳.

Product: Starink 15A Black LaserJet Toner. Category: Starink. Subcategory: Toner. Price: 1,000৳.
",152,419216,419368
3029,sentence,"Subcategory: Toner. Price: 1,000৳.

Product: Starink 76A Black LaserJet Toner without Chip. Category: Starink. Subcategory: Toner. Price: 1,100৳.

Product: Starink 12A Black LaserJet Toner. ",190,419333,419523
3030,sentence,"
Product: Starink 12A Black LaserJet Toner. Category: Starink. Subcategory: Toner. Price: 1,200৳.

Product: Starink 107A Black LaserJet Toner with Chip. Category: Starink. Subcategory: Toner. ",192,419479,419671
3031,sentence,"Category: Starink. Subcategory: Toner. Price: 1,600৳.

Product: Starink 55A Black LaserJet Toner. Category: Starink. Subcategory: Toner. Price: 1,600৳.

Product: Starink 56A Black LaserJet Toner. ",196,419632,419828
3032,sentence,"
Product: Starink 56A Black LaserJet Toner. Category: Starink. Subcategory: Toner. Price: 1,750৳.

Product: Starink 76A Black LaserJet Toner with Chip. Category: Starink. Subcategory: Toner. ",191,419784,419975
3033,sentence,"Category: Starink. Subcategory: Toner. Price: 2,200৳.

Product: Starink 151A LaserJet Toner Without Chip. Category: Starink. Subcategory: Toner. Price: Up Coming.
",163,419936,420099
3034,sentence,"Subcategory: Toner. Price: Up Coming.

Product: Starink 48A Black LaserJet Toner. Category: Starink. Subcategory: Toner. Price: Up Coming.

Product: Starink 107A Black LaserJet Toner Without Chip. ",197,420061,420258
3035,sentence,"Category: Starink. Subcategory: Toner. Price: Up Coming.

Product: Starink 87A Black LaserJet Toner. Category: Starink. Subcategory: Toner. Price: Up Coming.

Product: Sharp MX-237AT Toner. ",190,420258,420448
3036,sentence,"
Product: Sharp MX-237AT Toner. Category: Sharp. Subcategory: Toner. Price: 8,400৳.

Product: Sharp MX-61AT-BA Black Toner. Category: Sharp. Subcategory: Toner. Price: 11,000৳.
",177,420416,420593
3037,sentence,"Subcategory: Toner. Price: 11,000৳.

Product: Sharp BP-AT300 Black Original Toner. Category: Sharp. Subcategory: Toner. Price: 12,500৳.

Product: Sharp BP-AT200 Black Original Toner. ",183,420557,420740
3038,sentence,"
Product: Sharp BP-AT200 Black Original Toner. Category: Sharp. Subcategory: Toner. Price: 9,500৳.

Product: Sharp MX-561AT Toner. Category: Sharp. Subcategory: Toner. Price: 14,500৳.
",184,420693,420877
3039,sentence,"Subcategory: Toner. Price: 14,500৳.

Product: Sharp MX-61AT-CA Cyan Toner. Category: Sharp. Subcategory: Toner. Price: 23,500৳.

Product: Sharp MX-61AT-MA Magenta Toner. Category: Sharp. ",187,420841,421028
3040,sentence,"Category: Sharp. Subcategory: Toner. Price: 23,500৳.

Product: Sharp MX-61AT-YA Yellow Toner. Category: Sharp. Subcategory: Toner. Price: 23,500৳.

Product: Sharp MX-238AT Toner. Category: Sharp. ",196,421011,421207
3041,sentence,"Category: Sharp. Subcategory: Toner. Price: Out Of Stock.

Product: Sharp MX-315AT Toner. Category: Sharp. Subcategory: Toner. Price: Out Of Stock.

Product: Sharp MX-B45AT Toner. Category: Sharp. ",197,421190,421387
3042,sentence,"Category: Sharp. Subcategory: Toner. Price: Out Of Stock.

Product: MaxGreen 76A Black LaserJet Toner. Category: MaxGreen. Subcategory: Toner. Price: 3,500৳4,800৳.
",164,421370,421534
3043,sentence,"Subcategory: Toner. Price: 3,500৳4,800৳.

Product: MaxGreen 26A Black LaserJet Toner. Category: MaxGreen. Subcategory: Toner. Price: Up Coming.

Product: MaxGreen 79A Black LaserJet Toner. ",189,421493,421682
3044,sentence,"
Product: MaxGreen 79A Black LaserJet Toner. Category: MaxGreen. Subcategory: Toner. Price: Up Coming.

Product: MaxGreen NPG-59 Black Toner Canon Photocopier. Category: MaxGreen. ",180,421637,421817
3045,sentence,"Category: MaxGreen. Subcategory: Toner. Price: Out Of Stock.

Product: MaxGreen 85A Black LaserJet Toner. Category: MaxGreen. Subcategory: Toner. Price: Out Of Stock.
",167,421797,421964
3046,sentence,"Subcategory: Toner. Price: Out Of Stock.

Product: MaxGreen 107A Black LaserJet Toner with Chip. Category: MaxGreen. Subcategory: Toner. Price: Out Of Stock.
",158,421923,422081
3047,sentence,"Subcategory: Toner. Price: Out Of Stock.

Product: G&G CE505A Black Universal Toner. Category: G&G. Subcategory: Toner. Price: 950৳.

Product: G&G CF226A Black Universal Toner. Category: G&G. ",192,422040,422232
3048,sentence,"Category: G&G. Subcategory: Toner. Price: 1,000৳.

Product: G&G TN-660 Black Universal Toner. Category: G&G. Subcategory: Toner. Price: 1,000৳.

Product: G&G PC-211EV Black Toner. Category: G&G. ",195,422217,422412
3049,sentence,"Category: G&G. Subcategory: Toner. Price: 1,200৳.

Product: G&G CF276A Black Toner Without Chip. Category: G&G. Subcategory: Toner. Price: 1,200৳.

Product: G&G Q5949A Black Toner. Category: G&G. ",196,422397,422593
3050,sentence,"Category: G&G. Subcategory: Toner. Price: 1,200৳.

Product: G&G TL-410H Black Toner. Category: G&G. Subcategory: Toner. Price: Out Of Stock.

Product: G&G W1510A Black Toner Without Chip. ",188,422578,422766
3051,sentence,"
Product: G&G W1510A Black Toner Without Chip. Category: G&G. Subcategory: Toner. Price: 1,400৳.

Product: G&G W1107A Black Toner With Chip. Category: G&G. Subcategory: Toner. Price: 1,400৳.
",191,422719,422910
3052,sentence,"Subcategory: Toner. Price: 1,400৳.

Product: G&G TL-410X Black Toner. Category: G&G. Subcategory: Toner. Price: 1,650৳.

Product: G&G TL-425X Black Toner. Category: G&G. Subcategory: Toner. ",190,422875,423065
3053,sentence,"Category: G&G. Subcategory: Toner. Price: 1,700৳.

Product: G&G TL-5120H Black Toner. Category: G&G. Subcategory: Toner. Price: 2,600৳.

Product: G&G DL-410 Black Toner. Category: G&G. ",185,423030,423215
3054,sentence,"Category: G&G. Subcategory: Toner. Price: 3,000৳.

Product: G&G DL-425 Black Toner. Category: G&G. Subcategory: Toner. Price: 3,000৳.

Product: G&G TL-5120X Black Toner. Category: G&G. ",185,423200,423385
3055,sentence,"Category: G&G. Subcategory: Toner. Price: 3,400৳.

Product: G&G CTL-1100HK Black Toner. Category: G&G. Subcategory: Toner. Price: 3,500৳.

Product: G&G CTL-1100HC Cyan Toner. Category: G&G. ",190,423370,423560
3056,sentence,"Category: G&G. Subcategory: Toner. Price: 3,500৳.

Product: G&G CTL-1100HM Magenta Toner. Category: G&G. Subcategory: Toner. Price: 3,600৳.

Product: SafeWay 85A Compatible Toner (Black). ",188,423545,423733
3057,sentence,"
Product: SafeWay 85A Compatible Toner (Black). Category: SafeWay. Subcategory: Toner. Price: 950৳.

Product: SafeWay 05A Compatible Toner (Black). Category: SafeWay. Subcategory: Toner. ",187,423685,423872
3058,sentence,"Category: SafeWay. Subcategory: Toner. Price: 950৳1,000৳.

Product: Safeway 76A Black Toner With Chip. Category: SafeWay. Subcategory: Toner. Price: 3,000৳.
",157,423833,423990
3059,sentence,"Subcategory: Toner. Price: 3,000৳.

Product: SafeWay 49A Universal Compatible Black Toner. Category: SafeWay. Subcategory: Toner. Price: Up Coming.
",148,423955,424103
3060,sentence,"Subcategory: Toner. Price: Up Coming.

Product: SafeWay 279/ 79A Compatible Toner (Black). Category: SafeWay. Subcategory: Toner. Price: Up Coming.

Product: SafeWay 48A Compatible Toner (Black). ",196,424065,424261
3061,sentence,"
Product: SafeWay 48A Compatible Toner (Black). Category: SafeWay. Subcategory: Toner. Price: Up Coming.

Product: SafeWay 26A Compatible Toner (Black). Category: SafeWay. Subcategory: Toner. ",192,424213,424405
3062,sentence,"Category: SafeWay. Subcategory: Toner. Price: Out Of Stock.

Product: Print-Rite 26A Black LaserJet Toner. Category: Print-Rite. Subcategory: Toner. Price: Up Coming.
",167,424366,424533
3063,sentence,"Subcategory: Toner. Price: Up Coming.

Product: Print-Rite 12A Black LaserJet Toner. Category: Print-Rite. Subcategory: Toner. Price: Out Of Stock.
",148,424495,424643
3064,sentence,"Subcategory: Toner. Price: Out Of Stock.

Product: Print-Rite 85A / 35A / 36A / 78A / 88A LaserJet Toner. Category: Print-Rite. Subcategory: Toner. Price: Out Of Stock.
",169,424602,424771
3065,sentence,"Subcategory: Toner. Price: Out Of Stock.

Product: Print-Rite 79A Black LaserJet Toner. Category: Print-Rite. Subcategory: Toner. Price: Out Of Stock.
",151,424730,424881
3066,sentence,"Subcategory: Toner. Price: Out Of Stock.

Product: Print-Rite 76A / 58A  Black LaserJet Toner. Category: Print-Rite. Subcategory: Toner. Price: Out Of Stock.
",158,424840,424998
3067,sentence,"Subcategory: Toner. Price: Out Of Stock.

Product: Print-Rite 850 / 3471 LaserJet Toner. Category: Print-Rite. Subcategory: Toner. Price: Out Of Stock.

Product: LongPrint 30A Black Toner Cartridge. ",199,424957,425156
3068,sentence,"
Product: LongPrint 30A Black Toner Cartridge. Category: LongPrint. Subcategory: Toner. Price: 1,600৳.

Product: LongPrint 136A Black Toner Without Chip. Category: LongPrint. Subcategory: Toner. ",195,425109,425304
3069,sentence,"Category: LongPrint. Subcategory: Toner. Price: 1,700৳.

Product: LongPrint 151A Toner Without Chip. Category: LongPrint. Subcategory: Toner. Price: 2,500৳.
",157,425263,425420
3070,sentence,"Subcategory: Toner. Price: 2,500৳.

Product: LongPrint 136A Black Toner With Chip. Category: LongPrint. Subcategory: Toner. Price: 2,700৳.

Product: LongPrint 151A Toner With Chip. ",181,425385,425566
3071,sentence,"
Product: LongPrint 151A Toner With Chip. Category: LongPrint. Subcategory: Toner. Price: Out Of Stock.

Product: Samsung MLT-D203L Toner. Category: Samsung. Subcategory: Toner. Price: 5,000৳7,000৳.
",199,425524,425723
3072,sentence,"Subcategory: Toner. Price: 5,000৳7,000৳.

Product: Samsung MLT-D115L Toner. Category: Samsung. Subcategory: Toner. Price: 5,000৳7,000৳.

Product: HP 680 Tri-color Original Ink Advantage Cartridge. ",197,425682,425879
3073,sentence,"Category: Cartridge. Price: 1,200৳.

Product: Brother LC3717C Cyan Ink Cartridge. Category: Cartridge. Price: 1,150৳.

Product: Brother LC3717Y Yellow Ink Cartridge. Category: Cartridge. ",187,425879,426066
3074,sentence,"Category: Cartridge. Price: 1,150৳.

Product: HP 680 Original Black Ink Advantage Cartridge. Category: Cartridge. Price: Sold Out.

Product: HP 682 Tri-Color Original Ink Advantage Cartridge. ",192,426045,426237
3075,sentence,"Category: Cartridge. Price: 1,250৳.

Product: HP 682 Black Original Ink Advantage Cartridge. Category: Cartridge. Price: 1,300৳.

Product: HP 305 Black Original Ink Cartridge. Category: Cartridge. ",197,426237,426434
3076,sentence,"Category: Cartridge. Price: 1,650৳.

Product: HP 305 Tri-color Original Ink Cartridge. Category: Cartridge. Price: 1,650৳.

Product: HP 67 Black Original Ink Cartridge. Category: Cartridge. ",190,426413,426603
3077,sentence,"Category: Cartridge. Price: 2,000৳.

Product: HP 67 Tri-color Original Ink Cartridge. Category: Cartridge. Price: 2,000৳.

Product: Brother LC3719XL-C Cyan Ink Cartridge. Category: Cartridge. ",192,426582,426774
3078,sentence,"Category: Cartridge. Price: 2,350৳.

Product: Brother LC3719XL-M Magenta Ink Cartridge. Category: Cartridge. Price: 2,350৳.

Product: Brother LC3719XL-Y Yellow Ink Cartridge. Category: Cartridge. ",196,426753,426949
3079,sentence,"Category: Cartridge. Price: 2,350৳.

Product: Brother LC472XL Cyan Ink Cartridge (Bundle With Full Set). Category: Cartridge. Price: 2,400৳.
",141,426928,427069
3080,sentence,"Category: Cartridge. Price: 2,400৳.

Product: Brother LC472XL Yellow Ink Cartridge (Bundle With Full Set). Category: Cartridge. Price: 2,400৳.
",143,427033,427176
3081,sentence,"Category: Cartridge. Price: 2,400৳.

Product: Brother LC472XL Magenta Ink Cartridge (Bundle With Full Set). Category: Cartridge. Price: 2,400৳.

Product: Brother LC3719XL-BK Black Ink Cartridge. ",195,427140,427335
3082,sentence,"Category: Cartridge. Price: 3,100৳.

Product: Brother LC472XLBK Black Ink Cartridge (Bundle With Full Set). Category: Cartridge. Price: 3,100৳.

Product: Canon PG-810XL Black Ink Cartridge. ",190,427335,427525
3083,sentence,"
Product: Canon PG-810XL Black Ink Cartridge. Category: Cartridge. Price: 3,500৳.

Product: Canon CL-811 XL Color Cartridge. Category: Cartridge. Price: 3,500৳3,800৳.
",167,427479,427646
3084,sentence,"Category: Cartridge. Price: 3,500৳3,800৳.

Product: Canon 067 Color Laser Toner (Full Set). Category: Canon. Subcategory: Cartridge. Price: 33,000৳.

Product: Canon BCI-24 Twin Pack Black Cartridge. ",199,427604,427803
3085,sentence,"Category: Canon. Subcategory: Cartridge. Price: Out Of Stock.

Product: Canon BCI-15 Black Ink Cartridge. Category: Canon. Subcategory: Cartridge. Price: Out Of Stock.
",168,427803,427971
3086,sentence,"Subcategory: Cartridge. Price: Out Of Stock.

Product: Canon 751 Cyan Cartridge. Category: Canon. Subcategory: Cartridge. Price: Out Of Stock.

Product: Canon 751 Magenta Cartridge. Category: Canon. ",199,427926,428125
3087,sentence,"Category: Canon. Subcategory: Cartridge. Price: Out Of Stock.

Product: Canon 751 Yellow Cartridge. Category: Canon. Subcategory: Cartridge. Price: Out Of Stock.
",162,428108,428270
3088,sentence,"Subcategory: Cartridge. Price: Out Of Stock.

Product: Canon 751BK Black Cartridge. Category: Canon. Subcategory: Cartridge. Price: Out Of Stock.

Product: Canon 302 Black Cartridge. ",183,428225,428408
3089,sentence,"
Product: Canon 302 Black Cartridge. Category: Canon. Subcategory: Cartridge. Price: Out Of Stock.

Product: Canon 302 Cyan Cartridge. Category: Canon. Subcategory: Cartridge. Price: Out Of Stock.
",197,428371,428568
3090,sentence,"Subcategory: Cartridge. Price: Out Of Stock.

Product: Canon 302 Yellow Cartridge. Category: Canon. Subcategory: Cartridge. Price: Out Of Stock.

Product: Canon 302 Magenta Cartridge. ",184,428523,428707
3091,sentence,"
Product: Canon 302 Magenta Cartridge. Category: Canon. Subcategory: Cartridge. Price: Out Of Stock.

Product: Epson T372 Tri-Color Photo Ink Cartridge. Category: Epson. Subcategory: Cartridge. ",194,428668,428862
3092,sentence,"Category: Epson. Subcategory: Cartridge. Price: Out Of Stock.

Product: Brother LC3717M Magenta Ink Cartridge. Category: Brother. Subcategory: Cartridge. Price: Up Coming.
",172,428821,428993
3093,sentence,"Subcategory: Cartridge. Price: Up Coming.

Product: Brother LC3717BK Black Ink Cartridge. Category: Brother. Subcategory: Cartridge. Price: Up Coming.
",151,428951,429102
3094,sentence,"Subcategory: Cartridge. Price: Up Coming.

Product: Brother LC675XL Yellow Original Ink Cartridge. Category: Brother. Subcategory: Cartridge. Price: Up Coming.
",160,429060,429220
3095,sentence,"Subcategory: Cartridge. Price: Up Coming.

Product: Brother LC675XL Cyan Original Ink Cartridge. Category: Brother. Subcategory: Cartridge. Price: Out Of Stock.
",161,429178,429339
3096,sentence,"Subcategory: Cartridge. Price: Out Of Stock.

Product: Brother LC675XL Magenta Original Ink Cartridge. Category: Brother. Subcategory: Cartridge. Price: Out Of Stock.
",167,429294,429461
3097,sentence,"Subcategory: Cartridge. Price: Out Of Stock.

Product: Brother LC679XL Black Original Ink Cartridge. Category: Brother. Subcategory: Cartridge. Price: Out Of Stock.
",165,429416,429581
3098,sentence,"Subcategory: Cartridge. Price: Out Of Stock.

Product: RICOH MP 3554S Black Print Toner Cartridge. Category: Ricoh. Subcategory: Toner. Price: 7,500৳.
",151,429536,429687
3099,sentence,"Subcategory: Toner. Price: 7,500৳.

Product: RICOH MP 2500S Black Print Toner Cartridge. Category: Ricoh. Subcategory: Toner. Price: 8,000৳.

Product: RICOH MP 2500S Cyan Print Toner Cartridge. ",194,429652,429846
3100,sentence,"Category: Ricoh. Subcategory: Toner. Price: 16,500৳.

Product: RICOH MP 2500S Yellow Print Toner Cartridge. Category: Ricoh. Subcategory: Toner. Price: 16,500৳.
",161,429846,430007
3101,sentence,"Subcategory: Toner. Price: 16,500৳.

Product: RICOH MP 2500S Magenta Print Toner Cartridge. Category: Ricoh. Subcategory: Toner. Price: 16,500৳.

Product: Ricoh MP 2014HS Black Copier Toner. ",191,429971,430162
3102,sentence,"
Product: Ricoh MP 2014HS Black Copier Toner. Category: Ricoh. Subcategory: Toner. Price: Up Coming.

Product: RICOH MP 6054S Black Print Toner Cartridge. Category: Ricoh. Subcategory: Toner. ",192,430116,430308
3103,sentence,"Category: Ricoh. Subcategory: Toner. Price: Out Of Stock.

Product: HP GT53 90-ml Black Original Ink Bottle. Category: Ink Bottle. Price: 950৳.

Product: HP GT52 Cyan Original Ink Bottle. ",188,430271,430459
3104,sentence,"
Product: HP GT52 Cyan Original Ink Bottle. Category: Ink Bottle. Price: 1,000৳1,050৳.

Product: HP GT52 Magenta Original Ink Bottle. Category: Ink Bottle. Price: 1,000৳1,050৳.
",177,430415,430592
3105,sentence,"Category: Ink Bottle. Price: 1,000৳1,050৳.

Product: HP GT52 Yellow Original Ink Bottle. Category: Ink Bottle. Price: 1,000৳1,050৳.

Product: Canon GI-790 Ink Bottle Black. Category: Ink Bottle. ",195,430549,430744
3106,sentence,"Category: Ink Bottle. Price: 1,100৳.

Product: Canon GI-790 Ink Bottle Cyan. Category: Ink Bottle. Price: 1,100৳.

Product: Canon GI-790 Ink Bottle Magenta. Category: Ink Bottle. Price: 1,100৳.
",194,430722,430916
3107,sentence,"Category: Ink Bottle. Price: 1,100৳.

Product: Canon GI-790 Ink Bottle Yellow. Category: Ink Bottle. Price: 1,100৳.

Product: Brother BTD100C Cyan Ink Bottle. Category: Ink Bottle. Price: 1,100৳.
",196,430879,431075
3108,sentence,"Category: Ink Bottle. Price: 1,100৳.

Product: HP 45 Black Original Ink Cartridge (51645AA). Category: HP. Subcategory: Cartridge. Price: 5,000৳5,700৳.

Product: HP 938 Color Cartridge (Full Set). ",197,431038,431235
3109,sentence,"
Product: HP 938 Color Cartridge (Full Set). Category: HP. Subcategory: Cartridge. Price: 16,000৳.

Product: HP 933XL High Yield Magenta Original Ink Cartridge. Category: HP. Subcategory: Cartridge. ",199,431190,431389
3110,sentence,"Category: HP. Subcategory: Cartridge. Price: Out Of Stock.

Product: HP 933XL High Yield Cyan Original Ink Cartridge. Category: HP. Subcategory: Cartridge. Price: Out Of Stock.
",177,431351,431528
3111,sentence,"Subcategory: Cartridge. Price: Out Of Stock.

Product: HP 63 Original Ink Black Cartridge. Category: HP. Subcategory: Cartridge. Price: Out Of Stock.
",150,431483,431633
3112,sentence,"Subcategory: Cartridge. Price: Out Of Stock.

Product: HP 63 Tri-color Original Ink Cartridge. Category: HP. Subcategory: Cartridge. Price: Out Of Stock.
",154,431588,431742
3113,sentence,"Subcategory: Cartridge. Price: Out Of Stock.

Product: HP 678 Tri-color Original Ink Advantage Cartridge. Category: HP. Subcategory: Cartridge. Price: Out Of Stock.
",165,431697,431862
3114,sentence,"Subcategory: Cartridge. Price: Out Of Stock.

Product: HP 678 Black Original Ink Advantage Cartridge. Category: HP. Subcategory: Cartridge. Price: Out Of Stock.
",161,431817,431978
3115,sentence,"Subcategory: Cartridge. Price: Out Of Stock.

Product: HP 932 Officejet Black Ink Cartridge. Category: HP. Subcategory: Cartridge. Price: Out Of Stock.
",152,431933,432085
3116,sentence,"Subcategory: Cartridge. Price: Out Of Stock.

Product: HP 61 Tri-color Original Ink Cartridge. Category: HP. Subcategory: Cartridge. Price: Out Of Stock.
",154,432040,432194
3117,sentence,"Subcategory: Cartridge. Price: Out Of Stock.

Product: HP 933XL High Yield Yellow Original Ink Cartridge. Category: HP. Subcategory: Cartridge. Price: Out Of Stock.
",165,432149,432314
3118,sentence,"Subcategory: Cartridge. Price: Out Of Stock.

Product: HP 61 Black Original Ink Cartridge. Category: HP. Subcategory: Cartridge. Price: Out Of Stock.

Product: Brother BTD100M Magenta Ink Bottle. ",196,432269,432465
3119,sentence,"
Product: Brother BTD100M Magenta Ink Bottle. Category: Brother. Subcategory: Ink Bottle. Price: 1,100৳.

Product: Brother BTD100Y Yellow Ink Bottle. Category: Brother. Subcategory: Ink Bottle. ",194,432419,432613
3120,sentence,"Category: Brother. Subcategory: Ink Bottle. Price: 1,100৳.

Product: Brother BT5000C Cyan Ink Bottle. Category: Brother. Subcategory: Ink Bottle. Price: 1,200৳.
",161,432569,432730
3121,sentence,"Subcategory: Ink Bottle. Price: 1,200৳.

Product: Brother BT5000Y Yellow Ink Bottle. Category: Brother. Subcategory: Ink Bottle. Price: 1,200৳.

Product: Brother BT5000M Megenta Ink Bottle. ",190,432690,432880
3122,sentence,"
Product: Brother BT5000M Megenta Ink Bottle. Category: Brother. Subcategory: Ink Bottle. Price: 1,200৳.

Product: Brother BTD60BK Black Ink Bottle. Category: Brother. Subcategory: Ink Bottle. ",193,432834,433027
3123,sentence,"Category: Brother. Subcategory: Ink Bottle. Price: 1,150৳.

Product: Brother BTD100BK Black Ink Bottle. Category: Brother. Subcategory: Ink Bottle. Price: 1,300৳.
",163,432983,433146
3124,sentence,"Subcategory: Ink Bottle. Price: 1,300৳.

Product: Brother BT6000BK Black Ink Bottle. Category: Brother. Subcategory: Ink Bottle. Price: Out Of Stock.

Product: HP GT53XL 135-ml Black Ink Bottle. ",195,433106,433301
3125,sentence,"
Product: HP GT53XL 135-ml Black Ink Bottle. Category: HP. Subcategory: Ink Bottle. Price: Out Of Stock.

Product: Epson C13-T6732 Cyan Ink Bottle. Category: Epson. Subcategory: Ink Bottle. ",190,433256,433446
3126,sentence,"Category: Epson. Subcategory: Ink Bottle. Price: 1,200৳.

Product: Epson C13-T6734 Yellow Ink Bottle. Category: Epson. Subcategory: Ink Bottle. Price: 1,200৳.
",159,433404,433563
3127,sentence,"Subcategory: Ink Bottle. Price: 1,200৳.

Product: Epson C13T6735 Light Cyan Ink Bottle. Category: Epson. Subcategory: Ink Bottle. Price: 1,200৳.

Product: Epson C13T6731 Black Ink Bottle. ",188,433523,433711
3128,sentence,"
Product: Epson C13T6731 Black Ink Bottle. Category: Epson. Subcategory: Ink Bottle. Price: 1,200৳.

Product: Epson C13T6733 Magenta Ink Bottle. Category: Epson. Subcategory: Ink Bottle. ",187,433668,433855
3129,sentence,"Category: Epson. Subcategory: Ink Bottle. Price: 1,200৳.

Product: Epson C13T6736 Light Magenta Ink Bottle. Category: Epson. Subcategory: Ink Bottle. Price: 1,200৳.
",165,433813,433978
3130,sentence,"Subcategory: Ink Bottle. Price: 1,200৳.

Product: Epson 005 Black Ink Bottle. Category: Epson. Subcategory: Ink Bottle. Price: 1,350৳.

Product: Epson 057 Black Ink Bottle. Category: Epson. ",190,433938,434128
3131,sentence,"Category: Epson. Subcategory: Ink Bottle. Price: 1,250৳.

Product: Epson 057 Ink Cyan Bottle. Category: Epson. Subcategory: Ink Bottle. Price: 1,300৳1,350৳.
",157,434111,434268
3132,sentence,"Subcategory: Ink Bottle. Price: 1,300৳1,350৳.

Product: Epson Perfection V39 II Photo and Document Flatbed Scanner. Category: Epson. Subcategory: Scanner. Price: 8,350৳9,000৳.
",176,434222,434398
3133,sentence,"Subcategory: Scanner. Price: 8,350৳9,000৳.

Product: Epson WorkForce ES-60W Wireless Portable Sheetfed Document Scanner. Category: Epson. Subcategory: Scanner. Price: 31,500৳32,000৳.
",183,434355,434538
3134,sentence,"Subcategory: Scanner. Price: 31,500৳32,000৳.

Product: Epson WorkForce DS-310 Portable Sheet-fed Document Scanner. Category: Epson. Subcategory: Scanner. Price: 37,500৳.
",170,434493,434663
3135,sentence,"Subcategory: Scanner. Price: 37,500৳.

Product: Epson DS-1630 Flatbed and Sheet Fed Color Legal Document Scanner with ADF. Category: Epson. Subcategory: Scanner. Price: 39,000৳40,000৳.
",185,434625,434810
3136,sentence,"Subcategory: Scanner. Price: 39,000৳40,000৳.

Product: Epson DS-530 II Color Duplex Document Scanner. Category: Epson. Subcategory: Scanner. Price: 64,800৳65,000৳.
",164,434765,434929
3137,sentence,"Subcategory: Scanner. Price: 64,800৳65,000৳.

Product: Epson DS-870 Color Duplex Document Scanner. Category: Epson. Subcategory: Scanner. Price: 71,500৳.
",154,434884,435038
3138,sentence,"Subcategory: Scanner. Price: 71,500৳.

Product: Epson DS-770II Color Duplex Document Scanner. Category: Epson. Subcategory: Scanner. Price: 74,500৳.
",149,435000,435149
3139,sentence,"Subcategory: Scanner. Price: 74,500৳.

Product: Epson WorkForce DS-50000 A3 Flatbed Document Scanner. Category: Epson. Subcategory: Scanner. Price: 173,000৳182,000৳.
",166,435111,435277
3140,sentence,"Subcategory: Scanner. Price: 173,000৳182,000৳.

Product: Epson Perfection V850 Pro Color A4 Flatbed Film and Photo Scanner. Category: Epson. Subcategory: Scanner. Price: 185,000৳.
",180,435230,435410
3141,sentence,"Subcategory: Scanner. Price: 185,000৳.

Product: Epson WorkForce DS-60000 A3 Flatbed Document Scanner with Duplex ADF. Category: Epson. Subcategory: Scanner. Price: 360,000৳365,000৳.
",183,435371,435554
3142,sentence,"Subcategory: Scanner. Price: 360,000৳365,000৳.

Product: Epson WorkForce DS-30 Portable Sheet-fed Document Scanner. Category: Epson. Subcategory: Scanner. Price: Up Coming.
",173,435507,435680
3143,sentence,"Subcategory: Scanner. Price: Up Coming.

Product: Epson WorkForce DS-970 A4 Duplex Sheet-fed Document Scanner. Category: Epson. Subcategory: Scanner. Price: Up Coming.
",168,435640,435808
3144,sentence,"Subcategory: Scanner. Price: Up Coming.

Product: Epson Perfection V800 Photo Flatbed Color Scanner (Part#B11B223201). Category: Epson. Subcategory: Scanner. Price: Out Of Stock.
",179,435768,435947
3145,sentence,"Subcategory: Scanner. Price: Out Of Stock.

Product: Epson WorkForce DS-860 Color Document Scanner. Category: Epson. Subcategory: Scanner. Price: Out Of Stock.
",160,435904,436064
3146,sentence,"Subcategory: Scanner. Price: Out Of Stock.

Product: Epson DS-530 Color Duplex Document Scanner. Category: Epson. Subcategory: Scanner. Price: Out Of Stock.
",157,436021,436178
3147,sentence,"Subcategory: Scanner. Price: Out Of Stock.

Product: Canon CanoScan LiDE 300 Flatbed Scanner. Category: Canon. Subcategory: Scanner. Price: 7,800৳8,200৳.

Product: Canon CanoScan LiDE 400 Scanner. ",197,436135,436332
3148,sentence,"
Product: Canon CanoScan LiDE 400 Scanner. Category: Canon. Subcategory: Scanner. Price: 10,800৳11,000৳.

Product: Canon DR-C240 Document Scanner. Category: Canon. Subcategory: Scanner. ",186,436289,436475
3149,sentence,"Category: Canon. Subcategory: Scanner. Price: 64,700৳65,000৳.

Product: Canon imageFORMULA CR-120 Cheque Scanner. Category: Canon. Subcategory: Scanner. Price: 112,000৳115,000৳.
",178,436436,436614
3150,sentence,"Subcategory: Scanner. Price: 112,000৳115,000৳.

Product: Canon GI-71 M Magenta Ink Bottle. Category: Canon. Subcategory: Ink Bottle. Price: 1,250৳.

Product: Canon GI-71 PGBK Black Ink Bottle. ",193,436567,436760
3151,sentence,"
Product: Canon GI-71 PGBK Black Ink Bottle. Category: Canon. Subcategory: Ink Bottle. Price: 1,300৳.

Product: Canon GI-71 C Cyan Ink Bottle. Category: Canon. Subcategory: Ink Bottle. ",185,436715,436900
3152,sentence,"Category: Canon. Subcategory: Ink Bottle. Price: 1,250৳.

Product: Canon GI-71 Y Yellow Ink Bottle. Category: Canon. Subcategory: Ink Bottle. Price: 1,250৳.

Product: Canon PFI-050 Black Ink Bottle. ",199,436858,437057
3153,sentence,"
Product: Canon PFI-050 Black Ink Bottle. Category: Canon. Subcategory: Ink Bottle. Price: 5,000৳.

Product: Canon PFI-050 Cyan Ink Bottle. Category: Canon. Subcategory: Ink Bottle. Price: 5,000৳.
",197,437015,437212
3154,sentence,"Subcategory: Ink Bottle. Price: 5,000৳.

Product: Canon PFI-050 Magenta Ink Bottle. Category: Canon. Subcategory: Ink Bottle. Price: 5,000৳.

Product: Canon PFI-050 Yellow Ink Bottle. ",184,437172,437356
3155,sentence,"
Product: Canon PFI-050 Yellow Ink Bottle. Category: Canon. Subcategory: Ink Bottle. Price: 5,000৳.

Product: Plustek OpticSlim 2610 Plus Flatbed A4 Document Scanner. Category: Plustek. ",186,437313,437499
3156,sentence,"Category: Plustek. Subcategory: Scanner. Price: 6,300৳6,500৳.

Product: Plustek ePhoto Z300 Photo and Document Scanner. Category: Plustek. Subcategory: Scanner. Price: 15,800৳.
",177,437480,437657
3157,sentence,"Subcategory: Scanner. Price: 15,800৳.

Product: Plustek OpticSlim 1680 Flatbed A3 Document Scanner. Category: Plustek. Subcategory: Scanner. Price: 35,600৳36,000৳.
",164,437619,437783
3158,sentence,"Subcategory: Scanner. Price: 35,600৳36,000৳.

Product: Plustek SmartOffice PL3060 A4 ADF Flatbed Scanner. Category: Plustek. Subcategory: Scanner. Price: 36,500৳37,500৳.
",170,437738,437908
3159,sentence,"Subcategory: Scanner. Price: 36,500৳37,500৳.

Product: Plustek MobileOffice S410 Plus Portable Scanner. Category: Plustek. Subcategory: Scanner. Price: Up Coming.
",163,437863,438026
3160,sentence,"Subcategory: Scanner. Price: Up Coming.

Product: Plustek SmartOffice PL4080 Flatbed Document Scanner. Category: Plustek. Subcategory: Scanner. Price: Up Coming.
",162,437986,438148
3161,sentence,"Subcategory: Scanner. Price: Up Coming.

Product: Plustek OpticSlim 2700 A4 Color Flatbed Scanner. Category: Plustek. Subcategory: Scanner. Price: Out Of Stock.
",161,438108,438269
3162,sentence,"Subcategory: Scanner. Price: Out Of Stock.

Product: Plustek SmartOffice PS188 High Speed Document Scanner. Category: Plustek. Subcategory: Scanner. Price: Out Of Stock.
",170,438226,438396
3163,sentence,"Subcategory: Scanner. Price: Out Of Stock.

Product: Plustek OpticSlim 1180 A3 Flatbed Scanner. Category: Plustek. Subcategory: Scanner. Price: Out Of Stock.
",158,438353,438511
3164,sentence,"Subcategory: Scanner. Price: Out Of Stock.

Product: Plustek SmartOffice PN30U Color Scanner. Category: Plustek. Subcategory: Scanner. Price: Out Of Stock.
",156,438468,438624
3165,sentence,"Subcategory: Scanner. Price: Out Of Stock.

Product: HP ScanJet Pro 2600 f1 Scanner with ADF. Category: HP. Subcategory: Scanner. Price: 30,500৳31,000৳.
",153,438581,438734
3166,sentence,"Subcategory: Scanner. Price: 30,500৳31,000৳.

Product: HP ScanJet Pro 2000 s2 Sheet-feed Scanner. Category: HP. Subcategory: Scanner. Price: 45,500৳48,000৳.
",157,438689,438846
3167,sentence,"Subcategory: Scanner. Price: 45,500৳48,000৳.

Product: HP ScanJet Pro 3000 s4 Sheet-feed Scanner. Category: HP. Subcategory: Scanner. Price: 69,500৳70,000৳.
",157,438801,438958
3168,sentence,"Subcategory: Scanner. Price: 69,500৳70,000৳.

Product: HP Scanjet Enterprise Flow 7000 s3 Sheet-Feed Scanner. Category: HP. Subcategory: Scanner. Price: 90,000৳95,000৳.
",169,438913,439082
3169,sentence,"Subcategory: Scanner. Price: 90,000৳95,000৳.

Product: HP ScanJet Pro N4600 fnw1 Wireless Network Scanner. Category: HP. Subcategory: Scanner. Price: 114,000৳115,000৳.
",168,439037,439205
3170,sentence,"Subcategory: Scanner. Price: 114,000৳115,000৳.

Product: HP Digital Sender Flow 8500 fn2 Document Capture Workstation. Category: HP. Subcategory: Scanner. Price: 415,000৳420,000৳.
",180,439158,439338
3171,sentence,"Subcategory: Scanner. Price: 415,000৳420,000৳.

Product: HP ScanJet Pro 3500 f1 Flatbed Scanner. Category: HP. Subcategory: Scanner. Price: Out Of Stock.
",154,439291,439445
3172,sentence,"Subcategory: Scanner. Price: Out Of Stock.

Product: HP ScanJet Pro 3600 f1 Flatbed Scanner. Category: HP. Subcategory: Scanner. Price: Out Of Stock.
",150,439402,439552
3173,sentence,"Subcategory: Scanner. Price: Out Of Stock.

Product: HP ScanJet Pro 4500 fn1 Network Scanner. Category: HP. Subcategory: Scanner. Price: Out Of Stock.
",151,439509,439660
3174,sentence,"Subcategory: Scanner. Price: Out Of Stock.

Product: HP Scanjet Enterprise Flow 7500 Flatbed Scanner. Category: HP. Subcategory: Scanner. Price: Out Of Stock.
",159,439617,439776
3175,sentence,"Subcategory: Scanner. Price: Out Of Stock.

Product: Avision FB10 A4 4800dpi Slim Flatbed Scanner. Category: Scanner. Price: 8,200৳8,500৳.

Product: Brother ADS-3100 Desktop Document Scanner. ",192,439733,439925
3176,sentence,"Category: Scanner. Price: 49,000৳.

Product: Brother ADS-4700W Desktop Document Scanner. Category: Scanner. Price: 65,000৳.

Product: Fujitsu FI-7460 Image Scanner. Category: Fujitsu. ",184,439925,440109
3177,sentence,"Category: Fujitsu. Subcategory: Scanner. Price: Call for Price.

Product: Fujitsu FI-8170 Image Scanner. Category: Fujitsu. Subcategory: Scanner. Price: Call for Price.
",169,440090,440259
3178,sentence,"Subcategory: Scanner. Price: Call for Price.

Product: Fujitsu FI-8150 Image Scanner. Category: Fujitsu. Subcategory: Scanner. Price: Call for Price.

Product: Fujitsu FI-7300NX Image Scanner. ",193,440214,440407
3179,sentence,"
Product: Fujitsu FI-7300NX Image Scanner. Category: Fujitsu. Subcategory: Scanner. Price: Call for Price.

Product: Fujitsu FI-65f Image Scanner. Category: Fujitsu. Subcategory: Scanner. ",188,440364,440552
3180,sentence,"Category: Fujitsu. Subcategory: Scanner. Price: Call for Price.

Product: Fujitsu FI-800r Image Scanner. Category: Fujitsu. Subcategory: Scanner. Price: Call for Price.
",169,440511,440680
3181,sentence,"Subcategory: Scanner. Price: Call for Price.

Product: Fujitsu SP-1120N Image Scanner. Category: Fujitsu. Subcategory: Scanner. Price: Call for Price.

Product: Fujitsu SP-1125N Image Scanner. ",193,440635,440828
3182,sentence,"
Product: Fujitsu SP-1125N Image Scanner. Category: Fujitsu. Subcategory: Scanner. Price: Call for Price.

Product: Kodak E1030 Document Scanner. Category: Kodak. Subcategory: Scanner. ",185,440786,440971
3183,sentence,"Category: Kodak. Subcategory: Scanner. Price: Pre Order.

Product: Kodak E1040 Document Scanner. Category: Kodak. Subcategory: Scanner. Price: Pre Order.

Product: Kodak i3500 Document Scanner. ",194,440932,441126
3184,sentence,"
Product: Kodak i3500 Document Scanner. Category: Kodak. Subcategory: Scanner. Price: Pre Order.

Product: Kodak S2070 Document Scanner. Category: Kodak. Subcategory: Scanner. Price: Pre Order.
",194,441086,441280
3185,sentence,"Subcategory: Scanner. Price: Pre Order.

Product: Kodak S3140 Max Document Scanner. Category: Kodak. Subcategory: Scanner. Price: Pre Order.

Product: Kodak S3120 Max Document Scanner. ",185,441240,441425
3186,sentence,"
Product: Kodak S3120 Max Document Scanner. Category: Kodak. Subcategory: Scanner. Price: Pre Order.

Product: AVISION MiWand 2 Wi-Fi Pro Portable Scanner. Category: Avision. Subcategory: Scanner. ",197,441381,441578
3187,sentence,"Category: Avision. Subcategory: Scanner. Price: Up Coming.

Product: Avision AV332U Sheet fed ADF Scanner. Category: Avision. Subcategory: Scanner. Price: Up Coming.
",166,441537,441703
3188,sentence,"Subcategory: Scanner. Price: Up Coming.

Product: AVISION AD130 Document Scanner. Category: Avision. Subcategory: Scanner. Price: Up Coming.

Product: AVISION FB5000 A3 Flatbed Scanner. ",186,441663,441849
3189,sentence,"
Product: AVISION FB5000 A3 Flatbed Scanner. Category: Avision. Subcategory: Scanner. Price: Up Coming.

Product: AVISION AD345FWN Document Scanner. Category: Avision. Subcategory: Scanner. ",190,441804,441994
3190,sentence,"Category: Avision. Subcategory: Scanner. Price: Up Coming.

Product: Avision FB25 Slim Flatbed Scanner. Category: Avision. Subcategory: Scanner. Price: Out Of Stock.
",166,441953,442119
3191,sentence,"Subcategory: Scanner. Price: Out Of Stock.

Product: AVISION AD120S Document Scanner. Category: Avision. Subcategory: Scanner. Price: Out Of Stock.

Product: AVISION AD120 Document Scanner. ",190,442076,442266
3192,sentence,"
Product: AVISION AD120 Document Scanner. Category: Avision. Subcategory: Scanner. Price: Out Of Stock.

Product: Avision AD340GWN A4 Sheet fed ADF Scanner. Category: Avision. Subcategory: Scanner. ",198,442224,442422
3193,sentence,"Category: Avision. Subcategory: Scanner. Price: Out Of Stock.

Product: AVISION FB6280E A3 Flatbed Book Scanner. Category: Avision. Subcategory: Scanner. Price: Out Of Stock.
",175,442381,442556
3194,sentence,"Subcategory: Scanner. Price: Out Of Stock.

Product: Avision AD250F Flatbed with ADF Scanner. Category: Avision. Subcategory: Scanner. Price: Out Of Stock.
",156,442513,442669
3195,sentence,"Subcategory: Scanner. Price: Out Of Stock.

Product: Avision AD360GWN A4 Sheet fed ADF Scanner. Category: Avision. Subcategory: Scanner. Price: Out Of Stock.
",158,442626,442784
3196,sentence,"Subcategory: Scanner. Price: Out Of Stock.

Product: AVISION AV5400 A3 Duplex Document Scanner. Category: Avision. Subcategory: Scanner. Price: Out Of Stock.
",158,442741,442899
3197,sentence,"Subcategory: Scanner. Price: Out Of Stock.

Product: Avision AD5800 A3 Document Scanner. Category: Avision. Subcategory: Scanner. Price: Out Of Stock.
",151,442856,443007
3198,sentence,"Subcategory: Scanner. Price: Out Of Stock.

Product: AVISION AD6090 A3 Duplex High-Volume Production Scanner. Category: Avision. Subcategory: Scanner. Price: Out Of Stock.
",172,442964,443136
3199,sentence,"Subcategory: Scanner. Price: Out Of Stock.

Product: Brother ADS-2800W Wired and Wireless Duplex Desktop Sheet-fed Scanner with ADF. Category: Brother. Subcategory: Scanner. Price: Out Of Stock.
",195,443093,443288
3200,sentence,"Subcategory: Scanner. Price: Out Of Stock.

Product: Brother ADS-1200 Auto Document Scanner. Category: Brother. Subcategory: Scanner. Price: Out Of Stock.
",155,443245,443400
3201,sentence,"Subcategory: Scanner. Price: Out Of Stock.

Product: Brother ADS-2200 Professional Document Scanner. Category: Brother. Subcategory: Scanner. Price: Out Of Stock.
",163,443357,443520
3202,sentence,"Subcategory: Scanner. Price: Out Of Stock.

Product: Brother ADS-4300N Professional Desktop Document Scanner. Category: Brother. Subcategory: Scanner. Price: Out Of Stock.
",172,443477,443649
3203,sentence,"Subcategory: Scanner. Price: Out Of Stock.

Product: Brother ADS-3000N Desktop Document Scanner. Category: Brother. Subcategory: Scanner. Price: Out Of Stock.
",159,443606,443765
3204,sentence,"Subcategory: Scanner. Price: Out Of Stock.

Product: Brother ADS-3600W Desktop Document Scanner. Category: Brother. Subcategory: Scanner. Price: Out Of Stock.
",159,443722,443881
3205,sentence,"Subcategory: Scanner. Price: Out Of Stock.

Product: Brother ADS-4900W Desktop Document Scanner. Category: Brother. Subcategory: Scanner. Price: Out Of Stock.
",159,443838,443997
3206,sentence,"Subcategory: Scanner. Price: Out Of Stock.

Product: Zebex Z-3250 Handy Wireless CCD Scanner. Category: ZEBEX. Subcategory: Barcode Scanner. Price: Out Of Stock.
",162,443954,444116
3207,sentence,"Price: Out Of Stock.

Product: Zebex Z-3220 Barcode Scanner. Category: ZEBEX. Subcategory: Barcode Scanner. Price: Out Of Stock.

Product: Zebex Z-3100 Barcode Scanner. Category: ZEBEX. ",186,444095,444281
3208,sentence,"Category: ZEBEX. Subcategory: Barcode Scanner. Price: Out Of Stock.

Product: Zebex Z-3151HS High-Speed Laser Handheld Scanner. Category: ZEBEX. Subcategory: Barcode Scanner. Price: Out Of Stock.
",196,444264,444460
3209,sentence,"Price: Out Of Stock.

Product: Zebex Z-3272 2D Image Gun Type Handheld Scanner. Category: ZEBEX. Subcategory: Barcode Scanner. Price: Out Of Stock.
",148,444439,444587
3210,sentence,"Price: Out Of Stock.

Product: Winson WNL-1051 1D Wired Handheld Barcode Scanner. Category: Barcode Scanner. Price: 2,100৳2,250৳.

Product: Sunlux XL-6500 1D Handheld Barcode Scanner. ",184,444566,444750
3211,sentence,"Category: Barcode Scanner. Price: 2,200৳2,400৳.

Product: Yumite YT-100 Barcode Scanner. Category: Barcode Scanner. Price: 2,350৳2,500৳.

Product: Sunlux RH10S 1D/2D Barcode Scanner. ",183,444750,444933
3212,sentence,"
Product: Sunlux RH10S 1D/2D Barcode Scanner. Category: Barcode Scanner. Price: 2,750৳2,850৳.

Product: Winson WNL-5000g 1D Wired Laser Warehouses Handheld Barcode Scanner. ",173,444887,445060
3213,sentence,"Category: Barcode Scanner. Price: 2,600৳3,000৳.

Product: Sunlux XL-3206 2D Wired Barcode Scanner. Category: Barcode Scanner. Price: 2,300৳3,000৳.

Product: Deli ES226 Barcode Scanner. ",185,445060,445245
3214,sentence,"
Product: Deli ES226 Barcode Scanner. Category: Barcode Scanner. Price: 3,300৳.

Product: Sunlux XL-3600 1D/2D Handheld Barcode Scanner. Category: Barcode Scanner. Price: 3,100৳3,400৳.
",185,445207,445392
3215,sentence,"Category: Barcode Scanner. Price: 3,100৳3,400৳.

Product: Sunlux XL-9010 1D/2D Portable Bluetooth Wireless Barcode Scanner. Category: Barcode Scanner. Price: 3,200৳3,500৳.
",172,445344,445516
3216,sentence,"Category: Barcode Scanner. Price: 3,200৳3,500৳.

Product: Deli ES226W Barcode Scanner. Category: Barcode Scanner. Price: 3,800৳.

Product: Deli ES236 Barcode Scanner. Category: Barcode Scanner. ",194,445468,445662
3217,sentence,"Category: Barcode Scanner. Price: 3,800৳.

Product: Deli E14952 Handheld Barcode Scanner. Category: Barcode Scanner. Price: 3,700৳4,000৳.

Product: Sunlux XL-9309B Laser Wireless Barcode Scanner. ",196,445635,445831
3218,sentence,"Category: Barcode Scanner. Price: 4,200৳4,500৳.

Product: Winson WNI-6710g 2D CMOS Wired Handheld Barcode Scanner. Category: Barcode Scanner. Price: Out Of Stock.
",163,445831,445994
3219,sentence,"Category: Barcode Scanner. Price: Out Of Stock.

Product: Sunlux XL-3620S 1D/2D Handheld Barcode Scanner. Category: Barcode Scanner. Price: 4,200৳4,700৳.
",154,445946,446100
3220,sentence,"Category: Barcode Scanner. Price: 4,200৳4,700৳.

Product: Yumite YT-200 1D Wireless Barcode Scanner. Category: Barcode Scanner. Price: 4,750৳5,000৳.

Product: Yumite YT-1000 Barcode Scanner. ",191,446052,446243
3221,sentence,"
Product: Yumite YT-1000 Barcode Scanner. Category: Barcode Scanner. Price: 4,800৳5,000৳.

Product: Winson WNI-S682 2D CMOS Handheld Wireless Barcode Scanner. Category: Barcode Scanner. ",186,446201,446387
3222,sentence,"Category: Barcode Scanner. Price: 4,200৳5,000৳.

Product: Sunlux XL-9221B 2D Wireless Barcode Scanner. Category: Barcode Scanner. Price: 5,000৳.

Product: Deli 14952W Barcode Scanner. ",184,446360,446544
3223,sentence,"
Product: Deli 14952W Barcode Scanner. Category: Deli. Subcategory: Barcode Scanner. Price: Up Coming.

Product: Deli E14884 Stand Barcode Scanner. Category: Deli. Subcategory: Barcode Scanner. ",194,446505,446699
3224,sentence,"Category: Deli. Subcategory: Barcode Scanner. Price: Up Coming.

Product: Winson WNI-7330DPM 2D Handheld Barcode Scanner. Category: Winson. Subcategory: Barcode Scanner. Price: 5,300৳5,800৳.
",191,446653,446844
3225,sentence,"Price: 5,300৳5,800৳.

Product: Winson WNI-6213/V 2D COMS Wireless RF433 Handheld Barcode Scanner. Category: Winson. Subcategory: Barcode Scanner. Price: 5,500৳7,000৳.
",167,446823,446990
3226,sentence,"Price: 5,500৳7,000৳.

Product: Winson WAI-5780 2D CMOS Omnidirectional Barcode Scanner. Category: Winson. Subcategory: Barcode Scanner. Price: 7,600৳10,800৳.
",158,446969,447127
3227,sentence,"Price: 7,600৳10,800৳.

Product: Winson WAI-6000 1D & 2D Omnidirectional Barcode Scanner. Category: Winson. Subcategory: Barcode Scanner. Price: 8,700৳12,000৳.
",159,447105,447264
3228,sentence,"Price: 8,700৳12,000৳.

Product: Winson WAI-7000 1D & 2D Omnidirectional Desktop Barcode Scanner. Category: Winson. Subcategory: Barcode Scanner. Price: 14,000৳15,000৳.
",168,447242,447410
3229,sentence,"Price: 14,000৳15,000৳.

Product: Winson WNI-6802/V 2D CMOS Handheld Wireless Barcode Scanner. Category: Winson. Subcategory: Barcode Scanner. Price: Out Of Stock.
",163,447387,447550
3230,sentence,"Price: Out Of Stock.

Product: Yumite YT-2202 1D/2D Wireless Barcode Scanner. Category: Yumite. Subcategory: Barcode Scanner. Price: 7,200৳8,000৳.
",147,447529,447676
3231,sentence,"Price: 7,200৳8,000৳.

Product: Yumite YT-2402 2D Wireless Barcode Scanner. Category: Yumite. Subcategory: Barcode Scanner. Price: 7,800৳8,000৳.
",144,447655,447799
3232,sentence,"Price: 7,800৳8,000৳.

Product: Yumite YT-2203 1D/2D Wireless Barcode Scanner. Category: Yumite. Subcategory: Barcode Scanner. Price: Out Of Stock.
",147,447778,447925
3233,sentence,"Price: Out Of Stock.

Product: Zebra SYMBOL LS2208 GENERAL PURPOSE BARCODE SCANNER. Category: Zebra. Subcategory: Barcode Scanner. Price: 7,900৳8,300৳.
",152,447904,448056
3234,sentence,"Price: 7,900৳8,300৳.

Product: Zebra DS2208 Corded 1D/2D Handheld Image Barcode Scanner. Category: Zebra. Subcategory: Barcode Scanner. Price: 10,000৳.
",152,448035,448187
3235,sentence,"Subcategory: Barcode Scanner. Price: 10,000৳.

Product: Zebra Symbol DS4208 Image Barcode Scanner. Category: Zebra. Subcategory: Barcode Scanner. Price: 13,500৳14,500৳.
",169,448141,448310
3236,sentence,"Price: 13,500৳14,500৳.

Product: Zebra Symbol DS4308 2D Barcode Scanner. Category: Zebra. Subcategory: Barcode Scanner. Price: 14,200৳14,500৳.
",143,448287,448430
3237,sentence,"Price: 14,200৳14,500৳.

Product: Zebra Symbol DS9308 1D-2D-QR USB Barcode Scanner. Category: Zebra. Subcategory: Barcode Scanner. Price: 14,700৳15,500৳.
",153,448407,448560
3238,sentence,"Price: 14,700৳15,500৳.

Product: Zebra Symbol DS9808-R General Purpose 1D/2D Barcode Scanner. Category: Zebra. Subcategory: Barcode Scanner. Price: 23,000৳23,500৳.
",164,448537,448701
3239,sentence,"Price: 23,000৳23,500৳.

Product: Zebra DS2278 Cordless Handheld 2D Barcode Scanner. Category: Zebra. Subcategory: Barcode Scanner. Price: 27,000৳28,000৳.
",154,448678,448832
3240,sentence,"Price: 27,000৳28,000৳.

Product: Zebra Symbol DS6878-SR Cordless Bluetooth 2D Barcode Scanner. Category: Zebra. Subcategory: Barcode Scanner. Price: 42,800৳44,000৳.
",165,448809,448974
3241,sentence,"Price: 42,800৳44,000৳.

Product: Zebra DS4608 Handheld 2D Barcode Scanner. Category: Zebra. Subcategory: Barcode Scanner. Price: 17,000৳.
",138,448951,449089
3242,sentence,"Subcategory: Barcode Scanner. Price: 17,000৳.

Product: Zebra Symbol LS1203 GENERAL PURPOSE BARCODE SCANNER. Category: Zebra. Subcategory: Barcode Scanner. Price: Out Of Stock.
",177,449043,449220
3243,sentence,"Price: Out Of Stock.

Product: Zebra Symbol DS9208 Barcode Scanner. Category: Zebra. Subcategory: Barcode Scanner. Price: Out Of Stock.
",136,449199,449335
3244,sentence,"Price: Out Of Stock.

Product: Honeywell Eclipse 5145 (1D) Handheld Barcode Scanner. Category: Honeywell. Subcategory: Barcode Scanner. Price: 6,700৳7,500৳.
",157,449314,449471
3245,sentence,"Price: 6,700৳7,500৳.

Product: Honeywell Voyager 1250g General Duty Scanner. Category: Honeywell. Subcategory: Barcode Scanner. Price: 7,500৳9,000৳.
",149,449450,449599
3246,sentence,"Price: 7,500৳9,000৳.

Product: Honeywell Voyager 9520 General Duty Scanners. Category: Honeywell. Subcategory: Barcode Scanner. Price: 11,000৳11,500৳.
",151,449578,449729
3247,sentence,"Price: 11,000৳11,500৳.

Product: Honeywell Voyager MK-9540 Handheld Barcode Scanner. Category: Honeywell. Subcategory: Barcode Scanner. Price: 11,500৳.

Product: Honeywell 1400G 2D Barcode Scanner. ",198,449706,449904
3248,sentence,"
Product: Honeywell 1400G 2D Barcode Scanner. Category: Honeywell. Subcategory: Barcode Scanner. Price: 11,500৳12,000৳.

Product: Honeywell Voyager 1950GSR USB Barcode Scanner. Category: Honeywell. ",198,449858,450056
3249,sentence,"Category: Honeywell. Subcategory: Barcode Scanner. Price: 15,000৳.

Product: Honeywell Voyager XP 1470g Barcode Scanner. Category: Honeywell. Subcategory: Barcode Scanner. Price: 16,000৳.
",188,450035,450223
3250,sentence,"Subcategory: Barcode Scanner. Price: 16,000৳.

Product: Honeywell Xenon MS 1900 2D Barcode Scanner. Category: Honeywell. Subcategory: Barcode Scanner. Price: 16,000৳16,500৳.
",174,450177,450351
3251,sentence,"Price: 16,000৳16,500৳.

Product: Honeywell Voyager 1202g-bf barcode scanner. Category: Honeywell. Subcategory: Barcode Scanner. Price: 20,000৳22,000৳.
",151,450328,450479
3252,sentence,"Price: 20,000৳22,000৳.

Product: Honeywell Xenon 1902 Wireless Barcode Scanner. Category: Honeywell. Subcategory: Barcode Scanner. Price: 31,000৳.

Product: ZKTeco ZKB202S Wireless Barcode Scanner. ",198,450456,450654
3253,sentence,"Category: ZKTeco. Subcategory: Barcode Scanner. Price: 6,435৳.

Product: ZKTeco ZKB201S Barcode Scanner. Category: ZKTeco. Subcategory: Barcode Scanner. Price: Up Coming.
",171,450654,450825
3254,sentence,"Subcategory: Barcode Scanner. Price: Up Coming.

Product: ZKTeco ZKB102S Barcode Scanner. Category: ZKTeco. Subcategory: Barcode Scanner. Price: Up Coming.
",156,450777,450933
3255,sentence,"Subcategory: Barcode Scanner. Price: Up Coming.

Product: Grandstream GRP2601 2-Line 2-SIP Carrier-Grade IP Phone with Adapter. Category: Grandstream. Subcategory: IP Phone. Price: 4,000৳4,200৳.
",195,450885,451080
3256,sentence,"Subcategory: IP Phone. Price: 4,000৳4,200৳.

Product: Grandstream GRP2601P IP Phone With POE & Without Adapter. Category: Grandstream. Subcategory: IP Phone. Price: 4,100৳4,300৳.
",179,451036,451215
3257,sentence,"Subcategory: IP Phone. Price: 4,100৳4,300৳.

Product: Grandstream GXP1610P IP Phone With PoE. Category: Grandstream. Subcategory: IP Phone. Price: 4,300৳.
",155,451171,451326
3258,sentence,"Subcategory: IP Phone. Price: 4,300৳.

Product: Grandstream GRP2601P Basic HD IP Phone With Adapter. Category: Grandstream. Subcategory: IP Phone. Price: 4,500৳.
",162,451288,451450
3259,sentence,"Subcategory: IP Phone. Price: 4,500৳.

Product: Grandstream GRP2602P IP Phone With POE & Without Adapter. Category: Grandstream. Subcategory: IP Phone. Price: 4,950৳5,100৳.
",173,451412,451585
3260,sentence,"Subcategory: IP Phone. Price: 4,950৳5,100৳.

Product: Grandstream GRP2602 2-Line 4-SIP Carrier Grade IP Phone with Adapter. Category: Grandstream. Subcategory: IP Phone. Price: 5,100৳.
",185,451541,451726
3261,sentence,"Subcategory: IP Phone. Price: 5,100৳.

Product: Grandstream GRP2602P Basic HD IP Phone With Adapter. Category: Grandstream. Subcategory: IP Phone. Price: 5,100৳5,500৳.
",168,451688,451856
3262,sentence,"Subcategory: IP Phone. Price: 5,100৳5,500৳.

Product: Grandstream GRP2601W Wi-Fi Essential HD IP Phone. Category: Grandstream. Subcategory: IP Phone. Price: 5,700৳.
",165,451812,451977
3263,sentence,"Subcategory: IP Phone. Price: 5,700৳.

Product: Grandstream GXV3450 16-Line 16-SIP PoE IP Phone. Category: Grandstream. Subcategory: IP Phone. Price: 33,000৳.
",159,451939,452098
3264,sentence,"Subcategory: IP Phone. Price: 33,000৳.

Product: Grandstream GRP2602G 2-Line 4-SIP PoE IP Phone without Adapter. Category: Grandstream. Subcategory: IP Phone. Price: 6,300৳.
",174,452059,452233
3265,sentence,"Subcategory: IP Phone. Price: 6,300৳.

Product: Grandstream GHP611W Wireless Hotel IP Phone with Adapter. Category: Grandstream. Subcategory: IP Phone. Price: 6,700৳.
",167,452195,452362
3266,sentence,"Subcategory: IP Phone. Price: 6,700৳.

Product: Grandstream GRP2604 3-Line 6-SIP Carrier Grade IP Phone with Adapter. Category: Grandstream. Subcategory: IP Phone. Price: 7,500৳.
",179,452324,452503
3267,sentence,"Subcategory: IP Phone. Price: 7,500৳.

Product: Grandstream GRP2604P 3-Line 6-SIP Carrier Grade IP Phone With POE. Category: Grandstream. Subcategory: IP Phone. Price: 8,100৳.
",176,452465,452641
3268,sentence,"Subcategory: IP Phone. Price: 8,100৳.

Product: Grandstream GHP621W Wireless Hotel IP Phone. Category: Grandstream. Subcategory: IP Phone. Price: 8,400৳.

Product: Grandstream GRP2612P HD IP Phone. ",198,452603,452801
3269,sentence,"
Product: Grandstream GRP2612P HD IP Phone. Category: Grandstream. Subcategory: IP Phone. Price: 8,200৳.

Product: Grandstream GRP2602W WiFi 2-Line 4-SIP Carrier Grade IP Phone. ",178,452757,452935
3270,sentence,"Category: Grandstream. Subcategory: IP Phone. Price: 8,500৳.

Product: Grandstream GRP2613 HD IP Phone. Category: Grandstream. Subcategory: IP Phone. Price: 9,500৳.
",165,452935,453100
3271,sentence,"Subcategory: IP Phone. Price: 9,500৳.

Product: Grandstream GXP2135 Enterprise IP Phone. Category: Grandstream. Subcategory: IP Phone. Price: 10,800৳11,300৳.
",158,453062,453220
3272,sentence,"Subcategory: IP Phone. Price: 10,800৳11,300৳.

Product: Grandstream GXP2130 Mid Range HD IP Phone. Category: Grandstream. Subcategory: IP Phone. Price: 11,300৳.
",161,453174,453335
3273,sentence,"Subcategory: IP Phone. Price: 11,300৳.

Product: Grandstream GRP2612W HD IP Phone. Category: Grandstream. Subcategory: IP Phone. Price: 11,500৳12,000৳.
",152,453296,453448
3274,sentence,"Subcategory: IP Phone. Price: 11,500৳12,000৳.

Product: Sunlux XL-9600 Laser Wireless Barcode Scanner. Category: Sunlux. Subcategory: Barcode Scanner. Price: 5,500৳6,000৳.
",172,453402,453574
3275,sentence,"Price: 5,500৳6,000৳.

Product: Sunlux RD10 2D Desktop Barcode Scanner. Category: Sunlux. Subcategory: Barcode Scanner. Price: 5,000৳6,200৳.

Product: Sunlux XL-2610 Desktop Barcode Scanner. ",190,453553,453743
3276,sentence,"Category: Sunlux. Subcategory: Barcode Scanner. Price: 8,000৳8,300৳.

Product: Sunlux XL-3610 1D/2D Handheld Barcode Scanner. Category: Sunlux. Subcategory: Barcode Scanner. Price: Up Coming.
",192,453743,453935
3277,sentence,"Subcategory: Barcode Scanner. Price: Up Coming.

Product: Sunlux XL-2600 Desktop Barcode Scanner. Category: Sunlux. Subcategory: Barcode Scanner. Price: Up Coming.
",164,453887,454051
3278,sentence,"Subcategory: Barcode Scanner. Price: Up Coming.

Product: Sunlux XL-2302 Desktop Barcode Scanner. Category: Sunlux. Subcategory: Barcode Scanner. Price: Up Coming.
",164,454003,454167
3279,sentence,"Subcategory: Barcode Scanner. Price: Up Coming.

Product: Sunlux XL-9620C 2D Wireless Handheld Barcode Scanner With Stand. Category: Sunlux. Subcategory: Barcode Scanner. Price: Out Of Stock.
",192,454119,454311
3280,sentence,"Price: Out Of Stock.

Product: Cisco CP-3905 Unified IP Phone. Category: Cisco. Subcategory: IP Phone. Price: Out Of Stock.

Product: Cisco 6821 IP Phone for MPP Systems. Category: Cisco. ",188,454290,454478
3281,sentence,"Category: Cisco. Subcategory: IP Phone. Price: Out Of Stock.

Product: Cisco 8811 IP Phone with Multiplatform Phone Firmware. Category: Cisco. Subcategory: IP Phone. Price: Out Of Stock.
",187,454461,454648
3282,sentence,"Subcategory: IP Phone. Price: Out Of Stock.

Product: Cisco 7821 IP Phone with Multiplatform Phone firmware. Category: Cisco. Subcategory: IP Phone. Price: Out Of Stock.
",170,454604,454774
3283,sentence,"Subcategory: IP Phone. Price: Out Of Stock.

Product: Cisco 8845 IP Phone with Camera. Category: Cisco. Subcategory: IP Phone. Price: Out Of Stock.

Product: Flyingvoice P10 2 SIP IP Phone. ",190,454730,454920
3284,sentence,"
Product: Flyingvoice P10 2 SIP IP Phone. Category: IP Phone. Price: 3,800৳4,000৳.

Product: Flyingvoice P10P 2 SIP PoE IP Phone. Category: IP Phone. Price: 3,800৳4,000৳.
",171,454878,455049
3285,sentence,"Category: IP Phone. Price: 3,800৳4,000৳.

Product: Snom D305 PoE Desk IP Phone Set. Category: IP Phone. Price: 4,300৳.

Product: DINSTAR C62UP Color Screen IP Phone with POE & Without Adapter. ",193,455008,455201
3286,sentence,"Category: IP Phone. Price: 4,800৳.

Product: Flyingvoice FIP11CP 3 SIP PoE IP Phone. Category: IP Phone. Price: 5,000৳.

Product: Flyingvoice P11P 2 SIP PoE IP Phone. Category: IP Phone. ",187,455201,455388
3287,sentence,"Category: IP Phone. Price: 5,000৳5,200৳.

Product: Flyingvoice P11W 2 SIP Wireless IP Phone. Category: IP Phone. Price: 5,300৳5,500৳.
",134,455368,455502
3288,sentence,"Category: IP Phone. Price: 5,300৳5,500৳.

Product: DINSTAR C60U-W Wi-Fi IP Phone with POE & Without Adapter. Category: IP Phone. Price: 5,700৳.
",144,455461,455605
3289,sentence,"Category: IP Phone. Price: 5,700৳.

Product: DINSTAR C63GP Color Screen IP Phone with POE & Without Adapter. Category: IP Phone. Price: 6,000৳.
",144,455570,455714
3290,sentence,"Category: IP Phone. Price: 6,000৳.

Product: DINSTAR C63GP Color Screen IP Phone with POE & With Adapter. Category: IP Phone. Price: 6,500৳.

Product: Avaya J129 3PCC IP Phone. Category: Avaya. ",194,455679,455873
3291,sentence,"Category: Avaya. Subcategory: IP Phone. Price: Out Of Stock.

Product: Avaya J139 3PCC IP Phone. Category: Avaya. Subcategory: IP Phone. Price: Out Of Stock.
",158,455856,456014
3292,sentence,"Subcategory: IP Phone. Price: Out Of Stock.

Product: SEWOO NBS-7250 1D Barcode Scanner. Category: SEWOO. Subcategory: Barcode Scanner. Price: 5,600৳7,500৳.
",157,455970,456127
3293,sentence,"Price: 5,600৳7,500৳.

Product: SEWOO NBS-8580 2D Bluetooth Barcode Scanner. Category: SEWOO. Subcategory: Barcode Scanner. Price: Out Of Stock.

Product: SEWOO NBS-8202 2D Barcode Scanner. ",189,456106,456295
3294,sentence,"
Product: SEWOO NBS-8202 2D Barcode Scanner. Category: SEWOO. Subcategory: Barcode Scanner. Price: 13,000৳.

Product: DINSTAR C64GP High-end Business IP Phone with POE & Without Adapter. ",187,456250,456437
3295,sentence,"Category: DINSTAR. Subcategory: IP Phone. Price: 8,500৳.

Product: DINSTAR C66GP High-end Business SIP Phone with POE & Without Adapter. Category: DINSTAR. Subcategory: IP Phone. Price: 9,500৳.
",194,456437,456631
3296,sentence,"Subcategory: IP Phone. Price: 9,500৳.

Product: DINSTAR C66GP High-end Business SIP Phone with POE & With Adapter. Category: DINSTAR. Subcategory: IP Phone. Price: 9,800৳.
",172,456593,456765
3297,sentence,"Subcategory: IP Phone. Price: 9,800৳.

Product: DINSTAR A810 Android Video IP Phone. Category: DINSTAR. Subcategory: IP Phone. Price: 50,000৳.
",143,456727,456870
3298,sentence,"Subcategory: IP Phone. Price: 50,000৳.

Product: DINSTAR C60SP Entry Level IP Phone with POE & Without Adapter. Category: DINSTAR. Subcategory: IP Phone. Price: Up Coming.
",172,456831,457003
3299,sentence,"Subcategory: IP Phone. Price: Up Coming.

Product: DINSTAR C60SP Entry Level IP Phone with POE & With Adapter. Category: DINSTAR. Subcategory: IP Phone. Price: Up Coming.
",171,456962,457133
3300,sentence,"Subcategory: IP Phone. Price: Up Coming.

Product: DINSTAR C64GP High-end Business IP Phone with POE & With Adapter. Category: DINSTAR. Subcategory: IP Phone. Price: Out Of Stock.
",180,457092,457272
3301,sentence,"Subcategory: IP Phone. Price: Out Of Stock.

Product: DINSTAR C62UP Color Screen IP Phone with POE & With Adapter. Category: DINSTAR. Subcategory: IP Phone. Price: Out Of Stock.
",178,457228,457406
3302,sentence,"Subcategory: IP Phone. Price: Out Of Stock.

Product: DINSTAR C60UP Entry Level IP Phone with POE & Without Adapter. Category: DINSTAR. Subcategory: IP Phone. Price: Out Of Stock.
",180,457362,457542
3303,sentence,"Subcategory: IP Phone. Price: Out Of Stock.

Product: DINSTAR C61SP Entry Level IP Phone with POE & Without Adapter. Category: DINSTAR. Subcategory: IP Phone. Price: Out Of Stock.
",180,457498,457678
3304,sentence,"Subcategory: IP Phone. Price: Out Of Stock.

Product: DINSTAR C60UP Entry Level IP Phone with POE & With Adapter. Category: DINSTAR. Subcategory: IP Phone. Price: Out Of Stock.
",177,457634,457811
3305,sentence,"Subcategory: IP Phone. Price: Out Of Stock.

Product: DINSTAR C61SP Entry Level IP Phone with POE & With Adapter. Category: DINSTAR. Subcategory: IP Phone. Price: Out Of Stock.
",177,457767,457944
3306,sentence,"Subcategory: IP Phone. Price: Out Of Stock.

Product: Mitel MiVoice Office 470 Basic IPABX System for 20 User. Category: Mitel. Subcategory: PABX System. Price: 125,000৳.
",171,457900,458071
3307,sentence,"Subcategory: PABX System. Price: 125,000৳.

Product: Mitel MiVoice Office 470 Basic IPABX System for 50 User. Category: Mitel. Subcategory: PABX System. Price: 250,000৳.
",170,458028,458198
3308,sentence,"Subcategory: PABX System. Price: 250,000৳.

Product: Mitel MiVoice Office 470 Basic IPABX System for 100 User. Category: Mitel. Subcategory: PABX System. Price: 450,000৳.
",171,458155,458326
3309,sentence,"Subcategory: PABX System. Price: 450,000৳.

Product: Mitel MiVoice Office 470 Basic IPABX System for 150 User. Category: Mitel. Subcategory: PABX System. Price: 650,000৳.
",171,458283,458454
3310,sentence,"Subcategory: PABX System. Price: 650,000৳.

Product: Mitel MiVoice Office 470 Basic IPABX System for 200 User. Category: Mitel. Subcategory: PABX System. Price: 850,000৳.
",171,458411,458582
3311,sentence,"Subcategory: PABX System. Price: 850,000৳.

Product: Snom D717 PoE Desk IP Phone Set. Category: Snom. Subcategory: IP Phone. Price: 9,500৳.

Product: Snom D345 PoE Desk IP Phone Set. Category: Snom. ",199,458539,458738
3312,sentence,"Category: Snom. Subcategory: IP Phone. Price: 13,500৳.

Product: Snom M55 Cordless IP Phone with Cradle. Category: Snom. Subcategory: IP Phone. Price: Up Coming.
",162,458722,458884
3313,sentence,"Subcategory: IP Phone. Price: Up Coming.

Product: Snom M30 Cordless IP Phone with Cradle. Category: Snom. Subcategory: IP Phone. Price: Up Coming.

Product: Snom C520 3-SIP PoE Conference IP Phone. ",199,458843,459042
3314,sentence,"Category: Snom. Subcategory: IP Phone. Price: Up Coming.

Product: Snom D3 Extension Module for SNOM D3xx Series. Category: Snom. Subcategory: IP Phone. Price: Up Coming.
",171,459042,459213
3315,sentence,"Subcategory: IP Phone. Price: Up Coming.

Product: Snom D335 PoE Desk IP Phone Set. Category: Snom. Subcategory: IP Phone. Price: 14,000৳.

Product: Snom D862 PoE Desk IP Phone Set. Category: Snom. ",198,459172,459370
3316,sentence,"Category: Snom. Subcategory: IP Phone. Price: 22,000৳.

Product: Mitel 6867i SIP Phone (80C00002AAA-A). Category: Mitel. Subcategory: IP Phone. Price: Call for Price.
",167,459354,459521
3317,sentence,"Subcategory: IP Phone. Price: Call for Price.

Product: Mitel 6863i SIP Phone (80C00005AAA-A). Category: Mitel. Subcategory: IP Phone. Price: Out Of Stock.
",156,459475,459631
3318,sentence,"Subcategory: IP Phone. Price: Out Of Stock.

Product: Mitel 6873i SIP Phone (50006790). Category: Mitel. Subcategory: IP Phone. Price: Out Of Stock.

Product: Flyingvoice FIP14G 8 SIP PoE IP Phone. ",198,459587,459785
3319,sentence,"
Product: Flyingvoice FIP14G 8 SIP PoE IP Phone. Category: Flyingvoice. Subcategory: IP Phone. Price: 8,500৳8,900৳.

Product: Flyingvoice FIP15G Plus 10 SIP PoE Touch Screen IP Phone. ",184,459736,459920
3320,sentence,"Category: Flyingvoice. Subcategory: IP Phone. Price: Up Coming.

Product: Flyingvoice FIP16Plus Portable Wireless IP Phone. Category: Flyingvoice. Subcategory: IP Phone. Price: Up Coming.
",188,459920,460108
3321,sentence,"Subcategory: IP Phone. Price: Up Coming.

Product: Flyingvoice P10G 2 SIP Gigabit PoE IP Phone. Category: Flyingvoice. Subcategory: IP Phone. Price: Up Coming.
",160,460067,460227
3322,sentence,"Subcategory: IP Phone. Price: Up Coming.

Product: Flyingvoice P10W 2 SIP Dual Band IP Phone. Category: Flyingvoice. Subcategory: IP Phone. Price: Up Coming.
",158,460186,460344
3323,sentence,"Subcategory: IP Phone. Price: Up Coming.

Product: Flyingvoice P11 2 SIP IP Phone. Category: Flyingvoice. Subcategory: IP Phone. Price: Up Coming.
",147,460303,460450
3324,sentence,"Subcategory: IP Phone. Price: Up Coming.

Product: Flyingvoice P11G 2 SIP Gigabit PoE IP Phone. Category: Flyingvoice. Subcategory: IP Phone. Price: Up Coming.
",160,460409,460569
3325,sentence,"Subcategory: IP Phone. Price: Up Coming.

Product: Flyingvoice P23GW 8 SIP Gigabit IP Phone. Category: Flyingvoice. Subcategory: IP Phone. Price: Up Coming.
",157,460528,460685
3326,sentence,"Subcategory: IP Phone. Price: Up Coming.

Product: Flyingvoice FIP11C 3 SIP IP Phone. Category: Flyingvoice. Subcategory: IP Phone. Price: Up Coming.

Product: Flyingvoice FIP13G 4 SIP PoE IP Phone. ",199,460644,460843
3327,sentence,"
Product: Flyingvoice FIP13G 4 SIP PoE IP Phone. Category: Flyingvoice. Subcategory: IP Phone. Price: Up Coming.

Product: DINSTAR UC100-1S1O VoIP PBX for SME. Category: PABX System. Price: 19,000৳.
",199,460794,460993
3328,sentence,"Category: PABX System. Price: 19,000৳.

Product: DINSTAR UC200 Pro IP PBX System. Category: PABX System. Price: 24,000৳.

Product: DINSTAR UC120-1S1O VoIP PBX. Category: PABX System. Price: 25,000৳.
",199,460954,461153
3329,sentence,"Category: PABX System. Price: 25,000৳.

Product: Grandstream GCC6010W Wireless WiFi 6 IP PBX System. Category: PABX System. Price: 40,000৳.

Product: Grandstream UCM6301 500 User IP PBX VoIP Supply. ",199,461114,461313
3330,sentence,"Category: PABX System. Price: 42,000৳.

Product: Grandstream GXW4224 Analog 24 FXS Port VoIP Gateway. Category: PABX System. Price: 68,000৳.

Product: Grandstream UCM6302 IP-PBX Phone System. ",192,461313,461505
3331,sentence,"Category: PABX System. Price: 72,000৳.

Product: Grandstream GXW4232 32 FXS Port VoIP Gateway. Category: PABX System. Price: 78,000৳.

Product: DINSTAR UC350-100 High-end IP PBX. ",179,461505,461684
3332,sentence,"
Product: DINSTAR UC350-100 High-end IP PBX. Category: PABX System. Price: 110,000৳.

Product: Grandstream UCM6510 IP PBX VoIP Supply. Category: PABX System. Price: 150,000৳.
",175,461639,461814
3333,sentence,"Category: PABX System. Price: 150,000৳.

Product: Panasonic KX-TDA100D Hybrid IP-PBX System. Category: PABX System. Price: 160,000৳.

Product: DINSTAR UC350-200 High-end IP PBX. ",178,461774,461952
3334,sentence,"
Product: DINSTAR UC350-200 High-end IP PBX. Category: PABX System. Price: 175,000৳.

Product: Grandstream HA100 IP PABX Server. Category: PABX System. Price: Pre Order.
",170,461907,462077
3335,sentence,"Category: PABX System. Price: Pre Order.

Product: Zycoo CooVox T200 IP PBX System Without Module. Category: PABX System. Price: Up Coming.

Product: Zycoo CooVox T100-S IP PBX System. ",185,462036,462221
3336,sentence,"
Product: Zycoo CooVox T100-S IP PBX System. Category: PABX System. Price: Up Coming.

Product: Zycoo CooVox T100-A202 IP PBX System. Category: Zycoo. Subcategory: PABX System. Price: Up Coming.
",195,462176,462371
3337,sentence,"Subcategory: PABX System. Price: Up Coming.

Product: Grandstream UCM6204 IP PBX VoIP Supply. Category: Grandstream. Subcategory: PABX System. Price: Out Of Stock.
",164,462327,462491
3338,sentence,"Subcategory: PABX System. Price: Out Of Stock.

Product: Grandstream UCM6202 IP PBX VoIP Supply. Category: Grandstream. Subcategory: PABX System. Price: Out Of Stock.
",167,462444,462611
3339,sentence,"Subcategory: PABX System. Price: Out Of Stock.

Product: Grandstream UCM6208 IP PBX VoIP Supply. Category: Grandstream. Subcategory: PABX System. Price: Out Of Stock.
",167,462564,462731
3340,sentence,"Subcategory: PABX System. Price: Out Of Stock.

Product: Kington KT-168 Multi-Currency Detection Machine. Category: Kington. Subcategory: Money Counting Machine. Price: 7,000৳7,800৳.
",183,462684,462867
3341,sentence,"Price: 7,000৳7,800৳.

Product: Kington Plus AL 6600W Premium Money Counting Machine. Category: Kington. Subcategory: Money Counting Machine. Price: 14,500৳.
",157,462846,463003
3342,sentence,"Price: 14,500৳.

Product: Kington Plus 7200T Pro Max Money Counting Machine. Category: Kington. Subcategory: Money Counting Machine. Price: 13,500৳15,000৳.
",156,462987,463143
3343,sentence,"Price: 13,500৳15,000৳.

Product: Kington Plus 6600T Pro Max Money Counting Machine. Category: Kington. Subcategory: Money Counting Machine. Price: 15,500৳.
",156,463120,463276
3344,sentence,"Price: 15,500৳.

Product: Kington Plus AL-6900T Pro Max Money Counting Machine. Category: Kington. Subcategory: Money Counting Machine. Price: 17,000৳18,000৳.
",159,463260,463419
3345,sentence,"Price: 17,000৳18,000৳.

Product: Kington Plus AL 6700T Pro Max Money Counting Machine. Category: Kington. Subcategory: Money Counting Machine. Price: 18,000৳20,000৳.
",166,463396,463562
3346,sentence,"Price: 18,000৳20,000৳.

Product: Kington JB-2000S Money Counting Machine. Category: Kington. Subcategory: Money Counting Machine. Price: 108,000৳118,000৳.
",155,463539,463694
3347,sentence,"Price: 108,000৳118,000৳.

Product: Kington NC-3000 Money Counting Machine. Category: Kington. Subcategory: Money Counting Machine. Price: Up Coming.

Product: Kington KT-900 Money Counting Machine. ",198,463669,463867
3348,sentence,"
Product: Kington KT-900 Money Counting Machine. Category: Kington. Subcategory: Money Counting Machine. Price: Out Of Stock.

Product: APOLLO AP-800S Money Counting Machine. Category: Apollo. ",193,463818,464011
3349,sentence,"Category: Apollo. Subcategory: Money Counting Machine. Price: Out Of Stock.

Product: Domens DMS-1580T Automatic Money Counter Machine. Category: Domens. Subcategory: Money Counting Machine. ",191,463993,464184
3350,sentence,"Subcategory: Money Counting Machine. Price: Up Coming.

Product: Domens DMS-1380T Automatic Money Counter Machine. Category: Domens. Subcategory: Money Counting Machine. Price: Up Coming.
",188,464147,464335
3351,sentence,"Price: Up Coming.

Product: Domens DMS-1180T Automatic Money Counter Machine. Category: Domens. Subcategory: Money Counting Machine. Price: Up Coming.
",151,464317,464468
3352,sentence,"Price: Up Coming.

Product: Domens DMS-1080T Automatic Money Counter Machine. Category: Domens. Subcategory: Money Counting Machine. Price: Up Coming.
",151,464450,464601
3353,sentence,"Price: Up Coming.

Product: Domens DMS-9200 Automatic Money Counter Machine. Category: Domens. Subcategory: Money Counting Machine. Price: Out Of Stock.
",153,464583,464736
3354,sentence,"Price: Out Of Stock.

Product: Chihua CH-600A Money Counting Machine. Category: Chihua. Subcategory: Money Counting Machine. Price: 215,000৳239,500৳.

Product: Yumite 5800UD Money Counter Machine. ",197,464715,464912
3355,sentence,"
Product: Yumite 5800UD Money Counter Machine. Category: Yumite. Subcategory: Money Counting Machine. Price: 13,500৳.

Product: Yumite MCM-650 Money Counter Machine. Category: Yumite. ",184,464865,465049
3356,sentence,"Category: Yumite. Subcategory: Money Counting Machine. Price: 135,000৳.

Product: Yumite VE-870 Vacuum Money Counter Machine. Category: Yumite. Subcategory: Money Counting Machine. Price: 140,000৳.
",198,465031,465229
3357,sentence,"Price: 140,000৳.

Product: Safescan s15 LED Type UV Detector. Category: Money Counting Machine. Price: 2,200৳2,500৳.

Product: Safescan s20 Money Counting Machine With Fake Note Detector. ",188,465212,465400
3358,sentence,"Category: Money Counting Machine. Price: 12,500৳.

Product: Deli E3904 Money Counting Machine. Category: Money Counting Machine. Price: 13,000৳.
",145,465400,465545
3359,sentence,"Price: 13,000৳.

Product: Julong SY-100 Desktop Money Counting Machine. Category: Money Counting Machine. Price: 13,000৳14,000৳.
",129,465529,465658
3360,sentence,"Price: 13,000৳14,000৳.

Product: Safescan S6300 Money Counting Machine With Fake Note Detector. Category: Money Counting Machine. Price: 14,000৳.

Product: Maxsell Mx-600 Money Counting Machine. ",195,465635,465830
3361,sentence,"
Product: Maxsell Mx-600 Money Counting Machine. Category: Money Counting Machine. Price: 100,000৳.

Product: Tay-Chian TC-2000S Money Counting Machine. Category: Money Counting Machine. ",187,465781,465968
3362,sentence,"Category: Money Counting Machine. Price: 116,000৳135,000৳.

Product: Namibind Turbojet Floor Standing Money Counting Machine. Category: Namibind. Subcategory: Money Counting Machine. ",183,465934,466117
3363,sentence,"Subcategory: Money Counting Machine. Price: Out Of Stock.

Product: Deli ET001 15L Paper Shredder. Category: Deli. Subcategory: Paper Shredder. Price: 12,000৳13,000৳.
",167,466080,466247
3364,sentence,"Price: 12,000৳13,000৳.

Product: Deli E9952 23L Paper Shredder. Category: Deli. Subcategory: Paper Shredder. Price: 15,000৳16,000৳.

Product: Deli E9917-EU 31L Paper Shredder. Category: Deli. ",192,466224,466416
3365,sentence,"Category: Deli. Subcategory: Paper Shredder. Price: 27,500৳29,000৳.

Product: Deli ET099 25 Sheets 31L Paper Shredder. Category: Deli. Subcategory: Paper Shredder. Price: 28,500৳31,000৳.
",187,466400,466587
3366,sentence,"Price: 28,500৳31,000৳.

Product: Deli E9911-EU 16L Paper Shredder. Category: Deli. Subcategory: Paper Shredder. Price: Up Coming.

Product: Deli E9903-EU 23L Paper Shredder. Category: Deli. ",190,466564,466754
3367,sentence,"Category: Deli. Subcategory: Paper Shredder. Price: Up Coming.

Product: Deli ET089 30L Paper Shredder. Category: Deli. Subcategory: Paper Shredder. Price: Up Coming.
",167,466738,466905
3368,sentence,"Subcategory: Paper Shredder. Price: Up Coming.

Product: Deli 9904 8 Sheet Paper Shredder. Category: Deli. Subcategory: Paper Shredder. Price: Up Coming.

Product: Deli 9914 6 Sheet Paper Shredder. ",198,466858,467056
3369,sentence,"
Product: Deli 9914 6 Sheet Paper Shredder. Category: Deli. Subcategory: Paper Shredder. Price: Up Coming.

Product: Deli 9902 Paper Shredder. Category: Deli. Subcategory: Paper Shredder. ",188,467012,467200
3370,sentence,"Category: Deli. Subcategory: Paper Shredder. Price: Up Coming.

Product: Deli 9905 Paper Shredder. Category: Deli. Subcategory: Paper Shredder. Price: Up Coming.

Product: Deli 9906 Paper Shredder. ",198,467155,467353
3371,sentence,"
Product: Deli 9906 Paper Shredder. Category: Deli. Subcategory: Paper Shredder. Price: Up Coming.

Product: Deli 9932 2 Sheet Mini Paper Shredder. Category: Deli. Subcategory: Paper Shredder. ",193,467317,467510
3372,sentence,"Category: Deli. Subcategory: Paper Shredder. Price: Out Of Stock.

Product: Deli ET016 Paper Shredder. Category: Deli. Subcategory: Paper Shredder. Price: Out Of Stock.
",169,467465,467634
3373,sentence,"Price: Out Of Stock.

Product: Deli 9915 Anion Paper Shredder. Category: Deli. Subcategory: Paper Shredder. Price: Out Of Stock.

Product: Deli E14400 30L Paper Shredder. Category: Deli. ",187,467613,467800
3374,sentence,"Category: Deli. Subcategory: Paper Shredder. Price: Out Of Stock.

Product: Deli E14403 Paper Shredder. Category: Deli. Subcategory: Paper Shredder. Price: Out Of Stock.
",170,467784,467954
3375,sentence,"Price: Out Of Stock.

Product: OFITECH OS1205C Paper Shredder Machine. Category: Paper Shredder. Price: 12,500৳13,500৳.

Product: Ofitech OS1801Ci Elite Heavy Duty Paper Shredder. ",180,467933,468113
3376,sentence,"Category: Paper Shredder. Price: 21,300৳22,500৳.

Product: Ofitech OS2502Ci Paper Shredder. Category: Paper Shredder. Price: 29,000৳31,000৳.

Product: Ofitech OS1201D Paper Shredder. ",183,468113,468296
3377,sentence,"
Product: Ofitech OS1201D Paper Shredder. Category: Paper Shredder. Price: Up Coming.

Product: Aurora AS1219CE Paper Shredder. Category: Paper Shredder. Price: Up Coming.
",172,468254,468426
3378,sentence,"Category: Paper Shredder. Price: Up Coming.

Product: Xtreme OS1501-12C MaxShred 12 Sheets Cross Cut Paper Shredder. Category: Paper Shredder. Price: Up Coming.
",161,468382,468543
3379,sentence,"Category: Paper Shredder. Price: Up Coming.

Product: Aurora AS2030CD Paper Shredder. Category: Paper Shredder. Price: Up Coming.

Product: Aurora AS1060SB Paper Shredder. Category: Paper Shredder. ",198,468499,468697
3380,sentence,"Category: Paper Shredder. Price: Out Of Stock.

Product: Xtreme OS2502Ci 25 Sheets Cross Cut Paper Shredder. Category: Xtreme. Subcategory: Paper Shredder. Price: Out Of Stock.
",177,468671,468848
3381,sentence,"Price: Out Of Stock.

Product: OFITECH OS808-9M Micro Cut Paper Shredder. Category: Ofitech. Subcategory: Paper Shredder. Price: Out Of Stock.

Product: Insta360 X3 Waterproof 360 Action Camera. ",195,468827,469022
3382,sentence,"Category: Insta360. Subcategory: Action Camera. Price: 43,440৳46,900৳.

Product: Insta360 Ace Pro 8K Waterproof Action Camera. Category: Insta360. Subcategory: Action Camera. Price: 42,900৳46,300৳.
",198,469022,469220
3383,sentence,"Price: 42,900৳46,300৳.

Product: Insta360 X4 Waterproof 8K 360 Action Camera. Category: Insta360. Subcategory: Action Camera. Price: 54,500৳62,000৳.
",149,469197,469346
3384,sentence,"Price: 54,500৳62,000৳.

Product: Insta360 X5 Waterproof 8K 360° Action Camera. Category: Insta360. Subcategory: Action Camera. Price: 65,900৳71,000৳.
",150,469323,469473
3385,sentence,"Price: 65,900৳71,000৳.

Product: Insta360 X5 Starter Bundle 8K 360° Action Camera. Category: Insta360. Subcategory: Action Camera. Price: 72,500৳77,000৳.
",154,469450,469604
3386,sentence,"Price: 72,500৳77,000৳.

Product: Insta360 ONE RS 4K Edition Waterproof Action Camera. Category: Insta360. Subcategory: Action Camera. Price: Out Of Stock.
",155,469581,469736
3387,sentence,"Price: Out Of Stock.

Product: Insta360 Ace Pro 2 8K AI-Powered Action Camera. Category: Insta360. Subcategory: Action Camera. Price: Out Of Stock.
",148,469715,469863
3388,sentence,"Price: Out Of Stock.

Product: Insta360 X5 Essentials Bundle Action Camera. Category: Insta360. Subcategory: Action Camera. Price: 78,690৳84,000৳.
",147,469842,469989
3389,sentence,"Price: 78,690৳84,000৳.

Product: Insta360 ONE RS Twin Edition Waterproof Action Camera. Category: Insta360. Subcategory: Action Camera. Price: Out Of Stock.
",157,469966,470123
3390,sentence,"Price: Out Of Stock.

Product: DJI Osmo Action 5 Pro Standard Combo Action Camera. Category: DJI. Subcategory: Action Camera. Price: 42,000৳.
",142,470102,470244
3391,sentence,"Subcategory: Action Camera. Price: 42,000৳.

Product: DJI Osmo Action 5 Pro Adventure Combo Action Camera. Category: DJI. Subcategory: Action Camera. Price: 51,000৳60,000৳.
",173,470200,470373
3392,sentence,"Price: 51,000৳60,000৳.

Product: DJI Osmo 360 Adventure Combo. Category: DJI. Subcategory: Action Camera. Price: 59,400৳64,000৳.

Product: DJI Osmo 360 Standard Combo. Category: DJI. ",183,470350,470533
3393,sentence,"Category: DJI. Subcategory: Action Camera. Price: Up Coming.

Product: DJI Action 2 Power Combo 128GB Storage 4K Action Camera. Category: DJI. Subcategory: Action Camera. Price: Out Of Stock.
",192,470518,470710
3394,sentence,"Price: Out Of Stock.

Product: DJI Osmo Action 3 Standard Combo Action Camera. Category: DJI. Subcategory: Action Camera. Price: Out Of Stock.
",143,470689,470832
3395,sentence,"Price: Out Of Stock.

Product: DJI Action 2 Dual-Screen Combo 4K Action Camera. Category: DJI. Subcategory: Action Camera. Price: Out Of Stock.
",144,470811,470955
3396,sentence,"Price: Out Of Stock.

Product: DJI Osmo Action 4 Standard Combo Action Camera. Category: DJI. Subcategory: Action Camera. Price: Out Of Stock.
",143,470934,471077
3397,sentence,"Price: Out Of Stock.

Product: DJI Osmo Action 3 Adventure Combo Action Camera. Category: DJI. Subcategory: Action Camera. Price: Out Of Stock.
",144,471056,471200
3398,sentence,"Price: Out Of Stock.

Product: DJI Osmo Action 4 Adventure Combo Action Camera. Category: DJI. Subcategory: Action Camera. Price: Out Of Stock.
",144,471179,471323
3399,sentence,"Price: Out Of Stock.

Product: DJI Osmo Pocket 3 Gimbal Stabilizer Action Camera. Category: DJI. Subcategory: Action Camera. Price: 56,000৳60,400৳.
",148,471302,471450
3400,sentence,"Price: 56,000৳60,400৳.

Product: DJI Osmo Pocket 3 Creator Combo 3 Axis Gimbal Stabilizer Action Camera. Category: DJI. Subcategory: Action Camera. Price: 69,499৳75,500৳.
",171,471427,471598
3401,sentence,"Price: 69,499৳75,500৳.

Product: DJI Osmo Pocket 2 Creator Combo 3 Axis Gimbal Stabilizer Action Camera. Category: DJI. Subcategory: Action Camera. Price: Out Of Stock.
",169,471575,471744
3402,sentence,"Price: Out Of Stock.

Product: Akaso EK7000 12MP 4K WiFi Action Camera. Category: AKASO. Subcategory: Action Camera. Price: 8,500৳9,000৳.
",138,471723,471861
3403,sentence,"Price: 8,500৳9,000৳.

Product: AKASO Brave 7 LE 20MP 4K Waterproof Dual Screen Wi-Fi Remote Control Action Camera. Category: AKASO. Subcategory: Action Camera. Price: 14,200৳15,000৳.
",183,471840,472023
3404,sentence,"Price: 14,200৳15,000৳.

Product: AKASO V50X 20MP 4K Waterproof Touch Screen Wifi Action Camera. Category: AKASO. Subcategory: Action Camera. Price: 10,700৳18,000৳.
",164,472000,472164
3405,sentence,"Price: 10,700৳18,000৳.

Product: Akaso EK7000 Pro 16MP 4K Ultra HD Waterproof Touch Screen WiFi Remote Control Action Camera. Category: AKASO. Subcategory: Action Camera. Price: Out Of Stock.
",192,472141,472333
3406,sentence,"Price: Out Of Stock.

Product: AKASO Brave 7 20MP 4K Waterproof Touch Screen Wifi Remote Control Action Camera. Category: AKASO. Subcategory: Action Camera. Price: Out Of Stock.
",178,472312,472490
3407,sentence,"Price: Out Of Stock.

Product: GoPro HERO13 27MP Waterproof Touch Screen 5.3K Action Camera. Category: GoPro. Subcategory: Action Camera. Price: 44,500৳57,500৳.
",161,472469,472630
3408,sentence,"Price: 44,500৳57,500৳.

Product: GoPro Media Mod for HERO9/HERO10/HERO11 Black. Category: GoPro. Subcategory: Action Camera. Price: Out Of Stock.
",146,472607,472753
3409,sentence,"Price: Out Of Stock.

Product: GoPro HERO9 Black 20MP 5K Ultra HD Touch Screen Waterproof Action Camera. Category: GoPro. Subcategory: Action Camera. Price: Out Of Stock.
",171,472732,472903
3410,sentence,"Price: Out Of Stock.

Product: GoPro HERO10 Black 23MP 5.3K Ultra HD Waterproof Touch Screen Action Camera with Accessories Bundle. Category: GoPro. Subcategory: Action Camera. Price: Out Of Stock.
",198,472882,473080
3411,sentence,"Price: Out Of Stock.

Product: GoPro HERO11 Black 27MP 5.3K Waterproof Touch Screen Action Camera. Category: GoPro. Subcategory: Action Camera. Price: Out Of Stock.
",165,473059,473224
3412,sentence,"Price: Out Of Stock.

Product: GoPro HERO12 27MP Waterproof Touch Screen 5.3K Action Camera. Category: GoPro. Subcategory: Action Camera. Price: Out Of Stock.
",159,473203,473362
3413,sentence,"Price: Out Of Stock.

Product: GoPro HERO11 Black Creator Edition 27MP 5.3K Waterproof Touch Screen Action Camera. Category: GoPro. Subcategory: Action Camera. Price: Out Of Stock.
",181,473341,473522
3414,sentence,"Price: Out Of Stock.

Product: GoPro HERO12 Creator Edition 27MP Waterproof Touch Screen 5.3K Action Camera. Category: GoPro. Subcategory: Action Camera. Price: Out Of Stock.
",175,473501,473676
3415,sentence,"Price: Out Of Stock.

Product: SJCAM SJ4000 Air Full Hd Wi-Fi Waterproof Sports Action Camera. Category: Action Camera. Subcategory: Camera. Price: 4,500৳4,700৳.
",162,473655,473817
3416,sentence,"Subcategory: Camera. Price: 4,500৳4,700৳.

Product: CB77 4G Portable Body Camera. Category: Action Camera. Subcategory: Camera. Price: 3,800৳4,800৳.

Product: S11 4G Portable Body Camera. ",188,473775,473963
3417,sentence,"
Product: S11 4G Portable Body Camera. Category: Action Camera. Subcategory: Camera. Price: 4,400৳4,800৳.

Product: CS05 1080P Wi-Fi Body Camera. Category: Action Camera. Subcategory: Camera. ",192,473924,474116
3418,sentence,"Category: Action Camera. Subcategory: Camera. Price: 2,800৳3,000৳.

Product: CS06 1080P Wi-Fi Body Camera. Category: Action Camera. Subcategory: Camera. Price: 3,150৳4,500৳.
",174,474070,474244
3419,sentence,"Subcategory: Camera. Price: 3,150৳4,500৳.

Product: L15 Ultra HD 4K Wifi Portable Body Camera. Category: Action Camera. Subcategory: Camera. Price: 4,500৳6,000৳.
",162,474202,474364
3420,sentence,"Subcategory: Camera. Price: 4,500৳6,000৳.

Product: CS07 1080P Wi-Fi Body Camera. Category: Action Camera. Subcategory: Camera. Price: 2,100৳3,000৳.

Product: CS11 2K Wi-Fi Body Camera. ",186,474322,474508
3421,sentence,"
Product: CS11 2K Wi-Fi Body Camera. Category: Action Camera. Subcategory: Camera. Price: 3,250৳3,500৳.

Product: CS12 1440P Wi-Fi Body Camera. Category: Action Camera. Subcategory: Camera. ",190,474471,474661
3422,sentence,"Category: Action Camera. Subcategory: Camera. Price: 4,400৳6,000৳.

Product: L13 1080P Wi-Fi Body Camera. Category: Action Camera. Subcategory: Camera. Price: 3,400৳4,500৳.
",173,474615,474788
3423,sentence,"Subcategory: Camera. Price: 3,400৳4,500৳.

Product: A100 1080P Wi-Fi Body Camera. Category: Action Camera. Subcategory: Camera. Price: 3,250৳4,500৳.

Product: A32 1080P Wi-Fi Body Camera. ",188,474746,474934
3424,sentence,"
Product: A32 1080P Wi-Fi Body Camera. Category: Action Camera. Subcategory: Camera. Price: 3,300৳5,000৳.

Product: A18 1080P Wi-Fi Body Camera. Category: Action Camera. Subcategory: Camera. ",191,474895,475086
3425,sentence,"Category: Action Camera. Subcategory: Camera. Price: 2,400৳3,500৳.

Product: MC81 1080P Wi-Fi Body Camera. Category: Action Camera. Subcategory: Camera. Price: 4,200৳6,000৳.
",174,475040,475214
3426,sentence,"Subcategory: Camera. Price: 4,200৳6,000৳.

Product: SJCAM SJ4000 Dual Screen Full HD WiFi Waterproof Sports Action Camera. Category: Action Camera. Subcategory: Camera. Price: 6,000৳6,200৳.
",190,475172,475362
3427,sentence,"Subcategory: Camera. Price: 6,000৳6,200৳.

Product: Ausek AT-S9R Combo 4K WiFi Action Camera. Category: Action Camera. Subcategory: Camera. Price: 6,200৳7,200৳.
",161,475320,475481
3428,sentence,"Subcategory: Camera. Price: 6,200৳7,200৳.

Product: Ausek AT-M40R Combo 5K Wifi Waterproof Action Camera. Category: Action Camera. Subcategory: Camera. Price: 6,200৳8,000৳.
",173,475439,475612
3429,sentence,"Subcategory: Camera. Price: 6,200৳8,000৳.

Product: AUSEK AT-Q60TR Combo 4K Dual Screen WiFi Action Camera. Category: Action Camera. Subcategory: Camera. Price: 7,200৳8,500৳.
",175,475570,475745
3430,sentence,"Subcategory: Camera. Price: 7,200৳8,500৳.

Product: Ausek AT-M40R Touch Combo 5K WiFi Waterproof Action Camera. Category: Action Camera. Subcategory: Camera. Price: 6,990৳8,500৳.
",179,475703,475882
3431,sentence,"Subcategory: Camera. Price: 6,990৳8,500৳.

Product: Ausek AT-M40R Touch Wireless Mic Combo 5K WiFi Waterproof Action Camera. Category: Action Camera. Subcategory: Camera. Price: 7,400৳8,500৳.
",192,475840,476032
3432,sentence,"Subcategory: Camera. Price: 7,400৳8,500৳.

Product: SJCAM SJ6 Legend 16MP 4K Wi-Fi Waterproof Touch Screen Sports Action Camera. Category: SJCAM. Subcategory: Action Camera. Price: 10,000৳11,000৳.
",197,475990,476187
3433,sentence,"Price: 10,000৳11,000৳.

Product: SJCAM SJ8 Dual Screen Sports Action Camera. Category: SJCAM. Subcategory: Action Camera. Price: 9,800৳11,200৳.
",144,476164,476308
3434,sentence,"Price: 9,800৳11,200৳.

Product: SJCAM SJ6 Pro 24MP 4K Wi-Fi Dual Screen Waterproof Sports Action Camera. Category: SJCAM. Subcategory: Action Camera. Price: 11,000৳11,800৳.
",173,476286,476459
3435,sentence,"Price: 11,000৳11,800৳.

Product: SJCAM A20 Wearable Multipurpose Portable Body Camera. Category: SJCAM. Subcategory: Action Camera. Price: 13,490৳15,000৳.
",155,476436,476591
3436,sentence,"Price: 13,490৳15,000৳.

Product: SJCAM SJ10X 12MP 4K Wi-Fi Waterproof Action Camera. Category: SJCAM. Subcategory: Action Camera. Price: 13,200৳19,000৳.
",153,476568,476721
3437,sentence,"Price: 13,200৳19,000৳.

Product: SJCAM A50 20MP 4K Portable Body Camera. Category: SJCAM. Subcategory: Action Camera. Price: 15,800৳21,000৳.

Product: SJCAM SJ20 Dual Lens WiFi Action Camera. ",192,476698,476890
3438,sentence,"Category: SJCAM. Subcategory: Action Camera. Price: 20,990৳26,000৳.

Product: SJCAM SJ8 Air Wi-Fi Waterproof Action Camera. Category: SJCAM. Subcategory: Action Camera. Price: Up Coming.
",187,476890,477077
3439,sentence,"Subcategory: Action Camera. Price: Up Coming.

Product: SJCAM C200 4K WiFi Waterproof Action Camera. Category: SJCAM. Subcategory: Action Camera. Price: Up Coming.
",164,477031,477195
3440,sentence,"Subcategory: Action Camera. Price: Up Coming.

Product: SJCAM C400 4K 16MP Handheld Action Camera. Category: SJCAM. Subcategory: Action Camera. Price: 19,900৳26,000৳.
",167,477149,477316
3441,sentence,"Price: 19,900৳26,000৳.

Product: SJCAM C200 4K 16M 6-Axis Gyroscope Stabilization Waterproof Action Camera. Category: SJCAM. Subcategory: Action Camera. Price: 8,800৳9,800৳.
",174,477293,477467
3442,sentence,"Price: 8,800৳9,800৳.

Product: SJCAM SJ11 Active 4K Dual Screen WiFi Waterproof Action Camera. Category: SJCAM. Subcategory: Action Camera. Price: 14,100৳16,000৳.
",163,477446,477609
3443,sentence,"Price: 14,100৳16,000৳.

Product: SJCAM C300 4K Dual Screen WiFi Action Camera. Category: SJCAM. Subcategory: Action Camera. Price: 12,900৳17,000৳.
",147,477586,477733
3444,sentence,"Price: 12,900৳17,000৳.

Product: SJCAM SJ8 Pro 12MP 4K Wi-Fi Dual Screen Waterproof Action Camera. Category: SJCAM. Subcategory: Action Camera. Price: Out Of Stock.
",165,477710,477875
3445,sentence,"Price: Out Of Stock.

Product: SJCAM C100 Plus 4K Portable Action Camera. Category: SJCAM. Subcategory: Action Camera. Price: Out Of Stock.

Product: SJCAM SJ20 Dual Lens WiFi Action Camera Combo. ",197,477854,478051
3446,sentence,"Category: SJCAM. Subcategory: Action Camera. Price: Out Of Stock.

Product: Feiyu Pocket 3 Cordless Detachable 3-Axis Gimbal Camera. Category: Feiyu. Subcategory: Action Camera. ",178,478051,478229
3447,sentence,"Category: Feiyu. Subcategory: Action Camera. Price: 32,450৳35,000৳.

Product: ORDRO M3 5K Gimbal Stabilizer Action Camera. Category: ORDRO. Subcategory: Action Camera. Price: 20,900৳24,000৳.
",191,478184,478375
3448,sentence,"Price: 20,900৳24,000৳.

Product: ORDRO M5 5K 3 Axis Gimbal Stabilizer Action Camera. Category: ORDRO. Subcategory: Action Camera. Price: 23,900৳28,500৳.
",153,478352,478505
3449,sentence,"Price: 23,900৳28,500৳.

Product: Ausek AT-M44R 5K Wifi Waterproof Action Camera. Category: AUSEK. Subcategory: Action Camera. Price: 5,900৳9,000৳.
",147,478482,478629
3450,sentence,"Price: 5,900৳9,000৳.

Product: Ausek AT-M82TR 6k WiFi Waterproof Action Camera. Category: AUSEK. Subcategory: Action Camera. Price: 11,800৳16,000৳.
",148,478608,478756
3451,sentence,"Price: 11,800৳16,000৳.

Product: Ausek AT-M86TR 8k WiFi Waterproof Action Camera. Category: AUSEK. Subcategory: Action Camera. Price: 16,000৳.
",143,478733,478876
3452,sentence,"Subcategory: Action Camera. Price: 16,000৳.

Product: Ausek AT-S84T 6K 30fps Waterproof Action Camera. Category: AUSEK. Subcategory: Action Camera. Price: Up Coming.
",166,478832,478998
3453,sentence,"Subcategory: Action Camera. Price: Up Coming.

Product: AUSEK AT-M60TR Combo 5K Waterproof Action Camera. Category: AUSEK. Subcategory: Action Camera. Price: Out Of Stock.
",172,478952,479124
3454,sentence,"Price: Out Of Stock.

Product: AUSEK AT-S81TR Wireless Waterproof Action Camera. Category: AUSEK. Subcategory: Action Camera. Price: Out Of Stock.
",147,479103,479250
3455,sentence,"Price: Out Of Stock.

Product: Ausek AT-S81TR Combo 5K 30fps EIS Waterproof Action Camera. Category: AUSEK. Subcategory: Action Camera. Price: Out Of Stock.
",157,479229,479386
3456,sentence,"Price: Out Of Stock.

Product: Ausek AT-S81TR Wireless Mic Combo 5K WIFI Action Camera. Category: AUSEK. Subcategory: Action Camera. Price: Out Of Stock.
",154,479365,479519
3457,sentence,"Price: Out Of Stock.

Product: Blisbond GO3 4K Portable Action Camera. Category: Blisbond. Subcategory: Action Camera. Price: 7,600৳9,000৳.
",140,479498,479638
3458,sentence,"Price: 7,600৳9,000৳.

Product: Blisbond Pro3 4K Portable Dual-Screen Action Camera. Category: Blisbond. Subcategory: Action Camera. Price: 12,400৳15,000৳.
",155,479617,479772
3459,sentence,"Price: 12,400৳15,000৳.

Product: Blisbond Fly3 4K Wi-Fi Waterproof Action Camera. Category: Blisbond. Subcategory: Action Camera. Price: 14,800৳18,000৳.
",153,479749,479902
3460,sentence,"Price: 14,800৳18,000৳.

Product: TELESIN Allin BOX Portable Storage Charger for GoPro Hero 9/10/11 with 2 Batteries. Category: Action Camera Accessories. Subcategory: Action Camera. Price: 4,600৳.
",197,479879,480076
3461,sentence,"Subcategory: Action Camera. Price: 4,600৳.

Product: Insta360 GO 2 Lens Guard. Category: Action Camera Accessories. Subcategory: Action Camera. Price: 803৳.

Product: Insta360 GO 2 Easy Clip. ",192,480033,480225
3462,sentence,"Price: 803৳.

Product: Insta360 GO 2 Easy Clip. Category: Action Camera Accessories. Subcategory: Action Camera. Price: 803৳.

Product: Insta360 GO 2 Pet Strap Mount. ",167,480177,480344
3463,sentence,"
Product: Insta360 GO 2 Pet Strap Mount. Category: Action Camera Accessories. Subcategory: Action Camera. Price: 803৳.

Product: Insta360 X3 Action Camera Lens Cap. ",165,480303,480468
3464,sentence,"
Product: Insta360 X3 Action Camera Lens Cap. Category: Action Camera Accessories. Subcategory: Action Camera. Price: 580৳990৳.

Product: Insta360 ONE RS Action Camera Lens Cap. ",178,480422,480600
3465,sentence,"Category: Action Camera Accessories. Subcategory: Action Camera. Price: 1,490৳.

Product: TELESIN Professional 45M Waterproof Diving Case For GoPro Hero9. Category: Action Camera Accessories. ",192,480600,480792
3466,sentence,"Category: Action Camera Accessories. Subcategory: Action Camera. Price: 1,249৳1,600৳.

Product: Insta360 ONE X2 Carry Case. Category: Action Camera Accessories. Subcategory: Action Camera. ",189,480755,480944
3467,sentence,"Subcategory: Action Camera. Price: 1,617৳.

Product: Insta360 One RS Mounting Bracket. Category: Action Camera Accessories. Subcategory: Action Camera. Price: 2,410৳.
",167,480916,481083
3468,sentence,"Subcategory: Action Camera. Price: 2,410৳.

Product: Insta360 ONE RS Cold Shoe. Category: Action Camera Accessories. Subcategory: Action Camera. Price: 2,410৳.
",160,481040,481200
3469,sentence,"Subcategory: Action Camera. Price: 2,410৳.

Product: Insta360 All-Purpose Mini Tripod. Category: Action Camera Accessories. Subcategory: Action Camera. Price: 2,999৳3,300৳.
",173,481157,481330
3470,sentence,"Price: 2,999৳3,300৳.

Product: Insta360 2-In-1 Invisible Selfie Stick & Tripod. Category: Action Camera Accessories. Subcategory: Action Camera. Price: Out Of Stock.
",166,481309,481475
3471,sentence,"Price: Out Of Stock.

Product: Insta360 ONE RS Core Battery Base. Category: Action Camera Accessories. Subcategory: Action Camera. Price: 2,800৳3,320৳.

Product: Insta360 One X2 Fast Charging Hub. ",197,481454,481651
3472,sentence,"
Product: Insta360 One X2 Fast Charging Hub. Category: Action Camera Accessories. Subcategory: Action Camera. Price: 4,015৳.
",125,481606,481731
3473,sentence,"Subcategory: Action Camera. Price: 4,015৳.

Product: TELESIN 3 Slots Battery Charger For GoPro Hero 9/10 with 2 Pcs Batteries Set. Category: Action Camera Accessories. Subcategory: Action Camera. ",196,481688,481884
3474,sentence,"Subcategory: Action Camera. Price: 4,200৳.

Product: Insta360 ONE RS Dive Case for 4K Boost Lens. Category: Action Camera Accessories. Subcategory: Action Camera. Price: 6,050৳.
",178,481856,482034
3475,sentence,"Subcategory: Action Camera. Price: 6,050৳.

Product: K&F Concept GOPRO HERO9/10 Action Camera HD Filter Set (ND8+ND16+ND32+CPL). Category: Action Camera Accessories. Subcategory: Action Camera. ",194,481991,482185
3476,sentence,"Subcategory: Action Camera. Price: 8,000৳9,500৳.

Product: Insta360 ONE RS Core Bundle with One RS Core, Battery and Frame. Category: Action Camera Accessories. Subcategory: Action Camera. ",189,482157,482346
3477,sentence,"Subcategory: Action Camera. Price: 27,900৳.

Product: Insta360 Motorcycle Mount Bundle. Category: Action Camera Accessories. Subcategory: Action Camera. Price: Out Of Stock.
",174,482318,482492
3478,sentence,"Price: Out Of Stock.

Product: GoPro Dual Battery Charger + Enduro 2 Pack Batteries. Category: Action Camera Accessories. Subcategory: Action Camera. Price: 12,500৳13,500৳.
",173,482471,482644
3479,sentence,"Price: 12,500৳13,500৳.

Product: Canon EF-S 18-55mm f/3.5-5.6 III Camera Lens. Category: Camera Lenses. Subcategory: Camera. Price: 8,000৳8,500৳.

Product: CANON EF-S 18-55mm f/3.5-5.6 IS STM Lens. ",198,482621,482819
3480,sentence,"Category: Camera Lenses. Subcategory: Camera. Price: 10,500৳11,000৳.

Product: Sony E PZ 16-50mm f/3.5-5.6 OSS Camera Lens. Category: Camera Lenses. Subcategory: Camera. Price: 15,500৳16,000৳.
",193,482819,483012
3481,sentence,"Subcategory: Camera. Price: 15,500৳16,000৳.

Product: Canon EF 50mm f/1.8 STM Lens. Category: Camera Lenses. Subcategory: Camera. Price: 16,500৳19,000৳.
",153,482968,483121
3482,sentence,"Subcategory: Camera. Price: 16,500৳19,000৳.

Product: FUJIFILM XC 15-45mm f/3.5-5.6 OIS PZ Camera Lens. Category: Camera Lenses. Subcategory: Camera. Price: 17,500৳18,000৳.
",173,483077,483250
3483,sentence,"Subcategory: Camera. Price: 17,500৳18,000৳.

Product: Nikon NIKKOR Z DX 16-50mm f/3.5-6.3 VR Lens. Category: Camera Lenses. Subcategory: Camera. Price: 13,000৳15,000৳.
",168,483206,483374
3484,sentence,"Subcategory: Camera. Price: 13,000৳15,000৳.

Product: Nikon AF-S Nikkor 50mm f/1.8G Lens. Category: Camera Lenses. Subcategory: Camera. Price: 26,000৳30,000৳.
",159,483330,483489
3485,sentence,"Subcategory: Camera. Price: 26,000৳30,000৳.

Product: Sony E 55-210mm f/4.5-6.3 OSS Lens. Category: Camera Lenses. Subcategory: Camera. Price: 25,500৳29,500৳.
",159,483445,483604
3486,sentence,"Subcategory: Camera. Price: 25,500৳29,500৳.

Product: Sony FE 28-60mm f/4-5.6 Camera Lens. Category: Camera Lenses. Subcategory: Camera. Price: 29,000৳33,000৳.

Product: Sony E 50mm f/1.8 OSS Lens. ",198,483560,483758
3487,sentence,"
Product: Sony E 50mm f/1.8 OSS Lens. Category: Camera Lenses. Subcategory: Camera. Price: 29,000৳32,000৳.

Product: Nikon AF-S DX NIKKOR 18-140mm f/3.5-5.6G ED VR Lens. Category: Camera Lenses. ",195,483720,483915
3488,sentence,"Category: Camera Lenses. Subcategory: Camera. Price: 29,000৳30,500৳.

Product: Sony FE 50mm f/1.8 Full Frame Lens. Category: Camera Lenses. Subcategory: Camera. Price: 29,000৳30,500৳.
",184,483890,484074
3489,sentence,"Subcategory: Camera. Price: 29,000৳30,500৳.

Product: Sony FE 28-70mm f/3.5-5.6 OSS Camera Lens. Category: Camera Lenses. Subcategory: Camera. Price: 33,000৳42,000৳.
",166,484030,484196
3490,sentence,"Subcategory: Camera. Price: 33,000৳42,000৳.

Product: Nikon NIKKOR Z 24-50mm f/4-6.3 Lens. Category: Camera Lenses. Subcategory: Camera. Price: 24,000৳28,000৳.
",160,484152,484312
3491,sentence,"Subcategory: Camera. Price: 24,000৳28,000৳.

Product: Nikon NIKKOR Z DX 24mm f/1.7 Lens. Category: Camera Lenses. Subcategory: Camera. Price: 37,000৳38,000৳.
",158,484268,484426
3492,sentence,"Subcategory: Camera. Price: 37,000৳38,000৳.

Product: Canon RF-S 55-210mm f/5-7.1 IS STM Lens. Category: Camera Lenses. Subcategory: Camera. Price: 39,000৳40,000৳.
",164,484382,484546
3493,sentence,"Subcategory: Camera. Price: 39,000৳40,000৳.

Product: Nikon NIKKOR Z DX 50-250mm f/4.5-6.3 VR Lens. Category: Camera Lenses. Subcategory: Camera. Price: 38,000৳40,000৳.
",169,484502,484671
3494,sentence,"Subcategory: Camera. Price: 38,000৳40,000৳.

Product: FUJIFILM XF 35mm f/2 R WR Camera Lens. Category: Camera Lenses. Subcategory: Camera. Price: 42,000৳43,000৳.
",162,484627,484789
3495,sentence,"Subcategory: Camera. Price: 42,000৳43,000৳.

Product: Nikon NIKKOR Z 28mm f/2.8 SE Lens. Category: Camera Lenses. Subcategory: Camera. Price: 31,000৳38,000৳.
",158,484745,484903
3496,sentence,"Subcategory: Camera. Price: 31,000৳38,000৳.

Product: Nikon NIKKOR Z 28-75mm f/2.8 Camera Lens. Category: Camera Lenses. Subcategory: Camera. Price: 100,000৳112,000৳.
",167,484859,485026
3497,sentence,"Subcategory: Camera. Price: 100,000৳112,000৳.

Product: Sony FE 85mm F/1.8 Lens. Category: Sony. Subcategory: Camera Lenses. Price: 50,500৳58,000৳.

Product: Sony E PZ 18-105mm f/4G OSS Lens. ",192,484980,485172
3498,sentence,"
Product: Sony E PZ 18-105mm f/4G OSS Lens. Category: Sony. Subcategory: Camera Lenses. Price: 57,000৳60,000৳.

Product: Sony E 18-135mm f/3.5-5.6 OSS Camera Lens. Category: Sony. ",180,485128,485308
3499,sentence,"Category: Sony. Subcategory: Camera Lenses. Price: 58,500৳64,000৳.

Product: Sony Sonnar T FE 55mm F1.8 ZA Lens. Category: Sony. Subcategory: Camera Lenses. Price: 59,000৳63,000৳.
",180,485292,485472
3500,sentence,"Price: 59,000৳63,000৳.

Product: Sony E 10-18mm f/4 OSS Camera Lens. Category: Sony. Subcategory: Camera Lenses. Price: 67,000৳68,000৳.

Product: Sony Vario-Tessar T* FE 24-70mm f/4 ZA OSS Lens. ",195,485449,485644
3501,sentence,"Category: Sony. Subcategory: Camera Lenses. Price: 65,000৳72,000৳.

Product: Sony FE 20mm f/1.8 G Camera Lens. Category: Sony. Subcategory: Camera Lenses. Price: 85,000৳95,000৳.
",178,485644,485822
3502,sentence,"Price: 85,000৳95,000৳.

Product: Sony FE 24-105mm f-4 G OSS Camera Lens. Category: Sony. Subcategory: Camera Lenses. Price: 99,000৳107,000৳.

Product: Sony FE 90mm f/2.8 Macro G OSS Lens. ",188,485799,485987
3503,sentence,"
Product: Sony FE 90mm f/2.8 Macro G OSS Lens. Category: Sony. Subcategory: Camera Lenses. Price: 90,000৳100,000৳.

Product: Sony FE 24mm f/1.4 GM Camera Lens. Category: Sony. ",176,485940,486116
3504,sentence,"Category: Sony. Subcategory: Camera Lenses. Price: 123,000৳130,000৳.

Product: Sony FE 85mm f/1.4 GM Lens. Category: Sony. Subcategory: Camera Lenses. Price: 135,000৳145,000৳.
",176,486100,486276
3505,sentence,"Price: 135,000৳145,000৳.

Product: Sony FE 14mm f/1.8 GM Lens. Category: Sony. Subcategory: Camera Lenses. Price: 140,000৳142,000৳.

Product: Sony FE 35mm f/1.8 Full Frame Lens. Category: Sony. ",194,486251,486445
3506,sentence,"Category: Sony. Subcategory: Camera Lenses. Price: 62,500৳70,000৳.

Product: Sony FE 35mm f/1.4 GM Lens. Category: Sony. Subcategory: Camera Lenses. Price: 126,000৳135,000৳.
",174,486429,486603
3507,sentence,"Price: 126,000৳135,000৳.

Product: Nikon AF-S NIKKOR 85mm f/1.8G Lens. Category: Nikon. Subcategory: Camera Lenses. Price: 45,000৳49,000৳.

Product: Nikon NIKKOR Z 24-70mm f4 S Camera Lens. ",190,486578,486768
3508,sentence,"Category: Nikon. Subcategory: Camera Lenses. Price: 62,000৳65,000৳.

Product: Nikon NIKKOR Z 35mm f/1.8 S Lens. Category: Nikon. Subcategory: Camera Lenses. Price: 75,000৳80,000৳.
",180,486768,486948
3509,sentence,"Price: 75,000৳80,000৳.

Product: Nikon NIKKOR Z 85mm f/1.8 S Lens. Category: Nikon. Subcategory: Camera Lenses. Price: 78,000৳85,000৳.

Product: Nikon NIKKOR Z 24-200mm f/4-6.3 VR Lens. ",186,486925,487111
3510,sentence,"Category: Nikon. Subcategory: Camera Lenses. Price: 91,000৳99,000৳.

Product: Nikon NIKKOR Z 24mm f/1.8 S Lens. Category: Nikon. Subcategory: Camera Lenses. Price: 98,000৳100,000৳.
",181,487111,487292
3511,sentence,"Price: 98,000৳100,000৳.

Product: Nikon NIKKOR Z 24-120mm f/4 S Lens. Category: Nikon. Subcategory: Camera Lenses. Price: 112,000৳124,000৳.

Product: Nikon NIKKOR Z 70-180mm f/2.8 Lens. ",186,487268,487454
3512,sentence,"
Product: Nikon NIKKOR Z 70-180mm f/2.8 Lens. Category: Nikon. Subcategory: Camera Lenses. Price: 140,000৳149,000৳.

Product: Nikon NIKKOR Z 180-600mm f/5.6-6.3 VR Lens. Category: Nikon. ",187,487408,487595
3513,sentence,"Category: Nikon. Subcategory: Camera Lenses. Price: 187,000৳195,000৳.

Product: Nikon NIKKOR Z 50mm f/1.2 S Lens. Category: Nikon. Subcategory: Camera Lenses. Price: 198,000৳202,000৳.
",184,487578,487762
3514,sentence,"Price: 198,000৳202,000৳.

Product: Nikon NIKKOR Z 400mm f/4.5 VR S Lens. Category: Nikon. Subcategory: Camera Lenses. Price: 375,000৳380,000৳.

Product: Nikon NIKKOR Z 28mm f/2.8 Lens. ",185,487737,487922
3515,sentence,"
Product: Nikon NIKKOR Z 28mm f/2.8 Lens. Category: Nikon. Subcategory: Camera Lenses. Price: 37,000৳40,000৳.

Product: Canon RF 85mm f/1.2 L USM Camera Lens. Category: Canon. ",176,487880,488056
3516,sentence,"Category: Canon. Subcategory: Camera Lenses. Price: 270,000৳280,000৳.

Product: Canon RF 28mm f/2.8 STM Camera Lens. Category: Canon. Subcategory: Camera Lenses. Price: 34,000৳40,000৳.
",185,488039,488224
3517,sentence,"Price: 34,000৳40,000৳.

Product: Canon RF 24mm f/1.8 Macro IS STM Camera Lens. Category: Canon. Subcategory: Camera Lenses. Price: 59,000৳62,000৳.
",147,488201,488348
3518,sentence,"Price: 59,000৳62,000৳.

Product: Canon RF 24-105mm f/4-7.1 IS STM Camera Lens. Category: Canon. Subcategory: Camera Lenses. Price: 50,000৳53,000৳.

Product: Canon RF-S18-150mm f/3.5-6.3 IS STM Lens. ",199,488325,488524
3519,sentence,"Category: Canon. Subcategory: Camera Lenses. Price: 50,000৳58,000৳.

Product: Canon EF 24-105mm f/4L IS USM Lens. Category: Canon. Subcategory: Camera Lenses. Price: 60,000৳66,000৳.
",182,488524,488706
3520,sentence,"Price: 60,000৳66,000৳.

Product: Canon RF 35mm f/1.8 Macro IS STM Lens. Category: Canon. Subcategory: Camera Lenses. Price: 60,000৳70,000৳.

Product: Canon RF 100mm f/2.8 L Macro IS USM Lens. ",192,488683,488875
3521,sentence,"Category: Canon. Subcategory: Camera Lenses. Price: 138,000৳140,000৳.

Product: Canon RF 24-70mm f/2.8 L IS USM Lens. Category: Canon. Subcategory: Camera Lenses. Price: 240,000৳243,000৳.
",188,488875,489063
3522,sentence,"Price: 240,000৳243,000৳.

Product: Canon RF 70-200mm f/2.8L IS USM Camera Lens. Category: Canon. Subcategory: Camera Lenses. Price: 260,000৳280,000৳.
",150,489038,489188
3523,sentence,"Price: 260,000৳280,000৳.

Product: Canon RF 100-500mm f/4.5-7.1L IS USM Camera Lens. Category: Canon. Subcategory: Camera Lenses. Price: 320,000৳325,000৳.
",155,489163,489318
3524,sentence,"Price: 320,000৳325,000৳.

Product: Canon EF-S 10-18mm f/4.5-5.6 IS STM Lens. Category: Canon. Subcategory: Camera Lenses. Price: 27,500৳29,500৳.

Product: Canon RF 16mm f/2.8 STM Lens. ",185,489293,489478
3525,sentence,"
Product: Canon RF 16mm f/2.8 STM Lens. Category: Canon. Subcategory: Camera Lenses. Price: 34,000৳39,000৳.

Product: Canon RF 85mm f/2 Macro IS STM Lens. Category: Canon. ",172,489438,489610
3526,sentence,"Category: Canon. Subcategory: Camera Lenses. Price: 72,000৳75,000৳.

Product: Canon RF 24-105mm f/4 L IS USM Camera Lens. Category: Canon. Subcategory: Camera Lenses. Price: 127,000৳130,000৳.
",192,489593,489785
3527,sentence,"Price: 127,000৳130,000৳.

Product: Canon EF-S 55-250mm f/4-5.6 IS STM Telephoto Zoom Lens. Category: Canon. Subcategory: Camera Lenses. Price: Out Of Stock.
",157,489760,489917
3528,sentence,"Price: Out Of Stock.

Product: Sony ZV-1F 20.1 MP 4K Vlogging Digital Camera. Category: Sony. Subcategory: Digital Camera. Price: 57,000৳65,000৳.
",146,489896,490042
3529,sentence,"Price: 57,000৳65,000৳.

Product: Sony ZV-E10 24.2MP 4k Touchscreen Vlogging Digital Camera with 16-50mm Lens. Category: Sony. Subcategory: Digital Camera. Price: 78,500৳85,000৳.
",178,490019,490197
3530,sentence,"Price: 78,500৳85,000৳.

Product: Sony ZV-1 II 21.0MP Digital Camera. Category: Sony. Subcategory: Digital Camera. Price: 81,000৳88,000৳.
",137,490174,490311
3531,sentence,"Price: 81,000৳88,000৳.

Product: Sony ZV-1 20.1MP Vlogging 4K Digital Camera for Content Creator. Category: Sony. Subcategory: Digital Camera. Price: Out Of Stock.
",164,490288,490452
3532,sentence,"Price: Out Of Stock.

Product: FUJIFILM X100V Digital Camera. Category: Fujifilm. Subcategory: Digital Camera. Price: Out Of Stock.

Product: Canon PowerShot G7 X Mark III 20.2MP Digital Camera. ",195,490431,490626
3533,sentence,"Category: Canon. Subcategory: Digital Camera. Price: 166,000৳175,000৳.

Product: Canon EOS 2000D DSLR Camera (Body Only). Category: DSLR. Subcategory: Camera. Price: 38,000৳43,000৳.
",182,490626,490808
3534,sentence,"Subcategory: Camera. Price: 38,000৳43,000৳.

Product: Canon EOS 4000D 18MP DSLR Camera With 18-55mm Lens. Category: DSLR. Subcategory: Camera. Price: 42,300৳49,000৳.
",166,490764,490930
3535,sentence,"Subcategory: Camera. Price: 42,300৳49,000৳.

Product: Canon EOS 3000D 18MP DSLR Camera With EF-S 18-55mm III Lens. Category: DSLR. Subcategory: Camera. Price: 41,000৳47,000৳.
",175,490886,491061
3536,sentence,"Subcategory: Camera. Price: 41,000৳47,000৳.

Product: Canon EOS 2000D 24.1MP Full HD Wi-Fi DSLR Camera With EF-S 18-55mm f/3.5-5.6 III Lens. Category: DSLR. Subcategory: Camera. ",178,491017,491195
3537,sentence,"Category: DSLR. Subcategory: Camera. Price: 42,500৳51,000৳.

Product: Canon EOS 1500D 24.1MP DSLR Camera With 18-55mm Lens. Category: DSLR. Subcategory: Camera. Price: 47,500৳52,000৳.
",184,491158,491342
3538,sentence,"Subcategory: Camera. Price: 47,500৳52,000৳.

Product: Canon EOS 2000D 24.1MP Full HD WI-FI DSLR Camera with 18-55mm IS II Kit Lens. Category: DSLR. Subcategory: Camera. Price: 43,500৳53,000৳.
",192,491298,491490
3539,sentence,"Subcategory: Camera. Price: 43,500৳53,000৳.

Product: Canon EOS 250D DSLR Camera (Body Only). Category: DSLR. Subcategory: Camera. Price: 59,000৳65,000৳.
",154,491446,491600
3540,sentence,"Subcategory: Camera. Price: 59,000৳65,000৳.

Product: Canon EOS 250D 24.1MP Full HD WI-FI DSLR Camera with 18-55mm III KIT Lens. Category: DSLR. Subcategory: Camera. Price: 63,500৳71,000৳.
",189,491556,491745
3541,sentence,"Subcategory: Camera. Price: 63,500৳71,000৳.

Product: Canon EOS 250D 24.1MP Full HD WI-FI DSLR Camera with 18-55mm IS STM KIT Lens. Category: DSLR. Subcategory: Camera. Price: 64,500৳72,000৳.
",192,491701,491893
3542,sentence,"Subcategory: Camera. Price: 64,500৳72,000৳.

Product: Canon EOS 850D DSLR Camera (Body Only). Category: DSLR. Subcategory: Camera. Price: 95,000৳105,000৳.
",155,491849,492004
3543,sentence,"Subcategory: Camera. Price: 95,000৳105,000৳.

Product: Canon EOS 850D 24.1 MP With 18-55mm IS STM Lens 4K UHD WI-FI Touchscreen DSLR Camera. Category: DSLR. Subcategory: Camera. ",178,491959,492137
3544,sentence,"Category: DSLR. Subcategory: Camera. Price: 103,000৳115,000৳.

Product: Canon EOS 6D Mark II DSLR Camera (Only Body). Category: DSLR. Subcategory: Camera. Price: 129,000৳132,000৳.
",180,492100,492280
3545,sentence,"Subcategory: Camera. Price: 129,000৳132,000৳.

Product: Canon EOS 90D 32.5MP 4K WI-FI Touchscreen DSLR Camera (Body Only). Category: DSLR. Subcategory: Camera. Price: Out Of Stock.
",181,492234,492415
3546,sentence,"Subcategory: Camera. Price: Out Of Stock.

Product: Canon EOS 90D 32.5MP DSLR Camera with 18-55MM STM Lens. Category: DSLR. Subcategory: Camera. Price: Out Of Stock.
",166,492373,492539
3547,sentence,"Subcategory: Camera. Price: Out Of Stock.

Product: Canon EOS 90D 32.5MP DSLR Camera with EF-S 18-135mm IS USM Lens. Category: DSLR. Subcategory: Camera. Price: Out Of Stock.
",175,492497,492672
3548,sentence,"Subcategory: Camera. Price: Out Of Stock.

Product: Sony FDR-AX43 4K Handycam Camcorder. Category: Handycam. Subcategory: Camera. Price: 92,000৳105,000৳.
",154,492630,492784
3549,sentence,"Subcategory: Camera. Price: 92,000৳105,000৳.

Product: Sony HDR-CX405 9.2MP 30X Optical Zoom Full HD Handycam. Category: Handycam. Subcategory: Camera. Price: Out Of Stock.
",173,492739,492912
3550,sentence,"Subcategory: Camera. Price: Out Of Stock.

Product: FUJIFILM XF 18-55mm f/2.8-4 R LM OIS Camera Lens. Category: FUJIFILM. Subcategory: Camera Lenses. Price: 50,000৳51,000৳.
",173,492870,493043
3551,sentence,"Price: 50,000৳51,000৳.

Product: FUJIFILM XF 90mm f/2 R LM WR Camera Lens. Category: FUJIFILM. Subcategory: Camera Lenses. Price: 73,000৳75,000৳.
",146,493020,493166
3552,sentence,"Price: 73,000৳75,000৳.

Product: FUJIFILM XF 16-55mm f2.8 R LM WR Camera Lens. Category: FUJIFILM. Subcategory: Camera Lenses. Price: 128,000৳130,000৳.
",152,493143,493295
3553,sentence,"Price: 128,000৳130,000৳.

Product: FUJIFILM XF 50mm f/2 R WR Camera Lens. Category: FUJIFILM. Subcategory: Camera Lenses. Price: Pre Order.

Product: FUJIFILM XC 35mm f/2 Camera Lens. ",184,493270,493454
3554,sentence,"
Product: FUJIFILM XC 35mm f/2 Camera Lens. Category: FUJIFILM. Subcategory: Camera Lenses. Price: Up Coming.

Product: FUJIFILM XF 18mm f/2 R Camera Lens. Category: FUJIFILM. ",176,493410,493586
3555,sentence,"Category: FUJIFILM. Subcategory: Camera Lenses. Price: Up Coming.

Product: FUJIFILM XF 23mm f/1.4 R Camera Lens. Category: FUJIFILM. Subcategory: Camera Lenses. Price: Up Coming.
",180,493566,493746
3556,sentence,"Subcategory: Camera Lenses. Price: Up Coming.

Product: FUJIFILM XF 100-400mm f/4.5-5.6 R LM OIS WR Camera Lens. Category: FUJIFILM. Subcategory: Camera Lenses. Price: Up Coming.
",179,493700,493879
3557,sentence,"Subcategory: Camera Lenses. Price: Up Coming.

Product: FUJIFILM GF 32-64mm f/4 R LM WR Camera Lens. Category: FUJIFILM. Subcategory: Camera Lenses. Price: Up Coming.
",167,493833,494000
3558,sentence,"Subcategory: Camera Lenses. Price: Up Coming.

Product: FUJIFILM GF 80mm f/1.7 R WR Camera Lens. Category: FUJIFILM. Subcategory: Camera Lenses. Price: Up Coming.
",163,493954,494117
3559,sentence,"Subcategory: Camera Lenses. Price: Up Coming.

Product: FUJIFILM XF 27mm f/2.8 R WR Camera Lens. Category: FUJIFILM. Subcategory: Camera Lenses. Price: Out Of Stock.
",166,494071,494237
3560,sentence,"Price: Out Of Stock.

Product: FUJIFILM XF 16mm f/1.4 R WR Camera Lens. Category: FUJIFILM. Subcategory: Camera Lenses. Price: Out Of Stock.

Product: FUJIFILM XF 16-80mm f/4 R OIS WR Camera Lens. ",197,494216,494413
3561,sentence,"Category: FUJIFILM. Subcategory: Camera Lenses. Price: Out Of Stock.

Product: FUJIFILM XF 70-300mm f/4-5.6 R LM OIS WR Camera Lens. Category: FUJIFILM. Subcategory: Camera Lenses. ",181,494413,494594
3562,sentence,"Category: FUJIFILM. Subcategory: Camera Lenses. Price: Out Of Stock.

Product: FUJIFILM XF 56mm f/1.2 R WR Camera Lens. Category: FUJIFILM. Subcategory: Camera Lenses. Price: Out Of Stock.
",189,494546,494735
3563,sentence,"Price: Out Of Stock.

Product: FUJIFILM XF 10-24mm f/4 R OIS WR Lens. Category: FUJIFILM. Subcategory: Camera Lenses. Price: Out Of Stock.
",139,494714,494853
3564,sentence,"Price: Out Of Stock.

Product: Nikon Z50 20.9MP Wi-Fi Mirrorless Digital Camera(Only Body). Category: Mirrorless Camera. Subcategory: Camera. Price: 80,000৳88,000৳.
",165,494832,494997
3565,sentence,"Subcategory: Camera. Price: 80,000৳88,000৳.

Product: Sony Alpha A6400 Mirrorless Digital Camera (Body Only). Category: Mirrorless Camera. Subcategory: Camera. Price: 83,000৳88,000৳.
",183,494953,495136
3566,sentence,"Subcategory: Camera. Price: 83,000৳88,000৳.

Product: Canon EOS R100 Mirrorless Camera with 18-45mm Lens. Category: Mirrorless Camera. Subcategory: Camera. Price: 67,000৳77,000৳.
",179,495092,495271
3567,sentence,"Subcategory: Camera. Price: 67,000৳77,000৳.

Product: Canon EOS R50 Mirrorless Camera With 18-45mm Lens. Category: Mirrorless Camera. Subcategory: Camera. Price: 84,000৳90,000৳.
",178,495227,495405
3568,sentence,"Subcategory: Camera. Price: 84,000৳90,000৳.

Product: Canon EOS RP Mirrorless Digital Camera (Body Only). Category: Mirrorless Camera. Subcategory: Camera. Price: 89,000৳95,000৳.
",179,495361,495540
3569,sentence,"Subcategory: Camera. Price: 89,000৳95,000৳.

Product: Nikon Z50 20.9MP Wi-Fi Mirrorless Digital Camera with 16-50mm Lens. Category: Mirrorless Camera. Subcategory: Camera. Price: 92,000৳98,000৳.
",195,495496,495691
3570,sentence,"Subcategory: Camera. Price: 92,000৳98,000৳.

Product: Canon EOS R10 Mirrorless Digital Camera (Body Only). Category: Mirrorless Camera. Subcategory: Camera. Price: 95,000৳103,000৳.
",181,495647,495828
3571,sentence,"Subcategory: Camera. Price: 95,000৳103,000৳.

Product: Sony Alpha A6400 Mirrorless Digital Camera with 16-50mm Lens. Category: Mirrorless Camera. Subcategory: Camera. Price: 94,000৳105,000৳.
",191,495783,495974
3572,sentence,"Subcategory: Camera. Price: 94,000৳105,000৳.

Product: Canon EOS R10 Mirrorless Camera With 18-45mm Lens. Category: Mirrorless Camera. Subcategory: Camera. Price: 102,000৳109,000৳.
",181,495929,496110
3573,sentence,"Subcategory: Camera. Price: 102,000৳109,000৳.

Product: Nikon Z5 Full Frame Mirrorless Digital Camera (Body Only). Category: Mirrorless Camera. Subcategory: Camera. Price: 102,000৳118,000৳.
",190,496064,496254
3574,sentence,"Subcategory: Camera. Price: 102,000৳118,000৳.

Product: Nikon D7500 Mirrorless Camera with 18-140mm Lens. Category: Mirrorless Camera. Subcategory: Camera. Price: 111,000৳119,000৳.
",181,496208,496389
3575,sentence,"Subcategory: Camera. Price: 111,000৳119,000৳.

Product: Sony ZV-E10 II Mirrorless Camera with 16-50mm Lens. Category: Mirrorless Camera. Subcategory: Camera. Price: 119,000৳125,000৳.
",183,496343,496526
3576,sentence,"Subcategory: Camera. Price: 119,000৳125,000৳.

Product: Canon EOS RP Mirrorless Camera with 24-105mm f/4-7.1 Lens. Category: Mirrorless Camera. Subcategory: Camera. Price: 132,000৳140,000৳.
",190,496480,496670
3577,sentence,"Subcategory: Camera. Price: 132,000৳140,000৳.

Product: Sony A6400 Mirrorless Camera With 18-135mm Lens. Category: Mirrorless Camera. Subcategory: Camera. Price: 138,000৳147,000৳.
",180,496624,496804
3578,sentence,"Subcategory: Camera. Price: 138,000৳147,000৳.

Product: Canon EOS R8 Mirrorless Camera(Only Body). Category: Mirrorless Camera. Subcategory: Camera. Price: 138,000৳148,000৳.
",174,496758,496932
3579,sentence,"Subcategory: Camera. Price: 138,000৳148,000৳.

Product: Canon EOS R10 Mirrorless Camera With RF-S18-150mm f/3.5-6.3 IS STM Lens. Category: Mirrorless Camera. Subcategory: Camera. ",179,496886,497065
3580,sentence,"Subcategory: Camera. Price: 141,000৳150,000৳.

Product: Sony Alpha A7 III Mirrorless Digital Camera (Only Body). Category: Mirrorless Camera. Subcategory: Camera. Price: 146,000৳155,000৳.
",188,497044,497232
3581,sentence,"Subcategory: Camera. Price: 146,000৳155,000৳.

Product: Sony Alpha 7C Compact Mirrorless Full-frame Camera (Only Body). Category: Mirrorless Camera. Subcategory: Camera. Price: 141,000৳155,000৳.
",195,497186,497381
3582,sentence,"Subcategory: Camera. Price: 141,000৳155,000৳.

Product: FUJIFILM X-T50 Mirrorless Camera (Body Only). Category: Mirrorless Camera. Subcategory: Camera. Price: 154,000৳160,000৳.
",177,497335,497512
3583,sentence,"Subcategory: Camera. Price: 154,000৳160,000৳.

Product: Canon EOS R8 Mirrorless Camera with RF 24-50mm f/4.5-6.3 IS STM Lens. Category: Mirrorless Camera. Subcategory: Camera. ",176,497466,497642
3584,sentence,"Subcategory: Camera. Price: 155,000৳165,000৳.

Product: Canon EOS R6 Mark II Mirrorless Camera (Only Body). Category: Canon. Subcategory: Mirrorless Camera. Price: 216,000৳227,000৳.
",182,497621,497803
3585,sentence,"Price: 216,000৳227,000৳.

Product: Canon EOS R5 Mirrorless Digital Camera (Only Body). Category: Canon. Subcategory: Mirrorless Camera. Price: 315,000৳325,000৳.
",161,497778,497939
3586,sentence,"Price: 315,000৳325,000৳.

Product: Canon EOS R6 Mark II Mirrorless Camera with 24-105mm f/4 Lens. Category: Canon. Subcategory: Mirrorless Camera. Price: 345,000৳360,000৳.
",172,497914,498086
3587,sentence,"Price: 345,000৳360,000৳.

Product: Canon EOS R5 Mark II Mirrorless Digital Camera (Only Body). Category: Canon. Subcategory: Mirrorless Camera. Price: Out Of Stock.
",165,498061,498226
3588,sentence,"Price: Out Of Stock.

Product: Nikon Z5 Mirrorless Camera with 24-70mm f/4 Lens. Category: Nikon. Subcategory: Mirrorless Camera. Price: 168,000৳180,000৳.
",155,498205,498360
3589,sentence,"Price: 168,000৳180,000৳.

Product: Nikon Z6 II Full Frame Mirrorless Digital Camera (Body Only). Category: Nikon. Subcategory: Mirrorless Camera. Price: 175,000৳185,000৳.
",171,498335,498506
3590,sentence,"Price: 175,000৳185,000৳.

Product: Nikon Zf 24.5MP Mirrorless Camera(Only Body). Category: Nikon. Subcategory: Mirrorless Camera. Price: 199,000৳205,000৳.
",155,498481,498636
3591,sentence,"Price: 199,000৳205,000৳.

Product: Nikon Z6 III Mirrorless Camera (Body Only). Category: Nikon. Subcategory: Mirrorless Camera. Price: 240,000৳260,000৳.
",153,498611,498764
3592,sentence,"Price: 240,000৳260,000৳.

Product: Nikon Z7 II Full Frame Mirrorless Digital Camera (Body Only). Category: Nikon. Subcategory: Mirrorless Camera. Price: 270,000৳280,000৳.
",171,498739,498910
3593,sentence,"Price: 270,000৳280,000৳.

Product: Nikon Z8 45.7MP Mirrorless Camera(Only Body). Category: Nikon. Subcategory: Mirrorless Camera. Price: 340,000৳390,000৳.
",155,498885,499040
3594,sentence,"Price: 340,000৳390,000৳.

Product: Nikon Z9 Mirrorless Camera(Only Body). Category: Nikon. Subcategory: Mirrorless Camera. Price: 580,000৳595,000৳.
",148,499015,499163
3595,sentence,"Price: 580,000৳595,000৳.

Product: Transcend DrivePro Body 30 Video Camera Camcorder. Category: Transcend. Subcategory: Dash Cam. Price: Up Coming.

Product: Transcend DrivePro 230 Dash Camera. ",194,499138,499332
3596,sentence,"
Product: Transcend DrivePro 230 Dash Camera. Category: Transcend. Subcategory: Dash Cam. Price: Out Of Stock.

Product: Transcend DrivePro 20 Motorcycle Dashcam. Category: Transcend. ",184,499286,499470
3597,sentence,"Category: Transcend. Subcategory: Dash Cam. Price: Out Of Stock.

Product: Transcend DrivePro 550 Dual Lens Dash Camera. Category: Transcend. Subcategory: Dash Cam. Price: Out Of Stock.
",186,499449,499635
3598,sentence,"Subcategory: Dash Cam. Price: Out Of Stock.

Product: Transcend DrivePro Body 60 Cylindrical Camera. Category: Transcend. Subcategory: Dash Cam. Price: Out Of Stock.
",166,499591,499757
3599,sentence,"Subcategory: Dash Cam. Price: Out Of Stock.

Product: Sony Alpha A6700 Mirrorless Camera (Body Only). Category: Sony. Subcategory: Mirrorless Camera. Price: 147,500৳170,000৳.
",175,499713,499888
3600,sentence,"Price: 147,500৳170,000৳.

Product: Sony Alpha a7R IIIA Full-Frame Mirrorless Camera (Body Only). Category: Sony. Subcategory: Mirrorless Camera. Price: 195,000৳210,000৳.
",170,499863,500033
3601,sentence,"Price: 195,000৳210,000৳.

Product: Sony Alpha A7C II Full Frame Mirrorless Camera (Only Body). Category: Sony. Subcategory: Mirrorless Camera. Price: 197,000৳210,000৳.
",168,500008,500176
3602,sentence,"Price: 197,000৳210,000৳.

Product: Sony a7 IV 33MP Mirrorless Digital Camera (Body Only). Category: Sony. Subcategory: Mirrorless Camera. Price: 214,000৳230,000৳.
",163,500151,500314
3603,sentence,"Price: 214,000৳230,000৳.

Product: Sony ZV-E1 Mirrorless Camera(Only Body). Category: Sony. Subcategory: Mirrorless Camera. Price: 227,000৳239,000৳.
",149,500289,500438
3604,sentence,"Price: 227,000৳239,000৳.

Product: Sony a7R IVA 61MP Mirrorless Digital Camera (Body Only). Category: Sony. Subcategory: Mirrorless Camera. Price: 252,000৳265,000৳.
",165,500413,500578
3605,sentence,"Price: 252,000৳265,000৳.

Product: Sony Alpha 7R IV 61MP Mirrorless Digital Camera (Body Only). Category: Sony. Subcategory: Mirrorless Camera. Price: 252,000৳265,000৳.
",169,500553,500722
3606,sentence,"Price: 252,000৳265,000৳.

Product: Sony a7CR Mirrorless Camera (Body Only). Category: Sony. Subcategory: Mirrorless Camera. Price: 310,000৳320,000৳.
",149,500697,500846
3607,sentence,"Price: 310,000৳320,000৳.

Product: Sony Alpha 7S III Mirrorless Full-frame Camera (Only Body). Category: Sony. Subcategory: Mirrorless Camera. Price: 318,000৳340,000৳.
",168,500821,500989
3608,sentence,"Price: 318,000৳340,000৳.

Product: Sony a7R V 61MP Mirrorless Camera (Only Body). Category: Sony. Subcategory: Mirrorless Camera. Price: 345,000৳375,000৳.
",155,500964,501119
3609,sentence,"Price: 345,000৳375,000৳.

Product: Sony Alpha A9 III Full Frame Mirrorless Camera (Only Body). Category: Sony. Subcategory: Mirrorless Camera. Price: 610,000৳650,000৳.
",168,501094,501262
3610,sentence,"Price: 610,000৳650,000৳.

Product: Sony Alpha 1 Mirrorless Digital Camera (Body Only). Category: Sony. Subcategory: Mirrorless Camera. Price: 650,000৳700,000৳.
",160,501237,501397
3611,sentence,"Price: 650,000৳700,000৳.

Product: Sony Alpha a1 II Mirrorless Camera (Body Only). Category: Sony. Subcategory: Mirrorless Camera. Price: 780,000৳830,000৳.
",156,501372,501528
3612,sentence,"Price: 780,000৳830,000৳.

Product: Sony Alpha a7C Mirrorless Camera with 28-60mm Lens. Category: Sony. Subcategory: Mirrorless Camera. Price: Out Of Stock.

Product: 70mai A400 2K QHD Dash Cam Set. ",198,501503,501701
3613,sentence,"
Product: 70mai A400 2K QHD Dash Cam Set. Category: Dash Cam. Subcategory: Camera. Price: Out Of Stock.

Product: 70mai Dash Cam Pro Plus+ Rear Cam Set. Category: Dash Cam. Subcategory: Camera. ",194,501659,501853
3614,sentence,"Category: Dash Cam. Subcategory: Camera. Price: Out Of Stock.

Product: 70mai M500 Dash Cam. Category: Dash Cam. Subcategory: Camera. Price: Out Of Stock.

Product: 70mai A800S 4K Dash Cam. ",190,501812,502002
3615,sentence,"
Product: 70mai A800S 4K Dash Cam. Category: Dash Cam. Subcategory: Camera. Price: Out Of Stock.

Product: Panasonic AG-CX6 4K Professional Camcorder. Category: Video Camera. Subcategory: Camera. ",196,501967,502163
3616,sentence,"Category: Video Camera. Subcategory: Camera. Price: 180,000৳183,000৳.

Product: Sony Alpha FX30 Cinema Line Camera (Body Only). Category: Video Camera. Subcategory: Camera. Price: 202,000৳219,000৳.
",198,502118,502316
3617,sentence,"Subcategory: Camera. Price: 202,000৳219,000৳.

Product: Sony PXW-Z90 4K HDR XDCAM Camcorder. Category: Video Camera. Subcategory: Camera. Price: 245,000৳250,000৳.
",163,502270,502433
3618,sentence,"Subcategory: Camera. Price: 245,000৳250,000৳.

Product: Sony HXR-NX5R Full HD compact professional NXCAM camcorder. Category: Video Camera. Subcategory: Camera. Price: 345,000৳350,000৳.
",186,502387,502573
3619,sentence,"Subcategory: Camera. Price: 345,000৳350,000৳.

Product: Sony PXW-Z150 4K XDCAM Camcorder. Category: Video Camera. Subcategory: Camera. Price: 385,000৳420,000৳.
",160,502527,502687
3620,sentence,"Subcategory: Camera. Price: 385,000৳420,000৳.

Product: Sony Alpha FX3 Cinema Line Full-frame Camera (Body Only). Category: Video Camera. Subcategory: Camera. Price: 415,000৳430,000৳.
",184,502641,502825
3621,sentence,"Subcategory: Camera. Price: 415,000৳430,000৳.

Product: Sony FX6 Full-Frame Cinema Line Camera (Body Only). Category: Video Camera. Subcategory: Camera. Price: 635,000৳660,000৳.
",178,502779,502957
3622,sentence,"Subcategory: Camera. Price: 635,000৳660,000৳.

Product: Sony PXW-FX9 XDCAM 6K Full-Frame Camcorder (Body Only). Category: Video Camera. Subcategory: Camera. Price: 1,380,000৳1,420,000৳.
",186,502911,503097
3623,sentence,"Price: 1,380,000৳1,420,000৳.

Product: Panasonic HC-pv100 Professional Camcorder. Category: Video Camera. Subcategory: Camera. Price: Out Of Stock.
",148,503068,503216
3624,sentence,"Subcategory: Camera. Price: Out Of Stock.

Product: Panasonic AG-UX90ED 4K Professional Camcorder. Category: Video Camera. Subcategory: Camera. Price: Out Of Stock.
",165,503174,503339
3625,sentence,"Subcategory: Camera. Price: Out Of Stock.

Product: Panasonic AG-CX7 4K Professional Camcorder. Category: Video Camera. Subcategory: Camera. Price: Out Of Stock.
",162,503297,503459
3626,sentence,"Subcategory: Camera. Price: Out Of Stock.

Product: FUJIFILM X-S20 Mirrorless Camera (Only Body). Category: FUJIFILM. Subcategory: Mirrorless Camera. Price: 151,000৳165,000৳.
",175,503417,503592
3627,sentence,"Price: 151,000৳165,000৳.

Product: FUJIFILM X-T5 Mirrorless Camera (Body Only). Category: FUJIFILM. Subcategory: Mirrorless Camera. Price: 206,000৳225,000৳.
",157,503567,503724
3628,sentence,"Price: 206,000৳225,000৳.

Product: FUJIFILM X-T5 Mirrorless Camera with 18-55mm Lens. Category: FUJIFILM. Subcategory: Mirrorless Camera. Price: 240,000৳260,000৳.
",163,503699,503862
3629,sentence,"Price: 240,000৳260,000৳.

Product: FUJIFILM X-T3 Mirrorless Digital Camera (Body Only). Category: FUJIFILM. Subcategory: Mirrorless Camera. Price: Up Coming.
",158,503837,503995
3630,sentence,"Price: Up Coming.

Product: FUJIFILM X-T30 II Mirrorless Camera (Body Only) Silver. Category: FUJIFILM. Subcategory: Mirrorless Camera. Price: Up Coming.
",154,503977,504131
3631,sentence,"Price: Up Coming.

Product: FUJIFILM X-T30 II Mirrorless Camera with 18-55mm Lens. Category: FUJIFILM. Subcategory: Mirrorless Camera. Price: Up Coming.
",153,504113,504266
3632,sentence,"Price: Up Coming.

Product: FUJIFILM X-T4 Mirrorless Digital Camera (Body Only). Category: FUJIFILM. Subcategory: Mirrorless Camera. Price: Up Coming.
",151,504248,504399
3633,sentence,"Price: Up Coming.

Product: FUJIFILM X-Pro3 Mirrorless Camera (Body Only). Category: FUJIFILM. Subcategory: Mirrorless Camera. Price: Up Coming.
",145,504381,504526
3634,sentence,"Price: Up Coming.

Product: FUJIFILM X-M5 Mirrorless Camera (Body Only). Category: FUJIFILM. Subcategory: Mirrorless Camera. Price: Out Of Stock.
",146,504508,504654
3635,sentence,"Price: Out Of Stock.

Product: FUJIFILM X-S10 Mirrorless Digital Camera (Body Only). Category: FUJIFILM. Subcategory: Mirrorless Camera. Price: Out Of Stock.
",158,504633,504791
3636,sentence,"Price: Out Of Stock.

Product: FUJIFILM X-T30 II Mirrorless Camera with XC 15-45mm OIS PZ Lens. Category: FUJIFILM. Subcategory: Mirrorless Camera. Price: Out Of Stock.
",169,504770,504939
3637,sentence,"Price: Out Of Stock.

Product: FUJIFILM X-E4 Mirrorless Camera with 27mm Lens Silver. Category: FUJIFILM. Subcategory: Mirrorless Camera. Price: Out Of Stock.
",159,504918,505077
3638,sentence,"Price: Out Of Stock.

Product: FUJIFILM X-T4 Mirrorless Camera with 18-55mm Lens. Category: FUJIFILM. Subcategory: Mirrorless Camera. Price: Out Of Stock.
",155,505056,505211
3639,sentence,"Price: Out Of Stock.

Product: Godox TT600 Speedlite Master Slave Off GN60 Camera Flash. Category: Camera Flash. Subcategory: Camera Accessories. Price: 8,000৳8,500৳.
",167,505190,505357
3640,sentence,"Price: 8,000৳8,500৳.

Product: Godox VING V850II Li-Ion Flash Kit. Category: Camera Flash. Subcategory: Camera Accessories. Price: 12,000৳15,000৳.
",147,505336,505483
3641,sentence,"Price: 12,000৳15,000৳.

Product: Godox Ving V860III TTL Li-Ion Flash Kit for Canon Cameras. Category: Camera Flash. Subcategory: Camera Accessories. Price: 17,500৳18,500৳.
",172,505460,505632
3642,sentence,"Price: 17,500৳18,500৳.

Product: Godox Ving V860III TTL Li-Ion Flash Kit for Nikon Cameras. Category: Camera Flash. Subcategory: Camera Accessories. Price: 18,500৳19,500৳.
",172,505609,505781
3643,sentence,"Price: 18,500৳19,500৳.

Product: Godox Ving V860III TTL Li-Ion Flash Kit for FUJIFILM Cameras. Category: Camera Flash. Subcategory: Camera Accessories. Price: 18,500৳19,500৳.
",175,505758,505933
3644,sentence,"Price: 18,500৳19,500৳.

Product: Godox V1 Flash for FUJIFILM. Category: Camera Flash. Subcategory: Camera Accessories. Price: 19,500৳20,500৳.

Product: Godox V1 Flash for Sony. ",177,505910,506087
3645,sentence,"
Product: Godox V1 Flash for Sony. Category: Camera Flash. Subcategory: Camera Accessories. Price: 19,500৳20,500৳.

Product: Godox V1 Flash for Canon. Category: Camera Flash. ",175,506052,506227
3646,sentence,"Category: Camera Flash. Subcategory: Camera Accessories. Price: 19,500৳20,500৳.

Product: Godox AD200Pro TTL Pocket Flash Kit. Category: Camera Flash. Subcategory: Camera Accessories. ",184,506203,506387
3647,sentence,"Subcategory: Camera Accessories. Price: 32,000৳34,000৳.

Product: Godox AD600BM Witstro Manual All-In-One Outdoor Flash. Category: Camera Flash. Subcategory: Camera Accessories. ",178,506354,506532
3648,sentence,"Subcategory: Camera Accessories. Price: 48,000৳50,000৳.

Product: Godox VING V860IIC TTL Li-Ion Flash Kit for Canon Cameras. Category: Camera Flash. Subcategory: Camera Accessories. ",182,506499,506681
3649,sentence,"Subcategory: Camera Accessories. Price: Up Coming.

Product: Godox V350S Flash for Sony Camera. Category: Camera Flash. Subcategory: Camera Accessories. Price: Out Of Stock.
",174,506648,506822
3650,sentence,"Price: Out Of Stock.

Product: Godox QT400IIM Flash Head. Category: Camera Flash. Subcategory: Camera Accessories. Price: Out Of Stock.

Product: K&F Concept 3 in 1 Camera Cleaning Kit. ",186,506801,506987
3651,sentence,"Category: Camera Accessories. Subcategory: Camera. Price: 980৳.

Product: K&F Concept 4 in 1 DSLR Camera Cleaning Kit. Category: Camera Accessories. Subcategory: Camera. Price: 1,300৳1,350৳.
",191,506987,507178
3652,sentence,"Subcategory: Camera. Price: 1,300৳1,350৳.

Product: K&F Concept KF34.042 Portable Metal Light Stand. Category: Camera Accessories. Subcategory: Camera. Price: 1,900৳2,400৳.
",173,507136,507309
3653,sentence,"Subcategory: Camera. Price: 1,900৳2,400৳.

Product: Simpex Premium Light Stand Mark III. Category: Camera Accessories. Subcategory: Camera. Price: 1,500৳1,600৳.
",161,507267,507428
3654,sentence,"Subcategory: Camera. Price: 1,500৳1,600৳.

Product: K&F Concept 49mm Blue Multi Coated HMC C Series CPL Camera Lens Filter. Category: Camera Accessories. Subcategory: Camera. Price: 1,650৳1,700৳.
",196,507386,507582
3655,sentence,"Subcategory: Camera. Price: 1,650৳1,700৳.

Product: K&F Concept 52mm Blue Multi Coated HMC C Series CPL Camera Lens Filter. Category: Camera Accessories. Subcategory: Camera. Price: 1,650৳1,700৳.
",196,507540,507736
3656,sentence,"Subcategory: Camera. Price: 1,650৳1,700৳.

Product: K&F Concept 55mm Blue Multi Coated HMC C Series CPL Camera Lens Filter. Category: Camera Accessories. Subcategory: Camera. Price: 1,650৳1,700৳.
",196,507694,507890
3657,sentence,"Subcategory: Camera. Price: 1,650৳1,700৳.

Product: K&F Concept 58mm Blue Multi Coated HMC C Series CPL Camera Lens Filter. Category: Camera Accessories. Subcategory: Camera. Price: 1,650৳1,700৳.
",196,507848,508044
3658,sentence,"Subcategory: Camera. Price: 1,650৳1,700৳.

Product: K&F Concept KF13.203 Waterproof Camera Lens Pouch Case Bag. Category: Camera Accessories. Subcategory: Camera. Price: 3,200৳4,200৳.
",184,508002,508186
3659,sentence,"Subcategory: Camera. Price: 3,200৳4,200৳.

Product: K&F Concept KF13.202 Waterproof Camera Lens Pouch Case Bag. Category: Camera Accessories. Subcategory: Camera. Price: 3,000৳4,000৳.
",184,508144,508328
3660,sentence,"Subcategory: Camera. Price: 3,000৳4,000৳.

Product: K&F Concept KF13.201 Waterproof Camera Lens Pouch Case Bag. Category: Camera Accessories. Subcategory: Camera. Price: 2,600৳3,200৳.
",184,508286,508470
3661,sentence,"Subcategory: Camera. Price: 2,600৳3,200৳.

Product: K&F Concept KF13.189 Waterproof Camera Lens Pouch Case Bag. Category: Camera Accessories. Subcategory: Camera. Price: 2,400৳3,000৳.
",184,508428,508612
3662,sentence,"Subcategory: Camera. Price: 2,400৳3,000৳.

Product: Nikon DSLR Camera Bag. Category: Camera Accessories. Subcategory: Camera. Price: 700৳1,000৳.

Product: Canon DSLR Camera Bag. ",178,508570,508748
3663,sentence,"
Product: Canon DSLR Camera Bag. Category: Camera Accessories. Subcategory: Camera. Price: 700৳1,000৳.

Product: K&F Concept KF13.117 4 Pocket Premium Filter Pouch Case Bag. ",174,508715,508889
3664,sentence,"Category: Camera Accessories. Subcategory: Camera. Price: 1,800৳1,900৳.

Product: K&F Concept KF13.167 Digital Camera Bag. Category: Camera Accessories. Subcategory: Camera. Price: 1,800৳2,000৳.
",195,508889,509084
3665,sentence,"Subcategory: Camera. Price: 1,800৳2,000৳.

Product: K&F Concept ND2-ND400 62mm Fader Slim Professional Variable Neutral Density Camera Lens Filter. Category: Camera Accessories. Subcategory: Camera. ",199,509042,509241
3666,sentence,"Subcategory: Camera. Price: 2,000৳2,070৳.

Product: K&F Concept 49mm HMC ND2-ND400 Variable C Series ND Camera Lens Filter. Category: Camera Accessories. Subcategory: Camera. Price: 2,200৳2,250৳.
",196,509220,509416
3667,sentence,"Subcategory: Camera. Price: 2,200৳2,250৳.

Product: K&F Concept 58mm HMC ND2-ND400 Variable C Series ND Camera Lens Filter. Category: Camera Accessories. Subcategory: Camera. Price: 2,200৳2,250৳.
",196,509374,509570
3668,sentence,"Subcategory: Camera. Price: 2,200৳2,250৳.

Product: K&F Concept 49mm MRC ND1000 NANO-X PRO ND Camera Lens Filter. Category: Camera Accessories. Subcategory: Camera. Price: 2,200৳2,250৳.
",186,509528,509714
3669,sentence,"Subcategory: Camera. Price: 2,200৳2,250৳.

Product: FUJIFILM INSTAX mini Instant Film (10 Sheets). Category: Instant Camera. Subcategory: Camera. Price: 2,000৳2,200৳.
",167,509672,509839
3670,sentence,"Subcategory: Camera. Price: 2,000৳2,200৳.

Product: FUJIFILM INSTAX mini Instant Film (20 Sheets). Category: Instant Camera. Subcategory: Camera. Price: 3,100৳3,300৳.
",167,509797,509964
3671,sentence,"Subcategory: Camera. Price: 3,100৳3,300৳.

Product: FUJIFILM INSTAX mini 12 Instant Film Camera. Category: Instant Camera. Subcategory: Camera. Price: 13,500৳15,000৳.
",167,509922,510089
3672,sentence,"Subcategory: Camera. Price: 13,500৳15,000৳.

Product: FUJIFILM Instax Mini EVO Hybrid Instant Camera. Category: Instant Camera. Subcategory: Camera. Price: Up Coming.
",167,510045,510212
3673,sentence,"Subcategory: Camera. Price: Up Coming.

Product: FUJIFILM INSTAX mini 11 Instant Film Camera. Category: Instant Camera. Subcategory: Camera. Price: Out Of Stock.
",162,510173,510335
3674,sentence,"Subcategory: Camera. Price: Out Of Stock.

Product: K&F Concept 67mm Blue Multi Coated HMC C Series CPL Camera Lens Filter. Category: Lens Filter. Subcategory: Camera Accessories. ",180,510293,510473
3675,sentence,"Subcategory: Camera Accessories. Price: 2,200৳2,250৳.

Product: K&F Concept 52mm HMC ND2-ND400 Variable C Series ND Camera Lens Filter. Category: Lens Filter. Subcategory: Camera Accessories. ",192,510440,510632
3676,sentence,"Subcategory: Camera Accessories. Price: 2,300৳2,350৳.

Product: K&F Concept 55mm HMC ND2-ND400 Variable C Series ND Camera Lens Filter. Category: Lens Filter. Subcategory: Camera Accessories. ",192,510599,510791
3677,sentence,"Subcategory: Camera Accessories. Price: 2,300৳2,350৳.

Product: K&F Concept ND2-ND400 72mm Fader Slim Professional Variable Neutral Density Camera Lens Filter. Category: Lens Filter. ",183,510758,510941
3678,sentence,"Category: Lens Filter. Subcategory: Camera Accessories. Price: 2,350৳2,415৳.

Product: K&F Concept ND2-ND400 77mm Fader Slim Professional Variable Neutral Density Camera Lens Filter. ",183,510918,511101
3679,sentence,"Category: Lens Filter. Subcategory: Camera Accessories. Price: Out Of Stock.

Product: K&F Concept 62mm HMC ND2-ND400 Variable C Series ND Camera Lens Filter. Category: Lens Filter. ",182,511101,511283
3680,sentence,"Category: Lens Filter. Subcategory: Camera Accessories. Price: 2,400৳2,470৳.

Product: K&F Concept 72mm Blue Multi Coated HMC C Series CPL Camera Lens Filter. Category: Lens Filter. ",182,511260,511442
3681,sentence,"Category: Lens Filter. Subcategory: Camera Accessories. Price: 2,550৳2,600৳.

Product: K&F Concept SKU.2180V1 Matte Box Kit With Two 4×5.65″ Square Filters. Category: Lens Adapter. ",181,511419,511600
3682,sentence,"Category: Lens Adapter. Subcategory: Camera Accessories. Price: 10,990৳14,900৳.

Product: K&F Concept SKU.2181V1 Matte Box Kit With Two 4×5.65″ Square Filters. Category: Lens Adapter. ",184,511576,511760
3683,sentence,"Category: Lens Adapter. Subcategory: Camera Accessories. Price: 17,500৳21,000৳.

Product: K&F Concept SKU.2182V1 Matte Box Kit With ND4+ND32 and Two 4×5.65″ Square Filters. Category: Lens Adapter. ",197,511736,511933
3684,sentence,"Category: Lens Adapter. Subcategory: Camera Accessories. Price: 22,500৳26,000৳.

Product: K&F Concept SKU.2364V1 Matte Box Kit With Two 4×5.65″ Square Filters. Category: Lens Adapter. ",184,511909,512093
3685,sentence,"Category: Lens Adapter. Subcategory: Camera Accessories. Price: 9,000৳11,000৳.

Product: Viltrox EF-EOS M Lens Mount Adapter for Canon Cameras. Category: Lens Adapter. ",168,512069,512237
3686,sentence,"Category: Lens Adapter. Subcategory: Camera Accessories. Price: 6,700৳7,000৳.

Product: Viltrox EF-EOS R Pro Lens Mount Adapter for Canon EF. Category: Lens Adapter. Subcategory: Camera Accessories. ",199,512213,512412
3687,sentence,"Subcategory: Camera Accessories. Price: 7,500৳8,000৳.

Product: Viltrox EF 1.4x Extender Teleconverter for Canon EF. Category: Lens Adapter. Subcategory: Camera Accessories. Price: 13,000৳14,000৳.
",197,512379,512576
3688,sentence,"Price: 13,000৳14,000৳.

Product: Viltrox EF-NEX IV Lens Mount Adapter for Canon EF-Mount Lens. Category: Lens Adapter. Subcategory: Camera Accessories. Price: 13,900৳14,500৳.
",175,512553,512728
3689,sentence,"Price: 13,900৳14,500৳.

Product: Sigma MC-11 Mount Converter/Lens Adapter (Sigma EF-Mount Lenses to Sony E). Category: Lens Adapter. Subcategory: Camera Accessories. Price: 20,500৳21,500৳.
",189,512705,512894
3690,sentence,"Price: 20,500৳21,500৳.

Product: Nikon FTZ II Lens Mount Adapter for Nikon Cameras. Category: Lens Adapter. Subcategory: Camera Accessories. Price: 24,500৳29,000৳.
",164,512871,513035
3691,sentence,"Price: 24,500৳29,000৳.

Product: Nikon Z Teleconverter TC-1.4x for Nikon Camera. Category: Lens Adapter. Subcategory: Camera Accessories. Price: 69,000৳70,000৳.
",161,513012,513173
3692,sentence,"Price: 69,000৳70,000৳.

Product: Viltrox EF-EOS R Lens Mount Adapter for Canon EF. Category: Lens Adapter. Subcategory: Camera Accessories. Price: Out Of Stock.
",161,513150,513311
3693,sentence,"Price: Out Of Stock.

Product: Viltrox EF-L Lens Mount Adapter for Canon EF or EF-S-Mount Lens to L-Mount Camera. Category: Lens Adapter. Subcategory: Camera Accessories. Price: Out Of Stock.
",192,513290,513482
3694,sentence,"Price: Out Of Stock.

Product: Simpex 400 LED professional Video light with Battery and Charger. Category: Studio Light. Subcategory: Camera Accessories. Price: 4,500৳4,700৳.
",175,513461,513636
3695,sentence,"Price: 4,500৳4,700৳.

Product: Simpex Led Video Light 520 with Battery & Charger. Category: Studio Light. Subcategory: Camera Accessories. Price: 5,300৳6,000৳.
",160,513615,513775
3696,sentence,"Price: 5,300৳6,000৳.

Product: Yongnuo YN300 II LED Variable-Color On-Camera Light. Category: Studio Light. Subcategory: Camera Accessories. Price: 6,800৳7,000৳.
",162,513754,513916
3697,sentence,"Price: 6,800৳7,000৳.

Product: Yongnuo YN360 II RGB LED Light Stick. Category: Studio Light. Subcategory: Camera Accessories. Price: 12,000৳14,000৳.
",149,513895,514044
3698,sentence,"Price: 12,000৳14,000৳.

Product: Yongnuo LUX200 Bi-Color LED Camera Light. Category: Studio Light. Subcategory: Camera Accessories. Price: 32,000৳34,000৳.
",155,514021,514176
3699,sentence,"Price: 32,000৳34,000৳.

Product: Yongnuo YN-600II LED Variable-Color On-Camera Light. Category: Studio Light. Subcategory: Camera Accessories. Price: 12,500৳14,500৳.
",166,514153,514319
3700,sentence,"Price: 12,500৳14,500৳.

Product: Yongnuo YN300 III LED Variable-Color On-Camera Light. Category: Studio Light. Subcategory: Camera Accessories. Price: 7,200৳7,500৳.
",165,514296,514461
3701,sentence,"Price: 7,200৳7,500৳.

Product: Godox SL60IID Daylight LED Video Light. Category: Studio Light. Subcategory: Camera Accessories. Price: 16,800৳18,000৳.
",151,514440,514591
3702,sentence,"Price: 16,800৳18,000৳.

Product: Zhiyun MOLUS G60 60W Bi-Color Pocket COB Light. Category: Studio Light. Subcategory: Camera Accessories. Price: 17,300৳19,000৳.
",161,514568,514729
3703,sentence,"Price: 17,300৳19,000৳.

Product: Godox LC500R RGB LED Light Stick (24""). Category: Studio Light. Subcategory: Camera Accessories. Price: 18,500৳19,000৳.

Product: Yongnuo YN1200 LED Panel Light. ",195,514706,514901
3704,sentence,"
Product: Yongnuo YN1200 LED Panel Light. Category: Studio Light. Subcategory: Camera Accessories. Price: 21,500৳23,000৳.

Product: Godox SL150W II LED Video Light. Category: Studio Light. ",189,514859,515048
3705,sentence,"Category: Studio Light. Subcategory: Camera Accessories. Price: 29,500৳32,000৳.

Product: Godox LED500LR Bi-Color Video Light. Category: Studio Light. Subcategory: Camera Accessories. ",184,515024,515208
3706,sentence,"Subcategory: Camera Accessories. Price: 16,500৳18,500৳.

Product: Godox SK400II-V Studio Flash Monolight. Category: Studio Light. Subcategory: Camera Accessories. Price: 18,000৳20,000৳.
",186,515175,515361
3707,sentence,"Price: 18,000৳20,000৳.

Product: Godox ML60 Daylight LED Monolight. Category: Studio Light. Subcategory: Camera Accessories. Price: 20,500৳23,000৳.

Product: Godox ML60Bi Bi-Color LED Monolight. ",195,515338,515533
3708,sentence,"
Product: Godox ML60Bi Bi-Color LED Monolight. Category: Studio Light. Subcategory: Camera Accessories. Price: 25,500৳27,500৳.

Product: Godox ML60IIBi Bi-Color LED Monolight Handgrip Kit. ",189,515486,515675
3709,sentence,"Category: Studio Light. Subcategory: Camera Accessories. Price: 22,000৳25,000৳.

Product: Godox SL200III Daylight LED Video Light. Category: Studio Light. Subcategory: Camera Accessories. ",188,515675,515863
3710,sentence,"Subcategory: Camera Accessories. Price: 34,300৳37,000৳.

Product: Godox Studio Speedlite 60x90cm Rectangular Softbox. Category: Softbox. Subcategory: Camera Accessories. Price: 6,500৳7,000৳.
",191,515830,516021
3711,sentence,"Price: 6,500৳7,000৳.

Product: Phottix Raja 65cm Quick-Folding SoftBox. Category: Softbox. Subcategory: Camera Accessories. Price: 9,000৳9,500৳.

Product: NEEWER 26''/65cm Octagonal Softbox. ",191,516000,516191
3712,sentence,"
Product: NEEWER 26''/65cm Octagonal Softbox. Category: Softbox. Subcategory: Camera Accessories. Price: 9,500৳10,000৳.

Product: Phottix Raja 85cm Quick-Folding Softbox. Category: Softbox. ",190,516145,516335
3713,sentence,"Category: Softbox. Subcategory: Camera Accessories. Price: 12,000৳13,500৳.

Product: Godox Photo Studio 80cm Portable Octagon Umbrella Softbox. Category: Softbox. Subcategory: Camera Accessories. ",196,516316,516512
3714,sentence,"Subcategory: Camera Accessories. Price: Out Of Stock.

Product: NEEWER NS65L Lantern Softbox One Step Quick Release. Category: Softbox. Subcategory: Camera Accessories. Price: Out Of Stock.
",190,516479,516669
3715,sentence,"Price: Out Of Stock.

Product: K&F Concept KF18.0012 4-in-1 U-Shape Curved Foldable Lighting Reflector Panel With Carrying Bag. Category: Softbox. Subcategory: Camera Accessories. ",180,516648,516828
3716,sentence,"Subcategory: Camera Accessories. Price: 11,500৳15,000৳.

Product: Godox P90L 35"" Deep Parabolic Softbox. Category: Softbox. Subcategory: Camera Accessories. Price: 9,000৳10,000৳.
",179,516795,516974
3717,sentence,"Price: 9,000৳10,000৳.

Product: K&F Concept KF31.030 Quick Release Plate. Category: Camera Tripod. Subcategory: Camera. Price: 700৳750৳.

Product: Digipod TR-452 Camera Tripod. ",177,516952,517129
3718,sentence,"
Product: Digipod TR-452 Camera Tripod. Category: Camera Tripod. Subcategory: Camera. Price: 1,450৳1,650৳.

Product: Digipod TR-564 Camera Tripod. Category: Camera Tripod. Subcategory: Camera. ",193,517089,517282
3719,sentence,"Category: Camera Tripod. Subcategory: Camera. Price: 1,650৳2,000৳.

Product: Digipod TR-462 Camera Tripod. Category: Camera Tripod. Subcategory: Camera. Price: 1,800৳1,950৳.
",174,517236,517410
3720,sentence,"Subcategory: Camera. Price: 1,800৳1,950৳.

Product: K&F Concept MS-01 Versatile Flexible Gorillapod Phone Tripod. Category: Camera Tripod. Subcategory: Camera. Price: 2,200৳3,000৳.
",181,517368,517549
3721,sentence,"Subcategory: Camera. Price: 2,200৳3,000৳.

Product: Telesin MT-11 Multifunctional Octopus Tripod. Category: Camera Tripod. Subcategory: Camera. Price: 1,350৳1,450৳.
",165,517507,517672
3722,sentence,"Subcategory: Camera. Price: 1,350৳1,450৳.

Product: K&F Concept KF31.029V3 BH-25 Camera Tripod Ball Head. Category: Camera Tripod. Subcategory: Camera. Price: 2,500৳2,700৳.
",173,517630,517803
3723,sentence,"Subcategory: Camera. Price: 2,500৳2,700৳.

Product: K&F Concept KF31.049 BH-26 Tripod Ball Head. Category: Camera Tripod. Subcategory: Camera. Price: 3,000৳3,200৳.
",164,517761,517925
3724,sentence,"Subcategory: Camera. Price: 3,000৳3,200৳.

Product: K&F Concept KF31.023V3 BH-28L Professional Tripod Ball Head. Category: Camera Tripod. Subcategory: Camera. Price: 3,000৳3,300৳.
",180,517883,518063
3725,sentence,"Subcategory: Camera. Price: 3,000৳3,300৳.

Product: Digipod TR-688V DSLR Camera Tripod. Category: Camera Tripod. Subcategory: Camera. Price: 3,100৳3,450৳.
",155,518021,518176
3726,sentence,"Subcategory: Camera. Price: 3,100৳3,450৳.

Product: K&F Concept KF31.037 Tripod Extension Arm Centre Column. Category: Camera Tripod. Subcategory: Camera. Price: 3,800৳4,200৳.
",176,518134,518310
3727,sentence,"Subcategory: Camera. Price: 3,800৳4,200৳.

Product: Yunteng VCT-691 Camera Tripod. Category: Camera Tripod. Subcategory: Camera. Price: 3,500৳3,550৳.
",150,518268,518418
3728,sentence,"Subcategory: Camera. Price: 3,500৳3,550৳.

Product: Jmary KP-2599 Professional Camera Tripod and Monopod. Category: Camera Tripod. Subcategory: Camera. Price: 3,300৳3,600৳.
",173,518376,518549
3729,sentence,"Subcategory: Camera. Price: 3,300৳3,600৳.

Product: Yunteng VCT-880 Aluminum Camera Tripod. Category: Camera Tripod. Subcategory: Camera. Price: 4,500৳4,600৳.
",159,518507,518666
3730,sentence,"Subcategory: Camera. Price: 4,500৳4,600৳.

Product: Qihe QH-J260 Heavy Duty Professional Studio Light Stand. Category: Camera Tripod. Subcategory: Camera. Price: 2,500৳2,500৳.
",176,518624,518800
3731,sentence,"Subcategory: Camera. Price: 2,500৳2,500৳.

Product: Yunteng VCT-998 Protable Camera Tripod. Category: Camera Tripod. Subcategory: Camera. Price: 5,000৳5,400৳.
",159,518758,518917
3732,sentence,"Subcategory: Camera. Price: 5,000৳5,400৳.

Product: Yunteng VCT-999 Camera Tripod. Category: Camera Tripod. Subcategory: Camera. Price: 5,700৳6,000৳.
",150,518875,519025
3733,sentence,"Subcategory: Camera. Price: 5,700৳6,000৳.

Product: K&F Concept KF09.101 Portable Camera Tripod. Category: Camera Tripod. Subcategory: Camera. Price: 7,000৳8,000৳.
",164,518983,519147
3734,sentence,"Subcategory: Camera. Price: 7,000৳8,000৳.

Product: K&F Concept KF09.115 K234A0 Aluminum Portable Video Tripod. Category: Camera Tripod. Subcategory: Camera. Price: 7,000৳8,000৳.
",179,519105,519284
3735,sentence,"Subcategory: Camera. Price: 7,000৳8,000৳.

Product: K&F Concept B234A1 Portable Tripod with Monopod. Category: Camera Tripod. Subcategory: Camera. Price: 9,500৳9,700৳.
",168,519242,519410
3736,sentence,"Subcategory: Camera. Price: 9,500৳9,700৳.

Product: K&F Concept NP-FZ100 Dual Slot Quick Charger. Category: Battery & Charger. Subcategory: Camera Accessories. Price: 2,500৳2,600৳.
",181,519368,519549
3737,sentence,"Price: 2,500৳2,600৳.

Product: K&F Concept NP-FW50 Dual Slot Quick Charger. Category: Battery & Charger. Subcategory: Camera Accessories. Price: 2,500৳2,700৳.
",159,519528,519687
3738,sentence,"Price: 2,500৳2,700৳.

Product: K&F Concept EN-EL15C Camera Battery With Type C Charging Port. Category: Battery & Charger. Subcategory: Camera Accessories. Price: 5,200৳6,000৳.
",177,519666,519843
3739,sentence,"Price: 5,200৳6,000৳.

Product: K&F Concept LP-E17 Dual Slot Battery Charger with Type-C Cable. Category: Battery & Charger. Subcategory: Camera Accessories. Price: 1,900৳2,500৳.
",178,519822,520000
3740,sentence,"Price: 1,900৳2,500৳.

Product: K&F Concept NP-F 4-Channel Battery Charger with LCD Display. Category: Battery & Charger. Subcategory: Camera Accessories. Price: 6,500৳8,000৳.
",175,519979,520154
3741,sentence,"Price: 6,500৳8,000৳.

Product: K&F Concept NP-W235 Dual Slot Battery Charger with Type-C Cable. Category: Battery & Charger. Subcategory: Camera Accessories. Price: 1,900৳2,500৳.
",179,520133,520312
3742,sentence,"Price: 1,900৳2,500৳.

Product: K&F Concept LP-E6NH Dual Slot Battery Charger with Type-C Cable. Category: Battery & Charger. Subcategory: Camera Accessories. Price: 1,900৳2,500৳.
",179,520291,520470
3743,sentence,"Price: 1,900৳2,500৳.

Product: K&F Concept EN-EL15 Dual Slot Battery Charger with Type-C Cable. Category: Battery & Charger. Subcategory: Camera Accessories. Price: 1,900৳2,500৳.
",179,520449,520628
3744,sentence,"Price: 1,900৳2,500৳.

Product: K&F Concept NP-W235 Camera Battery for Fujifilm Camera. Category: Battery & Charger. Subcategory: Camera Accessories. Price: 2,800৳3,500৳.
",170,520607,520777
3745,sentence,"Price: 2,800৳3,500৳.

Product: K&F Concept NP-FZ100 Camera Battery for Sony Camera. Category: Battery & Charger. Subcategory: Camera Accessories. Price: 4,000৳5,000৳.
",167,520756,520923
3746,sentence,"Price: 4,000৳5,000৳.

Product: K&F Concept EN-EL15 2100mAh Camera Battery for Nikon Camera. Category: Battery & Charger. Subcategory: Camera Accessories. Price: 2,000৳2,500৳.
",175,520902,521077
3747,sentence,"Price: 2,000৳2,500৳.

Product: K&F Concept LP-E17 Camera Battery for Canon Camera. Category: Battery & Charger. Subcategory: Camera Accessories. Price: 2,000৳2,500৳.
",166,521056,521222
3748,sentence,"Price: 2,000৳2,500৳.

Product: K&F Concept NP-FW50 1100mAh Camera Battery for Sony Camera. Category: Battery & Charger. Subcategory: Camera Accessories. Price: 2,000৳2,500৳.
",174,521201,521375
3749,sentence,"Price: 2,000৳2,500৳.

Product: K&F Concept LP-E10 Dual Camera Battery with Dual Charger. Category: Battery & Charger. Subcategory: Camera Accessories. Price: 4,300৳5,000৳.
",172,521354,521526
3750,sentence,"Price: 4,300৳5,000৳.

Product: K&F Concept NP-F970 Dual Camera Battery with Dual Charger. Category: Battery & Charger. Subcategory: Camera Accessories. Price: 9,500৳11,000৳.
",174,521505,521679
3751,sentence,"Price: 9,500৳11,000৳.

Product: K&F Concept NP-FW50 Camera Battery with Type-C Cable. Category: Battery & Charger. Subcategory: Camera Accessories. Price: 3,000৳3,200৳.
",169,521657,521826
3752,sentence,"Price: 3,000৳3,200৳.

Product: K&F Concept KF13.106 4-Pocket Filter Case for Round or Square ND CPL 100x100mm. Category: Camera Bag. Subcategory: Camera Accessories. Price: 3,600৳3,900৳.
",187,521805,521992
3753,sentence,"Price: 3,600৳3,900৳.

Product: K&F Concept KF13.062V1 Multifunctional Waterproof Camera Shoulder Backpack. Category: Camera Bag. Subcategory: Camera Accessories. Price: 5,100৳6,000৳.
",183,521971,522154
3754,sentence,"Price: 5,100৳6,000৳.

Product: K&F Concept KF13.171 Beta Series 05L Sling Camera Backpack. Category: Camera Bag. Subcategory: Camera Accessories. Price: 4,700৳5,500৳.
",167,522133,522300
3755,sentence,"Price: 4,700৳5,500৳.

Product: K&F Concept KF13.141 10L Beta Series Sling Camera Backpack. Category: Camera Bag. Subcategory: Camera Accessories. Price: 4,500৳4,600৳.
",167,522279,522446
3756,sentence,"Price: 4,500৳4,600৳.

Product: K&F Concept KF13.157V3 Multifunctional Waterproof Camera Side Bag. Category: Camera Bag. Subcategory: Camera Accessories. Price: 4,900৳5,200৳.
",174,522425,522599
3757,sentence,"Price: 4,900৳5,200৳.

Product: K&F Concept KF13.140 15L Beta DSLR Camera Backpack. Category: Camera Bag. Subcategory: Camera Accessories. Price: 6,400৳8,500৳.
",159,522578,522737
3758,sentence,"Price: 6,400৳8,500৳.

Product: K&F Concept KF13.044 Multifunctional Waterproof Camera Backpack. Category: Camera Bag. Subcategory: Camera Accessories. Price: 6,800৳7,000৳.
",172,522716,522888
3759,sentence,"Price: 6,800৳7,000৳.

Product: K&F Concept KF13.129 Multifunctional Waterproof Collapsible 2 in 1 Camera Backpack with Side Bag. Category: Camera Bag. Subcategory: Camera Accessories. ",184,522867,523051
3760,sentence,"Subcategory: Camera Accessories. Price: 6,800৳7,000৳.

Product: K&F Concept KF13.087 Multifunctional Waterproof Large Camera Backpack Blue. Category: Camera Bag. Subcategory: Camera Accessories. ",195,523018,523213
3761,sentence,"Subcategory: Camera Accessories. Price: 7,000৳7,200৳.

Product: K&F Concept KF13.119 Large Camera Backpack. Category: Camera Bag. Subcategory: Camera Accessories. Price: 7,000৳7,200৳.
",184,523180,523364
3762,sentence,"Price: 7,000৳7,200৳.

Product: K&F Concept KF13.122 Professional Camera Backpack. Category: Camera Bag. Subcategory: Camera Accessories. Price: 7,000৳7,200৳.
",158,523343,523501
3763,sentence,"Price: 7,000৳7,200৳.

Product: K&F Concept KF13.096V1 Professional Camera Backpack. Category: Camera Bag. Subcategory: Camera Accessories. Price: 7,000৳7,200৳.
",160,523480,523640
3764,sentence,"Price: 7,000৳7,200৳.

Product: Wonderful DB2820 DSLR Camera Lens Dry Cabinet Box S Size. Category: Dry Cabinet. Subcategory: Camera Accessories. Price: Up Coming.
",163,523619,523782
3765,sentence,"Price: Up Coming.

Product: WONDERFUL PC-7226 Waterproof Safety Professional Hard Case For Camera. Category: Dry Cabinet. Subcategory: Camera Accessories. Price: Up Coming.
",173,523764,523937
3766,sentence,"Price: Up Coming.

Product: Wonderful DB3820 DSLR Camera Lens Dry Cabinet Box. Category: Dry Cabinet. Subcategory: Camera Accessories. Price: Out Of Stock.
",156,523919,524075
3767,sentence,"Price: Out Of Stock.

Product: Wonderful DB3826 DSLR Camera Lens Dry Cabinet Box M Size. Category: Dry Cabinet. Subcategory: Camera Accessories. Price: Out Of Stock.
",166,524054,524220
3768,sentence,"Price: Out Of Stock.

Product: Wonderful DB3828 DSLR Camera Lens Dry Cabinet Box. Category: Dry Cabinet. Subcategory: Camera Accessories. Price: Out Of Stock.
",159,524199,524358
3769,sentence,"Price: Out Of Stock.

Product: Manbily KF-0 Camera Tripod Ball Head. Category: Manbily. Subcategory: Camera Tripod. Price: Up Coming.

Product: Digipod TR-472 Camera Tripod. Category: Digipod. ",193,524337,524530
3770,sentence,"Category: Digipod. Subcategory: Camera Tripod. Price: 1,900৳2,300৳.

Product: Libec TH-650EX Video Tripod with Fluid Tilter. Category: Libec. Subcategory: Camera Tripod. Price: 27,000৳32,000৳.
",193,524511,524704
3771,sentence,"Price: 27,000৳32,000৳.

Product: Libec TH-X Camera Tripod. Category: Libec. Subcategory: Camera Tripod. Price: 34,000৳38,000৳.

Product: K&F Concept K254A3 Portable Tripod with Monopod. ",186,524681,524867
3772,sentence,"Category: K&F Concept. Subcategory: Camera Tripod. Price: 9,800৳10,000৳.

Product: K&F Concept KF09.087V4 S210 Aluminum Overhead Camera Tripod. Category: K&F Concept. Subcategory: Camera Tripod. ",195,524867,525062
3773,sentence,"Subcategory: Camera Tripod. Price: 10,500৳11,000৳.

Product: K&F Concept KF09.123 K254C2 BH-36L Portable Carbon Fiber Camera Tripod. Category: K&F Concept. Subcategory: Camera Tripod. ",184,525034,525218
3774,sentence,"Subcategory: Camera Tripod. Price: 11,200৳11,500৳.

Product: K&F Concept KF09.112 T255A3 Aluminum Ball Head Camera Tripod. Category: K&F Concept. Subcategory: Camera Tripod. Price: 11,500৳12,000৳.
",197,525190,525387
3775,sentence,"Price: 11,500৳12,000৳.

Product: K&F Concept SA254T2 Lightweight Aluminum Compact Tripod. Category: K&F Concept. Subcategory: Camera Tripod. Price: 12,000৳12,500৳.
",164,525364,525528
3776,sentence,"Price: 12,000৳12,500৳.

Product: K&F Concept KF09.109 D254C1 BH-28L Ball Head Carbon Fiber Camera Tripod. Category: K&F Concept. Subcategory: Camera Tripod. Price: 14,500৳15,000৳.
",180,525505,525685
3777,sentence,"Price: 14,500৳15,000৳.

Product: K&F Concept KF09.086V1 T254A8 BH-28L Aluminum Overhead Camera Tripod. Category: K&F Concept. Subcategory: Camera Tripod. Price: 14,500৳15,000৳.
",177,525662,525839
3778,sentence,"Price: 14,500৳15,000৳.

Product: K&F Concept K234A7+FH-03 Professional Video Tripod with Fluid Head. Category: K&F Concept. Subcategory: Camera Tripod. Price: 14,900৳17,000৳.
",175,525816,525991
3779,sentence,"Price: 14,900৳17,000৳.

Product: K&F Concept KF31.087 FH-03 Professional Fluid Video Head For Pan & Tilt. Category: K&F Concept. Subcategory: Camera Tripod. Price: 8,200৳10,900৳.
",179,525968,526147
3780,sentence,"Price: 8,200৳10,900৳.

Product: K&F Concept S225A1+BH-25 Portable Desktop Tripod. Category: K&F Concept. Subcategory: Camera Tripod. Price: 7,500৳8,000৳.
",154,526125,526279
3781,sentence,"Price: 7,500৳8,000৳.

Product: K&F Concept B174A1 Portable Video Tripod. Category: K&F Concept. Subcategory: Camera Tripod. Price: 3,000৳3,500৳.
",145,526258,526403
3782,sentence,"Price: 3,000৳3,500৳.

Product: Kingjoy VT-866 Aluminum Alloy Professional Camera Tripod. Category: Kingjoy. Subcategory: Camera Tripod. Price: Up Coming.

Product: Yunteng VCT-391 Camera Tripod. ",195,526382,526577
3783,sentence,"
Product: Yunteng VCT-391 Camera Tripod. Category: Yunteng. Subcategory: Camera Tripod. Price: Up Coming.

Product: Yunteng VCT-590 Camera Tripod. Category: Yunteng. Subcategory: Camera Tripod. ",194,526536,526730
3784,sentence,"Category: Yunteng. Subcategory: Camera Tripod. Price: Up Coming.

Product: Yunteng VCT-668 Camera Tripod. Category: Yunteng. Subcategory: Camera Tripod. Price: Out Of Stock.
",174,526683,526857
3785,sentence,"Price: Out Of Stock.

Product: Jmary KP-2294 Professional Over Head Camera Tripod. Category: Jmary. Subcategory: Camera Tripod. Price: 3,400৳3,500৳.
",149,526836,526985
3786,sentence,"Price: 3,400৳3,500৳.

Product: Jmary KP-2264 Professional Camera Tripod. Category: Jmary. Subcategory: Camera Tripod. Price: Out Of Stock.
",139,526964,527103
3787,sentence,"Price: Out Of Stock.

Product: Manfrotto BeFree One Aluminium Travel Tripod with Head. Category: Manfrotto. Subcategory: Camera Tripod. Price: 11,500৳12,000৳.
",159,527082,527241
3788,sentence,"Price: 11,500৳12,000৳.

Product: Manfrotto Off Road Ultra Lightweight Portable Aluminum Travel Tripod with Ball Head. Category: Manfrotto. Subcategory: Camera Tripod. Price: Out Of Stock.
",188,527218,527406
3789,sentence,"Price: Out Of Stock.

Product: Fantech SS100 Tongsis Bluetooth Selfie Stick Tripod. Category: Fantech. Subcategory: Camera Tripod. Price: Out Of Stock.
",152,527385,527537
3790,sentence,"Price: Out Of Stock.

Product: Fantech SS170 Tongsis Bluetooth Selfie Stick Tripod. Category: Fantech. Subcategory: Camera Tripod. Price: Out Of Stock.
",152,527516,527668
3791,sentence,"Price: Out Of Stock.

Product: Meari S1 Plus 3MP Indoor Pan/Tilt Portable WiFi Camera. Category: Meari. Subcategory: Portable WiFi Camera. Price: 2,475৳2,700৳.
",160,527647,527807
3792,sentence,"Price: 2,475৳2,700৳.

Product: Meari S2 Plus 3MP Outdoor Smart PTZ WiFi Camera. Category: Meari. Subcategory: Portable WiFi Camera. Price: 4,950৳5,450৳.
",153,527786,527939
3793,sentence,"Price: 4,950৳5,450৳.

Product: Meari N2 3MP Outdoor Smart PTZ WiFi Camera With Solar Panel. Category: Meari. Subcategory: Portable WiFi Camera. Price: 8,625৳9,500৳.
",165,527918,528083
3794,sentence,"Price: 8,625৳9,500৳.

Product: Meari N1 3MP Outdoor Smart WiFi Camera With Built-in Battery. Category: Meari. Subcategory: Portable WiFi Camera. Price: 7,475৳8,250৳.
",166,528062,528228
3795,sentence,"Price: 7,475৳8,250৳.

Product: Meari V1 3MP Outdoor 4G PTZ Camera With Battery & Solar Panel. Category: Meari. Subcategory: Portable WiFi Camera. Price: Out Of Stock.
",167,528207,528374
3796,sentence,"Price: Out Of Stock.

Product: Meari S3 3MP+3MP Dual-Lens Indoor Pan/Tilt Portable WiFi Camera. Category: Meari. Subcategory: Portable WiFi Camera. Price: Out Of Stock.
",169,528353,528522
3797,sentence,"Price: Out Of Stock.

Product: Meari L1 Plus 3MP Outdoor Fixed Smart WiFi Camera. Category: Meari. Subcategory: Portable WiFi Camera. Price: Out Of Stock.
",155,528501,528656
3798,sentence,"Price: Out Of Stock.

Product: Meari M1 2MP Indoor Fixed Smart Wi‑Fi Camera. Category: Meari. Subcategory: Portable WiFi Camera. Price: Out Of Stock.
",150,528635,528785
3799,sentence,"Price: Out Of Stock.

Product: Meari S4 4MP Outdoor PTZ Smart WiFi Camera. Category: Meari. Subcategory: Portable WiFi Camera. Price: Out Of Stock.
",148,528764,528912
3800,sentence,"Price: Out Of Stock.

Product: Imou Ranger Mini 3MP 2K Pan & Tilt Portable Wi-Fi Camera. Category: Portable WiFi Camera. Subcategory: Security. Price: 2,450৳2,500৳.
",165,528891,529056
3801,sentence,"Subcategory: Security. Price: 2,450৳2,500৳.

Product: EZVIZ CP1 Lite 2MP Pan & Tilt WiFi Dome IP Camera. Category: Portable WiFi Camera. Subcategory: Security. Price: 1,800৳.
",175,529012,529187
3802,sentence,"Subcategory: Security. Price: 1,800৳.

Product: TP-Link Tapo C200C 2MP Wi-Fi IP Camera. Category: Portable WiFi Camera. Subcategory: Security. Price: 2,000৳.
",158,529149,529307
3803,sentence,"Subcategory: Security. Price: 2,000৳.

Product: Tenda CP3 Pro 3MP WIFI Pan/Tilt Camera. Category: Portable WiFi Camera. Subcategory: Security. Price: 2,090৳2,300৳.
",164,529269,529433
3804,sentence,"Subcategory: Security. Price: 2,090৳2,300৳.

Product: TP-Link Tapo C202 2MP Pan & Tilt Wi-Fi Security Camera. Category: Portable WiFi Camera. Subcategory: Security. Price: 2,090৳2,390৳.
",186,529389,529575
3805,sentence,"Subcategory: Security. Price: 2,090৳2,390৳.

Product: Dahua DH-IPC-H3AE 3MP Indoor Fixed-focal Wi-Fi Pan & Tilt WiFi Camera. Category: Portable WiFi Camera. Subcategory: Security. ",180,529531,529711
3806,sentence,"Subcategory: Security. Price: 1,936৳2,050৳.

Product: Havit IPC20 (2.0MP) Wi-Fi Dome IP Camera (Built-in Audio). Category: Portable WiFi Camera. Subcategory: Security. Price: 2,400৳2,500৳.
",189,529688,529877
3807,sentence,"Subcategory: Security. Price: 2,400৳2,500৳.

Product: Imou Ranger 2 WiFi Camera with 360 Degree Coverage. Category: Portable WiFi Camera. Subcategory: Security. Price: 2,140৳2,550৳.
",182,529833,530015
3808,sentence,"Subcategory: Security. Price: 2,140৳2,550৳.

Product: Imou IPC-K6CP-3H0WEB 3MP Wi-Fi Camera. Category: Portable WiFi Camera. Subcategory: Security. Price: 2,236৳2,600৳.
",169,529971,530140
3809,sentence,"Subcategory: Security. Price: 2,236৳2,600৳.

Product: Dahua DH-IPC-H5AE 5MP Indoor Pan & Tilt portable WiFi Camera. Category: Portable WiFi Camera. Subcategory: Security. Price: 2,430৳2,700৳.
",192,530096,530288
3810,sentence,"Subcategory: Security. Price: 2,430৳2,700৳.

Product: Tenda CP6 2K Security Pan Tilt Camera. Category: Portable WiFi Camera. Subcategory: Security. Price: 2,063৳2,250৳.
",169,530244,530413
3811,sentence,"Subcategory: Security. Price: 2,063৳2,250৳.

Product: Jovision JVS-HD301C 2.0MP Wi-Fi Camera. Category: Portable WiFi Camera. Subcategory: Security. Price: 2,249৳2,800৳.
",170,530369,530539
3812,sentence,"Subcategory: Security. Price: 2,249৳2,800৳.

Product: Tenda CP7 360° 4MP Pan Tilt Security Wifi IP Camera. Category: Portable WiFi Camera. Subcategory: Security. Price: 2,740৳3,100৳.
",183,530495,530678
3813,sentence,"Subcategory: Security. Price: 2,740৳3,100৳.

Product: ZKTeco C2B2 2MP Pan/Tilt WIFI Camera. Category: Portable WiFi Camera. Subcategory: Security. Price: 1,920৳3,200৳.
",168,530634,530802
3814,sentence,"Subcategory: Security. Price: 1,920৳3,200৳.

Product: ZKTeco C3A2 2MP Outdoor WIFI Camera. Category: Portable WiFi Camera. Subcategory: Security. Price: 2,140৳2,250৳.
",167,530758,530925
3815,sentence,"Subcategory: Security. Price: 2,140৳2,250৳.

Product: EZVIZ CS-H6c Pro 3MP Pan & Tilt Smart Portable WiFi Camera. Category: Portable WiFi Camera. Subcategory: Security. Price: 1,984৳3,200৳.
",190,530881,531071
3816,sentence,"Subcategory: Security. Price: 1,984৳3,200৳.

Product: Imou IPC-K6C-5H1WEB 5MP Wi-Fi Camera. Category: Portable WiFi Camera. Subcategory: Security. Price: 2,656৳3,200৳.
",168,531027,531195
3817,sentence,"Subcategory: Security. Price: 2,656৳3,200৳.

Product: Jovision JVS-H950E 3MP Wi-Fi Network IP Camera. Category: Jovision. Subcategory: Portable WiFi Camera. Price: 2,300৳2,750৳.
",178,531151,531329
3818,sentence,"Price: 2,300৳2,750৳.

Product: Jovision JVS-H320C 3MP Pan/Tilt Wi-Fi Camera. Category: Jovision. Subcategory: Portable WiFi Camera. Price: 4,900৳.
",147,531308,531455
3819,sentence,"Price: 4,900৳.

Product: Jovision JVS-H322C 3MP Full-Color Pan/Tilt Wi-Fi Camera. Category: Jovision. Subcategory: Portable WiFi Camera. Price: 6,500৳.
",152,531440,531592
3820,sentence,"Price: 6,500৳.

Product: Jovision JVS-N97-X3 3MP Full-Color Wi-Fi Pan Tilt Camera. Category: Jovision. Subcategory: Portable WiFi Camera. Price: 6,600৳7,000৳.
",159,531577,531736
3821,sentence,"Price: 6,600৳7,000৳.

Product: Jovision JVS-N98-X3 3MP Dual-Lens Full-Color Wi-Fi PTZ Camera. Category: Jovision. Subcategory: Portable WiFi Camera. Price: 6,890৳8,500৳.
",170,531715,531885
3822,sentence,"Price: 6,890৳8,500৳.

Product: Jovision JVS-H930E 3MP Wi-Fi Pan Tilt IP Camera. Category: Jovision. Subcategory: Portable WiFi Camera. Price: Out Of Stock.
",156,531864,532020
3823,sentence,"Price: Out Of Stock.

Product: Jovision JVS-N96-X3 3MP Wi-Fi Full-Color Pan Tilt IP Camera. Category: Jovision. Subcategory: Portable WiFi Camera. Price: Out Of Stock.
",168,531999,532167
3824,sentence,"Price: Out Of Stock.

Product: Dahua DH-PFM3250D-1210BS 12V 1A Power Adapter. Category: Security. Price: 380৳.

Product: Hikvision DS-1H18-A 1080P 2MP Video Balun for CC Camera. Category: Security. ",198,532146,532344
3825,sentence,"Category: Security. Price: 250৳.

Product: ZKTeco EX-802 Exit Button. Category: Security. Price: 350৳450৳.

Product: Nexakey A86H Exit Button For DoorLock. Category: Security. Price: 650৳.
",189,532324,532513
3826,sentence,"Category: Security. Price: 650৳.

Product: Hikvision DS-2CE76D0T-ITPF 2 MP Indoor Fixed Turret Camera. Category: Security. Price: 1,030৳1,400৳.
",144,532480,532624
3827,sentence,"Category: Security. Price: 1,030৳1,400৳.

Product: Hikvision DS-2CE16D0T-EXLPF (3.6mm) 2MP Smart Hybrid Light Bullet CC Camera. Category: Security. Price: 1,375৳.
",163,532583,532746
3828,sentence,"Category: Security. Price: 1,375৳.

Product: Hikvision DS-2CE76D0T-EXLPF (2.8mm) 2MP Smart Hybrid Light Dome CC Camera. Category: Security. Price: 1,375৳.
",155,532711,532866
3829,sentence,"Category: Security. Price: 1,375৳.

Product: Hikvision DS-2CE16D0T-ITF 2MP Bullet CCTV Camera. Category: Security. Price: 1,550৳.

Product: Hikvision DS-2CE11D0T-PIRLO 2MP Bullet CCTV Camera. ",192,532831,533023
3830,sentence,"Category: Security. Price: Out Of Stock.

Product: Hikvision DS-2CE76D0T-LPFS 2MP Dual Light Audio Fixed Turret Camera. Category: Security. Price: 1,705৳.
",155,533023,533178
3831,sentence,"Category: Security. Price: 1,705৳.

Product: Uniview UAC-T112-F28 Turret Analog Camera. Category: Security. Price: 1,650৳.
",123,533143,533266
3832,sentence,"Category: Security. Price: 1,650৳.

Product: Hikvision DS-2CE16D0T-LPFS 2MP Dual Light Audio Fixed Mini Bullet Camera. Category: Security. Price: 1,705৳.
",154,533231,533385
3833,sentence,"Category: Security. Price: 1,705৳.

Product: Uniview UAC-B112-F40 Bullet Analog Camera. Category: Security. Price: 1,200৳1,700৳.
",129,533350,533479
3834,sentence,"Category: Security. Price: 1,200৳1,700৳.

Product: Dahua HAC-B1A21P-U-IL 2MP Smart Dual Light HDCVI Bullet CC Camera. Category: Security. Price: 1,150৳1,700৳.
",159,533438,533597
3835,sentence,"Category: Security. Price: 1,150৳1,700৳.

Product: Dahua HAC-T1A21P-U-IL 2MP Smart Dual Light HDCVI Eyeball CC Camera. Category: Security. Price: 999৳1,700৳.
",158,533556,533714
3836,sentence,"Category: Security. Price: 999৳1,700৳.

Product: ZKTeco ZK-D100S Hand Held Metal Detector. Category: Security. Price: 1,800৳.

Product: Imou Bulb Cam WiFi Camera. Category: Imou. ",179,533675,533854
3837,sentence,"Category: Imou. Subcategory: Portable WiFi Camera. Price: 3,150৳3,500৳.

Product: Imou Bullet 2E 3MP Outdoor WiFi IP Camera. Category: Imou. Subcategory: Portable WiFi Camera. Price: 3,145৳3,700৳.
",197,533838,534035
3838,sentence,"Price: 3,145৳3,700৳.

Product: Imou Cruiser SC 5MP 3K Pan & Tilt Wi-Fi IP Camera. Category: Imou. Subcategory: Portable WiFi Camera. Price: Out Of Stock.
",154,534014,534168
3839,sentence,"Price: Out Of Stock.

Product: Imou Ranger Dual Lens 6MP Pan & Tilt WiFi Camera. Category: Imou. Subcategory: Portable WiFi Camera. Price: 4,900৳5,500৳.

Product: Imou Cruiser 4G Dome IP Camera. ",195,534147,534342
3840,sentence,"
Product: Imou Cruiser 4G Dome IP Camera. Category: Imou. Subcategory: Portable WiFi Camera. Price: 4,446৳5,700৳.

Product: Imou Rex VT 5MP Wi-Fi IP Camera with Display. Category: Imou. ",186,534300,534486
3841,sentence,"Category: Imou. Subcategory: Portable WiFi Camera. Price: 5,550৳5,900৳.

Product: Imou Cruiser Dual Lens 6MP 2K Outdoor WiFi Camera. Category: Imou. Subcategory: Portable WiFi Camera. ",184,534470,534654
3842,sentence,"Subcategory: Portable WiFi Camera. Price: 7,690৳8,000৳.

Product: Imou Ranger S2 2MP 360-degree Portable WiFi Camera. Category: Imou. Subcategory: Portable WiFi Camera. Price: Out Of Stock.
",190,534619,534809
3843,sentence,"Price: Out Of Stock.

Product: Imou IPC-TA22CP Ranger 2C IP Camera. Category: Imou. Subcategory: Portable WiFi Camera. Price: Out Of Stock.

Product: Imou Ranger RC 3MP Indoor Portable Wi-Fi Camera. ",199,534788,534987
3844,sentence,"Category: Imou. Subcategory: Portable WiFi Camera. Price: Out Of Stock.

Product: Imou REX 2D 3MP Indoor Pan & Tilt WiFi Camera. Category: Imou. Subcategory: Portable WiFi Camera. ",180,534987,535167
3845,sentence,"Subcategory: Portable WiFi Camera. Price: Out Of Stock.

Product: Imou Ranger Pro IP Camera with 360 Degree Coverage. Category: Imou. Subcategory: Portable WiFi Camera. Price: Out Of Stock.
",190,535132,535322
3846,sentence,"Price: Out Of Stock.

Product: Imou Cruiser SE 2MP Outdoor Pan & Tilt Wi-Fi Camera. Category: Imou. Subcategory: Portable WiFi Camera. Price: Out Of Stock.
",156,535301,535457
3847,sentence,"Price: Out Of Stock.

Product: Imou IPC-S21FEP Cruiser SE 2MP Outdoor Pan & Tilt Wi-Fi Camera. Category: Imou. Subcategory: Portable WiFi Camera. Price: Out Of Stock.
",167,535436,535603
3848,sentence,"Price: Out Of Stock.

Product: Imou Rex 4MP Dome Wifi IP Camera. Category: Imou. Subcategory: Portable WiFi Camera. Price: Out Of Stock.

Product: Imou Cruiser 2 3MP Outdoor Security Wi-Fi Camera. ",197,535582,535779
3849,sentence,"Category: Imou. Subcategory: Portable WiFi Camera. Price: Out Of Stock.

Product: EZVIZ H3c 3MP Wi-Fi Smart Home Outdoor Security Camera with Audio. Category: EZVIZ. ",166,535779,535945
3850,sentence,"Category: EZVIZ. Subcategory: Portable WiFi Camera. Price: 4,200৳4,700৳.

Product: EZVIZ CS-H8c 3MP PoE Pan & Tilt WiFi Camera. Category: EZVIZ. Subcategory: Portable WiFi Camera. Price: 5,990৳.
",195,535928,536123
3851,sentence,"Price: 5,990৳.

Product: EZVIZ CS-H6C Pro 5MP Pan & Tilt Portable WiFi Camera. Category: EZVIZ. Subcategory: Portable WiFi Camera. Price: 3,190৳3,300৳.
",152,536108,536260
3852,sentence,"Price: 3,190৳3,300৳.

Product: EZVIZ CS-H8c Pro 3MP 2K Pan & Tilt Wi-Fi IP Camera. Category: EZVIZ. Subcategory: Portable WiFi Camera. Price: 4,250৳.
",150,536239,536389
3853,sentence,"Price: 4,250৳.

Product: EZVIZ H6 5MP Pan & Tilt Wi-Fi Smart Home Security Camera. Category: EZVIZ. Subcategory: Portable WiFi Camera. Price: 4,850৳5,200৳.
",156,536374,536530
3854,sentence,"Price: 4,850৳5,200৳.

Product: EZVIZ H8C 4G 3MP Pan & Tilt Smart Home Security Camera. Category: EZVIZ. Subcategory: Portable WiFi Camera. Price: 5,050৳5,400৳.
",160,536509,536669
3855,sentence,"Price: 5,050৳5,400৳.

Product: EZVIZ H7c 4MP Dual Lens 2K Pan & Tilt Portable WiFi Camera. Category: EZVIZ. Subcategory: Portable WiFi Camera. Price: 4,750৳5,500৳.
",164,536648,536812
3856,sentence,"Price: 4,750৳5,500৳.

Product: EZVIZ H3c 4MP Wi-Fi Smart Home Outdoor Security Camera with Audio. Category: EZVIZ. Subcategory: Portable WiFi Camera. Price: 4,900৳5,600৳.
",171,536791,536962
3857,sentence,"Price: 4,900৳5,600৳.

Product: EZVIZ CS-H8c Pro 5MP 3K Pan & Tilt Wi-Fi IP Camera. Category: EZVIZ. Subcategory: Portable WiFi Camera. Price: 4,800৳.
",150,536941,537091
3858,sentence,"Price: 4,800৳.

Product: EZVIZ H9c Dual 2K 3MP+3MP Pan & Tilt WiFi Camera. Category: EZVIZ. Subcategory: Portable WiFi Camera. Price: 6,699৳6,900৳.
",148,537076,537224
3859,sentence,"Price: 6,699৳6,900৳.

Product: EZVIZ CS-CB2 2MP Outdoor Wi-Fi Smart Home Battery Security Camera. Category: EZVIZ. Subcategory: Portable WiFi Camera. Price: 6,500৳6,800৳.
",171,537203,537374
3860,sentence,"Price: 6,500৳6,800৳.

Product: EZVIZ EB5 4K 8MP Type-C Outdoor WiFi Camera With Solar Battery. Category: EZVIZ. Subcategory: Portable WiFi Camera. Price: 13,800৳.
",163,537353,537516
3861,sentence,"Price: 13,800৳.

Product: EZVIZ CS-H6C 360° Pan & Tilt Smart Home Security Camera. Category: EZVIZ. Subcategory: Portable WiFi Camera. Price: Out Of Stock.
",156,537500,537656
3862,sentence,"Price: Out Of Stock.

Product: EZVIZ CS-C6N 2MP Wi-Fi PT IP Camera. Category: EZVIZ. Subcategory: Portable WiFi Camera. Price: Out Of Stock.
",141,537635,537776
3863,sentence,"Price: Out Of Stock.

Product: EZVIZ H6c Pro 2MP Pan & Tilt Smart Home Security Camera. Category: EZVIZ. Subcategory: Portable WiFi Camera. Price: Out Of Stock.
",161,537755,537916
3864,sentence,"Price: Out Of Stock.

Product: EZVIZ H6c Pro 4MP Pan & Tilt Smart Home Security Camera. Category: EZVIZ. Subcategory: Portable WiFi Camera. Price: Out Of Stock.
",161,537895,538056
3865,sentence,"Price: Out Of Stock.

Product: EZVIZ CS-H6C Pro 4MP Pan & Tilt Smart Portable WiFi Camera. Category: EZVIZ. Subcategory: Portable WiFi Camera. Price: Out Of Stock.
",164,538035,538199
3866,sentence,"Price: Out Of Stock.

Product: EZVIZ CS-C3N A0-3G2WFL1 Wifi Bullet 2mp Outdoor IP Camera. Category: EZVIZ. Subcategory: Portable WiFi Camera. Price: Out Of Stock.
",163,538178,538341
3867,sentence,"Price: Out Of Stock.

Product: Tenda CH3-WCA Smart Full-Color Night Vision Wi-Fi IP Camera. Category: Tenda. Subcategory: Portable WiFi Camera. Price: Out Of Stock.
",165,538320,538485
3868,sentence,"Price: Out Of Stock.

Product: Tenda CP3 360° 2MP Pan Tilt Security Wifi IP Camera. Category: Tenda. Subcategory: Portable WiFi Camera. Price: Out Of Stock.
",157,538464,538621
3869,sentence,"Price: Out Of Stock.

Product: Tenda CH3-WCA v2.0 Smart Full-Color Night Vision Wi-Fi IP Camera. Category: Tenda. Subcategory: Portable WiFi Camera. Price: 4,000৳.
",164,538600,538764
3870,sentence,"Price: 4,000৳.

Product: Tenda CH7-WCA 4MP AI Smart Outdoor Pan & Tilt WiFi Camera. Category: Tenda. Subcategory: Portable WiFi Camera. Price: Out Of Stock.
",157,538749,538906
3871,sentence,"Price: Out Of Stock.

Product: Tenda CH9-WCA 6MP Dual-lens Smart Outdoor Pan & Tilt WiFi Camera. Category: Tenda. Subcategory: Portable WiFi Camera. Price: Out Of Stock.
",170,538885,539055
3872,sentence,"Price: Out Of Stock.

Product: Tenda CP3 V3 360° 3MP Pan Tilt Security Wi-Fi IP Camera. Category: Tenda. Subcategory: Portable WiFi Camera. Price: Out Of Stock.
",161,539034,539195
3873,sentence,"Price: Out Of Stock.

Product: TP-Link Tapo C320WS 4MP Outdoor Wi-Fi Night Vision Security Camera. Category: TP-Link. Subcategory: Portable WiFi Camera. Price: 4,002৳4,350৳.
",174,539174,539348
3874,sentence,"Price: 4,002৳4,350৳.

Product: TP-Link Tapo C225 4MP Pan/Tilt AI Home Security Wi-Fi Camera. Category: TP-Link. Subcategory: Portable WiFi Camera. Price: 4,441৳4,700৳.
",168,539327,539495
3875,sentence,"Price: 4,441৳4,700৳.

Product: TP-Link Tapo C200 2MP Home Security Wi-Fi Dome IP Camera. Category: TP-Link. Subcategory: Portable WiFi Camera. Price: Out Of Stock.
",164,539474,539638
3876,sentence,"Price: Out Of Stock.

Product: TP-Link Tapo C210 3MP Pan & Tilt Wi-Fi Security Camera. Category: TP-Link. Subcategory: Portable WiFi Camera. Price: Out Of Stock.
",162,539617,539779
3877,sentence,"Price: Out Of Stock.

Product: TP-Link Tapo C212 3MP Pan & Tilt Wi-Fi Security Camera. Category: TP-Link. Subcategory: Portable WiFi Camera. Price: Out Of Stock.
",162,539758,539920
3878,sentence,"Price: Out Of Stock.

Product: TP-Link Tapo C310 Outdoor Security Wi-Fi IP Camera. Category: TP-Link. Subcategory: Portable WiFi Camera. Price: Out Of Stock.
",158,539899,540057
3879,sentence,"Price: Out Of Stock.

Product: TP-Link Tapo C500 2MP Outdoor Pan Tilt Security WiFi IP Camera. Category: TP-Link. Subcategory: Portable WiFi Camera. Price: Out Of Stock.
",170,540036,540206
3880,sentence,"Price: Out Of Stock.

Product: Xiaomi Mi C200 360° 1080P Home Security Smart Camera. Category: Xiaomi. Subcategory: Portable WiFi Camera. Price: Out Of Stock.
",159,540185,540344
3881,sentence,"Price: Out Of Stock.

Product: Xiaomi Mi MJSXJ05CM 360° Motion Detection WiFi Security Camera White. Category: Xiaomi. Subcategory: Portable WiFi Camera. Price: Out Of Stock.
",175,540323,540498
3882,sentence,"Price: Out Of Stock.

Product: Imilab CMSXJ16A 360° 1080P Basic Home Security Camera White. Category: Xiaomi. Subcategory: Portable WiFi Camera. Price: Out Of Stock.
",166,540477,540643
3883,sentence,"Price: Out Of Stock.

Product: Xiaomi Mi MJSXJ10CM 360° Kamepa Home Wi-Fi Security Camera White. Category: Xiaomi. Subcategory: Portable WiFi Camera. Price: Out Of Stock.
",171,540622,540793
3884,sentence,"Price: Out Of Stock.

Product: Imilab C20 360° 2MP Home Security Dome Wi-Fi IP Camera. Category: Xiaomi. Subcategory: Portable WiFi Camera. Price: Out Of Stock.
",161,540772,540933
3885,sentence,"Price: Out Of Stock.

Product: Xiaomi Mi MJSXJ03HL Magnetic Mount 360° 2K Smart Home Security WiFi Camera. Category: Xiaomi. Subcategory: Portable WiFi Camera. Price: Out Of Stock.
",181,540912,541093
3886,sentence,"Price: Out Of Stock.

Product: Xiaomi Mi XMC01 C300 360° 2K Smart Home Security WiFi Camera. Category: Xiaomi. Subcategory: Portable WiFi Camera. Price: Out Of Stock.
",167,541072,541239
3887,sentence,"Price: Out Of Stock.

Product: Xiaomi C301 3MP 2K 360° Smart WiFi Camera. Category: Xiaomi. Subcategory: Portable WiFi Camera. Price: Out Of Stock.
",148,541218,541366
3888,sentence,"Price: Out Of Stock.

Product: Xiaomi Mi MWC14 1080p 2MP Wireless Outdoor Security Wifi IP Camera. Category: Xiaomi. Subcategory: Portable WiFi Camera. Price: Out Of Stock.
",173,541345,541518
3889,sentence,"Price: Out Of Stock.

Product: Xiaomi Mi MWC13 1080p 2MP Wireless Outdoor Security Wifi IP Camera. Category: Xiaomi. Subcategory: Portable WiFi Camera. Price: Out Of Stock.
",173,541497,541670
3890,sentence,"Price: Out Of Stock.

Product: Vimtag 843 2MP Outdoor PTZ 360° WiFi IP Camera. Category: Vimtag. Subcategory: Portable WiFi Camera. Price: 6,900৳.
",147,541649,541796
3891,sentence,"Price: 6,900৳.

Product: Vimtag 843 2MP Outdoor PTZ 360° 3G/4G IP Camera. Category: Vimtag. Subcategory: Portable WiFi Camera. Price: Out Of Stock.
",148,541781,541929
3892,sentence,"Price: Out Of Stock.

Product: Jovision JVS-N933-KDL-PE 3MP Full Color Dome IP Camera. Category: Jovision. Subcategory: IP Camera. Price: 2,900৳.
",146,541908,542054
3893,sentence,"Subcategory: IP Camera. Price: 2,900৳.

Product: Jovision JVS-N937-SDL 3MP Full-Color PoE Dome IP Camera. Category: Jovision. Subcategory: IP Camera. Price: 4,200৳.
",165,542015,542180
3894,sentence,"Subcategory: IP Camera. Price: 4,200৳.

Product: Jovision JVS-N537-SDL 5MP Full-Color Video Audio PoE IP Camera. Category: Jovision. Subcategory: IP Camera. Price: 4,400৳.
",172,542141,542313
3895,sentence,"Subcategory: IP Camera. Price: 4,400৳.

Product: Jovision JVS-N517-SDL 5MP Full-Color Audio POE IP Camera. Category: Jovision. Subcategory: IP Camera. Price: 4,900৳5,500৳.
",172,542274,542446
3896,sentence,"Subcategory: IP Camera. Price: 4,900৳5,500৳.

Product: Jovision JVS-N516-YDL 5MP Full-Color Video Audio PoE IP Bullet Camera. Category: Jovision. Subcategory: IP Camera. Price: 5,800৳.
",185,542401,542586
3897,sentence,"Subcategory: IP Camera. Price: 5,800৳.

Product: Jovision JVS-N837-UDL 8MP Full-Color Audio PoE Dome IP Camera. Category: Jovision. Subcategory: IP Camera. Price: 7,500৳.
",171,542547,542718
3898,sentence,"Subcategory: IP Camera. Price: 7,500৳.

Product: Jovision JVS-N519-PWL 5MP Full Color PoE IP Camera. Category: Jovision. Subcategory: IP Camera. Price: 9,500৳.
",160,542679,542839
3899,sentence,"Subcategory: IP Camera. Price: 9,500৳.

Product: Jovision JVS-N518-ZDL 5MP Full-Color Video & Audio AI Network Camera. Category: Jovision. Subcategory: IP Camera. Price: 18,000৳.
",179,542800,542979
3900,sentence,"Subcategory: IP Camera. Price: 18,000৳.

Product: Jovision JVS-N933-K1-PE 3.0MP Starlight Audio PoE Dome IP Camera. Category: Jovision. Subcategory: IP Camera. Price: Out Of Stock.
",181,542939,543120
3901,sentence,"Subcategory: IP Camera. Price: Out Of Stock.

Product: Jovision JVS-N913-K1-PE 3MP Starlight Audio PoE IP Camera. Category: Jovision. Subcategory: IP Camera. Price: Out Of Stock.
",179,543075,543254
3902,sentence,"Subcategory: IP Camera. Price: Out Of Stock.

Product: Jovision JVS-N916-KDL-PE 3MP PoE IP Camera. Category: Jovision. Subcategory: IP Camera. Price: Out Of Stock.
",164,543209,543373
3903,sentence,"Subcategory: IP Camera. Price: Out Of Stock.

Product: Jovision JVS-N430K-SDL 8MP 4K Metal Full Color Eyeball Network Camera. Category: Jovision. Subcategory: IP Camera. Price: Out Of Stock.
",191,543328,543519
3904,sentence,"Subcategory: IP Camera. Price: Out Of Stock.

Product: Jovision JVS-N410K-SDL 8MP 4K Metal Full Color Bullet Network Camera. Category: Jovision. Subcategory: IP Camera. Price: Out Of Stock.
",190,543474,543664
3905,sentence,"Subcategory: IP Camera. Price: Out Of Stock.

Product: Hikvision HiLook IPC-B121H-C 2MP Bullet IP Camera. Category: Hikvision. Subcategory: IP Camera. Price: 1,830৳1,850৳.
",172,543619,543791
3906,sentence,"Subcategory: IP Camera. Price: 1,830৳1,850৳.

Product: Hikvision HiLook IPC-T221H 2MP Dome IP Camera. Category: Hikvision. Subcategory: IP Camera. Price: 1,900৳.
",162,543746,543908
3907,sentence,"Subcategory: IP Camera. Price: 1,900৳.

Product: Hikvision DS-2CD1323G0E-I 2MP Basic IR Mini Dome IP-Camera. Category: Hikvision. Subcategory: IP Camera. Price: 2,695৳.
",169,543869,544038
3908,sentence,"Subcategory: IP Camera. Price: 2,695৳.

Product: Hikvision DS-2CD1T23G0-I 2MP Basic IR Bullet IP Camera. Category: Hikvision. Subcategory: IP Camera. Price: 2,860৳.
",165,543999,544164
3909,sentence,"Subcategory: IP Camera. Price: 2,860৳.

Product: Hikvision DS-2CD1T23G2-LIU 2MP Bullet IP Camera. Category: Hikvision. Subcategory: IP Camera. Price: 3,850৳.
",158,544125,544283
3910,sentence,"Subcategory: IP Camera. Price: 3,850৳.

Product: Hikvision DS-2CD1323G2-LIU 2MP Smart Hybrid Light Fixed Turret Network Camera. Category: Hikvision. Subcategory: IP Camera. Price: 3,410৳.
",188,544244,544432
3911,sentence,"Subcategory: IP Camera. Price: 3,410৳.

Product: Hikvision DS-2CD1027G2H-LIU (4mm) 2MP ColorVu Audio Bullet IP Camera. Category: Hikvision. Subcategory: IP Camera. Price: 4,400৳.
",179,544393,544572
3912,sentence,"Subcategory: IP Camera. Price: 4,400৳.

Product: Hikvision DS-2CD1327G0-L 2MP ColorVu PoE IP Camera. Category: Hikvision. Subcategory: IP Camera. Price: 3,785৳4,350৳.
",167,544533,544700
3913,sentence,"Subcategory: IP Camera. Price: 3,785৳4,350৳.

Product: Hikvision DS-2CD1327G2H-LIU 2MP 2.8mm Audio Dome Network IP Camera. Category: Hikvision. Subcategory: IP Camera. Price: 4,400৳.
",183,544655,544838
3914,sentence,"Subcategory: IP Camera. Price: 4,400৳.

Product: Hikvision DS-2CD1143G2-LIU 4MP Smart Hybrid Light Fixed Dome Network Camera. Category: Hikvision. Subcategory: IP Camera. Price: 5,170৳.
",186,544799,544985
3915,sentence,"Subcategory: IP Camera. Price: 5,170৳.

Product: Hikvision DS-2CD1043G2-LIU 4MP Smart Hybrid Light Bullet IP Camera. Category: Hikvision. Subcategory: IP Camera. Price: 4,950৳.
",177,544946,545123
3916,sentence,"Subcategory: IP Camera. Price: 4,950৳.

Product: Hikvision DS-2CD1T43G2-LIU 4MP Bullet IP Camera. Category: Hikvision. Subcategory: IP Camera. Price: 5,300৳5,400৳.
",164,545084,545248
3917,sentence,"Subcategory: IP Camera. Price: 5,300৳5,400৳.

Product: Hikvision DS-2CD2023G2-IU 2MP AcuSense Built-In-Mic Fixed Bullet IP Camera. Category: Hikvision. Subcategory: IP Camera. Price: 5,500৳.
",191,545203,545394
3918,sentence,"Subcategory: IP Camera. Price: 5,500৳.

Product: Hikvision DS-2CD1163G2-LIU 6MP Smart Hybrid Light Dome IP Camera. Category: Hikvision. Subcategory: IP Camera. Price: 5,500৳.
",175,545355,545530
3919,sentence,"Subcategory: IP Camera. Price: 5,500৳.

Product: Hikvision DS-2CD1347G2H-LIU 4 MP ColorVu Fixed Turret Network Camera. Category: Hikvision. Subcategory: IP Camera. Price: 5,830৳.
",179,545491,545670
3920,sentence,"Subcategory: IP Camera. Price: 5,830৳.

Product: Hikvision DS-2DE2C400MWG-E (4mm) 4MP Fixed Outdoor Smart Hybrid-light PT IP Camera. Category: Hikvision. Subcategory: IP Camera. Price: 6,499৳7,000৳.
",199,545631,545830
3921,sentence,"Subcategory: IP Camera. Price: 6,499৳7,000৳.

Product: Hikvision DS-2CD2T43G2-4I 4MP IP Bullet Camera. Category: Hikvision. Subcategory: IP Camera. Price: 8,300৳8,500৳.
",169,545785,545954
3922,sentence,"Subcategory: IP Camera. Price: 8,300৳8,500৳.

Product: Hikvision  DS-2CD1043G2-LIUF 4MP Smart Hybrid Light Bullet IP Camera. Category: Hikvision. Subcategory: IP Camera. Price: Up Coming.
",188,545909,546097
3923,sentence,"Subcategory: IP Camera. Price: Up Coming.

Product: Hikvision DS-2CD1T23G2-I 2MP Fixed Bullet Network Camera. Category: Hikvision. Subcategory: IP Camera. Price: Out Of Stock.
",176,546055,546231
3924,sentence,"Subcategory: IP Camera. Price: Out Of Stock.

Product: Hikvision DS-2CD1223G0E-I 2MP Basic IR Mini Bullet IP-Camera. Category: Hikvision. Subcategory: IP Camera. Price: Out Of Stock.
",183,546186,546369
3925,sentence,"Subcategory: IP Camera. Price: Out Of Stock.

Product: Dahua DH-IPC-HDW1230T2-S5 2MP Dome IP Camera. Category: Dahua. Subcategory: IP Camera. Price: 2,590৳2,700৳.
",163,546324,546487
3926,sentence,"Subcategory: IP Camera. Price: 2,590৳2,700৳.

Product: Dahua DH-IPC-HFW1230TL2-S5 2MP Bullet IP Camera. Category: Dahua. Subcategory: IP Camera. Price: 2,590৳2,800৳.
",166,546442,546608
3927,sentence,"Subcategory: IP Camera. Price: 2,590৳2,800৳.

Product: Dahua DH-IPC-HFW1239TL1-A-IL 2MP Smart Dual Light Bullet IP Camera. Category: Dahua. Subcategory: IP Camera. Price: 3,350৳3,950৳.
",185,546563,546748
3928,sentence,"Subcategory: IP Camera. Price: 3,350৳3,950৳.

Product: Dahua DH-IPC-HDW1239V-A-IL 2MP Smart Dual Light Eyeball IP Camera. Category: Dahua. Subcategory: IP Camera. Price: 3,950৳.
",178,546703,546881
3929,sentence,"Subcategory: IP Camera. Price: 3,950৳.

Product: Dahua DH-IPC-HFW1230S1-A 2MP 30 Meter IR Bullet Network Camera. Category: Dahua. Subcategory: IP Camera. Price: 3,700৳4,000৳.
",175,546842,547017
3930,sentence,"Subcategory: IP Camera. Price: 3,700৳4,000৳.

Product: Dahua DH-IPC-HDW1230S-S5 2MP IR Dome Network Camera. Category: Dahua. Subcategory: IP Camera. Price: 4,200৳.
",164,546972,547136
3931,sentence,"Subcategory: IP Camera. Price: 4,200৳.

Product: Dahua DH-IPC-HFW1439TL1-A-IL 4MP Smart Dual Light Bullet IP Camera. Category: Dahua. Subcategory: IP Camera. Price: 3,800৳4,550৳.
",179,547097,547276
3932,sentence,"Subcategory: IP Camera. Price: 3,800৳4,550৳.

Product: Dahua DH-IPC-HDW1439V-A-IL 4MP Smart Dual Light Eyeball IP Camera. Category: Dahua. Subcategory: IP Camera. Price: 3,800৳4,550৳.
",184,547231,547415
3933,sentence,"Subcategory: IP Camera. Price: 3,800৳4,550৳.

Product: Dahua IPC-HFW1230S1P 2MP IR-30M Bullet Network Camera. Category: Dahua. Subcategory: IP Camera. Price: Out Of Stock.
",172,547370,547542
3934,sentence,"Subcategory: IP Camera. Price: Out Of Stock.

Product: Dahua IPC-HDW1230T1P 2MP IR-30M IR Eyeball Camera. Category: Dahua. Subcategory: IP Camera. Price: Out Of Stock.
",168,547497,547665
3935,sentence,"Subcategory: IP Camera. Price: Out Of Stock.

Product: Dahua IPC-HDW1239T1P-LED 2MP Lite Full-color Fixed-focal Eyeball Network Camera. Category: Dahua. Subcategory: IP Camera. Price: Out Of Stock.
",198,547620,547818
3936,sentence,"Subcategory: IP Camera. Price: Out Of Stock.

Product: Dahua IPC-HDW1239T1-A-LED 2.0MP Full color Audio Dome IP Camera. Category: Dahua. Subcategory: IP Camera. Price: Out Of Stock.
",182,547773,547955
3937,sentence,"Subcategory: IP Camera. Price: Out Of Stock.

Product: Dahua IPC-HDW1230T1-A 2MP IR 30M Dome Network IP Camera. Category: Dahua. Subcategory: IP Camera. Price: Out Of Stock.
",174,547910,548084
3938,sentence,"Subcategory: IP Camera. Price: Out Of Stock.

Product: Dahua IPC-HFW1239S1P-LED 2MP Lite Full-color Fixed-focal Bullet Network Camera. Category: Dahua. Subcategory: IP Camera. Price: Out Of Stock.
",197,548039,548236
3939,sentence,"Subcategory: IP Camera. Price: Out Of Stock.

Product: Dahua IPC-HFW1239S1-A-LED 2MP Full-Color Audio Bullet IP Camera. Category: Dahua. Subcategory: IP Camera. Price: Out Of Stock.
",182,548191,548373
3940,sentence,"Subcategory: IP Camera. Price: Out Of Stock.

Product: Dahua DH-IPC-HFW1431S1-S4 4MP IR Fixed-focal Bullet Camera. Category: Dahua. Subcategory: IP Camera. Price: Out Of Stock.
",177,548328,548505
3941,sentence,"Subcategory: IP Camera. Price: Out Of Stock.

Product: Dahua DH-IPC-HDW1431T1-S4 4MP IR Fixed-focal Eyeball IP Camera. Category: Dahua. Subcategory: IP Camera. Price: Out Of Stock.
",181,548460,548641
3942,sentence,"Subcategory: IP Camera. Price: Out Of Stock.

Product: Dahua DH-IPC-HFW1439S1-LED-S4 4MP Lite Full-color Bullet IP Camera. Category: Dahua. Subcategory: IP Camera. Price: Out Of Stock.
",185,548596,548781
3943,sentence,"Subcategory: IP Camera. Price: Out Of Stock.

Product: Dahua IPC-HDW1431S 4 Megapixel WDR IR Eyeball Network Camera. Category: Dahua. Subcategory: IP Camera. Price: Out Of Stock.
",179,548736,548915
3944,sentence,"Subcategory: IP Camera. Price: Out Of Stock.

Product: Dahua DH-IPC-HDW1439T1P-A-LED-S4 4MP Full-color Fixed-focal Eyeball IP Camera. Category: Dahua. Subcategory: IP Camera. Price: Out Of Stock.
",196,548870,549066
3945,sentence,"Subcategory: IP Camera. Price: Out Of Stock.

Product: TP-Link VIGI C420I 2MP IR Turret IP Camera. Category: IP Camera. Subcategory: Security. Price: 2,700৳.
",158,549021,549179
3946,sentence,"Subcategory: Security. Price: 2,700৳.

Product: TP-Link VIGI C420I 2MP 4mm Lens IR Turret IP Camera. Category: IP Camera. Subcategory: Security. Price: 2,106৳2,700৳.
",166,549141,549307
3947,sentence,"Subcategory: Security. Price: 2,106৳2,700৳.

Product: TP-Link VIGI C400HP 3MP IR Turret IP Camera. Category: IP Camera. Subcategory: Security. Price: 2,372৳2,790৳.
",164,549263,549427
3948,sentence,"Subcategory: Security. Price: 2,372৳2,790৳.

Product: Uniview IPC3612LB-SF28(40)-A 2MP Fixed  IR Dome IP Camera. Category: IP Camera. Subcategory: Security. Price: 2,800৳.
",172,549383,549555
3949,sentence,"Subcategory: Security. Price: 2,800৳.

Product: TP-Link VIGI C340I 4MP IR Bullet IP Camera. Category: IP Camera. Subcategory: Security. Price: 2,800৳2,900৳.
",157,549517,549674
3950,sentence,"Subcategory: Security. Price: 2,800৳2,900৳.

Product: TP-Link VIGI C320I 2.8mm 2MP IR Bullet IP Camera. Category: IP Camera. Subcategory: Security. Price: 2,690৳3,000৳.
",169,549630,549799
3951,sentence,"Subcategory: Security. Price: 2,690৳3,000৳.

Product: TP-Link VIGI C430I 3MP 4mm Lens IR Turret IP Camera. Category: IP Camera. Subcategory: Security. Price: 2,650৳3,290৳.
",172,549755,549927
3952,sentence,"Subcategory: Security. Price: 2,650৳3,290৳.

Product: TP-Link VIGI C220I 2MP IR Dome IP Camera. Category: IP Camera. Subcategory: Security. Price: 3,050৳3,300৳.
",161,549883,550044
3953,sentence,"Subcategory: Security. Price: 3,050৳3,300৳.

Product: TP-Link VIGI C220I 2MP 4mm Lens IR Dome IP Camera. Category: IP Camera. Subcategory: Security. Price: 2,888৳3,319৳.
",170,550000,550170
3954,sentence,"Subcategory: Security. Price: 2,888৳3,319৳.

Product: TP-Link VIGI C440I 4MP IR Turret IP Camera. Category: IP Camera. Subcategory: Security. Price: 2,700৳3,349৳.
",163,550126,550289
3955,sentence,"Subcategory: Security. Price: 2,700৳3,349৳.

Product: TP-Link VIGI C440I 4MP 4mm Lens IR Turret IP Camera. Category: IP Camera. Subcategory: Security. Price: 2,700৳3,349৳.
",172,550245,550417
3956,sentence,"Subcategory: Security. Price: 2,700৳3,349৳.

Product: Uniview IPC2123LB-AF40KM-G 3MP HD Fixed IR Bullet IP Camera. Category: IP Camera. Subcategory: Security. Price: 3,500৳.
",174,550373,550547
3957,sentence,"Subcategory: Security. Price: 3,500৳.

Product: Uniview IPC3613LB-AF28K-G 3MP HD IR Fixed Eyeball IP Camera. Category: Uniview. Subcategory: IP Camera. Price: 2,450৳3,650৳.
",173,550509,550682
3958,sentence,"Subcategory: IP Camera. Price: 2,450৳3,650৳.

Product: Uniview IPC2122LB-SF40-A 2MP IR Mini IP Bullet Camera. Category: Uniview. Subcategory: IP Camera. Price: 2,900৳3,790৳.
",174,550637,550811
3959,sentence,"Subcategory: IP Camera. Price: 2,900৳3,790৳.

Product: Uniview IPC2122LB-TS-F 2MP Fixed Bullet Network Camera. Category: Uniview. Subcategory: IP Camera. Price: 4,000৳.
",169,550766,550935
3960,sentence,"Subcategory: IP Camera. Price: 4,000৳.

Product: Uniview IPC322LB-SF28-A 2MP Vandal-resistant Network IR Dome Camera. Category: Uniview. Subcategory: IP Camera. Price: 4,000৳.
",176,550896,551072
3961,sentence,"Subcategory: IP Camera. Price: 4,000৳.

Product: Uniview IPC2122LB-DSF28KM 2MP Mini Fixed Bullet Network Camera. Category: Uniview. Subcategory: IP Camera. Price: 4,190৳.
",171,551033,551204
3962,sentence,"Subcategory: IP Camera. Price: 4,190৳.

Product: Uniview IPC3612LB-SF28-A 2MP Mini Fixed  IR Dome IP Camera. Category: Uniview. Subcategory: IP Camera. Price: 4,200৳.
",167,551165,551332
3963,sentence,"Subcategory: IP Camera. Price: 4,200৳.

Product: Uniview IPC3612ER3-PF40-B 2MP IR Fixed Dome IP Camera. Category: Uniview. Subcategory: IP Camera. Price: 4,300৳.
",162,551293,551455
3964,sentence,"Subcategory: IP Camera. Price: 4,300৳.

Product: Uniview IPC222ER-F36 2MP IR Bullet IP Camera. Category: Uniview. Subcategory: IP Camera. Price: 4,500৳.
",153,551416,551569
3965,sentence,"Subcategory: IP Camera. Price: 4,500৳.

Product: Uniview IPC3612LB-AF28KT-WL 2MP HD Fixed Dome IP Camera. Category: Uniview. Subcategory: IP Camera. Price: 4,650৳.
",164,551530,551694
3966,sentence,"Subcategory: IP Camera. Price: 4,650৳.

Product: Uniview IPC2122LB-ADF40KM-G 2MP HD WDR Fixed IR Bullet IP Camera. Category: Uniview. Subcategory: IP Camera. Price: 4,900৳.
",173,551655,551828
3967,sentence,"Subcategory: IP Camera. Price: 4,900৳.

Product: Uniview IPC2123LR3-PF40M-F 3MP Mini Fixed Bullet IP Camera. Category: Uniview. Subcategory: IP Camera. Price: 4,950৳.
",167,551789,551956
3968,sentence,"Subcategory: IP Camera. Price: 4,950৳.

Product: Uniview IPC2122LE-ADF40KMC-WL 2MP ColorHunter Fixed Bullet Network Camera. Category: Uniview. Subcategory: IP Camera. Price: 5,300৳.
",182,551917,552099
3969,sentence,"Subcategory: IP Camera. Price: 5,300৳.

Product: Uniview IPC3612ER3-PF28-C 2MP Fixed Dome Network Camera. Category: Uniview. Subcategory: IP Camera. Price: Out Of Stock.
",170,552060,552230
3970,sentence,"Subcategory: IP Camera. Price: Out Of Stock.

Product: Uniview IPC3614LR3-PF28 4MP Fixed Dome Network Camera. Category: Uniview. Subcategory: IP Camera. Price: 5,500৳.
",168,552185,552353
3971,sentence,"Subcategory: IP Camera. Price: 5,500৳.

Product: Uniview IPC3612LE-ADF28KC-WL 2MP Fixed Eyeball Network Camera. Category: Uniview. Subcategory: IP Camera. Price: 5,500৳.
",170,552314,552484
3972,sentence,"Subcategory: IP Camera. Price: 5,500৳.

Product: Uniview IPC3614LB- SF28- A 4MP Fixed IR Eyeball Dome IP Camera. Category: Uniview. Subcategory: IP Camera. Price: 5,500৳.
",171,552445,552616
3973,sentence,"Subcategory: IP Camera. Price: 5,500৳.

Product: Uniview IPC2124LB-SF40-A 4MP Fixed Bullet Network Camera. Category: Uniview. Subcategory: IP Camera. Price: 4,200৳5,740৳.
",171,552577,552748
3974,sentence,"Subcategory: IP Camera. Price: 4,200৳5,740৳.

Product: Uniview IPC2124LR5-DUPF40M-F 4MP EasyStar Mini Fixed Bullet IP Camera. Category: Uniview. Subcategory: IP Camera. Price: 5,900৳6,500৳.
",190,552703,552893
3975,sentence,"Subcategory: IP Camera. Price: 5,900৳6,500৳.

Product: Hikvision DS-2DE5425IW-AE(T5) 4MP 25X Zoom PTZ Camera (Wall Mount & Without Adapter). Category: Hikvision. Subcategory: PTZ Camera. ",187,552848,553035
3976,sentence,"Category: Hikvision. Subcategory: PTZ Camera. Price: 53,800৳57,000৳.

Product: Hikvision DS-2AE4223TI-D HD1080P Turbo IR PTZ Dome Camera. Category: Hikvision. Subcategory: PTZ Camera. ",184,552989,553173
3977,sentence,"Category: Hikvision. Subcategory: PTZ Camera. Price: Out Of Stock.

Product: Hikvision DS-2AE4225TI-D 2MP HD1080P Turbo IR PTZ Dome Camera. Category: Hikvision. Subcategory: PTZ Camera. ",186,553127,553313
3978,sentence,"Category: Hikvision. Subcategory: PTZ Camera. Price: Out Of Stock.

Product: Hikvision DS-2AE5223TI-A HD1080P Turbo IR PTZ Dome Camera. Category: Hikvision. Subcategory: PTZ Camera. ",182,553267,553449
3979,sentence,"Category: Hikvision. Subcategory: PTZ Camera. Price: Out Of Stock.

Product: Hikvision DS-2DE5225IW-AE 2MP Network 265+ Comprasion IR PTZ Dome Camera. Category: Hikvision. Subcategory: PTZ Camera. ",197,553403,553600
3980,sentence,"Category: Hikvision. Subcategory: PTZ Camera. Price: Out Of Stock.

Product: Hikvision DS-2DE5220I-AE HD1080P Defog IR PTZ Camera. Category: Hikvision. Subcategory: PTZ Camera. Price: Out Of Stock.
",198,553554,553752
3981,sentence,"Subcategory: PTZ Camera. Price: Out Of Stock.

Product: TP-Link VIGI C330I 3MP IR Bullet IP Camera. Category: TP-Link. Subcategory: IP Camera. Price: 3,600৳.
",158,553706,553864
3982,sentence,"Subcategory: IP Camera. Price: 3,600৳.

Product: TP-Link VIGI C430I Lens 2.8mm 3MP IR Turret IP Camera. Category: TP-Link. Subcategory: IP Camera. Price: 2,650৳3,650৳.
",168,553825,553993
3983,sentence,"Subcategory: IP Camera. Price: 2,650৳3,650৳.

Product: TP-Link VIGI C230I (2.8MM) 3MP IR Dome Network IP Camera. Category: TP-Link. Subcategory: IP Camera. Price: 3,030৳3,650৳.
",177,553948,554125
3984,sentence,"Subcategory: IP Camera. Price: 3,030৳3,650৳.

Product: TP-Link VIGI C430 3MP Full-Color Audio Turret IP Camera. Category: TP-Link. Subcategory: IP Camera. Price: 2,800৳3,800৳.
",176,554080,554256
3985,sentence,"Subcategory: IP Camera. Price: 2,800৳3,800৳.

Product: TP-Link VIGI C430 3MP 4mm Lens Full-Color Audio Turret IP Camera. Category: TP-Link. Subcategory: IP Camera. Price: 3,344৳3,800৳.
",185,554211,554396
3986,sentence,"Subcategory: IP Camera. Price: 3,344৳3,800৳.

Product: TP-Link VIGI C340I 4MP 4mm Lens IR Bullet IP Camera. Category: TP-Link. Subcategory: IP Camera. Price: 3,949৳.
",166,554351,554517
3987,sentence,"Subcategory: IP Camera. Price: 3,949৳.

Product: TP-Link VIGI C340I 4MP 6mm Lens IR Bullet IP Camera. Category: TP-Link. Subcategory: IP Camera. Price: 2,700৳3,949৳.
",166,554478,554644
3988,sentence,"Subcategory: IP Camera. Price: 2,700৳3,949৳.

Product: TP-Link VIGI C230I 3MP 4mm Lens IR Dome IP Camera. Category: TP-Link. Subcategory: IP Camera. Price: 3,990৳.
",164,554599,554763
3989,sentence,"Subcategory: IP Camera. Price: 3,990৳.

Product: TP-Link VIGI C230I Mini 3MP IR Audio Dome IP Camera. Category: TP-Link. Subcategory: IP Camera. Price: 4,100৳.
",160,554724,554884
3990,sentence,"Subcategory: IP Camera. Price: 4,100৳.

Product: TP-Link VIGI C330 3MP 4mm Lens Full-Color Audio Bullet IP Camera. Category: TP-Link. Subcategory: IP Camera. Price: 3,100৳4,100৳.
",179,554845,555024
3991,sentence,"Subcategory: IP Camera. Price: 3,100৳4,100৳.

Product: Dahua HAC-HFW1200CLP-IL-A 2MP Smart Dual Light Audio Bullet CC Camera. Category: CC Camera. Subcategory: Security. Price: 1,440৳1,800৳.
",191,554979,555170
3992,sentence,"Subcategory: Security. Price: 1,440৳1,800৳.

Product: Dahua HAC-HFW-1200RP 2MP HDCVI IR BULLET Camera. Category: CC Camera. Subcategory: Security. Price: 1,499৳1,900৳.
",168,555126,555294
3993,sentence,"Subcategory: Security. Price: 1,499৳1,900৳.

Product: Dahua HAC-HDW-1200RP 2MP DOME Camera. Category: CC Camera. Subcategory: Security. Price: 1,499৳1,900৳.
",157,555250,555407
3994,sentence,"Subcategory: Security. Price: 1,499৳1,900৳.

Product: Hikvision DS-2CE76D0T-ITMF 2 MP Indoor Fixed Turret Camera. Category: CC Camera. Subcategory: Security. Price: 1,450৳1,900৳.
",179,555363,555542
3995,sentence,"Subcategory: Security. Price: 1,450৳1,900৳.

Product: Dahua HAC-B2A21P 2MP HDCVI IR Bullet Camera. Category: CC Camera. Subcategory: Security. Price: 1,800৳2,000৳.
",164,555498,555662
3996,sentence,"Subcategory: Security. Price: 1,800৳2,000৳.

Product: Hikvision DS-2CE16H0T-ITPFS 5MP Audio Mini Bullet Camera. Category: CC Camera. Subcategory: Security. Price: 1,550৳2,000৳.
",177,555618,555795
3997,sentence,"Subcategory: Security. Price: 1,550৳2,000৳.

Product: HikVision DS-2CE16D0T-ITPFS 2MP Audio Fixed Mini Bullet Camera. Category: CC Camera. Subcategory: Security. Price: 1,500৳2,100৳.
",183,555751,555934
3998,sentence,"Subcategory: Security. Price: 1,500৳2,100৳.

Product: Dahua HAC-T1A51P 5MP HDCVI IR Dome Camera. Category: CC Camera. Subcategory: Security. Price: 1,950৳2,100৳.
",162,555890,556052
3999,sentence,"Subcategory: Security. Price: 1,950৳2,100৳.

Product: Hikvision DS-2CE10DF0T-PFS 2MP ColorVu Audio Fixed Mini Bullet Camera. Category: CC Camera. Subcategory: Security. Price: 2,300৳.
",184,556008,556192
4000,sentence,"Subcategory: Security. Price: 2,300৳.

Product: HikVision DS-2CE17H0T-IT3F 5MP Fixed Bullet Camera. Category: Hikvision. Subcategory: CC Camera. Price: 2,200৳.
",160,556154,556314
4001,sentence,"Subcategory: CC Camera. Price: 2,200৳.

Product: HikVision DS-2CE17D0T-LFS 2MP Smart Hybrid Light Audio Fixed Bullet Camera. Category: Hikvision. Subcategory: CC Camera. Price: 2,365৳.
",185,556275,556460
4002,sentence,"Subcategory: CC Camera. Price: 2,365৳.

Product: Hikvision DS-2CE70DF0T-MFS 2MP ColorVu Audio Fixed Turret Camera. Category: Hikvision. Subcategory: CC Camera. Price: 2,475৳.
",175,556421,556596
4003,sentence,"Subcategory: CC Camera. Price: 2,475৳.

Product: Hikvision DS-2CE10DF0T-FS 2MP ColorVu Audio Fixed Mini Bullet Camera. Category: Hikvision. Subcategory: CC Camera. Price: 2,475৳.
",179,556557,556736
4004,sentence,"Subcategory: CC Camera. Price: 2,475৳.

Product: Hikvision DS-2CE16K0T-LFS 5.0MP 3K Mini Bullet CC Camera. Category: Hikvision. Subcategory: CC Camera. Price: 2,600৳2,700৳.
",173,556697,556870
4005,sentence,"Subcategory: CC Camera. Price: 2,600৳2,700৳.

Product: Hikvision DS-2CE71H0T-PIRLO 5 MP PIR Fixed Turret Camera. Category: Hikvision. Subcategory: CC Camera. Price: 2,700৳.
",173,556825,556998
4006,sentence,"Subcategory: CC Camera. Price: 2,700৳.

Product: Hikvision DS-2CE12DF0T-FS 2MP ColorVu Audio Bullet Camera. Category: Hikvision. Subcategory: CC Camera. Price: 2,805৳.
",168,556959,557127
4007,sentence,"Subcategory: CC Camera. Price: 2,805৳.

Product: HikVision DS-2CE18D0T-LFS 2MP Smart Hybrid Light Audio Fixed Bullet Camera. Category: Hikvision. Subcategory: CC Camera. Price: 3,300৳.
",185,557088,557273
4008,sentence,"Subcategory: CC Camera. Price: 3,300৳.

Product: Hikvision DS-2CE70KF0T-MFS 3K ColorVu Audio Fixed Turret Camera. Category: Hikvision. Subcategory: CC Camera. Price: 3,630৳.
",174,557234,557408
4009,sentence,"Subcategory: CC Camera. Price: 3,630৳.

Product: Uniview UAC-T115-F28 Turret Analog Camera. Category: Uniview. Subcategory: CC Camera. Price: 2,400৳.
",150,557369,557519
4010,sentence,"Subcategory: CC Camera. Price: 2,400৳.

Product: Uniview UAC-B115-F40 Bullet Analog Camera. Category: Uniview. Subcategory: CC Camera. Price: Out Of Stock.
",156,557480,557636
4011,sentence,"Subcategory: CC Camera. Price: Out Of Stock.

Product: Uniview UAC-B112-F40-W 2MP ColourHunter HD Fixed Mini Bullet Analog Camera. Category: Uniview. Subcategory: CC Camera. Price: 1,950৳2,650৳.
",195,557591,557786
4012,sentence,"Subcategory: CC Camera. Price: 1,950৳2,650৳.

Product: Uniview UAC-T112-F28-W 2MP ColourHunter HD Fixed Turret Analog Camera. Category: Uniview. Subcategory: CC Camera. Price: 2,650৳.
",184,557741,557925
4013,sentence,"Subcategory: CC Camera. Price: 2,650৳.

Product: Uniview UAC-B115-F40-W 5MP ColourHunter HD Fixed Mini Bullet Analog Camera. Category: Uniview. Subcategory: CC Camera. Price: 3,500৳.
",183,557886,558069
4014,sentence,"Subcategory: CC Camera. Price: 3,500৳.

Product: Uniview UAC-T115-F28-W 5MP ColourHunter HD Fixed Turret Analog Camera. Category: Uniview. Subcategory: CC Camera. Price: 4,250৳.
",178,558030,558208
4015,sentence,"Subcategory: CC Camera. Price: 4,250৳.

Product: Uniview UAC-P112-AF40-W 2MP ColorHunter Analog PT Camera. Category: Uniview. Subcategory: CC Camera. Price: Out Of Stock.
",171,558169,558340
4016,sentence,"Subcategory: CC Camera. Price: Out Of Stock.

Product: Jovision JVS-N43-Z25 4MP 25x Zoom Starlight AI PTZ Camera. Category: PTZ Camera. Subcategory: Security. Price: 36,500৳.
",175,558295,558470
4017,sentence,"Subcategory: Security. Price: 36,500৳.

Product: Dahua SD49225DB-HNY 2MP IR Network PTZ Camera. Category: PTZ Camera. Subcategory: Security. Price: 37,500৳.
",157,558431,558588
4018,sentence,"Subcategory: Security. Price: 37,500৳.

Product: Uniview IPC742SR9-PZ30-32G 1080P Zoom Lens IR PTZ Camera. Category: PTZ Camera. Subcategory: Security. Price: Call for Price.
",175,558549,558724
4019,sentence,"Subcategory: Security. Price: Call for Price.

Product: Uniview IPC744SR5-PF60-32G 4MP Fixed Lens IR PT Camera. Category: PTZ Camera. Subcategory: Security. Price: Call for Price.
",180,558678,558858
4020,sentence,"Subcategory: Security. Price: Call for Price.

Product: Uniview IPC6424SR-X25-VF 4MP 25x PTZ Dome Network Camera. Category: PTZ Camera. Subcategory: Security. Price: Call for Price.
",182,558812,558994
4021,sentence,"Subcategory: Security. Price: Call for Price.

Product: Uniview IPC6622SR-X33-VF 2MP 33x PTZ Dome Network Camera. Category: PTZ Camera. Subcategory: Security. Price: Call for Price.
",182,558948,559130
4022,sentence,"Subcategory: Security. Price: Call for Price.

Product: Uniview TR-WE45-A-IN PTZ Dome Wall Mount. Category: PTZ Camera. Subcategory: Security. Price: Call for Price.
",166,559084,559250
4023,sentence,"Subcategory: Security. Price: Call for Price.

Product: Uniview KB-1100 Four-Dimensional Joystick Control for PTZ Camera. Category: PTZ Camera. Subcategory: Security. Price: Call for Price.
",190,559204,559394
4024,sentence,"Subcategory: Security. Price: Call for Price.

Product: Dahua SD5A432GB-HNR 4MP 32x Starlight IR Network PTZ Camera. Category: PTZ Camera. Subcategory: Security. Price: Call for Price.
",185,559348,559533
4025,sentence,"Subcategory: Security. Price: Call for Price.

Product: Srihome SH045B 2MP Full Color Night Vision IP PTZ Camera. Category: PTZ Camera. Subcategory: Security. Price: Out Of Stock.
",180,559487,559667
4026,sentence,"Subcategory: Security. Price: Out Of Stock.

Product: Dahua SD2A200HB-GN-AW-PV-S2 2MP Full-color Network PTZ Camera. Category: PTZ Camera. Subcategory: Security. Price: Out Of Stock.
",183,559623,559806
4027,sentence,"Subcategory: Security. Price: Out Of Stock.

Product: Dahua SD2A200HB-GN-A-PV-S2 2MP Full-color Network PTZ Camera. Category: PTZ Camera. Subcategory: Security. Price: Out Of Stock.
",182,559762,559944
4028,sentence,"Subcategory: Security. Price: Out Of Stock.

Product: TP-Link VIGI C540 4MP Full-Color IP PTZ Camera. Category: PTZ Camera. Subcategory: Security. Price: Out Of Stock.
",168,559900,560068
4029,sentence,"Subcategory: Security. Price: Out Of Stock.

Product: TP-Link VIGI C540-W 4MP Full-Color Wi-Fi IP PTZ Camera. Category: PTZ Camera. Subcategory: Security. Price: Out Of Stock.
",176,560024,560200
4030,sentence,"Subcategory: Security. Price: Out Of Stock.

Product: Dahua SD2A500HB-GN-AW-PV-S2 5MP Full-color Network PTZ Camera. Category: PTZ Camera. Subcategory: Security. Price: Out Of Stock.
",183,560156,560339
4031,sentence,"Subcategory: Security. Price: Out Of Stock.

Product: TP-Link VIGI C540V 4MP Full-Color Dual-Lens IP PTZ Camera. Category: PTZ Camera. Subcategory: Security. Price: Out Of Stock.
",179,560295,560474
4032,sentence,"Subcategory: Security. Price: Out Of Stock.

Product: TP-Link VIGI C540S 4MP ColorPro Night Vision PTZ Camera. Category: PTZ Camera. Subcategory: Security. Price: Out Of Stock.
",177,560430,560607
4033,sentence,"Subcategory: Security. Price: Out Of Stock.

Product: Uniview IPC675LFW-AX4DUPKC-VG 5MP LightHunter Active Deterrence Mini PTZ Camera. Category: PTZ Camera. Subcategory: Security. Price: 18,500৳.
",196,560563,560759
4034,sentence,"Subcategory: Security. Price: 18,500৳.

Product: Dahua DH-SD49225-HC-LA 2MP 25x Starlight IR PTZ HDCVI Camera. Category: PTZ Camera. Subcategory: Security. Price: Out Of Stock.
",177,560720,560897
4035,sentence,"Subcategory: Security. Price: Out Of Stock.

Product: Dahua HAC-B1A51P 5MP HDCVI IR Bullet Camera. Category: Dahua. Subcategory: CC Camera. Price: 2,200৳.
",155,560853,561008
4036,sentence,"Subcategory: CC Camera. Price: 2,200৳.

Product: DAHUA HAC-HFW1200TLP 2MP HDCVI IR Bullet Camera. Category: Dahua. Subcategory: CC Camera. Price: 1,950৳2,250৳.
",160,560969,561129
4037,sentence,"Subcategory: CC Camera. Price: 1,950৳2,250৳.

Product: Dahua HAC-HDW1200CLQP-IL-A 2MP Eyeball CC Camera. Category: Dahua. Subcategory: CC Camera. Price: 1,550৳2,250৳.
",167,561084,561251
4038,sentence,"Subcategory: CC Camera. Price: 1,550৳2,250৳.

Product: Dahua HAC-T1A51 5MP HDCVI IR Eyeball Camera. Category: Dahua. Subcategory: CC Camera. Price: 2,500৳.
",156,561206,561362
4039,sentence,"Subcategory: CC Camera. Price: 2,500৳.

Product: Dahua DH-HAC-HDW1500CLQP-IL-A 5MP Dual Light HDCVI Dome Camera. Category: Dahua. Subcategory: CC Camera. Price: 2,350৳2,500৳.
",175,561323,561498
4040,sentence,"Subcategory: CC Camera. Price: 2,350৳2,500৳.

Product: Dahua HAC-HFW1500CLP-IL-A 5MP Smart Dual Light Audio Bullet Camera. Category: Dahua. Subcategory: CC Camera. Price: 2,400৳2,700৳.
",185,561453,561638
4041,sentence,"Subcategory: CC Camera. Price: 2,400৳2,700৳.

Product: Dahua HAC-HFW1200TLMP-IL-A 2MP Smart Dual Light HDCVI Fixed-focal Bullet Camera. Category: Dahua. Subcategory: CC Camera. Price: 2,800৳.
",192,561593,561785
4042,sentence,"Subcategory: CC Camera. Price: 2,800৳.

Product: Dahua HAC-HDW1500TLMP-IL-A 5MP Smart Dual Light HDCVI Eyeball Dome Camera. Category: Dahua. Subcategory: CC Camera. Price: 2,950৳3,200৳.
",186,561746,561932
4043,sentence,"Subcategory: CC Camera. Price: 2,950৳3,200৳.

Product: Dahua HAC-HFW1500TLMP-IL-A 5MP Smart Dual Light HDCVI Bullet CC Camera. Category: Dahua. Subcategory: CC Camera. Price: 3,850৳.
",183,561887,562070
4044,sentence,"Subcategory: CC Camera. Price: 3,850৳.

Product: Dahua DH-HAC-HDW1509TLQP-A-LED 5MP Color HDCVI Eyeball Camera. Category: Dahua. Subcategory: CC Camera. Price: 3,608৳4,400৳.
",174,562031,562205
4045,sentence,"Subcategory: CC Camera. Price: 3,608৳4,400৳.

Product: Dahua DH-HAC-HFW1509MHP-A-LED 5MP Color HDCVI Bullet Camera. Category: Dahua. Subcategory: CC Camera. Price: 4,550৳5,900৳.
",178,562160,562338
4046,sentence,"Subcategory: CC Camera. Price: 4,550৳5,900৳.

Product: Dahua-HAC-T1A21P 2MP HDCVI IR Eyeball camera. Category: Dahua. Subcategory: CC Camera. Price: Out Of Stock.
",163,562293,562456
4047,sentence,"Subcategory: CC Camera. Price: Out Of Stock.

Product: Dahua HAC-B1A21P 2MP HDCVI IR Bullet Camera. Category: Dahua. Subcategory: CC Camera. Price: Out Of Stock.
",162,562411,562573
4048,sentence,"Subcategory: CC Camera. Price: Out Of Stock.

Product: Dahua SD49225XA-HNR 2MP 25X Starlight IR WizSense Network PTZ Camera. Category: Dahua. Subcategory: PTZ Camera. Price: Out Of Stock.
",188,562528,562716
4049,sentence,"Subcategory: PTZ Camera. Price: Out Of Stock.

Product: Dahua SD5A225GB-HNR 2MP 25x Starlight IR WizSense Network PTZ Camera. Category: Dahua. Subcategory: PTZ Camera. Price: Out Of Stock.
",189,562670,562859
4050,sentence,"Subcategory: PTZ Camera. Price: Out Of Stock.

Product: Dahua SD5A432XA-HNR 4MP 32X Starlight IR WizSense Network PTZ Camera. Category: Dahua. Subcategory: PTZ Camera. Price: Out Of Stock.
",189,562813,563002
4051,sentence,"Subcategory: PTZ Camera. Price: Out Of Stock.

Product: Tiandy TC-H324S 2MP 25× Starlight IR PTZ Camera. Category: Tiandy. Subcategory: PTZ Camera. Price: Out Of Stock.
",169,562956,563125
4052,sentence,"Subcategory: PTZ Camera. Price: Out Of Stock.

Product: Tiandy TC-H344S 4MP 25× Starlight IR PTZ Camera. Category: Tiandy. Subcategory: PTZ Camera. Price: Out Of Stock.
",169,563079,563248
4053,sentence,"Subcategory: PTZ Camera. Price: Out Of Stock.

Product: Dahua 2 unit CC camera package. Category: Dahua. Subcategory: CC Camera Package. Price: 9,900৳13,500৳.
",159,563202,563361
4054,sentence,"Price: 9,900৳13,500৳.

Product: Dahua 3 unit Cc camera package. Category: Dahua. Subcategory: CC Camera Package. Price: 10,590৳15,500৳.

Product: Dahua 4 unit CC camera package. Category: Dahua. ",195,563339,563534
4055,sentence,"Category: Dahua. Subcategory: CC Camera Package. Price: 10,999৳18,000৳.

Product: Dahua 5 unit Cc camera package. Category: Dahua. Subcategory: CC Camera Package. Price: 14,990৳21,500৳.
",186,563517,563703
4056,sentence,"Price: 14,990৳21,500৳.

Product: Dahua 6 unit Cc camera package. Category: Dahua. Subcategory: CC Camera Package. Price: 16,990৳24,000৳.

Product: Dahua 8 unit Cc camera package. Category: Dahua. ",196,563680,563876
4057,sentence,"Category: Dahua. Subcategory: CC Camera Package. Price: 17,999৳29,000৳.

Product: Dahua 16 unit Cc camera package. Category: Dahua. Subcategory: CC Camera Package. Price: 34,990৳50,500৳.
",187,563859,564046
4058,sentence,"Price: 34,990৳50,500৳.

Product: TP-Link 2 Unit IP Camera Package. Category: TP-Link. Subcategory: IP Camera Package. Price: 19,500৳.

Product: TP-Link 4 Unit IP Camera Package. Category: TP-Link. ",197,564023,564220
4059,sentence,"Category: TP-Link. Subcategory: IP Camera Package. Price: 29,000৳.

Product: TP-Link 6 Unit IP Camera Package. Category: TP-Link. Subcategory: IP Camera Package. Price: 40,000৳.
",178,564201,564379
4060,sentence,"Subcategory: IP Camera Package. Price: 40,000৳.

Product: Hikvision 2 Unit IP Camera Package. Category: Hikvision. Subcategory: IP Camera Package. Price: 15,990৳19,250৳.
",170,564331,564501
4061,sentence,"Price: 15,990৳19,250৳.

Product: Hikvision 3 Unit IP Camera Package. Category: Hikvision. Subcategory: IP Camera Package. Price: 18,500৳23,500৳.

Product: Hikvision 4 Unit IP Camera Package. ",191,564478,564669
4062,sentence,"
Product: Hikvision 4 Unit IP Camera Package. Category: Hikvision. Subcategory: IP Camera Package. Price: 20,990৳28,000৳.

Product: Hikvision 5 Unit IP Camera Package. Category: Hikvision. ",189,564623,564812
4063,sentence,"Category: Hikvision. Subcategory: IP Camera Package. Price: 24,500৳33,000৳.

Product: Hikvision 6 Unit IP Camera Package. Category: Hikvision. Subcategory: IP Camera Package. Price: 27,500৳37,000৳.
",198,564791,564989
4064,sentence,"Price: 27,500৳37,000৳.

Product: HIKVISION 2 unit 1080P night vision security cc camera Package. Category: CC Camera Package. Subcategory: Security. Price: 9,990৳13,000৳.
",171,564966,565137
4065,sentence,"Subcategory: Security. Price: 9,990৳13,000৳.

Product: HIKVISION 3 unit 1080P night vision security cc camera Package. Category: CC Camera Package. Subcategory: Security. Price: 10,590৳15,300৳.
",194,565092,565286
4066,sentence,"Subcategory: Security. Price: 10,590৳15,300৳.

Product: HIKVISION 4 unit 1080P night vision security cc camera Package. Category: CC Camera Package. Subcategory: Security. Price: 10,999৳17,900৳.
",195,565240,565435
4067,sentence,"Subcategory: Security. Price: 10,999৳17,900৳.

Product: HIKVISION 5 unit 1080P night vision security cc camera Package. Category: CC Camera Package. Subcategory: Security. Price: 14,990৳21,500৳.
",195,565389,565584
4068,sentence,"Subcategory: Security. Price: 14,990৳21,500৳.

Product: HIKVISION 6 unit 1080P night vision security cc camera Package. Category: CC Camera Package. Subcategory: Security. Price: 16,990৳24,500৳.
",195,565538,565733
4069,sentence,"Subcategory: Security. Price: 16,990৳24,500৳.

Product: HIKVISION 8 unit 1080P night vision security cc camera Package. Category: CC Camera Package. Subcategory: Security. Price: 17,999৳29,750৳.
",195,565687,565882
4070,sentence,"Subcategory: Security. Price: 17,999৳29,750৳.

Product: Uniview IPC6322SR-X22P-D 2MP 22x PTZ Dome Network Camera. Category: Uniview. Subcategory: PTZ Camera. Price: Out Of Stock.
",179,565836,566015
4071,sentence,"Subcategory: PTZ Camera. Price: Out Of Stock.

Product: Uniview IPC6222ER-X30 2MP 30x IR Network PTZ Dome Camera. Category: Uniview. Subcategory: PTZ Camera. Price: Out Of Stock.
",179,565969,566148
4072,sentence,"Subcategory: PTZ Camera. Price: Out Of Stock.

Product: Uniview IPC6322SR-X33UP-D 2MP 33x PTZ Dome Network Camera. Category: Uniview. Subcategory: PTZ Camera. Price: Out Of Stock.
",180,566102,566282
4073,sentence,"Subcategory: PTZ Camera. Price: Out Of Stock.

Product: Uniview IPC6222ER-X30P 2MP 30x IR Network PTZ Dome Camera. Category: Uniview. Subcategory: PTZ Camera. Price: Out Of Stock.
",180,566236,566416
4074,sentence,"Subcategory: PTZ Camera. Price: Out Of Stock.

Product: Uniview IPC6253SR-X33 3MP 33x IR Network PTZ Dome Camera. Category: Uniview. Subcategory: PTZ Camera. Price: Out Of Stock.
",179,566370,566549
4075,sentence,"Subcategory: PTZ Camera. Price: Out Of Stock.

Product: Dahua DH-IPC-HFW1230TL2-S5 2 Unit IP Camera With Package. Category: Dahua. Subcategory: IP Camera Package. Price: 14,500৳19,500৳.
",186,566503,566689
4076,sentence,"Price: 14,500৳19,500৳.

Product: Dahua DH-IPC-HFW1230TL2-S5 3 Unit IP Camera With Package. Category: Dahua. Subcategory: IP Camera Package. Price: 17,490৳24,000৳.
",163,566666,566829
4077,sentence,"Price: 17,490৳24,000৳.

Product: Dahua DH-IPC-HFW1230TL2-S5 4 Unit IP Camera With Package. Category: Dahua. Subcategory: IP Camera Package. Price: 20,500৳29,000৳.
",163,566806,566969
4078,sentence,"Price: 20,500৳29,000৳.

Product: Dahua DH-IPC-HFW1230TL2-S5 5 Unit IP Camera With Package. Category: Dahua. Subcategory: IP Camera Package. Price: 27,500৳35,000৳.
",163,566946,567109
4079,sentence,"Price: 27,500৳35,000৳.

Product: Dahua DH-IPC-HFW1230TL2-S5 6 Unit IP Camera With Package. Category: Dahua. Subcategory: IP Camera Package. Price: 30,990৳40,000৳.
",163,567086,567249
4080,sentence,"Price: 30,990৳40,000৳.

Product: Hikvision DS-7104HGHI-ECO/M1 4 Channel Mini 1U DVR. Category: Hikvision. Subcategory: DVR. Price: 2,075৳2,400৳.
",145,567226,567371
4081,sentence,"Subcategory: DVR. Price: 2,075৳2,400৳.

Product: Hikvision DS-7108HGHI-M1/T 08 Channel Mini 1U DVR. Category: Hikvision. Subcategory: DVR. Price: 3,050৳3,410৳.
",160,567332,567492
4082,sentence,"Subcategory: DVR. Price: 3,050৳3,410৳.

Product: Hikvision DS-7108HGHI-M1/ECO 08 Channel Mini 1U DVR. Category: Hikvision. Subcategory: DVR. Price: 3,200৳.
",156,567453,567609
4083,sentence,"Subcategory: DVR. Price: 3,200৳.

Product: HIKVISION DS-7204HGHI-F1 4-CH Turbo HD 720P DVR. Category: Hikvision. Subcategory: DVR. Price: 4,200৳.
",146,567576,567722
4084,sentence,"Subcategory: DVR. Price: 4,200৳.

Product: Hikvision DS-7108HGHI-F1/N 8 CH 1MP (720P) Turbo HD DVR. Category: Hikvision. Subcategory: DVR. Price: 5,000৳.
",154,567689,567843
4085,sentence,"Subcategory: DVR. Price: 5,000৳.

Product: Hikvision IDS-7104HQHI-M1-S 4 Channel 1080P Mini 1U H.265 AcuSense DVR. Category: Hikvision. Subcategory: DVR. Price: 4,179৳.
",169,567810,567979
4086,sentence,"Subcategory: DVR. Price: 4,179৳.

Product: Hikvision DS-7116HGHI-M1 16 Channel DVR. Category: Hikvision. Subcategory: DVR. Price: 6,050৳.
",138,567946,568084
4087,sentence,"Subcategory: DVR. Price: 6,050৳.

Product: Hikvision iDS-7108HQHI-M1/S 8 Channel 1080P Mini 1U H.265 AcuSense DVR. Category: Hikvision. Subcategory: DVR. Price: 5,665৳.
",169,568051,568220
4088,sentence,"Subcategory: DVR. Price: 5,665৳.

Product: HIKVISION DS-7216HGHI-K1 16-CH Turbo HD 720P DVR. Category: Hikvision. Subcategory: DVR. Price: 8,000৳.
",147,568187,568334
4089,sentence,"Subcategory: DVR. Price: 8,000৳.

Product: Hikvision IDS-7208HQHI-M2/XT 8 Channel 1U H.265 AcuSense DVR. Category: Hikvision. Subcategory: DVR. Price: 9,500৳.
",159,568301,568460
4090,sentence,"Subcategory: DVR. Price: 9,500৳.

Product: Hikvision iDS-7116HQHI-M1/S 16 Channel AcuSense DVR. Category: Hikvision. Subcategory: DVR. Price: 9,350৳.
",150,568427,568577
4091,sentence,"Subcategory: DVR. Price: 9,350৳.

Product: Hikvision IDS-7232HQHI-M2-S 32 Channel 1080p 1U H.265 AcuSense DVR. Category: Hikvision. Subcategory: DVR. Price: 32,000৳.
",166,568544,568710
4092,sentence,"Subcategory: DVR. Price: 32,000৳.

Product: Hikvision IDS-7232HQHI-M2/XT 32 Channel 1080p 1U H.265 AcuSense DVR. Category: Hikvision. Subcategory: DVR. Price: 32,000৳.
",168,568676,568844
4093,sentence,"Subcategory: DVR. Price: 32,000৳.

Product: Hikvision DS-7104HGHI-K1 4-Ch 1080p Lite Mini 1U H.265 DVR. Category: Hikvision. Subcategory: DVR. Price: Out Of Stock.
",164,568810,568974
4094,sentence,"Subcategory: DVR. Price: Out Of Stock.

Product: HIKVISION DS-7104HGHI-F1 4 Channel Turbo HD 720P DVR. Category: Hikvision. Subcategory: DVR. Price: Out Of Stock.
",163,568935,569098
4095,sentence,"Subcategory: DVR. Price: Out Of Stock.

Product: HIKVISION DS-7104HQHI-K1 4-CH Turbo HD 1080P DVR. Category: Hikvision. Subcategory: DVR. Price: Out Of Stock.
",159,569059,569218
4096,sentence,"Subcategory: DVR. Price: Out Of Stock.

Product: Hikvision DS-7108HGHI-K1 8-CH Turbo HD 1080P DVR. Category: Hikvision. Subcategory: DVR. Price: Out Of Stock.
",159,569179,569338
4097,sentence,"Subcategory: DVR. Price: Out Of Stock.

Product: Hikvision IDS-7204HUHI-M1-S 4 Channel 1 HDD 1U H.265 AcuSense DVR. Category: Hikvision. Subcategory: DVR. Price: Out Of Stock.
",176,569299,569475
4098,sentence,"Subcategory: DVR. Price: Out Of Stock.

Product: HIKVISION DS-7204HQHI-K1 4-CH Turbo HD 1080P DVR. Category: Hikvision. Subcategory: DVR. Price: Out Of Stock.
",159,569436,569595
4099,sentence,"Subcategory: DVR. Price: Out Of Stock.

Product: HIKVISION DS-7208HGHI-F1 8-CH Turbo HD 720P DVR. Category: Hikvision. Subcategory: DVR. Price: Out Of Stock.
",158,569556,569714
4100,sentence,"Subcategory: DVR. Price: Out Of Stock.

Product: Jovision CloudSee JVS-D6008-S3 DVR. Category: Jovision. Subcategory: DVR. Price: 3,800৳.

Product: Jovision CloudSee JVS-D6016-S3 DVR. ",184,569675,569859
4101,sentence,"
Product: Jovision CloudSee JVS-D6016-S3 DVR. Category: Jovision. Subcategory: DVR. Price: 5,000৳7,000৳.

Product: Uniview NVR301-04LS2 4 Channel 1 SATA NVR. Category: NVR. Subcategory: Security. ",196,569813,570009
4102,sentence,"Category: NVR. Subcategory: Security. Price: 4,000৳.

Product: Hikvision DS-7104NI-Q1/M 4 Channel Mini 1U NVR. Category: NVR. Subcategory: Security. Price: 4,620৳.
",164,569971,570135
4103,sentence,"Subcategory: Security. Price: 4,620৳.

Product: Dahua NVR1104HS-S3/H 4 Channel Network Video Recorder (NVR). Category: NVR. Subcategory: Security. Price: 4,090৳4,500৳.
",168,570097,570265
4104,sentence,"Subcategory: Security. Price: 4,090৳4,500৳.

Product: Hikvision HiLook NVR-108MH-D 8-Channel 1080p NVR. Category: NVR. Subcategory: Security. Price: 4,700৳.
",157,570221,570378
4105,sentence,"Subcategory: Security. Price: 4,700৳.

Product: Jovision JVS-ND6610-HD 10 Channel H.265 1 SATA NVR. Category: NVR. Subcategory: Security. Price: 5,400৳.

Product: Uniview NVR301-04S 4 Channel NVR. ",197,570340,570537
4106,sentence,"
Product: Uniview NVR301-04S 4 Channel NVR. Category: NVR. Subcategory: Security. Price: 5,500৳.

Product: Hikvision DS-7108NI-Q1/M 8 Channel Network Video Recorder (NVR). Category: NVR. ",187,570493,570680
4107,sentence,"Category: NVR. Subcategory: Security. Price: 5,720৳.

Product: Uniview NVR301-08S3 8CH 4K NVR. Category: NVR. Subcategory: Security. Price: 6,000৳.

Product: Hikvision DS-7604NI-Q1 4 Channel 4K NVR. ",199,570665,570864
4108,sentence,"Category: NVR. Subcategory: Security. Price: 5,900৳6,500৳.

Product: Dahua NVR1108HS-S3/H 8 Channel Network Video Recorder (NVR). Category: NVR. Subcategory: Security. Price: 5,299৳6,600৳.
",189,570864,571053
4109,sentence,"Subcategory: Security. Price: 5,299৳6,600৳.

Product: Uniview NVR301-08S2 8 Channel 4K NVR. Category: NVR. Subcategory: Security. Price: 5,850৳6,600৳.
",151,571009,571160
4110,sentence,"Subcategory: Security. Price: 5,850৳6,600৳.

Product: TP-Link VIGI NVR1004H-4P 4 Channel PoE+ Network Video Recorder (NVR). Category: NVR. Subcategory: Security. Price: Out Of Stock.
",183,571116,571299
4111,sentence,"Subcategory: Security. Price: Out Of Stock.

Product: EZVIZ CS-X5S-8W 8 Channel Wireless NVR. Category: NVR. Subcategory: Security. Price: 5,199৳5,500৳.
",153,571255,571408
4112,sentence,"Subcategory: Security. Price: 5,199৳5,500৳.

Product: Dahua imou NVR1108HS-W-S2 8 Channel Wi-Fi NVR. Category: NVR. Subcategory: Security. Price: 7,900৳.
",154,571364,571518
4113,sentence,"Subcategory: Security. Price: 7,900৳.

Product: Dahua DHI-NVR1104HS-P-S3/H 04-Channel Compact 1U Lite POE NVR. Category: NVR. Subcategory: Security. Price: 7,900৳.
",164,571480,571644
4114,sentence,"Subcategory: Security. Price: 7,900৳.

Product: TP-Link VIGI NVR1016H V1 16 Channel NVR. Category: NVR. Subcategory: Security. Price: 6,962৳7,500৳.
",148,571606,571754
4115,sentence,"Subcategory: Security. Price: 6,962৳7,500৳.

Product: Hikvision DS-7608NI-Q2 8 Channel 1U 4K NVR. Category: NVR. Subcategory: Security. Price: 9,900৳.
",151,571710,571861
4116,sentence,"Subcategory: Security. Price: 9,900৳.

Product: Uniview NVR301-16S3 16 Channel 1 SATA NVR. Category: NVR. Subcategory: Security. Price: 9,200৳.

Product: Uniview NVR301-16E2 16 Channel NVR. ",190,571823,572013
4117,sentence,"
Product: Uniview NVR301-16E2 16 Channel NVR. Category: NVR. Subcategory: Security. Price: 9,600৳.

Product: Hikvision DS-7616NI-Q1 16 Channel Network Video Recorder (NVR). Category: NVR. ",188,571967,572155
4118,sentence,"Category: NVR. Subcategory: Security. Price: 10,000৳10,500৳.

Product: Dahua NVR1108HS-8P-S3/H 8 Channel Network Video Recorder (NVR). Category: Dahua. Subcategory: NVR. Price: 10,500৳.
",186,572140,572326
4119,sentence,"Subcategory: NVR. Price: 10,500৳.

Product: Dahua NVR2216-4KS3 16 Channel Lite Network Video Recorder (NVR). Category: Dahua. Subcategory: NVR. Price: 12,500৳.
",160,572292,572452
4120,sentence,"Subcategory: NVR. Price: 12,500৳.

Product: Dahua NVR4232-4KS3 32 Channel 1U 2 HDD Network Video Recorder (NVR). Category: Dahua. Subcategory: NVR. Price: 17,800৳21,500৳.
",171,572418,572589
4121,sentence,"Subcategory: NVR. Price: 17,800৳21,500৳.

Product: Dahua NVR5216-EI 16 Channels 1U 2HDDs WizSense Network Video Recorder (NVR). Category: Dahua. Subcategory: NVR. Price: 25,000৳.
",179,572548,572727
4122,sentence,"Subcategory: NVR. Price: 25,000৳.

Product: Dahua NVR4432-EI 32 Channel WizSense Network Video Recorder (NVR). Category: Dahua. Subcategory: NVR. Price: 37,500৳.
",162,572693,572855
4123,sentence,"Subcategory: NVR. Price: 37,500৳.

Product: Dahua NVR5832-EI 32 Channels 8HDD 2U Network Video Recorder. Category: Dahua. Subcategory: NVR. Price: 57,999৳59,500৳.
",163,572821,572984
4124,sentence,"Subcategory: NVR. Price: 57,999৳59,500৳.

Product: Dahua NVR5464-EI 64 Channel 4HDD 1.5U WizSense NVR. Category: Dahua. Subcategory: NVR. Price: 65,000৳.

Product: Dahua NVR5864-EI 64 Channels NVR. ",198,572943,573141
4125,sentence,"
Product: Dahua NVR5864-EI 64 Channels NVR. Category: Dahua. Subcategory: NVR. Price: 75,500৳.

Product: Dahua imou NVR1104HS-W-S2 4 Channel Wi-Fi NVR. Category: Dahua. Subcategory: NVR. ",187,573097,573284
4126,sentence,"Category: Dahua. Subcategory: NVR. Price: Out Of Stock.

Product: Dahua imou N18P 8 Channel PoE NVR. Category: Dahua. Subcategory: NVR. Price: Out Of Stock.
",157,573249,573406
4127,sentence,"Subcategory: NVR. Price: Out Of Stock.

Product: Dahua NVR4116HS-4KS3 16 Channel Smart 1U 1HDD Network Video Recorder (NVR). Category: Dahua. Subcategory: NVR. Price: Out Of Stock.
",181,573367,573548
4128,sentence,"Subcategory: NVR. Price: Out Of Stock.

Product: DAHUA NVR4116HS-4KS2 16 Channel Compact 1U Lite Network Video Recorder (NVR). Category: Dahua. Subcategory: NVR. Price: Out Of Stock.
",183,573509,573692
4129,sentence,"Subcategory: NVR. Price: Out Of Stock.

Product: Dahua DHI-NVR4216-4KS2/L 16 Channel 1U 2HDDs (NVR). Category: Dahua. Subcategory: NVR. Price: Out Of Stock.
",157,573653,573810
4130,sentence,"Subcategory: NVR. Price: Out Of Stock.

Product: Dahua NVR4208-8P-4KS2 8 Channel 1U Network Video Recorder (NVR). Category: Dahua. Subcategory: NVR. Price: Out Of Stock.
",170,573771,573941
4131,sentence,"Subcategory: NVR. Price: Out Of Stock.

Product: Dahua NVR4216-4KS3 16 Channel Smart Network Video Recorder (NVR). Category: Dahua. Subcategory: NVR. Price: Out Of Stock.
",171,573902,574073
4132,sentence,"Subcategory: NVR. Price: Out Of Stock.

Product: Dahua NVR4232-EI 32 Channel 1U 2HDDs WizSense NVR. Category: Dahua. Subcategory: NVR. Price: Out Of Stock.
",156,574034,574190
4133,sentence,"Subcategory: NVR. Price: Out Of Stock.

Product: Hikvision DS-7616NI-Q2 16-CH 4k NVR. Category: Hikvision. Subcategory: NVR. Price: 11,000৳.
",141,574151,574292
4134,sentence,"Subcategory: NVR. Price: 11,000৳.

Product: Hikvision DS-7632NXI-K2 AcuSense 32-Channel 4K NVR. Category: Hikvision. Subcategory: NVR. Price: 20,350৳.
",151,574258,574409
4135,sentence,"Subcategory: NVR. Price: 20,350৳.

Product: Hikvision DS-7732NXI-K4 AcuSense 32-Channel 4K NVR. Category: Hikvision. Subcategory: NVR. Price: 29,500৳.
",151,574375,574526
4136,sentence,"Subcategory: NVR. Price: 29,500৳.

Product: Hikvision DS-7764NI-M4 64 Channel 4HDD 8K NVR. Category: Hikvision. Subcategory: NVR. Price: 51,700৳.
",146,574492,574638
4137,sentence,"Subcategory: NVR. Price: 51,700৳.

Product: Hikvision DS-8664NXI-I8/S 64 Channel 2U AcuSense 4K NVR. Category: Hikvision. Subcategory: NVR. Price: 71,500৳.
",156,574604,574760
4138,sentence,"Subcategory: NVR. Price: 71,500৳.

Product: Hikvision DS-8632NI-K8 Embedded 4K NVR. Category: Hikvision. Subcategory: NVR. Price: 68,000৳.

Product: Hikvision DS-9664NI-M8 64 Channel 4K NVR. ",191,574726,574917
4139,sentence,"Category: Hikvision. Subcategory: NVR. Price: 135,000৳.

Product: Hikvision DS-9632NI-M8 32 Channel 2U 8K Network Video Recorder (NVR). Category: Hikvision. Subcategory: NVR. Price: Up Coming.
",193,574917,575110
4140,sentence,"Subcategory: NVR. Price: Up Coming.

Product: Hikvision DS-7604NI-K1 4 Channel Network Video Recorder (NVR). Category: Hikvision. Subcategory: NVR. Price: Out Of Stock.
",169,575074,575243
4141,sentence,"Subcategory: NVR. Price: Out Of Stock.

Product: Hikvision DS-7608NI-Q1 8 Channel Network Video Recorder (NVR). Category: Hikvision. Subcategory: NVR. Price: Out Of Stock.
",172,575204,575376
4142,sentence,"Subcategory: NVR. Price: Out Of Stock.

Product: Hikvision DS-7604NI-Q1/4P 4-Channel 1U 4 PoE 4K NVR. Category: Hikvision. Subcategory: NVR. Price: Out Of Stock.
",162,575337,575499
4143,sentence,"Subcategory: NVR. Price: Out Of Stock.

Product: Hikvision DS-7616NXI-Q2 16-CH 4k NVR. Category: Hikvision. Subcategory: NVR. Price: Out Of Stock.
",147,575460,575607
4144,sentence,"Subcategory: NVR. Price: Out Of Stock.

Product: Hikvision DS-7608NI-Q1/8P 8-Channel 1U 8 PoE 4K NVR. Category: Hikvision. Subcategory: NVR. Price: Out Of Stock.
",162,575568,575730
4145,sentence,"Subcategory: NVR. Price: Out Of Stock.

Product: Hikvision DS-7616NI-K2 4K resolution 16 channel IP Network Video Recorder (NVR). Category: Hikvision. Subcategory: NVR. Price: Out Of Stock.
",190,575691,575881
4146,sentence,"Subcategory: NVR. Price: Out Of Stock.

Product: Jovision JVS-ND7932-HV 32CH H.265 NVR. Category: Jovision. Subcategory: NVR. Price: 15,000৳.

Product: Jovision JVS-ND7932-DV 32CH H.265 FHD NVR. ",195,575842,576037
4147,sentence,"Category: Jovision. Subcategory: NVR. Price: 26,500৳.

Product: Jovision JVS-ND6616-H2 Series NVR. Category: Jovision. Subcategory: NVR. Price: Out Of Stock.
",158,576037,576195
4148,sentence,"Subcategory: NVR. Price: Out Of Stock.

Product: Jovision JVS-ND7608-HP 8CH H.265 4K NVR. Category: Jovision. Subcategory: NVR. Price: Out Of Stock.

Product: Jovision JVS-ND6632-H2 Series NVR. ",194,576156,576350
4149,sentence,"
Product: Jovision JVS-ND6632-H2 Series NVR. Category: Jovision. Subcategory: NVR. Price: Out Of Stock.

Product: Jovision JVS-ND6604-HD 4CH H.265 NVR. Category: Jovision. Subcategory: NVR. ",190,576305,576495
4150,sentence,"Category: Jovision. Subcategory: NVR. Price: Out Of Stock.

Product: TP-Link VIGI NVR4032H 32 Channel NVR. Category: TP-Link. Subcategory: NVR. Price: 28,000৳28,190৳.
",167,576457,576624
4151,sentence,"Subcategory: NVR. Price: 28,000৳28,190৳.

Product: TP-Link VIGI NVR1004H 4 Channel Network Video Recorder (NVR). Category: TP-Link. Subcategory: NVR. Price: Out Of Stock.
",171,576583,576754
4152,sentence,"Subcategory: NVR. Price: Out Of Stock.

Product: TP-Link VIGI NVR1008H 8 Channel Network Video Recorder (NVR). Category: TP-Link. Subcategory: NVR. Price: Out Of Stock.
",169,576715,576884
4153,sentence,"Subcategory: NVR. Price: Out Of Stock.

Product: TP-Link VIGI NVR1008H-8P 8 Channel PoE+ Network Video Recorder (NVR). Category: TP-Link. Subcategory: NVR. Price: Out Of Stock.
",177,576845,577022
4154,sentence,"Subcategory: NVR. Price: Out Of Stock.

Product: Uniview NVR302-16S 16 Channel 4K NVR. Category: Uniview. Subcategory: NVR. Price: 10,700৳12,800৳.

Product: Uniview NVR302-16S2 16 Channel 2 HDD NVR. ",199,576983,577182
4155,sentence,"Category: Uniview. Subcategory: NVR. Price: 15,000৳.

Product: Uniview NVR302-32S 32 Channel 4K 2 HDDs NVR. Category: Uniview. Subcategory: NVR. Price: 15,300৳17,500৳.
",168,577182,577350
4156,sentence,"Subcategory: NVR. Price: 15,300৳17,500৳.

Product: Uniview NVR304-32S 32 Channel 4K 4 HDDs NVR. Category: Uniview. Subcategory: NVR. Price: 24,000৳.
",149,577309,577458
4157,sentence,"Subcategory: NVR. Price: 24,000৳.

Product: Uniview NVR302-16E-P16 16 Channel 2 HDD PoE NVR. Category: Uniview. Subcategory: NVR. Price: 30,000৳.
",146,577424,577570
4158,sentence,"Subcategory: NVR. Price: 30,000৳.

Product: Uniview NVR304-16E 16 Channel 4K 4HDDs NVR. Category: Uniview. Subcategory: NVR. Price: 31,000৳.

Product: Uniview NVR304-16EP 16 Channel 4 HDDs NVR. ",194,577536,577730
4159,sentence,"Category: Uniview. Subcategory: NVR. Price: 35,000৳.

Product: Uniview NVR508-64B 64 Channel 4K NVR. Category: Uniview. Subcategory: NVR. Price: 49,500৳.
",154,577730,577884
4160,sentence,"Subcategory: NVR. Price: 49,500৳.

Product: Uniview NVR308-16X 16 Channel 4K 8HDDs NVR. Category: Uniview. Subcategory: NVR. Price: 55,000৳.

Product: Uniview NVR308-64X 64 Channel 4K NVR. ",189,577850,578039
4161,sentence,"
Product: Uniview NVR308-64X 64 Channel 4K NVR. Category: Uniview. Subcategory: NVR. Price: Call for Price.

Product: Uniview NVR516-64 64 Channel 4K 16 HDDs RAID NVR. Category: Uniview. ",187,577991,578178
4162,sentence,"Category: Uniview. Subcategory: NVR. Price: Call for Price.

Product: Uniview UNICORN Video Management System. Category: Uniview. Subcategory: NVR. Price: Call for Price.
",171,578159,578330
4163,sentence,"Subcategory: NVR. Price: Call for Price.

Product: Uniview NVR301-08LS3-P8 8 Channel NVR. Category: Uniview. Subcategory: NVR. Price: Call for Price.

Product: Uniview NVR302-08S2-P8 8 Channel NVR. ",198,578289,578487
4164,sentence,"
Product: Uniview NVR302-08S2-P8 8 Channel NVR. Category: Uniview. Subcategory: NVR. Price: Call for Price.

Product: Tiandy TC-R3220 20 Channel H.265 2HDD Network Video Recorder (NVR). ",186,578439,578625
4165,sentence,"Category: Tiandy. Subcategory: NVR. Price: Up Coming.

Product: Tiandy TC-R3240 40 Channel H.265 2HDD Network Video Recorder (NVR). Category: Tiandy. Subcategory: NVR. Price: Up Coming.
",186,578625,578811
4166,sentence,"Subcategory: NVR. Price: Up Coming.

Product: Tiandy TC-R3232 32 Channel H.265 2HDD Network Video Recorder (NVR). Category: Tiandy. Subcategory: NVR. Price: Up Coming.
",168,578775,578943
4167,sentence,"Subcategory: NVR. Price: Up Coming.

Product: Tiandy TC-R3105 5 Channel 8TB HDD NVR. Category: Tiandy. Subcategory: NVR. Price: Out Of Stock.

Product: Tiandy TC-R3110 10 Channel 8TB HDD NVR. ",192,578907,579099
4168,sentence,"Category: Tiandy. Subcategory: NVR. Price: Out Of Stock.

Product: Tiandy TC-R3104 4 Channel PoE NVR. Category: Tiandy. Subcategory: NVR. Price: Out Of Stock.
",159,579099,579258
4169,sentence,"Subcategory: NVR. Price: Out Of Stock.

Product: Tiandy TC-R3105 5 Channel PoE NVR. Category: Tiandy. Subcategory: NVR. Price: Out Of Stock.

Product: Tiandy TC-R3108 8 Channel PoE NVR. ",186,579219,579405
4170,sentence,"
Product: Tiandy TC-R3108 8 Channel PoE NVR. Category: Tiandy. Subcategory: NVR. Price: Out Of Stock.

Product: Tiandy TC-R3110 10 Channel PoE NVR. Category: Tiandy. Subcategory: NVR. ",184,579360,579544
4171,sentence,"Category: Tiandy. Subcategory: NVR. Price: Out Of Stock.

Product: DAHUA DH-XVR1B04-I 4-Channel Digital Video Recorder. Category: Dahua. Subcategory: XVR. Price: 2,450৳2,950৳.
",176,579508,579684
4172,sentence,"Subcategory: XVR. Price: 2,450৳2,950৳.

Product: Dahua XVR1B08-I 8 Channel Penta-brid 1080N/720p Cooper 1U XVR. Category: Dahua. Subcategory: XVR. Price: 2,550৳3,500৳.
",168,579645,579813
4173,sentence,"Subcategory: XVR. Price: 2,550৳3,500৳.

Product: Dahua XVR1B16-I 16-Channel Penta-brid Compact Digital Video Recorder. Category: Dahua. Subcategory: XVR. Price: 5,600৳6,200৳.
",175,579774,579949
4174,sentence,"Subcategory: XVR. Price: 5,600৳6,200৳.

Product: Dahua XVR1B04H-I 4 Channel Penta-brid 5M-N/1080p Cooper DVR. Category: Dahua. Subcategory: XVR. Price: 4,499৳6,500৳.
",166,579910,580076
4175,sentence,"Subcategory: XVR. Price: 4,499৳6,500৳.

Product: DAHUA XVR5104HS-I2 4-Channel Digital Video Recorder. Category: Dahua. Subcategory: XVR. Price: Out Of Stock.
",158,580037,580195
4176,sentence,"Subcategory: XVR. Price: Out Of Stock.

Product: Dahua XVR1B08H-I 8 Channel Penta-brid 5M-N/1080p Cooper DVR. Category: Dahua. Subcategory: XVR. Price: 6,099৳7,900৳.
",166,580156,580322
4177,sentence,"Subcategory: XVR. Price: 6,099৳7,900৳.

Product: DAHUA XVR1B16H 16 Channel Penta-brid 4M-N/1080P Cooper 1U Digital Video Recorder. Category: Dahua. Subcategory: XVR. Price: 10,999৳12,500৳.
",189,580283,580472
4178,sentence,"Subcategory: XVR. Price: 10,999৳12,500৳.

Product: Dahua DHI-XVR4232AN 32 Channel Digital Video Recorder. Category: Dahua. Subcategory: XVR. Price: 22,000৳.
",157,580431,580588
4179,sentence,"Subcategory: XVR. Price: 22,000৳.

Product: Dahua XVR5232AN-I3 32 Channel Penta-brid WizSense Digital Video Recorder. Category: Dahua. Subcategory: XVR. Price: 27,900৳29,500৳.
",176,580554,580730
4180,sentence,"Subcategory: XVR. Price: 27,900৳29,500৳.

Product: DAHUA XVR5108HS-I2 8-Channel Digital Video Recorder. Category: Dahua. Subcategory: XVR. Price: Out Of Stock.
",160,580689,580849
4181,sentence,"Subcategory: XVR. Price: Out Of Stock.

Product: Dahua DH-XVR4216AN-I 16 Channel Penta-brid WizSense Digital Video Recorder. Category: Dahua. Subcategory: XVR. Price: 16,000৳.
",176,580810,580986
4182,sentence,"Subcategory: XVR. Price: 16,000৳.

Product: DAHUA XVR5116HS-S2 16 Channel Digital Video Recorder. Category: Dahua. Subcategory: XVR. Price: Out Of Stock.
",154,580952,581106
4183,sentence,"Subcategory: XVR. Price: Out Of Stock.

Product: DAHUA XVR5216AN-I2 16-Channel Digital Video Recorder. Category: Dahua. Subcategory: XVR. Price: Out Of Stock.
",159,581067,581226
4184,sentence,"Subcategory: XVR. Price: Out Of Stock.

Product: DAHUA XVR5216AN-I3 16CH Penta-brid 5MP WizSense Digital Video Recorder. Category: Dahua. Subcategory: XVR. Price: Out Of Stock.
",177,581187,581364
4185,sentence,"Subcategory: XVR. Price: Out Of Stock.

Product: Dahua XVR5216AN-S2 16 Channel Penta-brid Full HD XVR. Category: Dahua. Subcategory: XVR. Price: Out Of Stock.
",159,581325,581484
4186,sentence,"Subcategory: XVR. Price: Out Of Stock.

Product: DAHUA XVR5232AN-S2 32 Channel Digital Video Recorder. Category: Dahua. Subcategory: XVR. Price: Out Of Stock.

Product: BNC JACK. ",179,581445,581624
4187,sentence,"Price: Out Of Stock.

Product: BNC JACK. Category: CC Camera Accessories. Subcategory: Security. Price: 70৳.

Product: AHD/CVI/TVI 720P/1080P (2MP) Video Balun for CC Camera. ",175,581583,581758
4188,sentence,"Category: CC Camera Accessories. Subcategory: Security. Price: 150৳250৳.

Product: 12V 2A Outdoor Waterproof AC/DC Power Adapter for CCTV Camera. Category: CC Camera Accessories. ",179,581758,581937
4189,sentence,"Category: CC Camera Accessories. Subcategory: Security. Price: 200৳250৳.

Product: 12V 2A Box waterproof AC/DC Power Adapter for CCTV Camera. Category: CC Camera Accessories. Subcategory: Security. ",198,581904,582102
4190,sentence,"Subcategory: Security. Price: 250৳400৳.

Product: High Quality RJ-6 PER MITER. Category: CC Camera Accessories. Subcategory: Security. Price: Out Of Stock.
",156,582079,582235
4191,sentence,"Subcategory: Security. Price: Out Of Stock.

Product: CC Camera Stand 10"" For IP Camera. Category: CC Camera Accessories. Subcategory: Security. Price: Out Of Stock.
",166,582191,582357
4192,sentence,"Subcategory: Security. Price: Out Of Stock.

Product: Uniview XVR301-04F 4 Chanel 1 SATA XVR. Category: Uniview. Subcategory: XVR. Price: 2,900৳4,000৳.
",152,582313,582465
4193,sentence,"Subcategory: XVR. Price: 2,900৳4,000৳.

Product: Uniview XVR301-04G3 4 Chanel 1 SATA XVR. Category: Uniview. Subcategory: XVR. Price: 4,250৳.

Product: Uniview XVR301-08F 8 Chanel 1 SATA XVR. ",192,582426,582618
4194,sentence,"Category: Uniview. Subcategory: XVR. Price: 5,000৳.

Product: Uniview XVR301-08G3 8 Chanel 1 SATA XVR. Category: Uniview. Subcategory: XVR. Price: 5,500৳.
",155,582618,582773
4195,sentence,"Subcategory: XVR. Price: 5,500৳.

Product: Uniview XVR301-16G3 16 Chanel 1 SATA XVR. Category: Uniview. Subcategory: XVR. Price: 9,000৳.

Product: Nexakey NX-280AS Single Door Magnetic Door Lock. ",196,582740,582936
4196,sentence,"Category: Door Lock. Subcategory: Security. Price: 2,450৳.

Product: ZKTeco LM-2802 Electromagnetic Door Lock. Category: Door Lock. Subcategory: Security. Price: 2,399৳2,500৳.
",176,582936,583112
4197,sentence,"Subcategory: Security. Price: 2,399৳2,500৳.

Product: SmartX SX-578 WiFi Fingerprint Smart Door Lock. Category: Door Lock. Subcategory: Security. Price: 9,500৳10,000৳.
",168,583068,583236
4198,sentence,"Subcategory: Security. Price: 9,500৳10,000৳.

Product: SmartX SX-528 WiFi Fingerprint Smart Door Lock. Category: Door Lock. Subcategory: Security. Price: 11,700৳11,950৳.
",170,583191,583361
4199,sentence,"Subcategory: Security. Price: 11,700৳11,950৳.

Product: SmartLife M1 Smart Door Lock. Category: Door Lock. Subcategory: Security. Price: Out Of Stock.
",151,583315,583466
4200,sentence,"Subcategory: Security. Price: Out Of Stock.

Product: ZKTeco GL300 Fingerprint Glass Door Smart Lock. Category: Door Lock. Subcategory: Security. Price: 14,000৳15,800৳.
",169,583422,583591
4201,sentence,"Subcategory: Security. Price: 14,000৳15,800৳.

Product: ZKTeco GL300W Fingerprint WiFi Glass Door Smart Lock. Category: Door Lock. Subcategory: Security. Price: 16,450৳17,000৳.
",177,583545,583722
4202,sentence,"Subcategory: Security. Price: 16,450৳17,000৳.

Product: STATA Door Lock Clutch. Category: Door Lock. Subcategory: Security. Price: Out Of Stock.

Product: SmartLife G1 Pro Smart Glass Door Lock. ",195,583676,583871
4203,sentence,"Category: Door Lock. Subcategory: Security. Price: 17,999৳.

Product: ZKTeco TL800 Wi-Fi Smart Digital Door Lock. Category: Door Lock. Subcategory: Security. Price: 18,650৳19,000৳.
",181,583871,584052
4204,sentence,"Subcategory: Security. Price: 18,650৳19,000৳.

Product: SmartLife G2 Smart Glass Door Lock. Category: Door Lock. Subcategory: Security. Price: 19,999৳.
",152,584006,584158
4205,sentence,"Subcategory: Security. Price: 19,999৳.

Product: SmartLife T1 Pro Smart Door Lock with 3D Face Recognition. Category: Door Lock. Subcategory: Security. Price: 19,999৳.
",168,584119,584287
4206,sentence,"Subcategory: Security. Price: 19,999৳.

Product: STATA X9 Lite Smart Digital Door Lock. Category: Door Lock. Subcategory: Security. Price: Out Of Stock.

Product: SmartLife K1 Smart Door Lock. ",193,584248,584441
4207,sentence,"
Product: SmartLife K1 Smart Door Lock. Category: Door Lock. Subcategory: Security. Price: 20,999৳.

Product: SmartX SX-Z3D-ECO Tuya WiFi Face Recognition Door Lock with Camera & Display. ",188,584401,584589
4208,sentence,"Category: Door Lock. Subcategory: Security. Price: 22,000৳.

Product: SmartX SX-718TT Fingerprint Smart Door Lock. Category: Door Lock. Subcategory: Security. Price: 22,900৳23,500৳.
",182,584589,584771
4209,sentence,"Subcategory: Security. Price: 22,900৳23,500৳.

Product: SmartX SX-718Pro WiFi Smart Door Lock with Camera & Display Tuya Smart Life. Category: Door Lock. Subcategory: Security. ",177,584725,584902
4210,sentence,"Category: Door Lock. Subcategory: Security. Price: 23,400৳24,500৳.

Product: SmartLife X1 Pro Smart Door Lock with Camera. Category: Door Lock. Subcategory: Security. Price: 23,499৳25,000৳.
",190,584858,585048
4211,sentence,"Subcategory: Security. Price: 23,499৳25,000৳.

Product: SmartX SX-F600 Tuya WiFi Face Recognition Door Lock with Camera & Display. Category: Door Lock. Subcategory: Security. Price: 25,000৳.
",191,585002,585193
4212,sentence,"Subcategory: Security. Price: 25,000৳.

Product: ZKTeco HBL100 Hybrid Biometric Smart Door Lock with Wireless Connection. Category: Door Lock. Subcategory: Security. Price: 25,500৳.
",182,585154,585336
4213,sentence,"Subcategory: Security. Price: 25,500৳.

Product: Jovision JVS-XD2604-FC10V 4 Channel XVR. Category: Jovision. Subcategory: XVR. Price: 5,100৳.
",143,585297,585440
4214,sentence,"Subcategory: XVR. Price: 5,100৳.

Product: Jovision JVS-XD2608-FC10V 8 Channel 5 In 1 XVR. Category: Jovision. Subcategory: XVR. Price: 7,100৳.
",144,585407,585551
4215,sentence,"Subcategory: XVR. Price: 7,100৳.

Product: Jovision JVS-XD2716-FC10T 16CH 1080N 5-in-1 XVR. Category: Jovision. Subcategory: XVR. Price: 9,500৳.

Product: Jovision JVS-XD2832-HE20K 32CH 5-in-1 XVR. ",198,585518,585716
4216,sentence,"Category: Jovision. Subcategory: XVR. Price: 23,500৳.

Product: Jovision JVS-XD2508-FC10T 8 Channel 5 IN 1 XVR. Category: Jovision. Subcategory: XVR. Price: Out Of Stock.
",171,585716,585887
4217,sentence,"Subcategory: XVR. Price: Out Of Stock.

Product: ZKTeco LM-1802 Magnetic Door Lock. Category: ZKTeco. Subcategory: Door Lock. Price: Out Of Stock.

Product: ZKTeco LM-280 Magnetic Door Lock. ",191,585848,586039
4218,sentence,"
Product: ZKTeco LM-280 Magnetic Door Lock. Category: ZKTeco. Subcategory: Door Lock. Price: Out Of Stock.

Product: ZKTeco Al-180d Electromagnetic Double Door Lock. Category: ZKTeco. ",184,585995,586179
4219,sentence,"Category: ZKTeco. Subcategory: Door Lock. Price: Out Of Stock.

Product: ZKTeco Al-280d(Led) Electromagnetic Double Door Lock. Category: ZKTeco. Subcategory: Door Lock. Price: Out Of Stock.
",190,586161,586351
4220,sentence,"Subcategory: Door Lock. Price: Out Of Stock.

Product: STATA X9 Plus Smart Digital Door Lock. Category: STATA. Subcategory: Door Lock. Price: Out Of Stock.

Product: STATA TAP Pro Smart Door Lock. ",197,586306,586503
4221,sentence,"
Product: STATA TAP Pro Smart Door Lock. Category: STATA. Subcategory: Door Lock. Price: Out Of Stock.

Product: STATA X9 Smart Digital Door Lock. Category: STATA. Subcategory: Door Lock. ",188,586462,586650
4222,sentence,"Category: STATA. Subcategory: Door Lock. Price: Out Of Stock.

Product: STATA Bolt Smart Digital Door Lock. Category: STATA. Subcategory: Door Lock. Price: Out Of Stock.
",170,586609,586779
4223,sentence,"Subcategory: Door Lock. Price: Out Of Stock.

Product: SmartX SX-N5-3D WiFi Face Recognition Door Lock with Camera & Video Doorbell. Category: SmartX. Subcategory: Door Lock. Price: 40,900৳42,500৳.
",198,586734,586932
4224,sentence,"Subcategory: Door Lock. Price: 40,900৳42,500৳.

Product: SmartX SX-D2 WiFi Dual Side Smart Door Lock. Category: SmartX. Subcategory: Door Lock. Price: 16,500৳.
",160,586885,587045
4225,sentence,"Subcategory: Door Lock. Price: 16,500৳.

Product: SmartX SX-N5TY WiFi Door Lock with Camera & Video Doorbell Tuya Smart Life App. Category: SmartX. Subcategory: Door Lock. Price: Out Of Stock.
",193,587005,587198
4226,sentence,"Subcategory: Door Lock. Price: Out Of Stock.

Product: SmartX SX-N500 WiFi Face Recognition Door Lock with Camera. Category: SmartX. Subcategory: Door Lock. Price: Out Of Stock.
",178,587153,587331
4227,sentence,"Subcategory: Door Lock. Price: Out Of Stock.

Product: SmartLife Y1 Pro Smart Door Lock with 3D Face Recognition. Category: SmartLife. Subcategory: Door Lock. Price: 29,999৳34,500৳.
",182,587286,587468
4228,sentence,"Subcategory: Door Lock. Price: 29,999৳34,500৳.

Product: SmartLife Z2 Pro Smart Door Lock with 3D Face Recognition. Category: SmartLife. Subcategory: Door Lock. Price: 49,999৳64,999৳.
",184,587421,587605
4229,sentence,"Subcategory: Door Lock. Price: 49,999৳64,999৳.

Product: SmartLife F2 Pro Smart Door Lock with 3D Face Recognition. Category: SmartLife. Subcategory: Door Lock. Price: 24,000৳.
",177,587558,587735
4230,sentence,"Subcategory: Door Lock. Price: 24,000৳.

Product: SmartLife F1 Pro Smart Door Lock with 3D Face Recognition. Category: SmartLife. Subcategory: Door Lock. Price: Out Of Stock.
",175,587695,587870
4231,sentence,"Subcategory: Door Lock. Price: Out Of Stock.

Product: SmartLife X2 Pro Smart Door Lock. Category: SmartLife. Subcategory: Door Lock. Price: Out Of Stock.
",155,587825,587980
4232,sentence,"Subcategory: Door Lock. Price: Out Of Stock.

Product: SmartLife Y2 Pro Smart Door Lock with 3D Face Recognition. Category: SmartLife. Subcategory: Door Lock. Price: Out Of Stock.
",180,587935,588115
4233,sentence,"Subcategory: Door Lock. Price: Out Of Stock.

Product: ZKTeco D0BPA Smart WiFi Video Door Bell. Category: Smart Door Bell. Subcategory: Security. Price: 7,100৳7,500৳.
",167,588070,588237
4234,sentence,"Subcategory: Security. Price: 7,100৳7,500৳.

Product: Hikvision DS-KIS204T Video Smart Door Bell. Category: Smart Door Bell. Subcategory: Security. Price: 10,000৳.
",164,588193,588357
4235,sentence,"Subcategory: Security. Price: 10,000৳.

Product: Grandstream GDS3710 HD IP Video Door Bell System. Category: Smart Door Bell. Subcategory: Security. Price: 39,000৳.
",165,588318,588483
4236,sentence,"Subcategory: Security. Price: 39,000৳.

Product: Tp-Link Tapo D130 Smart Wired Video Doorbell. Category: Smart Door Bell. Subcategory: Security. Price: Up Coming.
",163,588444,588607
4237,sentence,"Subcategory: Security. Price: Up Coming.

Product: Grandstream GDS3705 IP Audio Door Bell System. Category: Smart Door Bell. Subcategory: Security. Price: Up Coming.
",166,588566,588732
4238,sentence,"Subcategory: Security. Price: Up Coming.

Product: Grandstream GDS3702 IP Audio Door Bell System. Category: Smart Door Bell. Subcategory: Security. Price: Up Coming.
",166,588691,588857
4239,sentence,"Subcategory: Security. Price: Up Coming.

Product: Seemo Smart Video Home Security DoorBell. Category: Smart Door Bell. Subcategory: Security. Price: Out Of Stock.
",164,588816,588980
4240,sentence,"Subcategory: Security. Price: Out Of Stock.

Product: STATA Smart Video Door Bell. Category: Smart Door Bell. Subcategory: Security. Price: Out Of Stock.
",154,588936,589090
4241,sentence,"Subcategory: Security. Price: Out Of Stock.

Product: Tp-Link Tapo D230S1 Smart WiFi Video Doorbell. Category: Smart Door Bell. Subcategory: Security. Price: Out Of Stock.
",172,589046,589218
4242,sentence,"Subcategory: Security. Price: Out Of Stock.

Product: Hikvision Ezviz DP2C Portable Wi-Fi Peephole Video Doorbell. Category: Smart Door Bell. Subcategory: Security. Price: Out Of Stock.
",186,589174,589360
4243,sentence,"Subcategory: Security. Price: Out Of Stock.

Product: Onspot OSF93 Access Control. Category: Access Control. Subcategory: Security. Price: 14,000৳.

Product: Onspot OSF92 Access Control. ",187,589316,589503
4244,sentence,"
Product: Onspot OSF92 Access Control. Category: Access Control. Subcategory: Security. Price: 13,000৳.

Product: Nexakey NX-2052 Offline Access Control. Category: Access Control. ",180,589464,589644
4245,sentence,"Category: Access Control. Subcategory: Security. Price: 2,250৳.

Product: Zkteco TLEB101-R Exit Button with Remote. Category: Access Control. Subcategory: Security. Price: 2,299৳2,500৳.
",186,589618,589804
4246,sentence,"Subcategory: Security. Price: 2,299৳2,500৳.

Product: Onspot OSF42 Access Control. Category: Access Control. Subcategory: Security. Price: 10,500৳.
",148,589760,589908
4247,sentence,"Subcategory: Security. Price: 10,500৳.

Product: ZKTeco SLK20R Biometric Fingerprint Scanner without Adapter. Category: Access Control. Subcategory: Security. Price: 4,750৳5,000৳.
",180,589869,590049
4248,sentence,"Subcategory: Security. Price: 4,750৳5,000৳.

Product: ZKTeco FR1200 Finger & RFID Exit Reader. Category: Access Control. Subcategory: Security. Price: 4,700৳5,500৳.
",165,590005,590170
4249,sentence,"Subcategory: Security. Price: 4,700৳5,500৳.

Product: ZKTeco K50A Fingerprint Time Attendance & Access Control Terminal with Adapter. Category: Access Control. Subcategory: Security. ",183,590126,590309
4250,sentence,"Subcategory: Security. Price: 5,915৳6,500৳.

Product: ZKTeco SenseFP M1 Biometric Time & Attendance Access Control Terminal. Category: Access Control. Subcategory: Security. Price: 6,600৳.
",189,590286,590475
4251,sentence,"Subcategory: Security. Price: 6,600৳.

Product: ZKTeco FR1300 Finger RFID & Password Exit Reader. Category: Access Control. Subcategory: Security. Price: Out Of Stock.
",168,590437,590605
4252,sentence,"Subcategory: Security. Price: Out Of Stock.

Product: ZKTeco K40 Time & Attendance Terminal Machine. Category: Access Control. Subcategory: Security. Price: 5,670৳6,500৳.
",171,590561,590732
4253,sentence,"Subcategory: Security. Price: 5,670৳6,500৳.

Product: ZKTeco K90 Fingerprint Time & Attendance and Access Control Terminal. Category: Access Control. Subcategory: Security. Price: 5,727৳6,900৳.
",194,590688,590882
4254,sentence,"Subcategory: Security. Price: 5,727৳6,900৳.

Product: ZKTeco MB20-VL Multibiometric Time Attendance Access Control. Category: Access Control. Subcategory: Security. Price: 8,199৳8,300৳.
",186,590838,591024
4255,sentence,"Subcategory: Security. Price: 8,199৳8,300৳.

Product: ZKTeco MB10-VL Hybrid Biometric Time & Attendance and Access Control Terminal. Category: Access Control. Subcategory: Security. ",182,590980,591162
4256,sentence,"Subcategory: Security. Price: 7,480৳8,500৳.

Product: ZKTeco iClock9000-G (GPRS/3G) Time Attendance Terminal Machine. Category: Access Control. Subcategory: Security. Price: 10,500৳.
",183,591139,591322
4257,sentence,"Subcategory: Security. Price: 10,500৳.

Product: ZKTeco MB10-VL Wi-fi Biometric Time & Attendance and Access Control Terminal. Category: Access Control. Subcategory: Security. Price: 10,500৳.
",192,591283,591475
4258,sentence,"Subcategory: Security. Price: 10,500৳.

Product: ZKTeco SenseFace 2A Access Control Terminal. Category: Access Control. Subcategory: Security. Price: 9,999৳10,500৳.
",165,591436,591601
4259,sentence,"Subcategory: Security. Price: 9,999৳10,500৳.

Product: ZKTeco F18 Access Control with Card & Finger Print. Category: Access Control. Subcategory: Security. Price: 9,765৳10,800৳.
",178,591556,591734
4260,sentence,"Subcategory: Security. Price: 9,765৳10,800৳.

Product: Hikvision DS-K1T320EFWX Face Recognition Access Control Terminal. Category: Hikvision. Subcategory: Access Control. Price: 10,400৳11,500৳.
",194,591689,591883
4261,sentence,"Price: 10,400৳11,500৳.

Product: Hikvision DS-K1T320EFWX-B Face Recognition Access Control. Category: Hikvision. Subcategory: Access Control. Price: 11,400৳11,500৳.
",165,591860,592025
4262,sentence,"Price: 11,400৳11,500৳.

Product: Hikvision DS-K1T343EFWX Face Recognition Access Control Terminal. Category: Hikvision. Subcategory: Access Control. Price: 13,800৳.
",165,592002,592167
4263,sentence,"Subcategory: Access Control. Price: 13,800৳.

Product: Hikvision DS-K1T342EX-E1 Face Recognition Access Control Terminal. Category: Hikvision. Subcategory: Access Control. Price: 16,000৳.
",188,592122,592310
4264,sentence,"Subcategory: Access Control. Price: 16,000৳.

Product: Hikvision DS-K1T342EFWX-E1 Face Recognition Access Control Terminal. Category: Hikvision. Subcategory: Access Control. Price: 17,500৳.
",190,592265,592455
4265,sentence,"Subcategory: Access Control. Price: 17,500৳.

Product: Hikvision DS-K1T8005EFWX-B Fingerprint Access Control. Category: Hikvision. Subcategory: Access Control. Price: Up Coming.
",178,592410,592588
4266,sentence,"Subcategory: Access Control. Price: Up Coming.

Product: Hikvision DS-K1T344EBFWX-E1 Face Recognition Access Control. Category: Hikvision. Subcategory: Access Control. Price: Up Coming.
",186,592541,592727
4267,sentence,"Subcategory: Access Control. Price: Up Coming.

Product: Hikvision DS-K1201AEF Fingerprint Reader. Category: Hikvision. Subcategory: Access Control. Price: Up Coming.
",167,592680,592847
4268,sentence,"Subcategory: Access Control. Price: Up Coming.

Product: Hikvision DS-K1801 Card Reader With Keyboard. Category: Hikvision. Subcategory: Access Control. Price: Up Coming.
",171,592800,592971
4269,sentence,"Subcategory: Access Control. Price: Up Coming.

Product: Hikvision DS-K1T342EFWX Face Recognition Access Control Terminal. Category: Hikvision. Subcategory: Access Control. Price: Up Coming.
",191,592924,593115
4270,sentence,"Subcategory: Access Control. Price: Up Coming.

Product: Hikvision DS-K1T320EX Face Recognition Access Control Terminal. Category: Hikvision. Subcategory: Access Control. Price: Out Of Stock.
",192,593068,593260
4271,sentence,"Price: Out Of Stock.

Product: Hikvision DS-K1A8503EF Fingerprint Time Attendance Terminal. Category: Hikvision. Subcategory: Access Control. Price: Out Of Stock.
",163,593239,593402
4272,sentence,"Price: Out Of Stock.

Product: Hikvision DS-K1T320EFX Face Recognition Access Control Terminal. Category: Hikvision. Subcategory: Access Control. Price: Out Of Stock.
",167,593381,593548
4273,sentence,"Price: Out Of Stock.

Product: Hikvision DS-K1T321EX Face Recognition Access Control Terminal. Category: Hikvision. Subcategory: Access Control. Price: Out Of Stock.
",166,593527,593693
4274,sentence,"Price: Out Of Stock.

Product: Hikvision DS-K1T321EFX Face Recognition Access Control Terminal. Category: Hikvision. Subcategory: Access Control. Price: Out Of Stock.
",167,593672,593839
4275,sentence,"Price: Out Of Stock.

Product: Hikvision DS-K1T321EFWX Face Recognition Access Control Terminal. Category: Hikvision. Subcategory: Access Control. Price: Out Of Stock.
",168,593818,593986
4276,sentence,"Price: Out Of Stock.

Product: Hikvision DS-K1T343EFX Face Recognition Access Control Terminal. Category: Hikvision. Subcategory: Access Control. Price: Out Of Stock.
",167,593965,594132
4277,sentence,"Price: Out Of Stock.

Product: Hikvision DS-K1T343EX Face Recognition Access Control Terminal. Category: Hikvision. Subcategory: Access Control. Price: Out Of Stock.
",166,594111,594277
4278,sentence,"Price: Out Of Stock.

Product: Hikvision DS-K1T321EFWX-B Face Recognition Access Control Terminal. Category: Hikvision. Subcategory: Access Control. Price: Out Of Stock.
",170,594256,594426
4279,sentence,"Price: Out Of Stock.

Product: Hikvision DS-K1T341CMF Face Recognition Access Control Terminal. Category: Hikvision. Subcategory: Access Control. Price: Out Of Stock.
",167,594405,594572
4280,sentence,"Price: Out Of Stock.

Product: Onspot OS456F Biometric Face Recognition Time Attendance Recorder & Access Control. Category: Onspot. Subcategory: Access Control. Price: 22,000৳.
",178,594551,594729
4281,sentence,"Subcategory: Access Control. Price: 22,000৳.

Product: Onspot OS930F Access Control. Category: Onspot. Subcategory: Access Control. Price: Out Of Stock.
",153,594684,594837
4282,sentence,"Price: Out Of Stock.

Product: Onspot OSF75 Access Control with Battary Backup. Category: Onspot. Subcategory: Access Control. Price: 8,000৳.

Product: TRENDnet TK-207K 2-Port USB KVM Switch Kit. ",196,594816,595012
4283,sentence,"Category: KVM Switch. Subcategory: Security. Price: 4,550৳.

Product: TRENDnet TK-407K 4-Port USB KVM Switch Kit. Category: KVM Switch. Subcategory: Security. Price: 8,400৳.
",174,595012,595186
4284,sentence,"Subcategory: Security. Price: 8,400৳.

Product: TRENDnet TK-803R 8-Port Rack Mount KVM Switch. Category: KVM Switch. Subcategory: Security. Price: 24,500৳.
",156,595148,595304
4285,sentence,"Subcategory: Security. Price: 24,500৳.

Product: Safenet SN-KC6808S 8-Port Stacking VGA KVM. Category: KVM Switch. Subcategory: Security. Price: 143,000৳.
",155,595265,595420
4286,sentence,"Subcategory: Security. Price: 143,000৳.

Product: COTE KVM-0819M 8 Port KVM Switch with 19"" Console. Category: KVM Switch. Subcategory: Security. Price: 160,000৳.
",163,595380,595543
4287,sentence,"Subcategory: Security. Price: 160,000৳.

Product: Safenet SN-KC7808S 8-Port TP KVM. Category: KVM Switch. Subcategory: Security. Price: 190,000৳.
",146,595503,595649
4288,sentence,"Subcategory: Security. Price: 190,000৳.

Product: COTE KVM-1619M 16 Port KVM Switch with 19"" Console. Category: KVM Switch. Subcategory: Security. Price: 195,000৳.
",164,595609,595773
4289,sentence,"Subcategory: Security. Price: 195,000৳.

Product: Safenet SN-KC7816S 16-Port TP KVM. Category: KVM Switch. Subcategory: Security. Price: 247,000৳.
",147,595733,595880
4290,sentence,"Subcategory: Security. Price: 247,000৳.

Product: Micronet SP214EL 4-PORT KVM SWITCH WITH 4 PS/2 CABLE. Category: KVM Switch. Subcategory: Security. Price: Out Of Stock.
",170,595840,596010
4291,sentence,"Subcategory: Security. Price: Out Of Stock.

Product: Micronet SP218D 8 Port USB IP KVM With 8 KVM Cable. Category: KVM Switch. Subcategory: Security. Price: Out Of Stock.
",172,595966,596138
4292,sentence,"Subcategory: Security. Price: Out Of Stock.

Product: Micronet SP226D 16 PORT Combo KVM with 16 Cable. Category: KVM Switch. Subcategory: Security. Price: Out Of Stock.
",169,596094,596263
4293,sentence,"Subcategory: Security. Price: Out Of Stock.

Product: Safenet SN-KC6816S 16-Port Stacking VGA KVM. Category: KVM Switch. Subcategory: Security. Price: Out Of Stock.
",165,596219,596384
4294,sentence,"Subcategory: Security. Price: Out Of Stock.

Product: ZKTeco F22 Fingerprint Time Attendance and Access Control Terminal. Category: ZKTeco. Subcategory: Access Control. Price: 9,720৳10,800৳.
",191,596340,596531
4295,sentence,"Price: 9,720৳10,800৳.

Product: ZKTeco F19 Fingerprint Standalone Access Control. Category: ZKTeco. Subcategory: Access Control. Price: 9,625৳12,500৳.
",151,596509,596660
4296,sentence,"Price: 9,625৳12,500৳.

Product: ZKTeco MB360 Fingerprint Time Attendance Terminal. Category: ZKTeco. Subcategory: Access Control. Price: 12,300৳13,400৳.
",153,596638,596791
4297,sentence,"Price: 12,300৳13,400৳.

Product: ZKTeco SenseFace 3A AI Based Access Control Terminal. Category: ZKTeco. Subcategory: Access Control. Price: 16,399৳17,000৳.
",157,596768,596925
4298,sentence,"Price: 16,399৳17,000৳.

Product: ZKTeco iClock260 Fingerprint Time Attendance and Access Control Terminal. Category: ZKTeco. Subcategory: Access Control. Price: 17,300৳.
",170,596902,597072
4299,sentence,"Subcategory: Access Control. Price: 17,300৳.

Product: Tipsoi Prompt P40 Biometric Time Attendance & Access Control Terminal. Category: Tipsoi. Subcategory: Access Control. Price: 10,000৳.
",189,597027,597216
4300,sentence,"Subcategory: Access Control. Price: 10,000৳.

Product: Tipsoi TF-80 Biometric Time Attendance & Access Control Terminal. Category: Tipsoi. Subcategory: Access Control. Price: 20,000৳.
",184,597171,597355
4301,sentence,"Subcategory: Access Control. Price: 20,000৳.

Product: Tipsoi Prompt P205 Biometric Time Attendance & Access Control Terminal. Category: Tipsoi. Subcategory: Access Control. Price: 17,500৳.
",190,597310,597500
4302,sentence,"Subcategory: Access Control. Price: 17,500৳.

Product: Tipsoi Prompt P310 Biometric Time Attendance & Access Control Terminal. Category: Tipsoi. Subcategory: Access Control. Price: 27,000৳.
",190,597455,597645
4303,sentence,"Subcategory: Access Control. Price: 27,000৳.

Product: Tipsoi Fastface 5 Lite Time Attendance & Access Control Terminal. Category: Tipsoi. Subcategory: Access Control. Price: 32,000৳.
",184,597600,597784
4304,sentence,"Subcategory: Access Control. Price: 32,000৳.

Product: Tipsoi Fastface 5 Time Attendance & Access Control Terminal. Category: Tipsoi. Subcategory: Access Control. Price: 42,000৳.
",179,597739,597918
4305,sentence,"Subcategory: Access Control. Price: 42,000৳.

Product: Tipsoi Fastface 5 Pro Time Attendance & Access Control Terminal. Category: Tipsoi. Subcategory: Access Control. Price: 50,000৳.
",183,597873,598056
4306,sentence,"Subcategory: Access Control. Price: 50,000৳.

Product: Tipsoi Fastface 5 Pro FP Biometric Time Attendance & Access Control Terminal. Category: Tipsoi. Subcategory: Access Control. Price: 55,000৳.
",196,598011,598207
4307,sentence,"Subcategory: Access Control. Price: 55,000৳.

Product: Tipsoi Fastface 7 Time Attendance & Access Control Terminal. Category: Tipsoi. Subcategory: Access Control. Price: 60,000৳.
",179,598162,598341
4308,sentence,"Subcategory: Access Control. Price: 60,000৳.

Product: Tipsoi Fastface 8 Time Attendance & Access Control Terminal. Category: Tipsoi. Subcategory: Access Control. Price: 80,000৳.
",179,598296,598475
4309,sentence,"Subcategory: Access Control. Price: 80,000৳.

Product: Tipsoi Fastface Go Lite Time Attendance & Access Control Terminal. Category: Tipsoi. Subcategory: Access Control. Price: 40,500৳.
",185,598430,598615
4310,sentence,"Subcategory: Access Control. Price: 40,500৳.

Product: NexaKey K2RR Touchless Exit Button with Remote. Category: NexaKey. Subcategory: Access Control. Price: Out Of Stock.
",172,598570,598742
4311,sentence,"Price: Out Of Stock.

Product: Deli ET520 Digital Safe Box / Locker / Vault. Category: Digital Locker & Vault. Subcategory: Security. Price: Out Of Stock.
",155,598721,598876
4312,sentence,"Subcategory: Security. Price: Out Of Stock.

Product: Deli ET580 Fireproof Digital Safe Box / Locker / Vault. Category: Digital Locker & Vault. Subcategory: Security. Price: 21,500৳22,000৳.
",190,598832,599022
4313,sentence,"Subcategory: Security. Price: 21,500৳22,000৳.

Product: Deli ET595 Fingerprint Password Digital Safe Box / Locker / Vault. Category: Digital Locker & Vault. Subcategory: Security. Price: 23,000৳.
",196,598976,599172
4314,sentence,"Subcategory: Security. Price: 23,000৳.

Product: Deli ET592 Fingerprint Password Digital Safe Box / Locker / Vault. Category: Digital Locker & Vault. Subcategory: Security. Price: 24,000৳.
",189,599133,599322
4315,sentence,"Subcategory: Security. Price: 24,000৳.

Product: Deli ET581 Fireproof Digital Safe Box / Locker / Vault. Category: Digital Locker & Vault. Subcategory: Security. Price: 24,500৳.
",178,599283,599461
4316,sentence,"Subcategory: Security. Price: 24,500৳.

Product: Deli ET596 Fingerprint Password Digital Safe Box / Locker / Vault. Category: Digital Locker & Vault. Subcategory: Security. Price: 26,000৳.
",189,599422,599611
4317,sentence,"Subcategory: Security. Price: 26,000৳.

Product: Deli ET593 Fingerprint Password Digital Safe Box / Locker / Vault. Category: Digital Locker & Vault. Subcategory: Security. Price: 28,000৳.
",189,599572,599761
4318,sentence,"Subcategory: Security. Price: 28,000৳.

Product: Deli ET594 Fingerprint Password Digital Safe Box / Locker / Vault. Category: Digital Locker & Vault. Subcategory: Security. Price: 32,000৳.
",189,599722,599911
4319,sentence,"Subcategory: Security. Price: 32,000৳.

Product: Deli ET597 Fingerprint Password Digital Safe Box / Locker / Vault. Category: Digital Locker & Vault. Subcategory: Security. Price: 34,500৳.
",189,599872,600061
4320,sentence,"Subcategory: Security. Price: 34,500৳.

Product: Deli ET600 Fireproof Digital Safe Box / Locker / Vault. Category: Digital Locker & Vault. Subcategory: Security. Price: 38,000৳.
",178,600022,600200
4321,sentence,"Subcategory: Security. Price: 38,000৳.

Product: Deli ET601 Fireproof Digital Safe Box / Locker / Vault. Category: Digital Locker & Vault. Subcategory: Security. Price: 45,000৳.
",178,600161,600339
4322,sentence,"Subcategory: Security. Price: 45,000৳.

Product: Deli ET602 Fireproof Digital Safe Box / Locker / Vault. Category: Digital Locker & Vault. Subcategory: Security. Price: 50,000৳.
",178,600300,600478
4323,sentence,"Subcategory: Security. Price: 50,000৳.

Product: Deli 4116G Fingerprint Password Digital Safe Box / Locker / Vault. Category: Digital Locker & Vault. Subcategory: Security. Price: Up Coming.
",191,600439,600630
4324,sentence,"Subcategory: Security. Price: Up Coming.

Product: Deli ET551 Password Digital Safe Box / Locker / Vault. Category: Digital Locker & Vault. Subcategory: Security. Price: Up Coming.
",181,600589,600770
4325,sentence,"Subcategory: Security. Price: Up Coming.

Product: Deli ET552 Password Digital Safe Box / Locker / Vault. Category: Digital Locker & Vault. Subcategory: Security. Price: Up Coming.
",181,600729,600910
4326,sentence,"Subcategory: Security. Price: Up Coming.

Product: Deli 4117G Fingerprint Password Digital Safe Box / Locker / Vault. Category: Digital Locker & Vault. Subcategory: Security. Price: Up Coming.
",193,600869,601062
4327,sentence,"Subcategory: Security. Price: Up Coming.

Product: Deli 4118G Fingerprint Password Digital Safe Box / Locker / Vault. Category: Digital Locker & Vault. Subcategory: Security. Price: Up Coming.
",193,601021,601214
4328,sentence,"Subcategory: Security. Price: Up Coming.

Product: Deli 4121 Fingerprint & Digital Safe Box / Locker / Vault. Category: Digital Locker & Vault. Subcategory: Security. Price: Up Coming.
",185,601173,601358
4329,sentence,"Subcategory: Security. Price: Up Coming.

Product: Deli ET553 Password Digital Safe Box / Locker / Vault. Category: Digital Locker & Vault. Subcategory: Security. Price: Up Coming.
",181,601317,601498
4330,sentence,"Subcategory: Security. Price: Up Coming.

Product: Deli 4122 Fingerprint & Digital Safe Box / Locker / Vault. Category: Digital Locker & Vault. Subcategory: Security. Price: Up Coming.
",185,601457,601642
4331,sentence,"Subcategory: Security. Price: Up Coming.

Product: Nexakey NX-280U U Magnetic Door Lock Bracket. Category: Access Control Accessories. Subcategory: Access Control. Price: 2,450৳.
",179,601601,601780
4332,sentence,"Subcategory: Access Control. Price: 2,450৳.

Product: ZKTeco LMB-180L L Bracket. Category: Access Control Accessories. Subcategory: Access Control. Price: 500৳.

Product: ZKTeco LMB-280L L Bracket. ",198,601736,601934
4333,sentence,"
Product: ZKTeco LMB-280L L Bracket. Category: Access Control Accessories. Subcategory: Access Control. Price: 600৳.

Product: Nexakey NX-280ZL EM Magnetic Door Lock Bracket. ",175,601897,602072
4334,sentence,"Category: Access Control Accessories. Subcategory: Access Control. Price: 1,400৳.

Product: ZKTeco LMB-280U Electromagnetic Lock U Bracket. Category: Access Control Accessories. ",178,602072,602250
4335,sentence,"Category: Access Control Accessories. Subcategory: Access Control. Price: 799৳850৳.

Product: ZKTeco LMB-280Z Z Bracket. Category: Access Control Accessories. Subcategory: Access Control. ",188,602212,602400
4336,sentence,"Subcategory: Access Control. Price: 699৳750৳.

Product: Zkteco LMB-280ZL Electromagnetic Lock Z & L Bracket. Category: Access Control Accessories. Subcategory: Access Control. Price: 1,300৳1,500৳.
",197,602371,602568
4337,sentence,"Price: 1,300৳1,500৳.

Product: ZKTeco LMB-180U U Bracket. Category: Access Control Accessories. Subcategory: Access Control. Price: Out Of Stock.

Product: ZKTeco LMB-180Z Bracket. ",181,602547,602728
4338,sentence,"
Product: ZKTeco LMB-180Z Bracket. Category: Access Control Accessories. Subcategory: Access Control. Price: Out Of Stock.

Product: ZKTeco ZK-D1010L Walk Through Metal Detector. ",179,602693,602872
4339,sentence,"Category: Entrance Control. Subcategory: Security. Price: 39,500৳42,500৳.

Product: ZKTeco ZK-D1065S Walk Through 6 Zones Metal Detector. Category: Entrance Control. Subcategory: Security. ",189,602872,603061
4340,sentence,"Subcategory: Security. Price: 55,000৳.

Product: Hikvision DS-TMG300-DL(3.4~6m telescopic) Straight Pole Barrier Gate. Category: Entrance Control. Subcategory: Security. Price: 55,000৳.
",186,603038,603224
4341,sentence,"Subcategory: Security. Price: 55,000৳.

Product: Hikvision DS-TMG301-DL(2+2m) Folding Pole Barrier Gate. Category: Entrance Control. Subcategory: Security. Price: 55,000৳.
",172,603185,603357
4342,sentence,"Subcategory: Security. Price: 55,000৳.

Product: Hikvision DS-TMG301-DR(2+2m) Folding Pole Barrier Gate. Category: Entrance Control. Subcategory: Security. Price: 55,000৳.
",172,603318,603490
4343,sentence,"Subcategory: Security. Price: 55,000৳.

Product: Hikvision DS-TMG4B0-RA 6 Meter Straight Pole Barrier Gate. Category: Entrance Control. Subcategory: Security. Price: 55,000৳.
",175,603451,603626
4344,sentence,"Subcategory: Security. Price: 55,000৳.

Product: ZKTeco ZK-D2180 Walk Through 18 Zones Metal Detector. Category: Entrance Control. Subcategory: Security. Price: 65,500৳.
",170,603587,603757
4345,sentence,"Subcategory: Security. Price: 65,500৳.

Product: ZKTeco ZK-D1065 Walk Through 6 Zones Metal Detector. Category: Entrance Control. Subcategory: Security. Price: 63,000৳.
",169,603718,603887
4346,sentence,"Subcategory: Security. Price: 63,000৳.

Product: ZKTeco ZK-D3180 Walk Through 18 Zones Metal Detector. Category: Entrance Control. Subcategory: Security. Price: 90,000৳105,000৳.
",178,603848,604026
4347,sentence,"Subcategory: Security. Price: 90,000৳105,000৳.

Product: Hikvision ISD-SG6550SA-2CL X-ray Intelligent Security Inspection System. Category: Entrance Control. Subcategory: Security. Price: 110,000৳.
",198,603979,604177
4348,sentence,"Subcategory: Security. Price: 110,000৳.

Product: ZKTeco ZK-TS2022 Pro Tripod Turnstile With Controller Fingerprint and RFID Reader. Category: Entrance Control. Subcategory: Security. ",184,604137,604321
4349,sentence,"Subcategory: Security. Price: 125,000৳.

Product: ZKTeco ZK-D4330 Walk Through 33 Zones Metal Detector. Category: Entrance Control. Subcategory: Security. Price: 210,000৳.
",172,604298,604470
4350,sentence,"Subcategory: Security. Price: 210,000৳.

Product: ZKTeco PB4130L/R Parking Barrier. Category: Entrance Control. Subcategory: Security. Price: Up Coming.
",153,604430,604583
4351,sentence,"Subcategory: Security. Price: Up Coming.

Product: ZKTeco ZKX5030A Single Energy X-ray Baggage Scanner. Category: Entrance Control. Subcategory: Security. Price: Up Coming.
",173,604542,604715
4352,sentence,"Subcategory: Security. Price: Up Coming.

Product: ZKTeco TS2000 Pro Tripod Turnstile with Controller Fingerprint and RFID Reader. Category: Entrance Control. Subcategory: Security. ",182,604674,604856
4353,sentence,"Subcategory: Security. Price: Up Coming.

Product: Hikvision ISD-SG5030SA-CL X-ray Intelligent Security Inspection System. Category: Entrance Control. Subcategory: Security. Price: Up Coming.
",192,604833,605025
4354,sentence,"Subcategory: Security. Price: Up Coming.

Product: Hikvision ISD-SMG1118L Walk Through Metal Detector. Category: Entrance Control. Subcategory: Security. Price: Up Coming.
",172,604984,605156
4355,sentence,"Subcategory: Security. Price: Up Coming.

Product: Hikvision ISD-SMG106 Walk Through Metal Detector. Category: Entrance Control. Subcategory: Security. Price: Up Coming.
",170,605115,605285
4356,sentence,"Subcategory: Security. Price: Up Coming.

Product: Hikvision NP-SH100 Hand Held Metal Detector. Category: Entrance Control. Subcategory: Security. Price: Up Coming.

Product: Starlink Mini Kit. ",194,605244,605438
4357,sentence,"Price: Up Coming.

Product: Starlink Mini Kit. Category: Starlink. Subcategory: Networking. Price: 26,500৳36,499৳.

Product: Starlink Standard Kit. Category: Starlink. Subcategory: Networking. ",193,605391,605584
4358,sentence,"Category: Starlink. Subcategory: Networking. Price: 49,500৳60,999৳.

Product: Starlink Flat High Performance Kit. Category: Starlink. Subcategory: Networking. Price: 185,000৳189,000৳.
",184,605539,605723
4359,sentence,"Price: 185,000৳189,000৳.

Product: Starlink Mini 15 Meter DC Power Cable for Mini KIT. Category: Starlink. Subcategory: Networking. Price: Up Coming.
",150,605698,605848
4360,sentence,"Subcategory: Networking. Price: Up Coming.

Product: Starlink Standard Power Supply Mount for Standard KIT. Category: Starlink. Subcategory: Networking. Price: Up Coming.
",171,605805,605976
4361,sentence,"Subcategory: Networking. Price: Up Coming.

Product: Starlink Mini 5 Meter USB Type-C Power Cable for Mini KIT. Category: Starlink. Subcategory: Networking. Price: Up Coming.
",175,605933,606108
4362,sentence,"Subcategory: Networking. Price: Up Coming.

Product: Starlink Mini 15 Meter RJ45 Ethernet Cable for Mini KIT. Category: Starlink. Subcategory: Networking. Price: Up Coming.
",173,606065,606238
4363,sentence,"Subcategory: Networking. Price: Up Coming.

Product: Starlink Mini 30 Meter DC Power Cable for Mini KIT. Category: Starlink. Subcategory: Networking. Price: Up Coming.
",168,606195,606363
4364,sentence,"Subcategory: Networking. Price: Up Coming.

Product: Starlink Mini Mobility Mount for Mini KIT. Category: Starlink. Subcategory: Networking. Price: Up Coming.
",159,606320,606479
4365,sentence,"Subcategory: Networking. Price: Up Coming.

Product: Starlink Standard Pipe Adapter Mount for Standard KIT. Category: Starlink. Subcategory: Networking. Price: Up Coming.
",171,606436,606607
4366,sentence,"Subcategory: Networking. Price: Up Coming.

Product: Starlink Standard Mobility Mount for Standard KIT. Category: Starlink. Subcategory: Networking. Price: Up Coming.
",167,606564,606731
4367,sentence,"Subcategory: Networking. Price: Up Coming.

Product: Starlink Mini Pipe Adapter and Flat Mount for Mini KIT. Category: Starlink. Subcategory: Networking. Price: Up Coming.
",172,606688,606860
4368,sentence,"Subcategory: Networking. Price: Up Coming.

Product: Starlink Vehicle Roof Rack Mount for Starlink Mini KIT. Category: Starlink. Subcategory: Networking. Price: Up Coming.
",172,606817,606989
4369,sentence,"Subcategory: Networking. Price: Up Coming.

Product: Starlink Standard 15 Meter RJ45 Ethernet Cable for Standard KIT. Category: Starlink. Subcategory: Networking. Price: Up Coming.
",181,606946,607127
4370,sentence,"Subcategory: Networking. Price: Up Coming.

Product: Starlink Gen 3 Router Mount. Category: Starlink. Subcategory: Networking. Price: Up Coming.

Product: Starlink Mini Wall Mount for Mini KIT. ",194,607084,607278
4371,sentence,"
Product: Starlink Mini Wall Mount for Mini KIT. Category: Starlink. Subcategory: Networking. Price: Up Coming.

Product: Starlink Mini Travel Kit. Category: Starlink. Subcategory: Networking. ",193,607229,607422
4372,sentence,"Category: Starlink. Subcategory: Networking. Price: Up Coming.

Product: Starlink Standard Wall Mount for Standard KIT. Category: Starlink. Subcategory: Networking. Price: Up Coming.
",183,607377,607560
4373,sentence,"Subcategory: Networking. Price: Up Coming.

Product: Starlink Standard Roof Rack Mount for Standard KIT. Category: Starlink. Subcategory: Networking. Price: Up Coming.
",168,607517,607685
4374,sentence,"Subcategory: Networking. Price: Up Coming.

Product: Starlink Standard 45 Meter RJ45 Ethernet Cable for Standard KIT. Category: Starlink. Subcategory: Networking. Price: Up Coming.
",181,607642,607823
4375,sentence,"Subcategory: Networking. Price: Up Coming.

Product: Vivanco VCA20 2 Port Faceplate with Shutter. Category: Networking. Price: 175৳.

Product: CommScope 2225211-1 Single Port Faceplate. ",186,607780,607966
4376,sentence,"Category: Networking. Price: 190৳.

Product: R&M CAT6 2-Port Faceplate. Category: Networking. Price: 200৳.

Product: Rosenberger CP21-112-10 Dual Port Faceplate. Category: Networking. ",184,607966,608150
4377,sentence,"Category: Networking. Price: 170৳200৳.

Product: Vention IBEGH 2M Cat.6 UTP Patch Cord Cable. Category: Networking. Price: 200৳.

Product: Vention IBELH 2M Cat.6 UTP Patch Cord Cable Blue. ",189,608128,608317
4378,sentence,"Category: Networking. Price: 200৳.

Product: Vention IBEOH 2M Cat.6 UTP Patch Cord Cable Orange. Category: Networking. Price: 200৳.

Product: Vention IBEPH 2M Cat.6 UTP Patch Cord Cable Pink. ",192,608317,608509
4379,sentence,"Category: Networking. Price: 200৳.

Product: Vention IBERH 2M Cat.6 UTP Patch Cord Cable Red. Category: Networking. Price: 200৳.

Product: Vention IBEYH 2M Cat.6 UTP Patch Cord Cable Yellow. ",191,608509,608700
4380,sentence,"Category: Networking. Price: 200৳.

Product: CommScope FPS-BS-2P-W 2-Ports Faceplate Kit. Category: Networking. Price: 210৳.

Product: Dintek 1303-12011CH 1-Port Wall Plate with Shutter. ",187,608700,608887
4381,sentence,"Category: Networking. Price: 220৳.

Product: Dintek 1303-12010CH 2-Port Wall Plate with Shutter. Category: Networking. Price: 220৳.

Product: CommScope 2225212-1 Dual Port Faceplate. ",183,608887,609070
4382,sentence,"Category: Networking. Price: 220৳.

Product: D-Link NFP-0WHI11 Single Faceplate. Category: Networking. Price: 240৳.

Product: Safenet 34-3551BL 0.5 Meter Cat6 LSZH UTP Patch Cord Blue. ",185,609070,609255
4383,sentence,"Category: Networking. Price: 250৳.

Product: Safenet 34-3551YL 0.5 Meter Cat6 LSZH UTP Patch Cord Yellow. Category: Networking. Price: 250৳.

Product: TP-Link TL-WR820N 300Mbps WiFi Router. ",190,609255,609445
4384,sentence,"
Product: TP-Link TL-WR820N 300Mbps WiFi Router. Category: TP-Link. Subcategory: Router. Price: 1,150৳1,190৳.

Product: TP-Link TL-WR840N 300Mbps Wireless Router. Category: TP-Link. ",182,609396,609578
4385,sentence,"Category: TP-Link. Subcategory: Router. Price: 1,350৳1,390৳.

Product: TP-Link TL-WR850N WiFi Router. Category: TP-Link. Subcategory: Router. Price: 1,390৳.
",157,609559,609716
4386,sentence,"Subcategory: Router. Price: 1,390৳.

Product: TP-Link TL-WR841N 300Mbps Wireless Router. Category: TP-Link. Subcategory: Router. Price: 1,510৳1,590৳.
",150,609680,609830
4387,sentence,"Subcategory: Router. Price: 1,510৳1,590৳.

Product: Tp-link TL-WR845N 300Mbps Wireless Router. Category: TP-Link. Subcategory: Router. Price: 1,650৳1,679৳.
",156,609788,609944
4388,sentence,"Subcategory: Router. Price: 1,650৳1,679৳.

Product: TP-Link TD-W8961N 300Mbps ADSL2+ Modem Router. Category: TP-Link. Subcategory: Router. Price: 1,796৳1,890৳.
",160,609902,610062
4389,sentence,"Subcategory: Router. Price: 1,796৳1,890৳.

Product: TP-Link Archer C24 AC750 Dual-Band WiFi Router. Category: TP-Link. Subcategory: Router. Price: 1,804৳1,899৳.
",161,610020,610181
4390,sentence,"Subcategory: Router. Price: 1,804৳1,899৳.

Product: TP-Link Archer C54 AC1200 Dual Band Wi-Fi Router. Category: TP-Link. Subcategory: Router. Price: 2,081৳2,179৳.
",163,610139,610302
4391,sentence,"Subcategory: Router. Price: 2,081৳2,179৳.

Product: TP-Link Archer C50 AC1200 Dual Band Wi-Fi Router. Category: TP-Link. Subcategory: Router. Price: 2,165৳2,279৳.
",163,610260,610423
4392,sentence,"Subcategory: Router. Price: 2,165৳2,279৳.

Product: TP-Link Deco E4 AC1200 Dual-band Mesh Router (1 Pack). Category: TP-Link. Subcategory: Router. Price: 2,649৳.
",162,610381,610543
4393,sentence,"Subcategory: Router. Price: 2,649৳.

Product: TP-Link Archer C64 AC1200 Dual-Band Gigabit WiFi Router. Category: TP-Link. Subcategory: Router. Price: 3,019৳.
",158,610507,610665
4394,sentence,"Subcategory: Router. Price: 3,019৳.

Product: TP-Link Archer C6 AC1200 Gigabit Router. Category: TP-Link. Subcategory: Router. Price: 3,148৳3,349৳.
",148,610629,610777
4395,sentence,"Subcategory: Router. Price: 3,148৳3,349৳.

Product: TP-Link XC220-G3 AC1200 Wireless XPON Router. Category: TP-Link. Subcategory: Router. Price: 3,325৳3,500৳.
",159,610735,610894
4396,sentence,"Subcategory: Router. Price: 3,325৳3,500৳.

Product: TP-Link Deco M4 AC1200 Dual-Band Mesh Router (1 Pack). Category: TP-Link. Subcategory: Router. Price: 3,308৳3,519৳.
",168,610852,611020
4397,sentence,"Subcategory: Router. Price: 3,308৳3,519৳.

Product: TP-Link Archer AX15 AX1500 Dual Band Gigabit WiFi Router. Category: TP-Link. Subcategory: Router. Price: 3,751৳3,990৳.
",171,610978,611149
4398,sentence,"Subcategory: Router. Price: 3,751৳3,990৳.

Product: TP-Link Archer C80 AC1900 Dual-Band Gigabit WiFi Router. Category: TP-Link. Subcategory: Router. Price: 3,799৳3,999৳.
",170,611107,611277
4399,sentence,"Subcategory: Router. Price: 3,799৳3,999৳.

Product: TP-Link TL-MR100 300Mbps 4G LTE Router. Category: TP-Link. Subcategory: Router. Price: 3,830৳3,999৳.
",153,611235,611388
4400,sentence,"Subcategory: Router. Price: 3,830৳3,999৳.

Product: TP-Link Archer C86 AC1900 Dual-Band Wi-Fi Router. Category: TP-Link. Subcategory: Router. Price: 3,894৳4,099৳.
",163,611346,611509
4401,sentence,"Subcategory: Router. Price: 3,894৳4,099৳.

Product: TP-Link TL-MR105 300Mbps 4G LTE Router. Category: TP-Link. Subcategory: Router. Price: 3,967৳4,099৳.
",153,611467,611620
4402,sentence,"Subcategory: Router. Price: 3,967৳4,099৳.

Product: TP-Link Deco S7 AC1900 Dual Band Mesh Router (1-Pack). Category: TP-Link. Subcategory: Router. Price: 4,227৳4,449৳.
",168,611578,611746
4403,sentence,"Subcategory: Router. Price: 4,227৳4,449৳.

Product: Mercusys MW306R 300Mbps WiFi Router. Category: Router. Subcategory: Networking. Price: 1,000৳1,109৳.
",153,611704,611857
4404,sentence,"Subcategory: Networking. Price: 1,000৳1,109৳.

Product: Mercusys MW325R 300Mbps Wifi Router. Category: Router. Subcategory: Networking. Price: 1,220৳1,309৳.
",157,611811,611968
4405,sentence,"Subcategory: Networking. Price: 1,220৳1,309৳.

Product: D-Link R04 N300 300mbps Smart Router. Category: Router. Subcategory: Networking. Price: 1,240৳1,350৳.
",158,611922,612080
4406,sentence,"Subcategory: Networking. Price: 1,240৳1,350৳.

Product: Tenda F3 300mbps Wireless Router. Category: Router. Subcategory: Networking. Price: 1,375৳.
",148,612034,612182
4407,sentence,"Subcategory: Networking. Price: 1,375৳.

Product: Zyxel NBG-418N V2 300 Mbps Wireless Router. Category: Router. Subcategory: Networking. Price: 980৳1,400৳.
",156,612142,612298
4408,sentence,"Subcategory: Networking. Price: 980৳1,400৳.

Product: Zyxel P-661HNU-F1 300Mbps ADSL2+ Wireless Router. Category: Router. Subcategory: Networking. Price: 1,120৳1,400৳.
",168,612254,612422
4409,sentence,"Subcategory: Networking. Price: 1,120৳1,400৳.

Product: Tenda F6 300Mbps WiFi Router. Category: Router. Subcategory: Networking. Price: 1,499৳1,550৳.

Product: Mercusys MW330HP 300Mbps WiFi Router. ",198,612376,612574
4410,sentence,"
Product: Mercusys MW330HP 300Mbps WiFi Router. Category: Router. Subcategory: Networking. Price: 1,529৳1,609৳.

Product: Mercusys AC10 AC1200 Dual Band WiFi Router. Category: Router. ",184,612526,612710
4411,sentence,"Category: Router. Subcategory: Networking. Price: 1,550৳1,609৳.

Product: Tenda AC5 AC1200 Dual-Band WiFi Router. Category: Router. Subcategory: Networking. Price: 1,891৳2,050৳.
",178,612692,612870
4412,sentence,"Subcategory: Networking. Price: 1,891৳2,050৳.

Product: Mercusys AC12 AC1200 Dual Band WiFi Router. Category: Router. Subcategory: Networking. Price: 1,927৳1,980৳.
",164,612824,612988
4413,sentence,"Subcategory: Networking. Price: 1,927৳1,980৳.

Product: Hikvision DS-3WR12C AC1200 1200Mbps Dual Band WiFi Router. Category: Router. Subcategory: Networking. Price: 1,957৳2,060৳.
",179,612942,613121
4414,sentence,"Subcategory: Networking. Price: 1,957৳2,060৳.

Product: BDCOM WAP2100-WR1200G Dual-Band Gigabit WiFi Router. Category: BDCOM. Subcategory: Router. Price: Out Of Stock.
",168,613075,613243
4415,sentence,"Subcategory: Router. Price: Out Of Stock.

Product: Ruijie RG-EW300 Pro 300Mbps Smart WiFi Router. Category: Ruijie. Subcategory: Router. Price: 2,200৳2,250৳.
",159,613201,613360
4416,sentence,"Subcategory: Router. Price: 2,200৳2,250৳.

Product: Ruijie RG-EW1800GX PRO 1800M Dual-Band Gigabit WiFi Router. Category: Ruijie. Subcategory: Router. Price: 7,050৳7,500৳.
",172,613318,613490
4417,sentence,"Subcategory: Router. Price: 7,050৳7,500৳.

Product: Ruijie RG-EG105GW(T) Wi-Fi 5 1267Mbps Wireless Business Router. Category: Ruijie. Subcategory: Router. Price: 9,900৳.
",170,613448,613618
4418,sentence,"Subcategory: Router. Price: 9,900৳.

Product: Ruijie RG-EG105G-P V2 5-Port Gigabit POE Cloud Managed Router. Category: Ruijie. Subcategory: Router. Price: 10,900৳.
",164,613582,613746
4419,sentence,"Subcategory: Router. Price: 10,900৳.

Product: Ruijie RG-EW3200GX PRO 3200Mbps Gigabit WiFi Router. Category: Ruijie. Subcategory: Router. Price: 12,125৳12,500৳.
",162,613709,613871
4420,sentence,"Subcategory: Router. Price: 12,125৳12,500৳.

Product: Ruijie RG-EW1200G PRO 1300M Dual-Band Gigabit WiFi Router. Category: Ruijie. Subcategory: Router. Price: Up Coming.
",170,613827,613997
4421,sentence,"Subcategory: Router. Price: Up Coming.

Product: Ruijie RG-EW1200 1200M Dual Band WiFi Router. Category: Ruijie. Subcategory: Router. Price: Out Of Stock.
",155,613958,614113
4422,sentence,"Subcategory: Router. Price: Out Of Stock.

Product: Ruijie RG-EW1300G 1300M Dual-Band Gigabit WiFi Router. Category: Ruijie. Subcategory: Router. Price: Out Of Stock.
",167,614071,614238
4423,sentence,"Subcategory: Router. Price: Out Of Stock.

Product: Ruijie RG-EG105G V2 5-Port Gigabit Cloud Managed Router. Category: Ruijie. Subcategory: Router. Price: Out Of Stock.
",169,614196,614365
4424,sentence,"Subcategory: Router. Price: Out Of Stock.

Product: Ruijie RG-EG209GS Reyee 9-Port Gigabit Cloud Managed SFP Router. Category: Ruijie. Subcategory: Router. Price: Out Of Stock.
",177,614323,614500
4425,sentence,"Subcategory: Router. Price: Out Of Stock.

Product: Ruijie RG-EG210G-P 10-Port Gigabit Cloud Managed PoE Router. Category: Ruijie. Subcategory: Router. Price: Out Of Stock.
",173,614458,614631
4426,sentence,"Subcategory: Router. Price: Out Of Stock.

Product: Mikrotik RB941-2nD-TC (HAP lite TC) Small Home Router. Category: Mikrotik. Subcategory: Router. Price: 3,650৳.
",163,614589,614752
4427,sentence,"Subcategory: Router. Price: 3,650৳.

Product: Mikrotik RB941-2nD hAP-Lite Small Home Wifi Router With Access Point. Category: Mikrotik. Subcategory: Router. Price: 3,750৳3,700৳.
",178,614716,614894
4428,sentence,"Subcategory: Router. Price: 3,750৳3,700৳.

Product: Mikrotik Hex lite RB750R2 Plastic Body Router. Category: Mikrotik. Subcategory: Router. Price: 4,845৳5,100৳.
",161,614852,615013
4429,sentence,"Subcategory: Router. Price: 4,845৳5,100৳.

Product: Mikrotik RB951Ui-2nD hAP Access Point Router. Category: Mikrotik. Subcategory: Router. Price: 5,400৳.
",154,614971,615125
4430,sentence,"Subcategory: Router. Price: 5,400৳.

Product: Mikrotik RB750UPr2 hEX PoE lite 5-Port Ethernet Router. Category: Mikrotik. Subcategory: Router. Price: 6,200৳.
",158,615089,615247
4431,sentence,"Subcategory: Router. Price: 6,200৳.

Product: Mikrotik Hex RB750GR3 Plastic Body Gigabit Ethernet Router. Category: Mikrotik. Subcategory: Router. Price: 6,800৳.
",162,615211,615373
4432,sentence,"Subcategory: Router. Price: 6,800৳.

Product: Mikrotik RB952Ui-5ac2nD-TC hAP ac Lite TC Dual Band Router. Category: Mikrotik. Subcategory: Router. Price: 7,100৳8,700৳.
",168,615337,615505
4433,sentence,"Subcategory: Router. Price: 7,100৳8,700৳.

Product: MikroTik RBD52G-5HacD2HnD-TC hAP ac2 Dual-Concurrent Router. Category: Mikrotik. Subcategory: Router. Price: 9,200৳9,300৳.
",175,615463,615638
4434,sentence,"Subcategory: Router. Price: 9,200৳9,300৳.

Product: Mikrotik RB960PGS hEX PoE 5 Port Gigabit Router. Category: Mikrotik. Subcategory: Router. Price: 12,500৳.
",158,615596,615754
4435,sentence,"Subcategory: Router. Price: 12,500৳.

Product: Mikrotik hAP ac³ 5 GbE Port Dual-Band WiFi Router. Category: Mikrotik. Subcategory: Router. Price: Out Of Stock.
",160,615717,615877
4436,sentence,"Subcategory: Router. Price: Out Of Stock.

Product: Mikrotik RB450GX4 Gigabit Ethernet Router (With Case). Category: Mikrotik. Subcategory: Router. Price: 13,800৳.
",164,615835,615999
4437,sentence,"Subcategory: Router. Price: 13,800৳.

Product: Mikrotik L009UiGS-2HaxD-IN 8-Port WiFi 6 Gigabit Router. Category: Mikrotik. Subcategory: Router. Price: 16,400৳.
",161,615962,616123
4438,sentence,"Subcategory: Router. Price: 16,400৳.

Product: Mikrotik RB3011UiAS-RM Gigabit Ethernet Router. Category: Mikrotik. Subcategory: Router. Price: 19,200৳20,000৳.
",159,616086,616245
4439,sentence,"Subcategory: Router. Price: 19,200৳20,000৳.

Product: Mikrotik RB4011iGS+RM 10xGigabit Ethernet Rackmount Router. Category: Mikrotik. Subcategory: Router. Price: 23,218৳24,700৳.
",178,616201,616379
4440,sentence,"Subcategory: Router. Price: 23,218৳24,700৳.

Product: Mikrotik RB1100AHX4 (Dude Edition With Sata Port) Rackmount 13X Gigabit Ethernet Router. Category: Mikrotik. Subcategory: Router. ",184,616335,616519
4441,sentence,"Category: Mikrotik. Subcategory: Router. Price: 44,500৳.

Product: Mikrotik CCR2004-16G-2S+ Cloud Core Router. Category: Mikrotik. Subcategory: Router. Price: 52,999৳54,900৳.
",175,616478,616653
4442,sentence,"Subcategory: Router. Price: 52,999৳54,900৳.

Product: Mikrotik CCR2004-1G-12S+2XS Ethernet Router. Category: Mikrotik. Subcategory: Router. Price: 65,500৳.
",156,616609,616765
4443,sentence,"Subcategory: Router. Price: 65,500৳.

Product: Mikrotik CCR2116-12G-4S+ 16 Core ARM CPU 10G Router. Category: Mikrotik. Subcategory: Router. Price: 104,160৳115,500৳.
",166,616728,616894
4444,sentence,"Subcategory: Router. Price: 104,160৳115,500৳.

Product: Mikrotik CCR1036-8G-2S+EM 1U rackmount 8-Port Gigabit Ethernet Router. Category: Mikrotik. Subcategory: Router. Price: 158,000৳.
",185,616848,617033
4445,sentence,"Subcategory: Router. Price: 158,000৳.

Product: Mikrotik RB951Ui-2HnD Wireless SOHO Access Point Router Board. Category: Mikrotik. Subcategory: Router. Price: Out Of Stock.
",173,616995,617168
4446,sentence,"Subcategory: Router. Price: Out Of Stock.

Product: Cudy WR1200 AC1200 Dual Band WiFi Router. Category: Cudy. Subcategory: Router. Price: 2,166৳2,280৳.
",152,617126,617278
4447,sentence,"Subcategory: Router. Price: 2,166৳2,280৳.

Product: Cudy M1200 AC1200 Dual Band Mesh Router (1 Pack). Category: Cudy. Subcategory: Router. Price: 2,592৳2,600৳.
",160,617236,617396
4448,sentence,"Subcategory: Router. Price: 2,592৳2,600৳.

Product: Cudy WR1300 V3 AC1200 Gigabit Dual Band Wi-Fi Router. Category: Cudy. Subcategory: Router. Price: 3,040৳3,200৳.
",164,617354,617518
4449,sentence,"Subcategory: Router. Price: 3,040৳3,200৳.

Product: Cudy M1300 AC1200 Dual Band Gigabit Mesh Router (1 Pack). Category: Cudy. Subcategory: Router. Price: 3,072৳3,200৳.
",168,617476,617644
4450,sentence,"Subcategory: Router. Price: 3,072৳3,200৳.

Product: Cudy WR1500 AX1500 Dual Band WiFi 6 Mesh Router. Category: Cudy. Subcategory: Router. Price: 3,500৳.
",153,617602,617755
4451,sentence,"Subcategory: Router. Price: 3,500৳.

Product: Cudy WR3000 AX3000 Gigabit Dual Band Smart Wi-Fi 6 Router. Category: Cudy. Subcategory: Router. Price: 4,655৳4,900৳.
",163,617719,617882
4452,sentence,"Subcategory: Router. Price: 4,655৳4,900৳.

Product: Cudy M1800 AX1800 Dual Band Mesh Router (1 Pack). Category: Cudy. Subcategory: Router. Price: 4,650৳5,000৳.
",160,617840,618000
4453,sentence,"Subcategory: Router. Price: 4,650৳5,000৳.

Product: Cudy M1200 AC1200 Dual Band Mesh Router (3 Pack). Category: Cudy. Subcategory: Router. Price: 7,125৳7,500৳.
",160,617958,618118
4454,sentence,"Subcategory: Router. Price: 7,125৳7,500৳.

Product: Cudy WR3600E BE3600 Gigabit Mesh Wi-Fi 7 Router. Category: Cudy. Subcategory: Router. Price: 7,410৳7,800৳.
",159,618076,618235
4455,sentence,"Subcategory: Router. Price: 7,410৳7,800৳.

Product: Cudy WR3600 BE3600 Gigabit Wi-Fi 7 Mesh Router. Category: Cudy. Subcategory: Router. Price: 7,999৳.
",152,618193,618345
4456,sentence,"Subcategory: Router. Price: 7,999৳.

Product: Cudy M1300 AC1200 Dual Band Gigabit Mesh Router (3 Pack). Category: Cudy. Subcategory: Router. Price: 8,674৳9,130৳.
",162,618309,618471
4457,sentence,"Subcategory: Router. Price: 8,674৳9,130৳.

Product: Cudy M1800 AX1800 Dual Band Mesh Router (2 Pack). Category: Cudy. Subcategory: Router. Price: 9,310৳9,500৳.
",160,618429,618589
4458,sentence,"Subcategory: Router. Price: 9,310৳9,500৳.

Product: Cudy M3000 AX3000 2.5G Dual Band Wi-Fi 6 Mesh Router (2 Pack). Category: Cudy. Subcategory: Router. Price: 10,230৳11,000৳.
",175,618547,618722
4459,sentence,"Subcategory: Router. Price: 10,230৳11,000৳.

Product: Cudy WR6500 BE6500 6500Mbps Dual Band Gigabit WiFi 7 Router. Category: Cudy. Subcategory: Router. Price: 13,500৳.
",168,618678,618846
4460,sentence,"Subcategory: Router. Price: 13,500৳.

Product: Cudy M1800 AX1800 Dual Band Mesh Router (3 Pack). Category: Cudy. Subcategory: Router. Price: 13,580৳14,000৳.
",157,618809,618966
4461,sentence,"Subcategory: Router. Price: 13,580৳14,000৳.

Product: Cudy M3000 AX3000 2.5G Dual Band Wi-Fi 6 Mesh Router (3 Pack). Category: Cudy. Subcategory: Router. Price: 14,520৳16,500৳.
",177,618922,619099
4462,sentence,"Subcategory: Router. Price: 14,520৳16,500৳.

Product: Cudy WR300 N300 300mbps WiFi Router. Category: Cudy. Subcategory: Router. Price: Out Of Stock.
",149,619055,619204
4463,sentence,"Subcategory: Router. Price: Out Of Stock.

Product: Cudy MF4 4G LTE Sim Supported Mobile Wi-Fi Router. Category: Cudy. Subcategory: Router. Price: Out Of Stock.
",161,619162,619323
4464,sentence,"Subcategory: Router. Price: Out Of Stock.

Product: Cudy LT400 4G 300 Mbps Sim Supported Wireless Router. Category: Cudy. Subcategory: Router. Price: 4,399৳4,450৳.
",164,619281,619445
4465,sentence,"Subcategory: Router. Price: 4,399৳4,450৳.

Product: Cudy X6 AX1800 Dual Band Smart WiFi Router. Category: Cudy. Subcategory: Router. Price: Out Of Stock.
",154,619403,619557
4466,sentence,"Subcategory: Router. Price: Out Of Stock.

Product: Tenda HG6 N300 Wi-Fi GPON ONT Router. Category: Tenda. Subcategory: Router. Price: 2,325৳2,400৳.
",149,619515,619664
4467,sentence,"Subcategory: Router. Price: 2,325৳2,400৳.

Product: Tenda AC10 AC1200 Dual Band Gigabit WiFi Router. Category: Tenda. Subcategory: Router. Price: 3,072৳3,200৳.
",160,619622,619782
4468,sentence,"Subcategory: Router. Price: 3,072৳3,200৳.

Product: Tenda TX2L Pro AX1500 Dual-Band Gigabit Wi-Fi 6 Router. Category: Tenda. Subcategory: Router. Price: 3,392৳3,570৳.
",167,619740,619907
4469,sentence,"Subcategory: Router. Price: 3,392৳3,570৳.

Product: Tenda TX12 Pro v2.0 AX3000 Dual Band Gigabit Wi-Fi 6 Router. Category: Tenda. Subcategory: Router. Price: 3,977৳4,100৳.
",172,619865,620037
4470,sentence,"Subcategory: Router. Price: 3,977৳4,100৳.

Product: Tenda TX3000 Pro AX3000 Dual Band Gigabit Wi-Fi 6 Router. Category: Tenda. Subcategory: Router. Price: 4,171৳4,300৳.
",169,619995,620164
4471,sentence,"Subcategory: Router. Price: 4,171৳4,300৳.

Product: Tenda TX9 Pro AX3000 Dual-band Gigabit Wi-Fi 6 Router. Category: Tenda. Subcategory: Router. Price: 6,150৳.
",160,620122,620282
4472,sentence,"Subcategory: Router. Price: 6,150৳.

Product: Tenda RX9 Pro AX3000 Dual Band Gigabit Wi-Fi 6 Router. Category: Tenda. Subcategory: Router. Price: 6,150৳.
",154,620246,620400
4473,sentence,"Subcategory: Router. Price: 6,150৳.

Product: Tenda AC15 AC1900 Dual-Band Gigabit WiFi Router. Category: Tenda. Subcategory: Router. Price: 7,550৳7,700৳.
",154,620364,620518
4474,sentence,"Subcategory: Router. Price: 7,550৳7,700৳.

Product: Tenda Nova MW12 AC2100 Tri-band Mesh Router (3 Pack). Category: Tenda. Subcategory: Router. Price: 16,900৳.
",160,620476,620636
4475,sentence,"Subcategory: Router. Price: 16,900৳.

Product: Tenda O3 Wireless 5km Outdoor Point To Point CPE. Category: Tenda. Subcategory: Router. Price: Up Coming.
",153,620599,620752
4476,sentence,"Subcategory: Router. Price: Up Coming.

Product: Tenda TX3 AX1800 Dual Band Gigabit WiFi 6 Router. Category: Tenda. Subcategory: Router. Price: Out Of Stock.
",158,620713,620871
4477,sentence,"Subcategory: Router. Price: Out Of Stock.

Product: Tenda N301 Wireless N300 Easy Setup Router. Category: Tenda. Subcategory: Router. Price: Out Of Stock.

Product: Tenda F9 600Mbps WiFi Router. ",195,620829,621024
4478,sentence,"
Product: Tenda F9 600Mbps WiFi Router. Category: Tenda. Subcategory: Router. Price: Out Of Stock.

Product: Tenda AC6 AC1200 Smart Dual-band WiFi Router. Category: Tenda. Subcategory: Router. ",193,620984,621177
4479,sentence,"Category: Tenda. Subcategory: Router. Price: Out Of Stock.

Product: Tenda AC8 AC1200 Dual-Band Gigabit Wi-Fi Router. Category: Tenda. Subcategory: Router. Price: Out Of Stock.
",177,621139,621316
4480,sentence,"Subcategory: Router. Price: Out Of Stock.

Product: Tenda AC21 AC2100 Dual Band Gigabit WiFi Router. Category: Tenda. Subcategory: Router. Price: Out Of Stock.
",160,621274,621434
4481,sentence,"Subcategory: Router. Price: Out Of Stock.

Product: Tenda AC23 AC2100 Dual Band Gigabit WiFi Router. Category: Tenda. Subcategory: Router. Price: Out Of Stock.
",160,621392,621552
4482,sentence,"Subcategory: Router. Price: Out Of Stock.

Product: D-Link COVR-C1202 AC1200 Dual-Band Mesh Router (2 Pack). Category: D-Link. Subcategory: Router. Price: 3,150৳3,500৳.
",169,621510,621679
4483,sentence,"Subcategory: Router. Price: 3,150৳3,500৳.

Product: D-Link R15 AX1500 Dual-Band WiFi Router. Category: D-Link. Subcategory: Router. Price: 4,450৳.

Product: D-Link DIR-615 Z1 300mbps WiFi Router. ",196,621637,621833
4484,sentence,"
Product: D-Link DIR-615 Z1 300mbps WiFi Router. Category: D-Link. Subcategory: Router. Price: Out Of Stock.

Product: D-Link R03 N300 300mbps Smart Router. Category: D-Link. Subcategory: Router. ",196,621784,621980
4485,sentence,"Category: D-Link. Subcategory: Router. Price: Out Of Stock.

Product: D-Link DIR-650IN N300 300mbps WiFi Router. Category: D-Link. Subcategory: Router. Price: Out Of Stock.
",173,621941,622114
4486,sentence,"Subcategory: Router. Price: Out Of Stock.

Product: D-Link DSL-2750U N300 ADSL2+ Modem Router. Category: D-Link. Subcategory: Router. Price: Out Of Stock.
",155,622072,622227
4487,sentence,"Subcategory: Router. Price: Out Of Stock.

Product: D-Link DIR-816 Wireless AC750 Dual Brand Router. Category: D-Link. Subcategory: Router. Price: Out Of Stock.
",161,622185,622346
4488,sentence,"Subcategory: Router. Price: Out Of Stock.

Product: D-Link DIR-806IN AC750 Dual-Band WiFi Router. Category: D-Link. Subcategory: Router. Price: Out Of Stock.
",158,622304,622462
4489,sentence,"Subcategory: Router. Price: Out Of Stock.

Product: D-Link DIR-819 AC750 Dual Band Router. Category: D-Link. Subcategory: Router. Price: Out Of Stock.

Product: D-Link DWR-921 4G LTE Router. ",191,622420,622611
4490,sentence,"
Product: D-Link DWR-921 4G LTE Router. Category: D-Link. Subcategory: Router. Price: Out Of Stock.

Product: Zyxel NBG6604 AC1200 Dual-Band WiFi Router. Category: Zyxel. Subcategory: Router. ",192,622571,622763
4491,sentence,"Category: Zyxel. Subcategory: Router. Price: 2,520৳3,199৳.

Product: Zyxel NBG6615 AC1200 Dual-Band WiFi Gigabit Router. Category: Zyxel. Subcategory: Router. Price: 2,975৳3,500৳.
",180,622725,622905
4492,sentence,"Subcategory: Router. Price: 2,975৳3,500৳.

Product: Zyxel NBG7510 AX1800 Dual-Band WiFi Gigabit Router. Category: Zyxel. Subcategory: Router. Price: 7,200৳.
",157,622863,623020
4493,sentence,"Subcategory: Router. Price: 7,200৳.

Product: Zyxel Armor G1 AC2600 Multi-Gigabit WiFi Router. Category: Zyxel. Subcategory: Router. Price: 14,999৳.
",149,622984,623133
4494,sentence,"Subcategory: Router. Price: 14,999৳.

Product: Zyxel NBG 6503 AC750 Dual-Band WiFi Router. Category: Zyxel. Subcategory: Router. Price: 19,760৳.
",145,623096,623241
4495,sentence,"Subcategory: Router. Price: 19,760৳.

Product: Zyxel Armor G5 AX6000 Multi-Gigabit WiFi Router. Category: Zyxel. Subcategory: Router. Price: 24,500৳.
",150,623204,623354
4496,sentence,"Subcategory: Router. Price: 24,500৳.

Product: Zyxel P-660HN-T1A 150Mbps ADSL2+ Wireless Gateway. Category: Zyxel. Subcategory: Router. Price: Call for Price.
",159,623317,623476
4497,sentence,"Subcategory: Router. Price: Call for Price.

Product: TOTOLINK X6000R AX3000 Dual Band Gigabit WiFi Router. Category: TOTOLINK. Subcategory: Router. Price: 2,909৳4,475৳.
",170,623432,623602
4498,sentence,"Subcategory: Router. Price: 2,909৳4,475৳.

Product: TOTOLINK T8 AC1200 Smart Home Mesh Router (2 Pack). Category: TOTOLINK. Subcategory: Router. Price: 4,500৳.
",160,623560,623720
4499,sentence,"Subcategory: Router. Price: 4,500৳.

Product: TOTOLINK X5000R AX1800 Dual Band Gigabit WiFi Router. Category: TOTOLINK. Subcategory: Router. Price: 5,000৳.
",156,623684,623840
4500,sentence,"Subcategory: Router. Price: 5,000৳.

Product: TOTOLINK A702R_V4 1200Mbps Dual Band WiFi Router. Category: TOTOLINK. Subcategory: Router. Price: Out Of Stock.
",158,623804,623962
4501,sentence,"Subcategory: Router. Price: Out Of Stock.

Product: ASUS RT-N12+ 300Mbps Wifi Router. Category: ASUS. Subcategory: Router. Price: 2,185৳2,300৳.

Product: ASUS RT-AX52 AX1800 Dual Band WiFi Router. ",197,623920,624117
4502,sentence,"Category: ASUS. Subcategory: Router. Price: 5,840৳6,600৳.

Product: ASUS RT-AX57 AX3000 Dual Band WiFi Router. Category: ASUS. Subcategory: Router. Price: 10,260৳13,500৳.
",171,624117,624288
4503,sentence,"Subcategory: Router. Price: 10,260৳13,500৳.

Product: ASUS RT-AX59U AX4200 Dual Band WiFi Router. Category: ASUS. Subcategory: Router. Price: 13,775৳14,500৳.
",158,624244,624402
4504,sentence,"Subcategory: Router. Price: 13,775৳14,500৳.

Product: ASUS TUF Gaming AX4200 Dual-Band WiFi 6 Gaming Router. Category: ASUS. Subcategory: Router. Price: 15,575৳17,500৳.
",169,624358,624527
4505,sentence,"Subcategory: Router. Price: 15,575৳17,500৳.

Product: ASUS RT-BE58U BE3600 Dual Band WiFi 7 Gaming Router. Category: ASUS. Subcategory: Router. Price: 17,266৳17,800৳.
",167,624483,624650
4506,sentence,"Subcategory: Router. Price: 17,266৳17,800৳.

Product: ASUS RT-AX82U AX5400 Dual-Band WiFi Gaming Router. Category: ASUS. Subcategory: Router. Price: 19,000৳.
",158,624606,624764
4507,sentence,"Subcategory: Router. Price: 19,000৳.

Product: ASUS TUF Gaming AX6000 Dual Band WiFi Gaming Router. Category: ASUS. Subcategory: Router. Price: 21,500৳22,000৳.
",160,624727,624887
4508,sentence,"Subcategory: Router. Price: 21,500৳22,000৳.

Product: ASUS RT-AX89X AX6000 Dual Band WiFi Gaming Router. Category: ASUS. Subcategory: Router. Price: 43,500৳.
",158,624843,625001
4509,sentence,"Subcategory: Router. Price: 43,500৳.

Product: Asus ROG Rapture GT-AX11000 Tri-Band WiFi Gaming Router. Category: ASUS. Subcategory: Router. Price: 48,500৳49,000৳.
",164,624964,625128
4510,sentence,"Subcategory: Router. Price: 48,500৳49,000৳.

Product: ASUS ROG Rapture GT-AX11000 Pro Tri-Band WiFi Gaming Router. Category: ASUS. Subcategory: Router. Price: 60,500৳61,000৳.
",175,625084,625259
4511,sentence,"Subcategory: Router. Price: 60,500৳61,000৳.

Product: ASUS RT-AC1200 V2 Dual-Band WiFi Router. Category: ASUS. Subcategory: Router. Price: Out Of Stock.
",153,625215,625368
4512,sentence,"Subcategory: Router. Price: Out Of Stock.

Product: Asus RT-AC1200G+ Dual Band WiFi Router. Category: ASUS. Subcategory: Router. Price: Out Of Stock.
",150,625326,625476
4513,sentence,"Subcategory: Router. Price: Out Of Stock.

Product: ASUS RT-AX53U AX1800 Dual-Band WiFi Router. Category: ASUS. Subcategory: Router. Price: Out Of Stock.
",154,625434,625588
4514,sentence,"Subcategory: Router. Price: Out Of Stock.

Product: Asus RT-AC66U Dual-band AC1750 Wifi Gigabit Router. Category: ASUS. Subcategory: Router. Price: Out Of Stock.
",162,625546,625708
4515,sentence,"Subcategory: Router. Price: Out Of Stock.

Product: ASUS RT-AX55 AX1800 Dual Band WiFi Router. Category: ASUS. Subcategory: Router. Price: Out Of Stock.
",153,625666,625819
4516,sentence,"Subcategory: Router. Price: Out Of Stock.

Product: ASUS RT-AX58U AX3000 Dual Band WiFi Router. Category: ASUS. Subcategory: Router. Price: Out Of Stock.
",154,625777,625931
4517,sentence,"Subcategory: Router. Price: Out Of Stock.

Product: ASUS RT-AX5400 AX5400 Dual-Band WiFi Router. Category: ASUS. Subcategory: Router. Price: Out Of Stock.
",155,625889,626044
4518,sentence,"Subcategory: Router. Price: Out Of Stock.

Product: ASUS TUF Gaming AX5400 Dual Band WiFi Gaming Router. Category: ASUS. Subcategory: Router. Price: Out Of Stock.
",163,626002,626165
4519,sentence,"Subcategory: Router. Price: Out Of Stock.

Product: ASUS ROG Rapture GT-AC2900 WiFi Gaming Router. Category: ASUS. Subcategory: Router. Price: Out Of Stock.
",157,626123,626280
4520,sentence,"Subcategory: Router. Price: Out Of Stock.

Product: Cisco C1111-4P ISR 1100 4 Ports Dual GE WAN Ethernet Router. Category: Cisco. Subcategory: Router. Price: 84,500৳.
",167,626238,626405
4521,sentence,"Subcategory: Router. Price: 84,500৳.

Product: Cisco C1111-8P Integrated Services Router. Category: Cisco. Subcategory: Router. Price: 95,000৳160,000৳.
",152,626368,626520
4522,sentence,"Subcategory: Router. Price: 95,000৳160,000৳.

Product: Cisco ISR4331/K9 Integrated Service Router With SEC license. Category: Cisco. Subcategory: Router. Price: 230,000৳.
",171,626475,626646
4523,sentence,"Subcategory: Router. Price: 230,000৳.

Product: Cisco ISR4221-SEC Integrated Service Router. Category: Cisco. Subcategory: Router. Price: Call for Price.
",154,626608,626762
4524,sentence,"Subcategory: Router. Price: Call for Price.

Product: Cisco RV042 Dual WAN 4-Port VPN Router. Category: Cisco. Subcategory: Router. Price: 5,000৳6,500৳.
",153,626718,626871
4525,sentence,"Subcategory: Router. Price: 5,000৳6,500৳.

Product: Cisco C891F Integrated Service Router. Category: Cisco. Subcategory: Router. Price: Out Of Stock.
",150,626829,626979
4526,sentence,"Subcategory: Router. Price: Out Of Stock.

Product: Planet WDRT-1202AC Dual Band Gigabit WiFi Router. Category: Planet. Subcategory: Router. Price: 2,070৳2,200৳.
",162,626937,627099
4527,sentence,"Subcategory: Router. Price: 2,070৳2,200৳.

Product: Grandstream GWN7052 1270Mbps Dual Band Gigabit WiFi Router. Category: Grandstream. Subcategory: Router. Price: 7,000৳.
",171,627057,627228
4528,sentence,"Subcategory: Router. Price: 7,000৳.

Product: Grandstream GWN7001 6-Port WAN Gigabit VPN Router. Category: Grandstream. Subcategory: Router. Price: 7,800৳.
",156,627192,627348
4529,sentence,"Subcategory: Router. Price: 7,800৳.

Product: Grandstream GWN7052F 1270Mbps Dual Band Gigabit WiFi Router. Category: Grandstream. Subcategory: Router. Price: 12,500৳.
",167,627312,627479
4530,sentence,"Subcategory: Router. Price: 12,500৳.

Product: Grandstream GWN7003 9-Port WAN Gigabit VPN Router. Category: Grandstream. Subcategory: Router. Price: 13,000৳14,300৳.
",165,627442,627607
4531,sentence,"Subcategory: Router. Price: 13,000৳14,300৳.

Product: Grandstream GWN7002 4-Port WAN Gigabit VPN Router. Category: Grandstream. Subcategory: Router. Price: Up Coming.
",167,627563,627730
4532,sentence,"Subcategory: Router. Price: Up Coming.

Product: Grandstream GWN7062 1770Mbps Dual Band Wi-Fi 6 Router. Category: Grandstream. Subcategory: Router. Price: Up Coming.
",166,627691,627857
4533,sentence,"Subcategory: Router. Price: Up Coming.

Product: Mercusys MR30G AC1200 Dual Band Gigabit Router. Category: Mercusys. Subcategory: Router. Price: 2,366৳2,490৳.
",159,627818,627977
4534,sentence,"Subcategory: Router. Price: 2,366৳2,490৳.

Product: Mercusys AC12G AC1300 1300Mbps Dual Band Gigabit Router. Category: Mercusys. Subcategory: Router. Price: 2,450৳2,500৳.
",171,627935,628106
4535,sentence,"Subcategory: Router. Price: 2,450৳2,500৳.

Product: Mercusys MR60X AX1500 Dual Band Gigabit WiFi 6 Router. Category: Mercusys. Subcategory: Router. Price: 2,949৳.
",163,628064,628227
4536,sentence,"Subcategory: Router. Price: 2,949৳.

Product: Mercusys AC12G AC1200 Dual Band Gigabit Router. Category: Mercusys. Subcategory: Router. Price: 2,450৳2,549৳.
",156,628191,628347
4537,sentence,"Subcategory: Router. Price: 2,450৳2,549৳.

Product: Mercusys Halo H30G AC1300 Dual Band Gigabit Mesh Router (2 Pack). Category: Mercusys. Subcategory: Router. Price: 5,150৳.
",174,628305,628479
4538,sentence,"Subcategory: Router. Price: 5,150৳.

Product: Mercusys Halo H50G AC1900 Dual Band Gigabit Mesh Router (2 Pack). Category: Mercusys. Subcategory: Router. Price: 6,490৳.
",168,628443,628611
4539,sentence,"Subcategory: Router. Price: 6,490৳.

Product: Mercusys MR20 AC750 Dual-Band WiFi Router. Category: Mercusys. Subcategory: Router. Price: Up Coming.
",148,628575,628723
4540,sentence,"Subcategory: Router. Price: Up Coming.

Product: Mercusys Halo H30 AC1200 Dual-Band Mesh Router (2 Pack). Category: Mercusys. Subcategory: Router. Price: Up Coming.
",165,628684,628849
4541,sentence,"Subcategory: Router. Price: Up Coming.

Product: Mercusys Halo H30 AC1200 Dual-Band Mesh Router (3 Pack). Category: Mercusys. Subcategory: Router. Price: Up Coming.
",165,628810,628975
4542,sentence,"Subcategory: Router. Price: Up Coming.

Product: Mercusys Halo H30G AC1300 Dual Band Gigabit Mesh Router (3 Pack). Category: Mercusys. Subcategory: Router. Price: Up Coming.
",174,628936,629110
4543,sentence,"Subcategory: Router. Price: Up Coming.

Product: Mercusys Halo H70X AX1800 Dual Band WiFi Mesh Router (2 Pack). Category: Mercusys. Subcategory: Router. Price: Up Coming.
",171,629071,629242
4544,sentence,"Subcategory: Router. Price: Up Coming.

Product: Mercusys Halo H70X AX1800 Dual Band WiFi Mesh Router (3 Pack). Category: Mercusys. Subcategory: Router. Price: Up Coming.
",171,629203,629374
4545,sentence,"Subcategory: Router. Price: Up Coming.

Product: Mercusys MW155R 150 Mbps Wireless N Wifi Router. Category: Mercusys. Subcategory: Router. Price: Out Of Stock.
",160,629335,629495
4546,sentence,"Subcategory: Router. Price: Out Of Stock.

Product: Mercusys MW301R 300Mbps WiFi Router. Category: Mercusys. Subcategory: Router. Price: Out Of Stock.

Product: Mercusys MW302R 300mbps WiFi Router. ",198,629453,629651
4547,sentence,"
Product: Mercusys MW302R 300mbps WiFi Router. Category: Mercusys. Subcategory: Router. Price: Out Of Stock.

Product: Prolink PRC3801 AC1200 Dual Band Gigabit Router. Category: PROLINK. ",187,629604,629791
4548,sentence,"Category: PROLINK. Subcategory: Router. Price: 3,300৳.

Product: Netgear R6850 Wireless AC2000 Dual-Band Gigabit WiFi Router. Category: NETGEAR. Subcategory: Router. Price: 6,300৳6,500৳.
",187,629772,629959
4549,sentence,"Subcategory: Router. Price: 6,300৳6,500৳.

Product: Netgear Orbi RBR350 AX1800 Dual-Band WiFi 6 Mesh Router. Category: NETGEAR. Subcategory: Router. Price: 15,000৳16,000৳.
",172,629917,630089
4550,sentence,"Subcategory: Router. Price: 15,000৳16,000৳.

Product: Netgear Orbi RBS750 AX4200 Tri-Band Mesh Router. Category: NETGEAR. Subcategory: Router. Price: 27,500৳.
",159,630045,630204
4551,sentence,"Subcategory: Router. Price: 27,500৳.

Product: Netgear Orbi RBK352 AX1800 Dual Band Mesh Router (2 Pack). Category: NETGEAR. Subcategory: Router. Price: 27,000৳29,000৳.
",169,630167,630336
4552,sentence,"Subcategory: Router. Price: 27,000৳29,000৳.

Product: Netgear Nighthawk RAX70 AX6600 Tri-Band WiFi Router. Category: NETGEAR. Subcategory: Router. Price: 31,000৳32,200৳.
",170,630292,630462
4553,sentence,"Subcategory: Router. Price: 31,000৳32,200৳.

Product: Netgear Orbi RBS850 AX6000 Tri-Band Mesh Router. Category: NETGEAR. Subcategory: Router. Price: 40,000৳.
",159,630418,630577
4554,sentence,"Subcategory: Router. Price: 40,000৳.

Product: Netgear ORBI RBK353 Ax1800 Dual Band Mesh Router (3-Pack). Category: NETGEAR. Subcategory: Router. Price: 40,000৳42,000৳.
",169,630540,630709
4555,sentence,"Subcategory: Router. Price: 40,000৳42,000৳.

Product: Netgear Orbi RBK852 AX6000 Tri-Band Mesh Router (2 Pack). Category: NETGEAR. Subcategory: Router. Price: 86,000৳.
",168,630665,630833
4556,sentence,"Subcategory: Router. Price: 86,000৳.

Product: Netgear Orbi RBS350 AX1800 WiFi 6 Dual-band Mesh Add-on Satellite. Category: NETGEAR. Subcategory: Router. Price: Out Of Stock.
",175,630796,630971
4557,sentence,"Subcategory: Router. Price: Out Of Stock.

Product: Netgear RAX10 AX1800 Dual-Band WiFi Router. Category: NETGEAR. Subcategory: Router. Price: Out Of Stock.
",157,630929,631086
4558,sentence,"Subcategory: Router. Price: Out Of Stock.

Product: Netgear Orbi Pro SRS60 AC3000 Tri Band Add-on Satellite. Category: NETGEAR. Subcategory: Router. Price: Out Of Stock.
",170,631044,631214
4559,sentence,"Subcategory: Router. Price: Out Of Stock.

Product: Netgear RAX40 AX3000 Nighthawk Dual-Band WiFi Router. Category: NETGEAR. Subcategory: Router. Price: Out Of Stock.
",167,631172,631339
4560,sentence,"Subcategory: Router. Price: Out Of Stock.

Product: Netgear Nighthawk MK62 AX1800 Mesh Router (2 Pack). Category: NETGEAR. Subcategory: Router. Price: Out Of Stock.
",165,631297,631462
4561,sentence,"Subcategory: Router. Price: Out Of Stock.

Product: Netgear Nighthawk RAX50 AX5400 Dual-Band Wi-Fi Router. Category: NETGEAR. Subcategory: Router. Price: Out Of Stock.
",168,631420,631588
4562,sentence,"Subcategory: Router. Price: Out Of Stock.

Product: Netgear RAX120 AX6000 Nighthawk Dual-Band WiFi Router. Category: NETGEAR. Subcategory: Router. Price: Out Of Stock.
",168,631546,631714
4563,sentence,"Subcategory: Router. Price: Out Of Stock.

Product: Netgear Nighthawk XR1000 AX5400 Pro Gaming WiFi 6 Router. Category: NETGEAR. Subcategory: Router. Price: Out Of Stock.
",171,631672,631843
4564,sentence,"Subcategory: Router. Price: Out Of Stock.

Product: Netgear Nighthawk RAX200 AX11000 Tri-Band WiFi Router. Category: NETGEAR. Subcategory: Router. Price: Out Of Stock.
",168,631801,631969
4565,sentence,"Subcategory: Router. Price: Out Of Stock.

Product: Netgear ORBI RBK853 AX6000 Tri-Band Mesh Router (3-Pack). Category: NETGEAR. Subcategory: Router. Price: 130,000৳.
",167,631927,632094
4566,sentence,"Subcategory: Router. Price: 130,000৳.

Product: Netgear Orbi RBK752 AX4200 Tri-band Mesh Router (2 Pack). Category: NETGEAR. Subcategory: Router. Price: Out Of Stock.
",167,632056,632223
4567,sentence,"Subcategory: Router. Price: Out Of Stock.

Product: Tenda A301 Wireless N300 Universal Range Extender. Category: Tenda. Subcategory: WiFi Range Extender. Price: 1,770৳.
",169,632181,632350
4568,sentence,"Price: 1,770৳.

Product: Tenda A9 Wireless N300 Universal Range Extender. Category: Tenda. Subcategory: WiFi Range Extender. Price: Out Of Stock.

Product: Tenda A18 AC1200 Dual Band WiFi Repeater. ",198,632335,632533
4569,sentence,"Category: Tenda. Subcategory: WiFi Range Extender. Price: Out Of Stock.

Product: Netis W1 300Mbps WiFi Router. Category: Netis. Subcategory: Router. Price: Up Coming.
",168,632533,632701
4570,sentence,"Subcategory: Router. Price: Up Coming.

Product: Netis DL4312 150 Mbps Wireless N ADSL+Modem Router. Category: Netis. Subcategory: Router. Price: Up Coming.
",157,632662,632819
4571,sentence,"Subcategory: Router. Price: Up Coming.

Product: Netis DL4323 300Mbps Wireless N ADSL2+ Modem Router. Category: Netis. Subcategory: Router. Price: Up Coming.
",158,632780,632938
4572,sentence,"Subcategory: Router. Price: Up Coming.

Product: Netis WF2375 AC600 Wireless Dual Band High Power Outdoor AP Router. Category: Netis. Subcategory: Router. Price: Up Coming.
",173,632899,633072
4573,sentence,"Subcategory: Router. Price: Up Coming.

Product: Netis Wf2419E 300Mbps Wireless N Router. Category: Netis. Subcategory: Router. Price: Out Of Stock.
",149,633033,633182
4574,sentence,"Subcategory: Router. Price: Out Of Stock.

Product: Netis WF2409E 300Mbps Wireless N Router. Category: Netis. Subcategory: Router. Price: Out Of Stock.

Product: Netis W4 300Mbps WiFi Router. ",192,633140,633332
4575,sentence,"
Product: Netis W4 300Mbps WiFi Router. Category: Netis. Subcategory: Router. Price: Out Of Stock.

Product: Netis N5 AC1200 Dual Band WiFi Router. Category: Netis. Subcategory: Router. ",186,633292,633478
4576,sentence,"Category: Netis. Subcategory: Router. Price: Out Of Stock.

Product: Netis N3D AC1200 Dual Band WiFi Router. Category: Netis. Subcategory: Router. Price: Out Of Stock.
",168,633440,633608
4577,sentence,"Subcategory: Router. Price: Out Of Stock.

Product: Netis N2 AC1200 Dual Band Gigabit WiFi Router. Category: Netis. Subcategory: Router. Price: Out Of Stock.
",158,633566,633724
4578,sentence,"Subcategory: Router. Price: Out Of Stock.

Product: Netis N3 AC1200 Dual Band Gigabit WiFi Router. Category: Netis. Subcategory: Router. Price: Out Of Stock.
",158,633682,633840
4579,sentence,"Subcategory: Router. Price: Out Of Stock.

Product: Netis MW5360 300Mbps 4G LTE Router. Category: Netis. Subcategory: Router. Price: Out Of Stock.
",147,633798,633945
4580,sentence,"Subcategory: Router. Price: Out Of Stock.

Product: Netis N6 AX1800 Dual Band Gigabit Wi-Fi 6 Router. Category: Netis. Subcategory: Router. Price: Out Of Stock.
",161,633903,634064
4581,sentence,"Subcategory: Router. Price: Out Of Stock.

Product: TP-Link M7200 150MBPS 4G LTE Sim Supported Portable Hotspot Pocket Router. Category: TP-Link. Subcategory: Pocket Router. Price: Out Of Stock.
",195,634022,634217
4582,sentence,"Price: Out Of Stock.

Product: TP-Link M7000 150Mbps 4G LTE Mobile Wi-Fi Router. Category: TP-Link. Subcategory: Pocket Router. Price: Out Of Stock.
",149,634196,634345
4583,sentence,"Price: Out Of Stock.

Product: Mercusys MT110 SIM Supported 4G LTE Mobile Wi-Fi Pocket Router. Category: Pocket Router. Subcategory: Networking. Price: 3,167৳3,599৳.
",166,634324,634490
4584,sentence,"Subcategory: Networking. Price: 3,167৳3,599৳.

Product: Zyxel WAH7601 4G LTE Portable Router. Category: Pocket Router. Subcategory: Networking. Price: Out Of Stock.
",165,634444,634609
4585,sentence,"Subcategory: Networking. Price: Out Of Stock.

Product: TP-Link TL-WA850RE 300Mbps Universal Wi-Fi Range Extender. Category: TP-Link. Subcategory: WiFi Range Extender. Price: 1,662৳1,749৳.
",189,634563,634752
4586,sentence,"Price: 1,662৳1,749৳.

Product: TP-Link TL-WA855RE 300Mbps Wi-Fi Range Extender. Category: TP-Link. Subcategory: WiFi Range Extender. Price: 1,891৳1,990৳.
",154,634731,634885
4587,sentence,"Price: 1,891৳1,990৳.

Product: TP-Link RE200 AC750 Wi-Fi Range Extender. Category: TP-Link. Subcategory: WiFi Range Extender. Price: 1,907৳2,119৳.
",147,634864,635011
4588,sentence,"Price: 1,907৳2,119৳.

Product: TP-Link RE305 AC1200 1200Mbps Dual Band WiFi Range Extender. Category: TP-Link. Subcategory: WiFi Range Extender. Price: 2,340৳2,590৳.
",166,634990,635156
4589,sentence,"Price: 2,340৳2,590৳.

Product: TP-Link RE190 V5 AC750 750Mbps Dual Band WiFi Range Extender. Category: TP-Link. Subcategory: WiFi Range Extender. Price: Up Coming.
",164,635135,635299
4590,sentence,"Price: Up Coming.

Product: TP-Link TL-WA860RE Range Extender with AC Passthrough. Category: TP-Link. Subcategory: WiFi Range Extender. Price: Out Of Stock.
",157,635281,635438
4591,sentence,"Price: Out Of Stock.

Product: Xiaomi RD10M N300 300MBPS Wi-Fi Range Extender. Category: WiFi Range Extender. Subcategory: Networking. Price: 1,187৳1,290৳.
",156,635417,635573
4592,sentence,"Subcategory: Networking. Price: 1,187৳1,290৳.

Product: D-Link DAP-1360 Wireless N Range Extender. Category: WiFi Range Extender. Subcategory: Networking. Price: 1,450৳.
",170,635527,635697
4593,sentence,"Subcategory: Networking. Price: 1,450৳.

Product: Ruijie RG-EST350 V2 5GHz 5KM Wireless Bridge. Category: WiFi Range Extender. Subcategory: Networking. Price: 20,500৳.
",168,635657,635825
4594,sentence,"Subcategory: Networking. Price: 20,500৳.

Product: Netgear ProSAFE WC7500 Fully Featured Centralized Wireless Management Controller. Category: WiFi Range Extender. Subcategory: Networking. ",189,635784,635973
4595,sentence,"Subcategory: Networking. Price: 61,000৳.

Product: Ubiquiti UDM-PRO-EU Dream Machine Professional UniFi Gateway Console. Category: WiFi Range Extender. Subcategory: Networking. Price: 95,150৳.
",193,635948,636141
4596,sentence,"Subcategory: Networking. Price: 95,150৳.

Product: Huawei eKitEngine AC650-128AP Gigabit Access Controller. Category: WiFi Range Extender. Subcategory: Networking. Price: 120,000৳.
",181,636100,636281
4597,sentence,"Subcategory: Networking. Price: 120,000৳.

Product: Huawei eKitEngine AC650-256AP Gigabit Access Controller. Category: WiFi Range Extender. Subcategory: Networking. Price: 155,000৳.
",182,636239,636421
4598,sentence,"Subcategory: Networking. Price: 155,000৳.

Product: Mercusys ME30 AC1200 Wi-Fi Range Extender. Category: WiFi Range Extender. Subcategory: Networking. Price: Up Coming.
",169,636379,636548
4599,sentence,"Subcategory: Networking. Price: Up Coming.

Product: Mercusys MW300RE 300Mbps Wi-Fi Range Extender. Category: WiFi Range Extender. Subcategory: Networking. Price: Out Of Stock.
",177,636505,636682
4600,sentence,"Subcategory: Networking. Price: Out Of Stock.

Product: Dlink DAP-1325 300Mbps WiFi Range Extender. Category: WiFi Range Extender. Subcategory: Networking. Price: Out Of Stock.
",177,636636,636813
4601,sentence,"Subcategory: Networking. Price: Out Of Stock.

Product: Xiaomi Mi RA75 AC1200 1200Mbps WiFi Range Extender. Category: WiFi Range Extender. Subcategory: Networking. Price: Out Of Stock.
",185,636767,636952
4602,sentence,"Subcategory: Networking. Price: Out Of Stock.

Product: Cudy RE1200 AC1200 1200Mbps Dual Band Mesh Range Extender. Category: WiFi Range Extender. Subcategory: Networking. Price: Out Of Stock.
",192,636906,637098
4603,sentence,"Subcategory: Networking. Price: Out Of Stock.

Product: Hikvision DS-3WR15X 1500Mbps Dual Band WiFi 6 Router. Category: Hikvision. Subcategory: Router. Price: 3,420৳3,600৳.
",173,637052,637225
4604,sentence,"Subcategory: Router. Price: 3,420৳3,600৳.

Product: Tenda W6S 300Mbps In-wall Wireless Access Point. Category: Tenda. Subcategory: Access Point. Price: 3,200৳.
",160,637183,637343
4605,sentence,"Subcategory: Access Point. Price: 3,200৳.

Product: Tenda W12 AC1200 Dual Band Gigabit In-Wall Access Point. Category: Tenda. Subcategory: Access Point. Price: 3,150৳3,200৳.
",174,637301,637475
4606,sentence,"Subcategory: Access Point. Price: 3,150৳3,200৳.

Product: Tenda i9 300 Mbps Ceiling Mount Access Point. Category: Tenda. Subcategory: Access Point. Price: 3,572৳3,800৳.
",169,637427,637596
4607,sentence,"Subcategory: Access Point. Price: 3,572৳3,800৳.

Product: Tenda B6 5GHz 11n 300Mbps Outdoor Waterproof Professional Basestation. Category: Tenda. Subcategory: Access Point. Price: 6,700৳6,800৳.
",194,637548,637742
4608,sentence,"Subcategory: Access Point. Price: 6,700৳6,800৳.

Product: Tenda W300A Wireless PoE Access Point. Category: Tenda. Subcategory: Access Point. Price: Out Of Stock.
",162,637694,637856
4609,sentence,"Subcategory: Access Point. Price: Out Of Stock.

Product: Tenda W1500A Wireless N150 Outdoor LR AP/Router. Category: Tenda. Subcategory: Access Point. Price: Out Of Stock.
",172,637808,637980
4610,sentence,"Subcategory: Access Point. Price: Out Of Stock.

Product: Tenda W310A 300Mbps Wireless Wall Mount Access Point. Category: Tenda. Subcategory: Access Point. Price: Out Of Stock.
",177,637932,638109
4611,sentence,"Subcategory: Access Point. Price: Out Of Stock.

Product: Tenda W301A Celling Mount Access Point. Category: Tenda. Subcategory: Access Point. Price: Out Of Stock.
",163,638061,638224
4612,sentence,"Subcategory: Access Point. Price: Out Of Stock.

Product: Tenda AP5 N300 Wireless Desktop Access Point. Category: Tenda. Subcategory: Access Point. Price: Out Of Stock.
",169,638176,638345
4613,sentence,"Subcategory: Access Point. Price: Out Of Stock.

Product: Tenda I6 Wireless N300 Access Point. Category: Tenda. Subcategory: Access Point. Price: Out Of Stock.
",160,638297,638457
4614,sentence,"Subcategory: Access Point. Price: Out Of Stock.

Product: Netgear ANT24501B ProSafe Outdoor Dual Band Omni Antenna Bundle Kit used with WND930 Access Point. Category: NETGEAR. ",176,638409,638585
4615,sentence,"Category: NETGEAR. Subcategory: Access Point. Price: 3,800৳.

Product: Netgear WAX615 AX3000 Dual-Band PoE Multi-Gig Insight Managed WiFi 6 Access Point. Category: NETGEAR. ",173,638566,638739
4616,sentence,"Category: NETGEAR. Subcategory: Access Point. Price: 19,500৳32,000৳.

Product: Netgear WAX620 AX3600 Wireless Dual-Band 2.5 Gigabit Access Point. Category: NETGEAR. Subcategory: Access Point. ",192,638720,638912
4617,sentence,"Category: NETGEAR. Subcategory: Access Point. Price: Call for Price.

Product: NETGEAR WAX625 AX5400 Dual-Band Multi-Gig Wi-Fi 6 Access Point. Category: NETGEAR. Subcategory: Access Point. ",189,638866,639055
4618,sentence,"Category: NETGEAR. Subcategory: Access Point. Price: Call for Price.

Product: NETGEAR WAX630 AX6000 Tri-Band PoE Multi-Gig WiFi 6 Access Point. Category: NETGEAR. Subcategory: Access Point. ",191,639009,639200
4619,sentence,"Category: NETGEAR. Subcategory: Access Point. Price: Call for Price.

Product: Netgear WAX214 AX1800 1800Mbps Dual Band WiFi 6 Wall/Ceiling Mount PoE Powered Access Point. Category: NETGEAR. ",191,639154,639345
4620,sentence,"Category: NETGEAR. Subcategory: Access Point. Price: Out Of Stock.

Product: Netgear WAX610Y AX1800 Mbps Dual Band Wi-Fi 6 Outdoor PoE Access Point. Category: NETGEAR. Subcategory: Access Point. ",195,639326,639521
4621,sentence,"Category: NETGEAR. Subcategory: Access Point. Price: Out Of Stock.

Product: Netgear WAX610 AX1800 Dual Band PoE Multi Gig Insight Cloud Managed WiFi 6 Access Point. Category: NETGEAR. ",185,639475,639660
4622,sentence,"Category: NETGEAR. Subcategory: Access Point. Price: Out Of Stock.

Product: Zyxel NWA1123ACv3 802.11ac Wave 2 Dual-Radio Ceiling Mount POE Access Point. Category: Zyxel. Subcategory: Access Point. ",198,639641,639839
4623,sentence,"Category: Zyxel. Subcategory: Access Point. Price: 13,000৳.

Product: Zyxel NWA50AX 802.11ax (WiFi 6) Dual-Radio PoE Access Point. Category: Zyxel. Subcategory: Access Point. Price: 14,000৳.
",191,639795,639986
4624,sentence,"Subcategory: Access Point. Price: 14,000৳.

Product: Zyxel NWA210AX 802.11ax (WiFi 6) Dual-Radio POE Access Point. Category: Zyxel. Subcategory: Access Point. Price: 26,000৳.
",175,639943,640118
4625,sentence,"Subcategory: Access Point. Price: 26,000৳.

Product: Zyxel WAX610D AX3000 Dual-Band WiFi 6 NebulaFlex Pro Access Point. Category: Zyxel. Subcategory: Access Point. Price: 30,450৳.
",180,640075,640255
4626,sentence,"Subcategory: Access Point. Price: 30,450৳.

Product: Ubiquiti Cloud Key Gen2 Plus UniFi Access Point. Category: Access Point. Subcategory: Networking. Price: 28,700৳.
",167,640212,640379
4627,sentence,"Subcategory: Networking. Price: 28,700৳.

Product: Ubiquiti Cloud Key Gen2 Plus UniFi Access Point With POE Adapter. Category: Access Point. Subcategory: Networking. Price: Out Of Stock.
",187,640338,640525
4628,sentence,"Subcategory: Networking. Price: Out Of Stock.

Product: TP-Link EAP115 300Mbps Wireless N Ceiling Mount Access Point. Category: Access Point. Subcategory: Networking. Price: 3,176৳3,490৳.
",188,640479,640667
4629,sentence,"Subcategory: Networking. Price: 3,176৳3,490৳.

Product: TP-Link TL-WA901ND 450Mbps Wireless N Access Point. Category: Access Point. Subcategory: Networking. Price: 3,829৳3,949৳.
",178,640621,640799
4630,sentence,"Subcategory: Networking. Price: 3,829৳3,949৳.

Product: IP-COM W36AP AC1200 Dual Band Gigabit In-Wall Access Point. Category: Access Point. Subcategory: Networking. Price: 4,000৳.
",180,640753,640933
4631,sentence,"Subcategory: Networking. Price: 4,000৳.

Product: Cudy AP1300 AC1200 1200Mbps Wireless Dual Band Indoor Access Point. Category: Access Point. Subcategory: Networking. Price: 4,600৳5,000৳.
",188,640893,641081
4632,sentence,"Subcategory: Networking. Price: 4,600৳5,000৳.

Product: TP-Link EAP235-Wall Omada AC1200 Wireless MU-MIMO Gigabit Wall Plate Access Point. Category: Access Point. Subcategory: Networking. ",188,641035,641223
4633,sentence,"Subcategory: Networking. Price: 5,390৳.

Product: Mikrotik cAP RBcAP2nD 300mbps Dual Chain Ceiling Access Point. Category: Access Point. Subcategory: Networking. Price: 5,301৳5,700৳.
",183,641198,641381
4634,sentence,"Subcategory: Networking. Price: 5,301৳5,700৳.

Product: Ruijie RG-RAP1200(F) Reyee Wi-Fi 5 1267Mbps Wall-mounted Access Point. Category: Access Point. Subcategory: Networking. Price: 6,700৳.
",191,641335,641526
4635,sentence,"Subcategory: Networking. Price: 6,700৳.

Product: IP-COM iUAP-AC-LITE 802.11ac Dual-Band Access Point. Category: Access Point. Subcategory: Networking. Price: 7,000৳.
",167,641486,641653
4636,sentence,"Subcategory: Networking. Price: 7,000৳.

Product: Grandstream GWN7602 Wi-Fi Access Point. Category: Access Point. Subcategory: Networking. Price: 8,100৳.
",154,641613,641767
4637,sentence,"Subcategory: Networking. Price: 8,100৳.

Product: TP-Link EAP615 AX1800 Wall Plate Dual-Band WiFi 6 Access Point. Category: Access Point. Subcategory: Networking. Price: 8,490৳.
",178,641727,641905
4638,sentence,"Subcategory: Networking. Price: 8,490৳.

Product: Edgecore ECW100 Indoor Dual-Band Access Point. Category: Access Point. Subcategory: Networking. Price: 8,700৳.
",161,641865,642026
4639,sentence,"Subcategory: Networking. Price: 8,700৳.

Product: TP-Link EAP613 AX1800 Ceiling Mount WiFi 6 Access Point. Category: Access Point. Subcategory: Networking. Price: 8,640৳9,290৳.
",177,641986,642163
4640,sentence,"Subcategory: Networking. Price: 8,640৳9,290৳.

Product: Ruijie RG-RAP1200(P) Reyee Wi-Fi 5 1267Mbps Wall-mounted Access Point. Category: Access Point. Subcategory: Networking. Price: 9,500৳.
",191,642117,642308
4641,sentence,"Subcategory: Networking. Price: 9,500৳.

Product: MikroTik RB931-2nD hAP mini 2GHz Wireless Access Point. Category: MikroTik. Subcategory: Access Point. Price: Out Of Stock.
",174,642268,642442
4642,sentence,"Subcategory: Access Point. Price: Out Of Stock.

Product: Mikrotik cAP ac Dual Band Wall Access Point. Category: MikroTik. Subcategory: Access Point. Price: Out Of Stock.
",171,642394,642565
4643,sentence,"Subcategory: Access Point. Price: Out Of Stock.

Product: Mikrotik cAP XL ac Dual Band Ceiling & Wall Mounting Access point. Category: MikroTik. Subcategory: Access Point. Price: Out Of Stock.
",193,642517,642710
4644,sentence,"Subcategory: Access Point. Price: Out Of Stock.

Product: Xiaomi Mi R03 Wi-Fi Amplifier Pro 300Mbps Access Point, Amplifier, Repeater. Category: XIAOMI. Subcategory: WiFi Range Extender. ",187,642662,642849
4645,sentence,"Subcategory: WiFi Range Extender. Price: Out Of Stock.

Product: TP-Link EAP653 AX3000 Ceiling Mount WiFi 6 Access Point. Category: TP-Link. Subcategory: Access Point. Price: 9,590৳.
",183,642815,642998
4646,sentence,"Subcategory: Access Point. Price: 9,590৳.

Product: Tp-Link EAP610-Outdoor AX1800 Indoor Outdoor WiFi 6 Access Point. Category: TP-Link. Subcategory: Access Point. Price: 13,290৳.
",180,642956,643136
4647,sentence,"Subcategory: Access Point. Price: 13,290৳.

Product: TP-Link EAP625-Outdoor HD AX1800 WiFi 6 Access Point. Category: TP-Link. Subcategory: Access Point. Price: 18,590৳.
",169,643093,643262
4648,sentence,"Subcategory: Access Point. Price: 18,590৳.

Product: Tp-Link EAP660 HD AX3600 Dual Band Multi-Gigabit Ceiling Mount Wireless Access Point. Category: TP-Link. Subcategory: Access Point. ",185,643219,643404
4649,sentence,"Category: TP-Link. Subcategory: Access Point. Price: 18,948৳21,290৳.

Product: TP-Link EAP115-Wall 300Mbps Wireless N Wall-Plate Access Point. Category: TP-Link. Subcategory: Access Point. ",189,643358,643547
4650,sentence,"Category: TP-Link. Subcategory: Access Point. Price: Out Of Stock.

Product: TP-Link CPE220 2.4GHz 300Mbps High Power Outdoor Wireless Access Point. Category: TP-Link. Subcategory: Access Point. ",195,643501,643696
4651,sentence,"Category: TP-Link. Subcategory: Access Point. Price: Out Of Stock.

Product: TP-Link CPE510 Outdoor 5GHz 300Mbps High Power Wireless Access Point. Category: TP-Link. Subcategory: Access Point. ",193,643650,643843
4652,sentence,"Category: TP-Link. Subcategory: Access Point. Price: Out Of Stock.

Product: TP-Link EAP225 AC1350 Wireless MU-MIMO Gigabit Ceiling Mount Access Point. Category: TP-Link. Subcategory: Access Point. ",198,643797,643995
4653,sentence,"Category: TP-Link. Subcategory: Access Point. Price: Out Of Stock.

Product: TP-Link EAP225-Outdoor AC1200 Wireless MU-MIMO Gigabit Indoor, Outdoor Access Point. Category: TP-Link. ",181,643949,644130
4654,sentence,"Category: TP-Link. Subcategory: Access Point. Price: Out Of Stock.

Product: TP-Link EAP245 AC1750 Wireless Dual-Band Gigabit Ceiling Mount Access Point. Category: TP-Link. ",173,644111,644284
4655,sentence,"Category: TP-Link. Subcategory: Access Point. Price: Out Of Stock.

Product: TP-Link EAP265 HD AC1750 Wireless MU-MIMO Gigabit Ceiling Mount Access Point. Category: TP-Link. ",174,644265,644439
4656,sentence,"Category: TP-Link. Subcategory: Access Point. Price: Out Of Stock.

Product: TP-Link OC200 Omada Centralized Access Point Management System/Controller. Category: TP-Link. Subcategory: Access Point. ",198,644420,644618
4657,sentence,"Category: TP-Link. Subcategory: Access Point. Price: Out Of Stock.

Product: Tp-Link EAP620 HD AX1800 Ceiling Mount WiFi 6 Access Point. Category: TP-Link. Subcategory: Access Point. ",183,644572,644755
4658,sentence,"Category: TP-Link. Subcategory: Access Point. Price: Out Of Stock.

Product: Ubiquiti UAP-AC-LR AC1300 1300 Mbps Dual-Band Gigabit UniFi Access Point. Category: Ubiquiti. Subcategory: Access Point. ",198,644709,644907
4659,sentence,"Category: Ubiquiti. Subcategory: Access Point. Price: 13,175৳15,500৳.

Product: Ubiquiti Unifi 6 Lite AX1500 Mbps Gigabit Dual Band Access Point (Without POE Adapter). Category: Ubiquiti. ",188,644860,645048
4660,sentence,"Category: Ubiquiti. Subcategory: Access Point. Price: 16,500৳.

Product: Ubiquiti UAP-AC-PRO AC1750 Mbps Gigabit Dual-Band UniFi Access Point With POE Adapter. Category: Ubiquiti. ",180,645028,645208
4661,sentence,"Category: Ubiquiti. Subcategory: Access Point. Price: 22,000৳23,500৳.

Product: Ubiquiti Unifi 6 Pro WiFi 6 Dual Band Access Point (With Out POE Adapter). Category: Ubiquiti. ",175,645188,645363
4662,sentence,"Category: Ubiquiti. Subcategory: Access Point. Price: 22,440৳26,400৳.

Product: Ubiquiti Unifi 6 Pro WiFi 6 Dual Band Access Point (With POE Adapter). Category: Ubiquiti. Subcategory: Access Point. ",198,645343,645541
4663,sentence,"Category: Ubiquiti. Subcategory: Access Point. Price: 27,300৳.

Product: Ubiquiti U6-LR Dual Brand 3000 Mbps Indoor Unifi Wi-Fi Access Point (With Out Adapter). Category: Ubiquiti. ",181,645494,645675
4664,sentence,"Category: Ubiquiti. Subcategory: Access Point. Price: 24,640৳28,000৳.

Product: Ubiquiti Unifi U7 Pro WiFi 7 Tri Band Access Point (WithOut POE Adapter). Category: Ubiquiti. ",174,645655,645829
4665,sentence,"Category: Ubiquiti. Subcategory: Access Point. Price: 27,456৳28,600৳.

Product: Ubiquiti U6-LR Dual Brand 3000 Mbps Indoor Unifi Wi-Fi Access Point (With Adapter). Category: Ubiquiti. ",184,645809,645993
4666,sentence,"Category: Ubiquiti. Subcategory: Access Point. Price: 31,000৳.

Product: Ubiquiti airCube ISP Access Point Unifi Router. Category: Ubiquiti. Subcategory: Access Point. Price: Out Of Stock.
",189,645973,646162
4667,sentence,"Subcategory: Access Point. Price: Out Of Stock.

Product: Ubiquiti NSM5(EU) Outdoor POE Point-to-Point Nano Station Radio Device With POE Adapter. Category: Ubiquiti. Subcategory: Access Point. ",194,646114,646308
4668,sentence,"Category: Ubiquiti. Subcategory: Access Point. Price: Out Of Stock.

Product: Ubiquiti Unifi 6 Lite AX1500 Mbps Gigabit Dual Band Access Point With POE Adapter. Category: Ubiquiti. ",181,646261,646442
4669,sentence,"Category: Ubiquiti. Subcategory: Access Point. Price: Out Of Stock.

Product: Ubiquiti UAP-AC-PRO AC1750 Mbps Gigabit Dual-Band UniFi Access Point Without POE Adapter. Category: Ubiquiti. ",188,646422,646610
4670,sentence,"Category: Ubiquiti. Subcategory: Access Point. Price: Out Of Stock.

Product: Ubiquiti airFiber AF-5XHD Gigabit Outdoor Point-to-Point Radio Device With POE Adapter. Category: Ubiquiti. ",186,646590,646776
4671,sentence,"Category: Ubiquiti. Subcategory: Access Point. Price: Out Of Stock.

Product: Ubiquiti UDM-SE-EU Dream Machine Special Edition UniFi Gateway Console. Category: Ubiquiti. Subcategory: Access Point. ",197,646756,646953
4672,sentence,"Category: Ubiquiti. Subcategory: Access Point. Price: Out Of Stock.

Product: Grandstream GWN7603 Dual-Band Wave-2 WiFi Access Point. Category: Grandstream. Subcategory: Access Point. Price: 9,800৳.
",199,646906,647105
4673,sentence,"Subcategory: Access Point. Price: 9,800৳.

Product: Grandstream GWN7605 MU-MIMO Dual-Band WiFi Access Point. Category: Grandstream. Subcategory: Access Point. Price: 10,500৳.
",175,647063,647238
4674,sentence,"Subcategory: Access Point. Price: 10,500৳.

Product: Grandstream GWN7625 MU-MIMO 2000Mbps Gigabit POE Access Point. Category: Grandstream. Subcategory: Access Point. Price: 12,960৳13,500৳.
",189,647195,647384
4675,sentence,"Price: 12,960৳13,500৳.

Product: Grandstream GWN7624 Dual Band PoE WiFi Access Point. Category: Grandstream. Subcategory: Access Point. Price: 13,500৳.
",152,647361,647513
4676,sentence,"Subcategory: Access Point. Price: 13,500৳.

Product: Grandstream GWN7615 Enterprise Performance Wi-Fi Access Point. Category: Grandstream. Subcategory: Access Point. Price: 13,800৳.
",182,647470,647652
4677,sentence,"Subcategory: Access Point. Price: 13,800৳.

Product: Grandstream GWN7604 AX3000 3Gbps WiFi 6 Indoor Access Point. Category: Grandstream. Subcategory: Access Point. Price: 15,000৳.
",180,647609,647789
4678,sentence,"Subcategory: Access Point. Price: 15,000৳.

Product: Grandstream GWN7630 Wi-Fi Access Point. Category: Grandstream. Subcategory: Access Point. Price: 19,200৳.
",159,647746,647905
4679,sentence,"Subcategory: Access Point. Price: 19,200৳.

Product: Grandstream GWN7664E AX6000 6Gbps Giagbit WiFi 6 Indoor Access Point. Category: Grandstream. Subcategory: Access Point. Price: 30,000৳.
",189,647862,648051
4680,sentence,"Subcategory: Access Point. Price: 30,000৳.

Product: Grandstream GWN7630LR Dual-Band PoE Outdoor Access Point. Category: Grandstream. Subcategory: Access Point. Price: Up Coming.
",179,648008,648187
4681,sentence,"Subcategory: Access Point. Price: Up Coming.

Product: Grandstream GWN7615 Enterprise Performance Wi-Fi Access Point with PoE Adapter. Category: Grandstream. Subcategory: Access Point. ",185,648142,648327
4682,sentence,"Subcategory: Access Point. Price: Out Of Stock.

Product: Grandstream GWN7605LR Dual-Band PoE Outdoor Access Point. Category: Grandstream. Subcategory: Access Point. Price: Out Of Stock.
",187,648300,648487
4683,sentence,"Subcategory: Access Point. Price: Out Of Stock.

Product: Grandstream GWN7660 Dual Band MU-MIMO WiFi 6 Indoor Access Point. Category: Grandstream. Subcategory: Access Point. Price: Out Of Stock.
",195,648439,648634
4684,sentence,"Subcategory: Access Point. Price: Out Of Stock.

Product: Grandstream GWN7664LR Long-Range Outdoor Wi-Fi 6 Access Point. Category: Grandstream. Subcategory: Access Point. Price: Out Of Stock.
",192,648586,648778
4685,sentence,"Subcategory: Access Point. Price: Out Of Stock.

Product: IP-COM Pro-6-LR 802.11AX Dual-Band Long Range Access Point. Category: IP-COM. Subcategory: Access Point. Price: 11,700৳.
",179,648730,648909
4686,sentence,"Subcategory: Access Point. Price: 11,700৳.

Product: IP-COM iUAP-AC-LR 802.11ac Dual-Band Long Range Access Point. Category: IP-COM. Subcategory: Access Point. Price: 12,900৳.
",176,648866,649042
4687,sentence,"Subcategory: Access Point. Price: 12,900৳.

Product: Ruijie RG-RAP2200(E) 1267Mbps Wi-Fi 5 Ceiling Access Point. Category: Ruijie. Subcategory: Access Point. Price: 11,500৳.
",174,648999,649173
4688,sentence,"Subcategory: Access Point. Price: 11,500৳.

Product: Ruijie RG-RAP6202(G) AC1300 Outdoor Omni-directional Access Point. Category: Ruijie. Subcategory: Access Point. Price: 17,500৳.
",181,649130,649311
4689,sentence,"Subcategory: Access Point. Price: 17,500৳.

Product: Ruijie RG-RAP2266 Reyee Wi-Fi 6 AX3000 Indoor Ceiling-Mount Access Point. Category: Ruijie. Subcategory: Access Point. Price: 20,200৳.
",188,649268,649456
4690,sentence,"Subcategory: Access Point. Price: 20,200৳.

Product: Ruijie RG-RAP6260(G) AX1800 Wi-Fi 6 Gigabit Outdoor Access Point. Category: Ruijie. Subcategory: Access Point. Price: 28,910৳29,500৳.
",187,649413,649600
4691,sentence,"Price: 28,910৳29,500৳.

Product: Ruijie RG-RAP2260(H) Reyee Wi-Fi 6 AX6000 Ceiling Access Point. Category: Ruijie. Subcategory: Access Point. Price: Up Coming.
",160,649577,649737
4692,sentence,"Subcategory: Access Point. Price: Up Coming.

Product: Ruijie RG-RAP2200(F) 1267Mbps Wi-Fi 5 Ceiling Access Point. Category: Ruijie. Subcategory: Access Point. Price: Out Of Stock.
",181,649692,649873
4693,sentence,"Subcategory: Access Point. Price: Out Of Stock.

Product: Ruijie RG-RAP1201 Reyee Wi-Fi 5 1267Mbps Wall-mounted Access Point. Category: Ruijie. Subcategory: Access Point. Price: Out Of Stock.
",192,649825,650017
4694,sentence,"Subcategory: Access Point. Price: Out Of Stock.

Product: Ruijie RG-RAP1261 Reyee Wi-Fi 6 AX3000 Ultra-Thin Wall Plate Access Point. Category: Ruijie. Subcategory: Access Point. Price: Out Of Stock.
",199,649969,650168
4695,sentence,"Subcategory: Access Point. Price: Out Of Stock.

Product: Ruijie RG-RAP1260 Reyee Wi-Fi 6 AX3000 Dual-Band Wall Plate Access Point. Category: Ruijie. Subcategory: Access Point. Price: Out Of Stock.
",198,650120,650318
4696,sentence,"Subcategory: Access Point. Price: Out Of Stock.

Product: Ruijie RG-AP720-L 1167Mbps Wi-Fi 5 Dual-Radio Indoor Access Point. Category: Ruijie. Subcategory: Access Point. Price: Out Of Stock.
",191,650270,650461
4697,sentence,"Subcategory: Access Point. Price: Out Of Stock.

Product: Ruijie RG-RAP52-OD Wi-Fi 5 AC1300 Dual-Band Outdoor Access Point. Category: Ruijie. Subcategory: Access Point. Price: Out Of Stock.
",190,650413,650603
4698,sentence,"Subcategory: Access Point. Price: Out Of Stock.

Product: Ruijie RG-EST310 V2 5GHz 1KM Wireless Bridge. Category: Ruijie. Subcategory: Access Point. Price: Out Of Stock.
",170,650555,650725
4699,sentence,"Subcategory: Access Point. Price: Out Of Stock.

Product: Ruijie RG-RAP2260(G) AX1800 1800Mbps Wi-Fi 6 Ceiling Access Point. Category: Ruijie. Subcategory: Access Point. Price: Out Of Stock.
",191,650677,650868
4700,sentence,"Subcategory: Access Point. Price: Out Of Stock.

Product: Ruijie RG-RAP2260 Reyee Wi-Fi 6 AX3000 Ceiling Access Point. Category: Ruijie. Subcategory: Access Point. Price: Out Of Stock.
",185,650820,651005
4701,sentence,"Subcategory: Access Point. Price: Out Of Stock.

Product: Ruijie RG-AP820-L(V3) AX3000 3000Mbps Wi-Fi 6 Indoor Access Point. Category: Ruijie. Subcategory: Access Point. Price: Out Of Stock.
",191,650957,651148
4702,sentence,"Subcategory: Access Point. Price: Out Of Stock.

Product: Ruijie RG-RAP6262(G) AX1800 Wi-Fi 6 Outdoor Access Point. Category: Ruijie. Subcategory: Access Point. Price: Out Of Stock.
",182,651100,651282
4703,sentence,"Subcategory: Access Point. Price: Out Of Stock.

Product: Ruijie RG-RAP2260(E) 3202Mbps Wi-Fi 6 Ceiling Access Point. Category: Ruijie. Subcategory: Access Point. Price: Out Of Stock.
",184,651234,651418
4704,sentence,"Subcategory: Access Point. Price: Out Of Stock.

Product: Cambium CnPilot e410 Wi-Fi Access Point (With Out Gigabit POE Adapter). Category: Cambium. Subcategory: Access Point. Price: 15,106৳18,200৳.
",199,651370,651569
4705,sentence,"Price: 15,106৳18,200৳.

Product: Cambium CnPilot e410 Wi-Fi Access Point with Gigabit POE Adapter. Category: Cambium. Subcategory: Access Point. Price: 16,340৳21,500৳.
",168,651546,651714
4706,sentence,"Price: 16,340৳21,500৳.

Product: Cambium XV2-21X Indoor Wi-Fi 6 Access Point (With Out Adapter). Category: Cambium. Subcategory: Access Point. Price: 24,570৳31,500৳.
",166,651691,651857
4707,sentence,"Price: 24,570৳31,500৳.

Product: Cambium XV2-2X Wi-Fi 6 Access Point With Out Adapter. Category: Cambium. Subcategory: Access Point. Price: Out Of Stock.
",154,651834,651988
4708,sentence,"Subcategory: Access Point. Price: Out Of Stock.

Product: Cudy AP1300 Outdoor AC1200 Dual Band Gigabit Wi-Fi Access Point. Category: Cudy. Subcategory: Access Point. Price: Out Of Stock.
",187,651940,652127
4709,sentence,"Subcategory: Access Point. Price: Out Of Stock.

Product: Cudy AP3000 AX3000 3000Mbps Dual Band WiFi 6 Indoor Access Point. Category: Cudy. Subcategory: Access Point. Price: Out Of Stock.
",188,652079,652267
4710,sentence,"Subcategory: Access Point. Price: Out Of Stock.

Product: Cudy AP3000 Outdoor AX3000 3000Mbps Dual Band WiFi 6 Access Point. Category: Cudy. Subcategory: Access Point. Price: Out Of Stock.
",189,652219,652408
4711,sentence,"Subcategory: Access Point. Price: Out Of Stock.

Product: Edgecore ECW5210-L Indoor Dual-Band Access Point. Category: Edgecore. Subcategory: Access Point. Price: 18,300৳.
",171,652360,652531
4712,sentence,"Subcategory: Access Point. Price: 18,300৳.

Product: Edgecore ECH502 Wireless Hotspot Gateway Access Point. Category: Edgecore. Subcategory: Access Point. Price: 22,000৳.
",171,652488,652659
4713,sentence,"Subcategory: Access Point. Price: 22,000৳.

Product: Edgecore ECW5211-L Indoor Dual-Band Access Point. Category: Edgecore. Subcategory: Access Point. Price: Out Of Stock.
",171,652616,652787
4714,sentence,"Subcategory: Access Point. Price: Out Of Stock.

Product: TRENDnet TEW-821DAP AC1200 Dual Band PoE Access Point. Category: TRENDnet. Subcategory: Access Point. Price: 13,400৳.
",176,652739,652915
4715,sentence,"Subcategory: Access Point. Price: 13,400৳.

Product: TRENDnet TEW-921DAP AX1800 Dual Band WiFi 6 PoE+ Access Point. Category: TRENDnet. Subcategory: Access Point. Price: 16,000৳.
",179,652872,653051
4716,sentence,"Subcategory: Access Point. Price: 16,000৳.

Product: TRENDnet TEW-923DAP AX3000 Dual Band WiFi 6 PoE+ Access Point. Category: TRENDnet. Subcategory: Access Point. Price: 16,500৳.
",179,653008,653187
4717,sentence,"Subcategory: Access Point. Price: 16,500৳.

Product: TRENDnet TEW-925DAP AX5400 Dual Band WiFi 6 PoE+ Access Point. Category: TRENDnet. Subcategory: Access Point. Price: 22,500৳.
",179,653144,653323
4718,sentence,"Subcategory: Access Point. Price: 22,500৳.

Product: TRENDnet TEW-WLC100 Wireless LAN Controller. Category: TRENDnet. Subcategory: Access Point. Price: Out Of Stock.
",166,653280,653446
4719,sentence,"Subcategory: Access Point. Price: Out Of Stock.

Product: Zyxel GS1900-8 8-Port GbE ROHS Smart Managed Switch. Category: Zyxel. Subcategory: Network Switch. Price: 4,500৳.
",172,653398,653570
4720,sentence,"Subcategory: Network Switch. Price: 4,500৳.

Product: Zyxel GS1008HP 8-Port GbE Unmanaged PoE Switch. Category: Zyxel. Subcategory: Network Switch. Price: 6,500৳.
",163,653526,653689
4721,sentence,"Subcategory: Network Switch. Price: 6,500৳.

Product: Zyxel GS1100 8HP 8-port Unmanaged PoE Switch. Category: Zyxel. Subcategory: Network Switch. Price: 6,800৳.
",161,653645,653806
4722,sentence,"Subcategory: Network Switch. Price: 6,800৳.

Product: Zyxel GS1900-10HP 8-port GbE Smart Managed PoE Switch with GbE Uplink. Category: Zyxel. Subcategory: Network Switch. Price: 13,900৳.
",187,653762,653949
4723,sentence,"Subcategory: Network Switch. Price: 13,900৳.

Product: Zyxel MES 3500-24F 24-port FE Fiber L2 Switch with Four GbE Combo Port. Category: Zyxel. Subcategory: Network Switch. Price: 25,000৳.
",189,653904,654093
4724,sentence,"Subcategory: Network Switch. Price: 25,000৳.

Product: Zyxel GS1200-5HPV2 5-Port Web Managed PoE Gigabit Switch. Category: Zyxel. Subcategory: Network Switch. Price: Out Of Stock.
",180,654048,654228
4725,sentence,"Price: Out Of Stock.

Product: Zyxel GS-105B v3 5-Port Desktop Gigabit Ethernet Switch. Category: Zyxel. Subcategory: Network Switch. Price: Out Of Stock.
",155,654207,654362
4726,sentence,"Price: Out Of Stock.

Product: Zyxel GS-105SV2 5-Port Desktop Gigabit Ethernet Media Switch. Category: Zyxel. Subcategory: Network Switch. Price: Out Of Stock.
",160,654341,654501
4727,sentence,"Price: Out Of Stock.

Product: Zyxel GS-108B v3 8-Port Desktop Gigabit Ethernet Switch. Category: Zyxel. Subcategory: Network Switch. Price: Out Of Stock.
",155,654480,654635
4728,sentence,"Price: Out Of Stock.

Product: Zyxel GS1005HP 5 Port GbE Unmanaged Gigabit PoE Switch (60W). Category: Zyxel. Subcategory: Network Switch. Price: Out Of Stock.
",160,654614,654774
4729,sentence,"Price: Out Of Stock.

Product: Zyxel GS1100-16-EU0103F 16 Port Gigabit Unmanaged Switch. Category: Zyxel. Subcategory: Network Switch. Price: Out Of Stock.
",156,654753,654909
4730,sentence,"Price: Out Of Stock.

Product: Zyxel ES1100-24G 24-port FE Unmanaged Switch. Category: Zyxel. Subcategory: Network Switch. Price: Out Of Stock.
",144,654888,655032
4731,sentence,"Price: Out Of Stock.

Product: Zyxel GS1100-24E v3 24-port Gigabit Unmanaged Switch. Category: Zyxel. Subcategory: Network Switch. Price: Out Of Stock.
",152,655011,655163
4732,sentence,"Price: Out Of Stock.

Product: Zyxel GS1900-24E v2 24-port GbE Smart Managed Switch. Category: Zyxel. Subcategory: Network Switch. Price: Out Of Stock.
",152,655142,655294
4733,sentence,"Price: Out Of Stock.

Product: Zyxel GS1900-24EP 24-port GbE Smart Managed PoE Switch. Category: Zyxel. Subcategory: Network Switch. Price: Out Of Stock.

Product: Tenda S105 5-port Ethernet Switch. ",199,655273,655472
4734,sentence,"
Product: Tenda S105 5-port Ethernet Switch. Category: Network Switch. Subcategory: Networking. Price: 580৳.

Product: TP-Link LS1005 5-Port 10/100Mbps Desktop Network Switch. ",176,655427,655603
4735,sentence,"Category: Network Switch. Subcategory: Networking. Price: 619৳.

Product: Dlink DES-1005C 5 Port 10/100M Unmanaged Desktop Switch. Category: Network Switch. Subcategory: Networking. Price: 625৳.
",195,655603,655798
4736,sentence,"Subcategory: Networking. Price: 625৳.

Product: TP-Link TL-SF1005D 5-Port 10/100 Mbps Desktop Switch. Category: Network Switch. Subcategory: Networking. Price: 699৳.
",166,655760,655926
4737,sentence,"Subcategory: Networking. Price: 699৳.

Product: TP-Link LS1008 8-Port 10/100Mbps Desktop Switch. Category: Network Switch. Subcategory: Networking. Price: 739৳.
",161,655888,656049
4738,sentence,"Subcategory: Networking. Price: 739৳.

Product: Tenda S108 10/100 8 Port Desktop Switch White. Category: Network Switch. Subcategory: Networking. Price: 645৳750৳.
",163,656011,656174
4739,sentence,"Subcategory: Networking. Price: 645৳750৳.

Product: TP-Link TL-SF1008D 8Port 10/100Mbps Desktop Switch. Category: Network Switch. Subcategory: Networking. Price: 859৳.
",168,656132,656300
4740,sentence,"Subcategory: Networking. Price: 859৳.

Product: Ruijie RG-ES05 5-Port 10/100 Mbps Unmanaged Desktop Switch. Category: Network Switch. Subcategory: Networking. Price: 899৳.
",172,656262,656434
4741,sentence,"Subcategory: Networking. Price: 899৳.

Product: C-Data CS2050G 5 Port Unmanaged Gigabit Switch. Category: Network Switch. Subcategory: Networking. Price: 1,190৳.
",162,656396,656558
4742,sentence,"Subcategory: Networking. Price: 1,190৳.

Product: Tenda SG105 5 Port Gigabit Desktop Switch. Category: Network Switch. Subcategory: Networking. Price: 1,280৳.
",159,656518,656677
4743,sentence,"Subcategory: Networking. Price: 1,280৳.

Product: TP-Link TL-SG1005D 5-Port Gigabit Desktop Switch. Category: Network Switch. Subcategory: Networking. Price: 1,195৳1,299৳.
",172,656637,656809
4744,sentence,"Subcategory: Networking. Price: 1,195৳1,299৳.

Product: TP-Link TL-SG1008D 08 Port Gigabit Desktop Switch. Category: Network Switch. Subcategory: Networking. Price: 1,738৳1,849৳.
",179,656763,656942
4745,sentence,"Subcategory: Networking. Price: 1,738৳1,849৳.

Product: C-Data CS2080G 8 Port Unmanaged Gigabit Switch. Category: Network Switch. Subcategory: Networking. Price: 1,850৳1,900৳.
",176,656896,657072
4746,sentence,"Subcategory: Networking. Price: 1,850৳1,900৳.

Product: Tenda S106PC 6-Port 100M Unmanaged PoE Switch. Category: Network Switch. Subcategory: Networking. Price: 1,950৳.
",169,657026,657195
4747,sentence,"Subcategory: Networking. Price: 1,950৳.

Product: Cudy FS1006P 6-Port 10/100M PoE+ Switch. Category: Network Switch. Subcategory: Networking. Price: 2,043৳2,150৳.
",163,657155,657318
4748,sentence,"Subcategory: Networking. Price: 2,043৳2,150৳.

Product: Tenda S16 16 Ports Ethernet Network Switch. Category: Network Switch. Subcategory: Networking. Price: 2,070৳2,200৳.
",172,657272,657444
4749,sentence,"Subcategory: Networking. Price: 2,070৳2,200৳.

Product: Cudy GS108D 8 Port Gigabit Desktop Switch. Category: Network Switch. Subcategory: Networking. Price: 2,002৳2,200৳.
",171,657398,657569
4750,sentence,"Subcategory: Networking. Price: 2,002৳2,200৳.

Product: Mercusys MS106LP 6-Port 10/100Mbps PoE Desktop Switch. Category: Network Switch. Subcategory: Networking. Price: 2,150৳2,219৳.
",183,657523,657706
4751,sentence,"Subcategory: Networking. Price: 2,150৳2,219৳.

Product: Hikvision DS-3E0106MP-E/M 4 Port Unmanaged PoE Switch. Category: Network Switch. Subcategory: Networking. Price: 2,150৳2,300৳.
",183,657660,657843
4752,sentence,"Subcategory: Networking. Price: 2,150৳2,300৳.

Product: Ruijie RG-ES08G 8-Port Gigabit Unmanaged Switch. Category: Network Switch. Subcategory: Networking. Price: 2,350৳.
",171,657797,657968
4753,sentence,"Subcategory: Networking. Price: 2,350৳.

Product: Cisco Business 150AX AX1480 Dual Band Wi-Fi 6 Access Point. Category: Cisco. Subcategory: Access Point. Price: 19,500৳.
",170,657928,658098
4754,sentence,"Subcategory: Access Point. Price: 19,500৳.

Product: Huawei eKitEngine AP362 Dual-Band Wi-Fi 6 Wireless Access Point. Category: Huawei. Subcategory: Access Point. Price: 23,000৳.
",179,658055,658234
4755,sentence,"Subcategory: Access Point. Price: 23,000৳.

Product: Huawei eKitEngine AP362E Dual-Band Wi-Fi 6 Wireless Access Point. Category: Huawei. Subcategory: Access Point. Price: 23,000৳.
",180,658191,658371
4756,sentence,"Subcategory: Access Point. Price: 23,000৳.

Product: Huawei eKitEngine AP263 Dual-Band Wi-Fi 6 Wireless Access Point. Category: Huawei. Subcategory: Access Point. Price: 25,000৳.
",179,658328,658507
4757,sentence,"Subcategory: Access Point. Price: 25,000৳.

Product: Huawei eKitEngine AP661 Dual-Band WiFi 6 Wireless Access Point. Category: Huawei. Subcategory: Access Point. Price: Call for Price.
",185,658464,658649
4758,sentence,"Price: Call for Price.

Product: Huawei eKitEngine AP361 1775Mbps Dual-Band WiFi 6 Access Point. Category: Huawei. Subcategory: Access Point. Price: Call for Price.
",165,658626,658791
4759,sentence,"Price: Call for Price.

Product: Huawei eKitEngine AP371 BE3600 Dual-Band WiFi 7 Access Point. Category: Huawei. Subcategory: Access Point. Price: Call for Price.
",163,658768,658931
4760,sentence,"Price: Call for Price.

Product: Huawei eKitEngine AP772E Dual-Band Access Point. Category: Huawei. Subcategory: Access Point. Price: Call for Price.
",150,658908,659058
4761,sentence,"Price: Call for Price.

Product: Huawei eKitEngine AP772 Dual-Band Access Point. Category: Huawei. Subcategory: Access Point. Price: Call for Price.
",149,659035,659184
4762,sentence,"Price: Call for Price.

Product: Huawei eKitEngine AP271E BE3600 Dual-Band WiFi 7 Access Point. Category: Huawei. Subcategory: Access Point. Price: Up Coming.
",159,659161,659320
4763,sentence,"Subcategory: Access Point. Price: Up Coming.

Product: Huawei eKitEngine AP673E BE14000 Tri-Band WiFi 7 Access Point. Category: Huawei. Subcategory: Access Point. Price: Up Coming.
",181,659275,659456
4764,sentence,"Subcategory: Access Point. Price: Up Coming.

Product: BDCOM WAP2100-T512 1200Mbps Dual Band Indoor PoE Access Point. Category: BDCOM. Subcategory: Access Point. Price: 10,200৳.
",178,659411,659589
4765,sentence,"Subcategory: Access Point. Price: 10,200৳.

Product: Cisco CBS110-24T-EU 24 Port Gigabit Ethernet Unmanaged Switch With 2 Gigabit SFP. Category: Cisco. Subcategory: Network Switch. ",181,659546,659727
4766,sentence,"Category: Cisco. Subcategory: Network Switch. Price: 28,000৳29,000৳.

Product: Cisco CBS350-8P-2G-EU 10-port Business Series Managed Network Switch. Category: Cisco. Subcategory: Network Switch. ",195,659681,659876
4767,sentence,"Category: Cisco. Subcategory: Network Switch. Price: 31,999৳.

Product: Cisco CBS350-8P-2G-EU 8-port GE PoE+ Gigabit Managed Switch. Category: Cisco. Subcategory: Network Switch. Price: 32,000৳.
",195,659830,660025
4768,sentence,"Subcategory: Network Switch. Price: 32,000৳.

Product: Cisco C1000FE-24T-4G-L Catalyst 1000 Series 24-Port Managed Switch. Category: Cisco. Subcategory: Network Switch. Price: 29,400৳33,000৳.
",192,659980,660172
4769,sentence,"Price: 29,400৳33,000৳.

Product: Cisco CBS350-24T-4G-EU 24-Port Gigabit Managed Switch. Category: Cisco. Subcategory: Network Switch. Price: 33,500৳.
",150,660149,660299
4770,sentence,"Subcategory: Network Switch. Price: 33,500৳.

Product: Cisco SF350-24P-K9-EU 24-Port 10/100 PoE Managed Switch. Category: Cisco. Subcategory: Network Switch. Price: Out Of Stock.
",179,660254,660433
4771,sentence,"Price: Out Of Stock.

Product: Cisco C1000FE-48T-4G-L 48 Port Managed Switch. Category: Cisco. Subcategory: Network Switch. Price: 45,500৳.
",140,660412,660552
4772,sentence,"Subcategory: Network Switch. Price: 45,500৳.

Product: Cisco CBS350-8S-E-2G 10-Port Gigabit Managed Switch. Category: Cisco. Subcategory: Network Switch. Price: 39,900৳40,700৳.
",177,660507,660684
4773,sentence,"Price: 39,900৳40,700৳.

Product: Cisco CBS350-24P-4G-EU 24-Port Gigabit PoE+ SFP Managed Switch. Category: Cisco. Subcategory: Network Switch. Price: 47,040৳49,000৳.
",166,660661,660827
4774,sentence,"Price: 47,040৳49,000৳.

Product: Cisco Catalyst C1000-24T-4G-L 24-Port Network Switch. Category: Cisco. Subcategory: Network Switch. Price: 45,045৳49,500৳.
",156,660804,660960
4775,sentence,"Price: 45,045৳49,500৳.

Product: Cisco CBS350-24T-4X-EU 24-Port Gigabit Managed Switch. Category: Cisco. Subcategory: Network Switch. Price: 69,490৳.
",150,660937,661087
4776,sentence,"Subcategory: Network Switch. Price: 69,490৳.

Product: Cisco CBS350-48T-4G-EU 48 Port GE Gigabit Managed Switch. Category: Cisco. Subcategory: Network Switch. Price: 78,000৳78,500৳.
",182,661042,661224
4777,sentence,"Price: 78,000৳78,500৳.

Product: Cisco Catalyst C1000FE-24P-4G-L 24-Port PoE Network Switch. Category: Cisco. Subcategory: Network Switch. Price: 80,000৳.
",155,661201,661356
4778,sentence,"Subcategory: Network Switch. Price: 80,000৳.

Product: Cisco Catalyst C1000-48T-4G-L 48 Gigabit Ethernet Network Switch. Category: Cisco. Subcategory: Network Switch. Price: 86,000৳.
",183,661311,661494
4779,sentence,"Subcategory: Network Switch. Price: 86,000৳.

Product: Cisco C1000-24P-4G-L 24 Port Gigabit POE Switch. Category: Cisco. Subcategory: Network Switch. Price: 86,400৳87,000৳.
",173,661449,661622
4780,sentence,"Price: 86,400৳87,000৳.

Product: Cisco CBS350-24S-4G-EU 24-Port SFP Gigabit Managed Network Switch. Category: Cisco. Subcategory: Network Switch. Price: 90,000৳95,000৳.
",169,661599,661768
4781,sentence,"Price: 90,000৳95,000৳.

Product: Cisco CBS350-24P-4X-EU 24 Port Gigabit PoE+ Managed Switch. Category: Cisco. Subcategory: Network Switch. Price: 105,000৳.
",156,661745,661901
4782,sentence,"Subcategory: Network Switch. Price: 105,000৳.

Product: Cisco C1000-24T-4X-L Catalyst 1000 Series 24-Port Managed Switch. Category: Cisco. Subcategory: Network Switch. Price: 115,000৳.
",185,661855,662040
4783,sentence,"Subcategory: Network Switch. Price: 115,000৳.

Product: Cisco CBS350-48P-4G-EU 48-port GE PoE+ Gigabit Managed Switch. Category: Cisco. Subcategory: Network Switch. Price: 123,500৳.
",182,661994,662176
4784,sentence,"Subcategory: Network Switch. Price: 123,500৳.

Product: Cisco C1000-24FP-4G-L 24 Port Gigabit PoE+ Compliant Managed Switch. Category: Cisco. Subcategory: Network Switch. Price: 127,000৳.
",188,662130,662318
4785,sentence,"Subcategory: Network Switch. Price: 127,000৳.

Product: Cudy FS1010P 8 Port PoE+ Unmanaged Switch. Category: Cudy. Subcategory: Network Switch. Price: Out Of Stock.
",165,662272,662437
4786,sentence,"Price: Out Of Stock.

Product: Cudy FS1010PG 8 Port PoE+ Switch with 2 Uplink Ports. Category: Cudy. Subcategory: Network Switch. Price: 3,950৳.
",145,662416,662561
4787,sentence,"Subcategory: Network Switch. Price: 3,950৳.

Product: Cudy GS1020PS2 16-Port Gigabit PoE+ Switch with 2 Gigabit SFP Ports. Category: Cudy. Subcategory: Network Switch. Price: 19,290৳.
",184,662517,662701
4788,sentence,"Subcategory: Network Switch. Price: 19,290৳.

Product: Cudy GS2024S2 24-Port 2-Layer Managed Gigabit Switch with 4 Gigabit SFP Slots. Category: Cudy. Subcategory: Network Switch. Price: 20,500৳.
",195,662656,662851
4789,sentence,"Subcategory: Network Switch. Price: 20,500৳.

Product: Cudy FS108D 8 Port 10/100Mbps Desktop Switch. Category: Cudy. Subcategory: Network Switch. Price: Out Of Stock.
",167,662806,662973
4790,sentence,"Price: Out Of Stock.

Product: Cudy GS105D 5-Port Gigabit Desktop Switch. Category: Cudy. Subcategory: Network Switch. Price: Out Of Stock.

Product: Cudy FS1016D 16-Port 10/100Mbps Desktop Switch. ",198,662952,663150
4791,sentence,"Category: Cudy. Subcategory: Network Switch. Price: 2,600৳.

Product: Cudy GS1005PTS1 5-Port Gigabit PoE+ Switch with 1 SFP Slot. Category: Cudy. Subcategory: Network Switch. Price: Out Of Stock.
",196,663150,663346
4792,sentence,"Price: Out Of Stock.

Product: Cudy GS1016 16-Port Gigabit Unmanaged Switch. Category: Cudy. Subcategory: Network Switch. Price: Out Of Stock.

Product: Cudy GS1010PE 8 Port Gigabit PoE+ Switch. ",195,663325,663520
4793,sentence,"Category: Cudy. Subcategory: Network Switch. Price: Out Of Stock.

Product: Cudy FS1018PS1 16 Port PoE+ Unmanaged Switch. Category: Cudy. Subcategory: Network Switch. Price: Out Of Stock.
",188,663520,663708
4794,sentence,"Price: Out Of Stock.

Product: Cudy GS1016E 16-Port Gigabit Unmanaged Switch. Category: Cudy. Subcategory: Network Switch. Price: Out Of Stock.
",144,663687,663831
4795,sentence,"Price: Out Of Stock.

Product: Cudy GS1024E 24-Port Gigabit Rackmount Switch. Category: Cudy. Subcategory: Network Switch. Price: Out Of Stock.
",144,663810,663954
4796,sentence,"Price: Out Of Stock.

Product: Cudy FS1026PS1 24 Port Gigabit PoE+ Unmanaged Switch. Category: Cudy. Subcategory: Network Switch. Price: Out Of Stock.
",151,663933,664084
4797,sentence,"Price: Out Of Stock.

Product: Cudy GS1028PS2 24 Port Gigabit PoE+ Switch. Category: Cudy. Subcategory: Network Switch. Price: Out Of Stock.
",141,664063,664204
4798,sentence,"Price: Out Of Stock.

Product: TP-Link LS106LP 6-Port 10/100Mbps Desktop Switch with 4-Port PoE. Category: TP-Link. Subcategory: Network Switch. Price: 2,518৳2,650৳.
",166,664183,664349
4799,sentence,"Price: 2,518৳2,650৳.

Product: TP-Link TL-SF1024M 24-Port 10/100Mbps Desktop Switch. Category: TP-Link. Subcategory: Network Switch. Price: 2,869৳2,989৳.
",154,664328,664482
4800,sentence,"Price: 2,869৳2,989৳.

Product: TP-Link TL-SF1006P 6-Port 10/100Mbps Desktop PoE Switch with 4-Port PoE+. Category: TP-Link. Subcategory: Network Switch. Price: 2,992৳3,149৳.
",174,664461,664635
4801,sentence,"Price: 2,992৳3,149৳.

Product: TP-Link TL-SF1009P 9-Port 10/100Mbps Desktop Switch with 8-Port PoE+. Category: TP-Link. Subcategory: Network Switch. Price: 3,929৳4,180৳.
",170,664614,664784
4802,sentence,"Price: 3,929৳4,180৳.

Product: TP-Link LS109P 9-Port 10/100Mbps PoE Switch With 8-Port PoE+. Category: TP-Link. Subcategory: Network Switch. Price: 4,250৳.
",156,664763,664919
4803,sentence,"Subcategory: Network Switch. Price: 4,250৳.

Product: TP-Link TL-SG116 16-Port Gigabit Desktop Switch. Category: TP-Link. Subcategory: Network Switch. Price: Out Of Stock.
",172,664875,665047
4804,sentence,"Price: Out Of Stock.

Product: TP-Link TL-SG1016D 16-Port Gigabit Desktop/Rackmount Switch. Category: TP-Link. Subcategory: Network Switch. Price: 5,537৳5,890৳.
",161,665026,665187
4805,sentence,"Price: 5,537৳5,890৳.

Product: TP-Link TL-SG1210P 10-Port Gigabit Desktop Switch with 8-Port PoE+. Category: TP-Link. Subcategory: Network Switch. Price: 7,075৳7,090৳.
",168,665166,665334
4806,sentence,"Price: 7,075৳7,090৳.

Product: TP-Link TL-SG1024D 24-Port Gigabit Rackmount Switch. Category: TP-Link. Subcategory: Network Switch. Price: 7,145৳7,990৳.
",153,665313,665466
4807,sentence,"Price: 7,145৳7,990৳.

Product: TP-Link TL-SG2218 JetStream 16-Port Gigabit Smart Switch with 2 SFP Ports. Category: TP-Link. Subcategory: Network Switch. Price: 11,690৳.
",170,665445,665615
4808,sentence,"Subcategory: Network Switch. Price: 11,690৳.

Product: TP-Link TL-SG2210MP JetStream 10-Port Gigabit Smart Switch with 8-Port PoE+. Category: TP-Link. Subcategory: Network Switch. ",180,665570,665750
4809,sentence,"Category: TP-Link. Subcategory: Network Switch. Price: 11,197৳13,490৳.

Product: TP-Link SG2218P Omada 18-Port Gigabit Smart Switch with 16-Port PoE+. Category: TP-Link. Subcategory: Network Switch. ",199,665702,665901
4810,sentence,"Category: TP-Link. Subcategory: Network Switch. Price: 18,490৳.

Product: TP-Link TL-SG1218MPE 18-Port Gigabit Easy Smart Switch with 16-Port PoE+. Category: TP-Link. Subcategory: Network Switch. ",196,665853,666049
4811,sentence,"Category: TP-Link. Subcategory: Network Switch. Price: 18,890৳.

Product: TP-Link TL-SG2428P JetStream 28-Port Gigabit Smart Switch with 24-Port PoE+. Category: TP-Link. Subcategory: Network Switch. ",199,666001,666200
4812,sentence,"Category: TP-Link. Subcategory: Network Switch. Price: 23,641৳27,490৳.

Product: Mikrotik CSS610-8G-2S+IN 10 Port (8 Port Gigabit + 2 Port SFP+) Managed Smart Cloud Switch. Category: MikroTik. ",193,666152,666345
4813,sentence,"Category: MikroTik. Subcategory: Network Switch. Price: 14,000৳15,500৳.

Product: Mikrotik CRS305-1G-4S+IN Single Gigabit Ethernet port Switch. Category: MikroTik. Subcategory: Network Switch. ",193,666325,666518
4814,sentence,"Subcategory: Network Switch. Price: 17,800৳.

Product: Mikrotik CRS112-8P-4S-IN 8 port Gigabit POE Smart Switch. Category: MikroTik. Subcategory: Network Switch. Price: 23,000৳.
",178,666489,666667
4815,sentence,"Subcategory: Network Switch. Price: 23,000৳.

Product: Mikrotik CRS318-16P-2S+OUT 16 Port Gigabit PoE Managed Switch With 2 SFP+ Port. Category: MikroTik. Subcategory: Network Switch. ",184,666622,666806
4816,sentence,"Subcategory: Network Switch. Price: 33,222৳33,900৳.

Product: Mikrotik CRS326-24S+2Q+RM 26-Port Cloud Router Switch. Category: MikroTik. Subcategory: Network Switch. Price: 78,500৳.
",182,666777,666959
4817,sentence,"Subcategory: Network Switch. Price: 78,500৳.

Product: Mikrotik CRS309-1G-8S+IN Gigabit port Mountable Rack Switch. Category: MikroTik. Subcategory: Network Switch. Price: 34,500৳.
",181,666914,667095
4818,sentence,"Subcategory: Network Switch. Price: 34,500৳.

Product: Mikrotik CRS317-1G-16S+RM (16 Port SFP + 1 Port Gigabit LAN) Managed Cloud Switch. Category: MikroTik. Subcategory: Network Switch. ",187,667050,667237
4819,sentence,"Subcategory: Network Switch. Price: 57,000৳57,500৳.

Product: Mikrotik CRS328-24P-4S+RM 24 port Mountable Rack Switch. Category: MikroTik. Subcategory: Network Switch. Price: 63,500৳.
",184,667208,667392
4820,sentence,"Subcategory: Network Switch. Price: 63,500৳.

Product: Mikrotik CRS125-24G-1S-IN 24 Port Gigabit Ethernet layer 3 Smart Switch. Category: MikroTik. Subcategory: Network Switch. Price: Out Of Stock.
",198,667347,667545
4821,sentence,"Price: Out Of Stock.

Product: Mikrotik CRS112-8G-4S-IN 8 Port Layer 3 Gigabit Smart Switch. Category: MikroTik. Subcategory: Network Switch. Price: Out Of Stock.
",163,667524,667687
4822,sentence,"Price: Out Of Stock.

Product: Mikrotik CRS328-4C-20S-4S+RM 28 Port Dual Boot Switch. Category: MikroTik. Subcategory: Network Switch. Price: Out Of Stock.
",156,667666,667822
4823,sentence,"Price: Out Of Stock.

Product: Mikrotik CSS326-24G-2S+RM SwOS powered 24 port Gigabit Ethernet switch with two SFP+ ports in 1U rackmount case. Category: MikroTik. Subcategory: Network Switch. ",193,667801,667994
4824,sentence,"Subcategory: Network Switch. Price: Out Of Stock.

Product: Tenda S110PC 10-Port 100M Unmanaged PoE Switch. Category: Tenda. Subcategory: Network Switch. Price: 3,000৳.
",169,667965,668134
4825,sentence,"Subcategory: Network Switch. Price: 3,000৳.

Product: Tenda SG108 8-Port Gigabit Desktop Switch. Category: Tenda. Subcategory: Network Switch. Price: 2,000৳3,359৳.
",164,668090,668254
4826,sentence,"Price: 2,000৳3,359৳.

Product: Tenda TEG1016D 16 Port Gigabit Ethernet Metal Body Switch. Category: Tenda. Subcategory: Network Switch. Price: 5,292৳5,670৳.
",157,668233,668390
4827,sentence,"Price: 5,292৳5,670৳.

Product: Tenda TEF1110P-8-102W 8 Port Gigabit Desktop Switch With 8-Port PoE. Category: Tenda. Subcategory: Network Switch. Price: 6,950৳.
",161,668369,668530
4828,sentence,"Subcategory: Network Switch. Price: 6,950৳.

Product: Tenda TEF1118P-16-150W 16 10/100Mbps PoE +1 Gigabit/SFP Slots Switch. Category: Tenda. Subcategory: Network Switch. Price: 10,001৳10,990৳.
",193,668486,668679
4829,sentence,"Price: 10,001৳10,990৳.

Product: Tenda TEG5310P-8-150W 8 Port L3 Managed PoE Switch. Category: Tenda. Subcategory: Network Switch. Price: 11,900৳.
",147,668656,668803
4830,sentence,"Subcategory: Network Switch. Price: 11,900৳.

Product: Tenda TEF1126P-24-250W 24 Port PoE Gigabit Switch. Category: Tenda. Subcategory: Network Switch. Price: 16,200৳.
",168,668758,668926
4831,sentence,"Subcategory: Network Switch. Price: 16,200৳.

Product: Tenda TEF1218P 16-Port 10/100Mbps + 2 Gigabit Smart PoE Switch. Category: Tenda. Subcategory: Network Switch. Price: 13,200৳15,000৳.
",188,668881,669069
4832,sentence,"Price: 13,200৳15,000৳.

Product: Tenda TEG1118P-16-250W 16GE+2SFP 16 Port Unmanaged PoE Switch. Category: Tenda. Subcategory: Network Switch. Price: 15,780৳.
",158,669046,669204
4833,sentence,"Subcategory: Network Switch. Price: 15,780৳.

Product: Tenda TEG1050F 48 Port 48GE+2SFP Ethernet Switch. Category: Tenda. Subcategory: Network Switch. Price: 22,525৳.
",167,669159,669326
4834,sentence,"Subcategory: Network Switch. Price: 22,525৳.

Product: Tenda TEF1226P-24-410W 24 Port PoE Smart Switch. Category: Tenda. Subcategory: Network Switch. Price: 24,200৳.
",166,669281,669447
4835,sentence,"Subcategory: Network Switch. Price: 24,200৳.

Product: Tenda TEG3224P 24-Port 10/100/1000 Mbps + 4 Shared SFP PoE Managed Switch. Category: Tenda. Subcategory: Network Switch. Price: 29,900৳.
",192,669402,669594
4836,sentence,"Subcategory: Network Switch. Price: 29,900৳.

Product: Tenda TEG5328P-24-410W (410W) L3 Managed PoE Switch. Category: Tenda. Subcategory: Network Switch. Price: 34,079৳.
",170,669549,669719
4837,sentence,"Subcategory: Network Switch. Price: 34,079৳.

Product: Tenda TEG3210P 8G+2SFP Managed PoE Switch. Category: Tenda. Subcategory: Network Switch. Price: Up Coming.
",162,669674,669836
4838,sentence,"Subcategory: Network Switch. Price: Up Coming.

Product: Tenda SG80 8-port Gigabit Switch. Category: Tenda. Subcategory: Network Switch. Price: Out Of Stock.
",158,669789,669947
4839,sentence,"Price: Out Of Stock.

Product: Hikvision DS-3E0110MP-E/M 8 Port Fast Ethernet Unmanaged PoE Switch. Category: HikVision. Subcategory: Network Switch. Price: 3,700৳.
",165,669926,670091
4840,sentence,"Subcategory: Network Switch. Price: 3,700৳.

Product: Hikvision DS-3E0318P-E/M(B) 16-Port Fast Ethernet Unmanaged POE Switch. Category: HikVision. Subcategory: Network Switch. Price: 17,500৳.
",192,670047,670239
4841,sentence,"Subcategory: Network Switch. Price: 17,500৳.

Product: Hikvision DS-3E0105P-E/M(B) 4-Port Fast Ethernet Unmanaged POE Switch. Category: HikVision. Subcategory: Network Switch. Price: Out Of Stock.
",197,670194,670391
4842,sentence,"Price: Out Of Stock.

Product: Hikvision DS-3E0109P-E/M(B) 8 Port Unmanaged PoE Switch. Category: HikVision. Subcategory: Network Switch. Price: Out Of Stock.
",159,670370,670529
4843,sentence,"Price: Out Of Stock.

Product: Hikvision DS-3E0326P-E/M(B) 24 Port Unmanaged POE Switch. Category: HikVision. Subcategory: Network Switch. Price: Out Of Stock.
",160,670508,670668
4844,sentence,"Price: Out Of Stock.

Product: D Link DGS-1008A 8-Port Gigabit Easy Desktop Switch. Category: D-Link. Subcategory: Network Switch. Price: 2,790৳.
",146,670647,670793
4845,sentence,"Subcategory: Network Switch. Price: 2,790৳.

Product: D-Link DES-1016A-16-port 10/100M Unmanaged Switch. Category: D-Link. Subcategory: Network Switch. Price: 2,928৳3,050৳.
",173,670749,670922
4846,sentence,"Price: 2,928৳3,050৳.

Product: D-link DES-F1010P-E 10 Port Unmanaged PoE Switch. Category: D-Link. Subcategory: Network Switch. Price: 5,200৳5,400৳.
",149,670901,671050
4847,sentence,"Price: 5,200৳5,400৳.

Product: D-LINK DGS-1016A 16-Port Gigabit Unmanaged Desktop Switch. Category: D-Link. Subcategory: Network Switch. Price: 7,800৳.
",152,671029,671181
4848,sentence,"Subcategory: Network Switch. Price: 7,800৳.

Product: D-Link DGS-1024C 24-Port 10/100/1000Base Unmanaged Switch. Category: D-Link. Subcategory: Network Switch. Price: 9,310৳9,500৳.
",181,671137,671318
4849,sentence,"Price: 9,310৳9,500৳.

Product: D-Link DES-1024C 24 Port 10/100 Unmanaged Rack Mount Switch. Category: D-Link. Subcategory: Network Switch. Price: 9,800৳.
",154,671297,671451
4850,sentence,"Subcategory: Network Switch. Price: 9,800৳.

Product: D-Link DGS-1210-28 24-Port Smart Managed Gigabit Switch. Category: D-Link. Subcategory: Network Switch. Price: Out Of Stock.
",179,671407,671586
4851,sentence,"Price: Out Of Stock.

Product: D-Link DGS-1210-52 52-port Gigabit Smart Managed Switch. Category: D-Link. Subcategory: Network Switch. Price: Out Of Stock.
",156,671565,671721
4852,sentence,"Price: Out Of Stock.

Product: Dlink DES-1008C 8 Port 10/100 Unmanaged Switch. Category: D-Link. Subcategory: Network Switch. Price: Out Of Stock.
",147,671700,671847
4853,sentence,"Price: Out Of Stock.

Product: D-Link DES-1008P 8-Port Desktop Switch with 4 PoE Ports. Category: D-Link. Subcategory: Network Switch. Price: Out Of Stock.
",156,671826,671982
4854,sentence,"Price: Out Of Stock.

Product: D-Link DGS-1008MP 8 port 10/100/1000 Giga Unmanaged PoE Desktop Switch. Category: D-Link. Subcategory: Network Switch. Price: Out Of Stock.
",171,671961,672132
4855,sentence,"Price: Out Of Stock.

Product: D-Link DGS-1210-10P 8 Port Gigabit Switch. Category: D-Link. Subcategory: Network Switch. Price: Out Of Stock.
",142,672111,672253
4856,sentence,"Price: Out Of Stock.

Product: D-Link DES-1024D 24-Ports 10/100 Fast Ethernet Unmanaged Rack Mount Switch. Category: D-Link. Subcategory: Network Switch. Price: Out Of Stock.
",175,672232,672407
4857,sentence,"Price: Out Of Stock.

Product: D-Link DES-1210-28P Web Smart 24-Port Fast PoE Ethernet Switch. Category: D-Link. Subcategory: Network Switch. Price: Out Of Stock.
",163,672386,672549
4858,sentence,"Price: Out Of Stock.

Product: D-Link DES-1210-52 48 Port Gigabit Smart Managed Switch. Category: D-Link. Subcategory: Network Switch. Price: Out Of Stock.
",156,672528,672684
4859,sentence,"Price: Out Of Stock.

Product: D-Link DGS-1510-28X Layer 3 Lite 24 Port Gigabit 4 SFP Plus Smart Managed Gigabit Switch. Category: D-Link. Subcategory: Network Switch. Price: Out Of Stock.
",189,672663,672852
4860,sentence,"Price: Out Of Stock.

Product: D-Link DGS-1210-52 48-port Gigabit Switch. Category: D-Link. Subcategory: Network Switch. Price: Out Of Stock.
",142,672831,672973
4861,sentence,"Price: Out Of Stock.

Product: Solitine SOL-7912 12 Port 10G L3 Managed Network Switch. Category: Solitine. Subcategory: Network Switch. Price: 32,000৳.
",153,672952,673105
4862,sentence,"Subcategory: Network Switch. Price: 32,000৳.

Product: Solitine S3028X-DP 28 Port Managed Network Switch. Category: Solitine. Subcategory: Network Switch. Price: 46,500৳.
",171,673060,673231
4863,sentence,"Subcategory: Network Switch. Price: 46,500৳.

Product: Ruijie RG-ES106D-P V2 6-port Desktop Unmanaged PoE Switch. Category: Ruijie. Subcategory: Network Switch. Price: 4,000৳.
",176,673186,673362
4864,sentence,"Subcategory: Network Switch. Price: 4,000৳.

Product: Ruijie RG-ES205GC-P 5-Port Gigabit Smart Cloud Managed PoE Switch. Category: Ruijie. Subcategory: Network Switch. Price: 6,490৳.
",183,673318,673501
4865,sentence,"Subcategory: Network Switch. Price: 6,490৳.

Product: Ruijie RG-ES206GS-P 6-Port Gigabit Managed Smart PoE Switch. Category: Ruijie. Subcategory: Network Switch. Price: 7,500৳.
",177,673457,673634
4866,sentence,"Subcategory: Network Switch. Price: 7,500৳.

Product: Ruijie RG-ES216GC 16 Port Gigabit Smart Managed Switch. Category: Ruijie. Subcategory: Network Switch. Price: 11,500৳.
",173,673590,673763
4867,sentence,"Subcategory: Network Switch. Price: 11,500৳.

Product: Ruijie RG-ES110GDS-P 10-port Unmanaged PoE Switch. Category: Ruijie. Subcategory: Network Switch. Price: 12,500৳.
",169,673718,673887
4868,sentence,"Subcategory: Network Switch. Price: 12,500৳.

Product: Ruijie RG-ES210GC-LP 10-Port Gigabit Smart Cloud Managed PoE Switch. Category: Ruijie. Subcategory: Network Switch. Price: 12,500৳.
",187,673842,674029
4869,sentence,"Subcategory: Network Switch. Price: 12,500৳.

Product: Ruijie RG-ES209GC-P 9-Port Gigabit Smart Cloud Managed PoE Switch. Category: Ruijie. Subcategory: Network Switch. Price: 12,800৳.
",185,673984,674169
4870,sentence,"Subcategory: Network Switch. Price: 12,800৳.

Product: Ruijie RG-ES124GD 24-Port Gigabit Unmanaged Switch. Category: Ruijie. Subcategory: Network Switch. Price: 13,000৳.
",170,674124,674294
4871,sentence,"Subcategory: Network Switch. Price: 13,000৳.

Product: Ruijie RG-NBS3100-8GT2SFP 8 Port Gigabit L2 Managed Switch. Category: Ruijie. Subcategory: Network Switch. Price: 13,500৳.
",178,674249,674427
4872,sentence,"Subcategory: Network Switch. Price: 13,500৳.

Product: Ruijie RG-ES118S-LP 16-Port Desktop Unmanaged PoE Switch. Category: Ruijie. Subcategory: Network Switch. Price: 17,000৳.
",176,674382,674558
4873,sentence,"Subcategory: Network Switch. Price: 17,000৳.

Product: Ruijie RG-ES224GC 24-Port Gigabit Smart Cloud Managed Switch. Category: Ruijie. Subcategory: Network Switch. Price: 20,000৳.
",180,674513,674693
4874,sentence,"Subcategory: Network Switch. Price: 20,000৳.

Product: Ruijie RG-ES118GS-P 18-Port Unmanaged PoE Switch. Category: Ruijie. Subcategory: Network Switch. Price: 21,000৳.
",168,674648,674816
4875,sentence,"Subcategory: Network Switch. Price: 21,000৳.

Product: Ruijie RG-NBS3100-24GT4SFP 28-Port Gigabit Layer 2 Cloud Managed Switch. Category: Ruijie. Subcategory: Network Switch. Price: 21,000৳.
",191,674771,674962
4876,sentence,"Subcategory: Network Switch. Price: 21,000৳.

Product: Ruijie RG-ES126FGS-LP 24-Port Unmanaged PoE Switch. Category: Ruijie. Subcategory: Network Switch. Price: 22,000৳.
",170,674917,675087
4877,sentence,"Subcategory: Network Switch. Price: 22,000৳.

Product: Ruijie RG-ES126S-LP V2 24-Port Desktop Unmanaged PoE Switch. Category: Ruijie. Subcategory: Network Switch. Price: 22,500৳.
",179,675042,675221
4878,sentence,"Subcategory: Network Switch. Price: 22,500৳.

Product: Ruijie RG-NBS3100-8GT2SFP-P 8 Port Gigabit L2 Managed POE Switch. Category: Ruijie. Subcategory: Network Switch. Price: 23,500৳.
",184,675176,675360
4879,sentence,"Subcategory: Network Switch. Price: 23,500৳.

Product: Ruijie RG-ES218GC-P 18-Port Gigabit Smart Cloud Managed PoE Switch. Category: Ruijie. Subcategory: Network Switch. Price: Up Coming.
",188,675315,675503
4880,sentence,"Subcategory: Network Switch. Price: Up Coming.

Product: Ruijie RG-ES08 8-Port 10/100 Mbps Unmanaged Desktop Switch. Category: Ruijie. Subcategory: Network Switch. Price: Out Of Stock.
",185,675456,675641
4881,sentence,"Price: Out Of Stock.

Product: Netgear GS108E 8-Port Gigabit Plus Managed Desktop Switch. Category: NETGEAR. Subcategory: Network Switch. Price: 3,780৳4,200৳.
",159,675620,675779
4882,sentence,"Price: 3,780৳4,200৳.

Product: Netgear GS305P 5-Port Gigabit Desktop Switch. Category: NETGEAR. Subcategory: Network Switch. Price: 8,200৳.
",140,675758,675898
4883,sentence,"Subcategory: Network Switch. Price: 8,200৳.

Product: Netgear GS108LP 8-Port Gigabit PoE Unmanaged Rackmount Switch (PoE Budget 60W). Category: NETGEAR. Subcategory: Network Switch. Price: 11,500৳.
",198,675854,676052
4884,sentence,"Subcategory: Network Switch. Price: 11,500৳.

Product: Netgear GS324 24-Port Gigabit Rackmount Switch. Category: NETGEAR. Subcategory: Network Switch. Price: 10,736৳12,200৳.
",174,676007,676181
4885,sentence,"Price: 10,736৳12,200৳.

Product: Netgear GS310TP 8-Port Gigabit PoE+ Ethernet Smart Managed Pro Desktop Switch with 2 SFP Ports. Category: NETGEAR. Subcategory: Network Switch. Price: 20,500৳.
",193,676158,676351
4886,sentence,"Subcategory: Network Switch. Price: 20,500৳.

Product: Netgear GS110TP 10-Port Gigabit Ethernet Smart Switch. Category: NETGEAR. Subcategory: Network Switch. Price: 20,500৳.
",174,676306,676480
4887,sentence,"Subcategory: Network Switch. Price: 20,500৳.

Product: Netgear GS116LP 16-Port Gigabit Ethernet Rackmount Unmanaged PoE/PoE+ Switch. Category: NETGEAR. Subcategory: Network Switch. ",181,676435,676616
4888,sentence,"Category: NETGEAR. Subcategory: Network Switch. Price: 20,500৳23,500৳.

Product: Netgear GS724T 24 Port Smart Gigabit Managed Pro Switch. Category: NETGEAR. Subcategory: Network Switch. ",186,676568,676754
4889,sentence,"Category: NETGEAR. Subcategory: Network Switch. Price: 31,300৳.

Product: Netgear GS348 48-Port Gigabit Unmanaged Rackmount Switch. Category: NETGEAR. Subcategory: Network Switch. Price: 42,500৳.
",196,676706,676902
4890,sentence,"Subcategory: Network Switch. Price: 42,500৳.

Product: Netgear GS728TP 24 + 4 SFP Port Pro Safe Gigabit PoE Manage Switch. Category: NETGEAR. Subcategory: Network Switch. Price: 48,000৳48,500৳.
",194,676857,677051
4891,sentence,"Price: 48,000৳48,500৳.

Product: Netgear GS748T 48-Port Gigabit Ethernet Smart Switch. Category: NETGEAR. Subcategory: Network Switch. Price: 64,000৳.
",151,677028,677179
4892,sentence,"Subcategory: Network Switch. Price: 64,000৳.

Product: Netgear M4250-10G2F-PoE+ AV Line 8G PoE+ 1G and SFP Managed Switch. Category: NETGEAR. Subcategory: Network Switch. Price: 75,000৳.
",187,677134,677321
4893,sentence,"Subcategory: Network Switch. Price: 75,000৳.

Product: Netgear GS752TP 52 Port Gigabit Ethernet Smart Switch (4SFP). Category: NETGEAR. Subcategory: Network Switch. Price: 93,500৳.
",181,677276,677457
4894,sentence,"Subcategory: Network Switch. Price: 93,500৳.

Product: Netgear M4300-28G (GSM4328S) 28 Port Stackable L3 Managed Switch. Category: NETGEAR. Subcategory: Network Switch. Price: 168,000৳.
",186,677412,677598
4895,sentence,"Subcategory: Network Switch. Price: 168,000৳.

Product: Netgear M4300-52G 48 Port Gigabit Stackable Managed Switch. Category: NETGEAR. Subcategory: Network Switch. Price: 215,000৳.
",181,677552,677733
4896,sentence,"Subcategory: Network Switch. Price: 215,000৳.

Product: Netgear AV Line M4250-40G8XF-PoE+ 48 Port Managed Switch. Category: NETGEAR. Subcategory: Network Switch. Price: Call for Price.
",185,677687,677872
4897,sentence,"Price: Call for Price.

Product: Netgear GS316P 16 Port Gigabit Ethernet Unmanaged PoE+ Switch with Flex PoE (115W). Category: NETGEAR. Subcategory: Network Switch. Price: Call for Price.
",188,677849,678037
4898,sentence,"Price: Call for Price.

Product: NETGEAR GS110EMX 8-Port Gigabit Ethernet Plus Switch. Category: NETGEAR. Subcategory: Network Switch. Price: Call for Price.
",158,678014,678172
4899,sentence,"Price: Call for Price.

Product: NETGEAR GS316EP 16-Port PoE+ Gigabit Ethernet Plus Switch. Category: NETGEAR. Subcategory: Network Switch. Price: Call for Price.
",163,678149,678312
4900,sentence,"Price: Call for Price.

Product: Netgear M4250-16XF AV Line 16-port SFP+ 10G Managed Switch. Category: NETGEAR. Subcategory: Network Switch. Price: Call for Price.
",164,678289,678453
4901,sentence,"Price: Call for Price.

Product: Dahua PFS3009-8ET-65 8-Port POE Switch. Category: Dahua. Subcategory: Network Switch. Price: 4,900৳.

Product: Dahua PFS3226-24ET-240 26-Port Unmanaged PoE Switch. ",197,678430,678627
4902,sentence,"Category: Dahua. Subcategory: Network Switch. Price: 22,500৳.

Product: BDCOM S1200-8P2G 8 Ports PoE Switch With 2 Gigabit Ports. Category: BDCOM. Subcategory: Network Switch. Price: 4,200৳.
",191,678627,678818
4903,sentence,"Subcategory: Network Switch. Price: 4,200৳.

Product: BDCOM S1210-8P 8 Ports 100M Unmanaged Switch. Category: BDCOM. Subcategory: Network Switch. Price: 8,500৳.
",161,678774,678935
4904,sentence,"Subcategory: Network Switch. Price: 8,500৳.

Product: BDCOM S2510-C 8 ports Managed Switch. Category: BDCOM. Subcategory: Network Switch. Price: 9,500৳.
",153,678891,679044
4905,sentence,"Subcategory: Network Switch. Price: 9,500৳.

Product: BDCOM S1500-24T2S 24-Port Gigabit Switch. Category: BDCOM. Subcategory: Network Switch. Price: 10,000৳.
",158,679000,679158
4906,sentence,"Subcategory: Network Switch. Price: 10,000৳.

Product: BDCOM S1500-16P2S 16-Port Unmanaged PoE Switch. Category: BDCOM. Subcategory: Network Switch. Price: 15,200৳.
",165,679113,679278
4907,sentence,"Subcategory: Network Switch. Price: 15,200৳.

Product: BDCOM S1518-16P 16 ports POE Unmanaged Switch. Category: BDCOM. Subcategory: Network Switch. Price: 21,000৳.
",164,679233,679397
4908,sentence,"Subcategory: Network Switch. Price: 21,000৳.

Product: BDCOM S1500-24P2S-370 24-Port Unmanaged PoE Switch. Category: BDCOM. Subcategory: Network Switch. Price: 23,000৳.
",169,679352,679521
4909,sentence,"Subcategory: Network Switch. Price: 23,000৳.

Product: BDCOM S2226-P 24 Ports POE Managed Switch. Category: BDCOM. Subcategory: Network Switch. Price: 25,500৳.
",160,679476,679636
4910,sentence,"Subcategory: Network Switch. Price: 25,500৳.

Product: BDCOM S2900-24T4X 24 Ports Gigabit Switch With 4 SFP Ports. Category: BDCOM. Subcategory: Network Switch. Price: 30,740৳.
",177,679591,679768
4911,sentence,"Subcategory: Network Switch. Price: 30,740৳.

Product: BDCOM S2900-48P6X 48-Port POE Gigabit Managed Switch. Category: BDCOM. Subcategory: Network Switch. Price: 86,500৳.
",171,679723,679894
4912,sentence,"Subcategory: Network Switch. Price: 86,500৳.

Product: BDCOM S5828 24-Port SFP 10G L3 Managed Switch. Category: BDCOM. Subcategory: Network Switch. Price: 145,000৳.
",165,679849,680014
4913,sentence,"Subcategory: Network Switch. Price: 145,000৳.

Product: BDCOM S1008-D 8 Ports Unmanaged Switches. Category: BDCOM. Subcategory: Network Switch. Price: Out Of Stock.
",165,679968,680133
4914,sentence,"Price: Out Of Stock.

Product: BDCOM S1008C 8 Port Unmanaged Switch. Category: BDCOM. Subcategory: Network Switch. Price: Out Of Stock.

Product: BDCOM S1006-4P 4-Port PoE Switch. Category: BDCOM. ",197,680112,680309
4915,sentence,"Category: BDCOM. Subcategory: Network Switch. Price: Out Of Stock.

Product: BDCOM S1508 E 8 Ports Unmanaged Switches. Category: BDCOM. Subcategory: Network Switch. Price: Out Of Stock.
",186,680292,680478
4916,sentence,"Price: Out Of Stock.

Product: BDCOM S1016C 16 Ports 100M Unmanaged Switch. Category: BDCOM. Subcategory: Network Switch. Price: Out Of Stock.
",143,680457,680600
4917,sentence,"Price: Out Of Stock.

Product: BDCOM S1000-8P2F 8-Port 100mbps Unmanaged PoE Switch. Category: BDCOM. Subcategory: Network Switch. Price: Out Of Stock.
",152,680579,680731
4918,sentence,"Price: Out Of Stock.

Product: BDCOM S1010-8P-120 8-Port 100mbps Multi functional PoE Switch (120W). Category: BDCOM. Subcategory: Network Switch. Price: Out Of Stock.
",168,680710,680878
4919,sentence,"Price: Out Of Stock.

Product: BDCOM S1024C 24 Ports 100M Unmanaged Switch. Category: BDCOM. Subcategory: Network Switch. Price: Out Of Stock.

Product: BDCOM S1516v1 16 Port Unmanaged Switch. ",193,680857,681050
4920,sentence,"Category: BDCOM. Subcategory: Network Switch. Price: Out Of Stock.

Product: Netis ST3116P 16 Port Fast Ethernet Switch. Category: Netis. Subcategory: Network Switch. Price: 2,380৳.
",182,681050,681232
4921,sentence,"Subcategory: Network Switch. Price: 2,380৳.

Product: Netis P106C 6-Port Unmanaged POE Switch. Category: Netis. Subcategory: Network Switch. Price: 2,500৳3,260৳.
",162,681188,681350
4922,sentence,"Price: 2,500৳3,260৳.

Product: Netis P110C 10-Port Unmanaged POE Switch. Category: Netis. Subcategory: Network Switch. Price: 3,200৳3,500৳.
",140,681329,681469
4923,sentence,"Price: 3,200৳3,500৳.

Product: Netis PE6108GH 8 Port Gigabit Ethernet PoE Switch. Category: Netis. Subcategory: Network Switch. Price: 8,500৳.

Product: Netis P116GH 16-Port Unmanaged POE Switch. ",196,681448,681644
4924,sentence,"Category: Netis. Subcategory: Network Switch. Price: 7,900৳14,290৳.

Product: Netis P124GH 24-Port Unmanaged POE Switch. Category: Netis. Subcategory: Network Switch. Price: 22,000৳.
",183,681644,681827
4925,sentence,"Subcategory: Network Switch. Price: 22,000৳.

Product: Grandstream GWN7700P 5 Port Gigabit PoE Network Switch. Category: Grandstream. Subcategory: Network Switch. Price: 4,200৳.
",178,681782,681960
4926,sentence,"Subcategory: Network Switch. Price: 4,200৳.

Product: Grandstream GWN7702 16 Port Gigabit Network Switch. Category: Grandstream. Subcategory: Network Switch. Price: 8,100৳.
",173,681916,682089
4927,sentence,"Subcategory: Network Switch. Price: 8,100৳.

Product: Grandstream GWN7701PA 8 Port Gigabit PoE Network Switch. Category: Grandstream. Subcategory: Network Switch. Price: 9,100৳.
",178,682045,682223
4928,sentence,"Subcategory: Network Switch. Price: 9,100৳.

Product: Grandstream GWN7703 24 Port Gigabit Network Switch. Category: Grandstream. Subcategory: Network Switch. Price: 10,500৳.
",174,682179,682353
4929,sentence,"Subcategory: Network Switch. Price: 10,500৳.

Product: Grandstream GWN7801 8 Port Gigabit Layer 2+ Managed Network Switch. Category: Grandstream. Subcategory: Network Switch. Price: 11,000৳.
",191,682308,682499
4930,sentence,"Subcategory: Network Switch. Price: 11,000৳.

Product: Grandstream GWN7801P 8 Port Gigabit Layer 2+ Managed PoE Network Switch. Category: Grandstream. Subcategory: Network Switch. Price: 15,000৳.
",196,682454,682650
4931,sentence,"Subcategory: Network Switch. Price: 15,000৳.

Product: Grandstream GWN7802 16 Port Gigabit Layer 2+ Managed Network Switch. Category: Grandstream. Subcategory: Network Switch. Price: 18,200৳.
",192,682605,682797
4932,sentence,"Subcategory: Network Switch. Price: 18,200৳.

Product: Grandstream GWN7803 24 Port Gigabit Layer 2+ Managed Network Switch. Category: Grandstream. Subcategory: Network Switch. Price: 21,400৳.
",192,682752,682944
4933,sentence,"Subcategory: Network Switch. Price: 21,400৳.

Product: Grandstream GWN7802P 16 Port Gigabit Layer 2+ Managed PoE Network Switch. Category: Grandstream. Subcategory: Network Switch. Price: 25,500৳.
",197,682899,683096
4934,sentence,"Subcategory: Network Switch. Price: 25,500৳.

Product: Grandstream GWN7813 24 Port Layer 3 Managed Network Switch. Category: Grandstream. Subcategory: Network Switch. Price: 27,000৳.
",183,683051,683234
4935,sentence,"Subcategory: Network Switch. Price: 27,000৳.

Product: Grandstream GWN7806 48 Port Gigabit Layer 2+ Managed Network Switch. Category: Grandstream. Subcategory: Network Switch. Price: 39,000৳.
",192,683189,683381
4936,sentence,"Subcategory: Network Switch. Price: 39,000৳.

Product: Grandstream GWN7831 32 Gigabit Port Layer 3 Managed Switch. Category: Grandstream. Subcategory: Network Switch. Price: 43,200৳.
",183,683336,683519
4937,sentence,"Subcategory: Network Switch. Price: 43,200৳.

Product: Grandstream GWN7803P Enterprise 24 Port Gigabit Managed PoE Switch. Category: Grandstream. Subcategory: Network Switch. Price: Call for Price.
",198,683474,683672
4938,sentence,"Price: Call for Price.

Product: TRENDnet TEG-S51 5-Port Gigabit Desktop Switch. Category: TRENDnet. Subcategory: Network Switch. Price: 3,800৳.
",145,683649,683794
4939,sentence,"Subcategory: Network Switch. Price: 3,800৳.

Product: TRENDnet TEG-S83 8-Port Gigabit Desktop Switch. Category: TRENDnet. Subcategory: Network Switch. Price: 3,870৳4,500৳.
",172,683750,683922
4940,sentence,"Price: 3,870৳4,500৳.

Product: TRENDnet TEG-S80ES 8-Port EdgeSmart Gigabit Switch. Category: TRENDnet. Subcategory: Network Switch. Price: 7,000৳.
",147,683901,684048
4941,sentence,"Subcategory: Network Switch. Price: 7,000৳.

Product: TRENDnet TPE-TG51g 5-Port Gigabit PoE+ Switch. Category: TRENDnet. Subcategory: Network Switch. Price: 7,500৳.
",165,684004,684169
4942,sentence,"Subcategory: Network Switch. Price: 7,500৳.

Product: TRENDnet TPE-TG83 8-Port Gigabit PoE+ Switch. Category: TRENDnet. Subcategory: Network Switch. Price: 11,900৳.
",165,684125,684290
4943,sentence,"Subcategory: Network Switch. Price: 11,900৳.

Product: TRENDnet TPE-TG82ES 8-Port EdgeSmart Gigabit PoE+ Switch. Category: TRENDnet. Subcategory: Network Switch. Price: 13,500৳.
",178,684245,684423
4944,sentence,"Subcategory: Network Switch. Price: 13,500৳.

Product: TRENDnet TPE-TG84 8-Port Gigabit PoE+ Switch. Category: TRENDnet. Subcategory: Network Switch. Price: 14,900৳.
",166,684378,684544
4945,sentence,"Subcategory: Network Switch. Price: 14,900৳.

Product: TRENDnet TEG-S17 16-Port Unmanaged Gigabit Switch. Category: TRENDnet. Subcategory: Network Switch. Price: 16,500৳.
",171,684499,684670
4946,sentence,"Subcategory: Network Switch. Price: 16,500৳.

Product: TRENDnet TEG-082WS 8-Port Web Smart Gigabit Switch With 2x SFP Ports. Category: TRENDnet. Subcategory: Network Switch. Price: 16,500৳.
",190,684625,684815
4947,sentence,"Subcategory: Network Switch. Price: 16,500৳.

Product: TRENDnet TEG-S25D 24-Port Gigabit Desktop Switch. Category: TRENDnet. Subcategory: Network Switch. Price: 17,500৳.
",170,684770,684940
4948,sentence,"Subcategory: Network Switch. Price: 17,500৳.

Product: TRENDnet TEG-S25 24-Port Unmanaged Gigabit Switch. Category: TRENDnet. Subcategory: Network Switch. Price: 20,000৳.
",171,684895,685066
4949,sentence,"Subcategory: Network Switch. Price: 20,000৳.

Product: TRENDnet TPE-082WS 10-Port Gigabit Web Smart PoE+ Switch. Category: TRENDnet. Subcategory: Network Switch. Price: 22,500৳.
",178,685021,685199
4950,sentence,"Subcategory: Network Switch. Price: 22,500৳.

Product: TRENDnet TPE-TG160H 16-Port Gigabit PoE+ Switch. Category: TRENDnet. Subcategory: Network Switch. Price: 23,500৳.
",169,685154,685323
4951,sentence,"Subcategory: Network Switch. Price: 23,500৳.

Product: TRENDnet TEG-204WS 20-Port Gigabit Web Smart Switch. Category: TRENDnet. Subcategory: Network Switch. Price: 25,500৳.
",173,685278,685451
4952,sentence,"Subcategory: Network Switch. Price: 25,500৳.

Product: TRENDnet TEG-284WS 28-Port Gigabit Web Smart Switch. Category: TRENDnet. Subcategory: Network Switch. Price: 30,500৳.
",173,685406,685579
4953,sentence,"Subcategory: Network Switch. Price: 30,500৳.

Product: TRENDnet TPE-TG380 8-Port Unmanaged 2.5G PoE+ Switch. Category: TRENDnet. Subcategory: Network Switch. Price: 30,500৳.
",174,685534,685708
4954,sentence,"Subcategory: Network Switch. Price: 30,500৳.

Product: TRENDnet TEG-30262 24-Port Gigabit Switch with 2 x 10G SFP+ Slots. Category: TRENDnet. Subcategory: Network Switch. Price: 32,000৳.
",187,685663,685850
4955,sentence,"Subcategory: Network Switch. Price: 32,000৳.

Product: TRENDnet TPE-TG182 18-Port Gigabit PoE+ Switch. Category: TRENDnet. Subcategory: Network Switch. Price: 33,500৳.
",168,685805,685973
4956,sentence,"Subcategory: Network Switch. Price: 33,500৳.

Product: TRENDnet TEG-30284 28-Port Web Smart Switch. Category: TRENDnet. Subcategory: Network Switch. Price: 35,900৳.
",165,685928,686093
4957,sentence,"Subcategory: Network Switch. Price: 35,900৳.

Product: TRENDnet TPE-TG182ES 18-Port EdgeSmart Gigabit PoE+ Switch. Category: TRENDnet. Subcategory: Network Switch. Price: 38,500৳.
",180,686048,686228
4958,sentence,"Subcategory: Network Switch. Price: 38,500৳.

Product: IP-COM G3310P-8-150W 8GE+2SFP Cloud Managed PoE Switch. Category: IP-COM. Subcategory: Network Switch. Price: 9,690৳9,900৳.
",179,686183,686362
4959,sentence,"Price: 9,690৳9,900৳.

Product: IP-COM Pro-S8-150W 8 Port Gigabit ProFi Switch. Category: IP-COM. Subcategory: Network Switch. Price: 11,700৳.
",142,686341,686483
4960,sentence,"Subcategory: Network Switch. Price: 11,700৳.

Product: IP-COM Pro-S24 24 Port Gigabit Managed ProFi Switch. Category: IP-COM. Subcategory: Network Switch. Price: 22,500৳.
",171,686438,686609
4961,sentence,"Subcategory: Network Switch. Price: 22,500৳.

Product: IP-COM Pro-S24-410W 24 Port Gigabit ProFi Switch. Category: IP-COM. Subcategory: Network Switch. Price: 29,900৳.
",168,686564,686732
4962,sentence,"Subcategory: Network Switch. Price: 29,900৳.

Product: C-Data CS2082G-POE 8 Port Gigabit Ethernet Unmanaged PoE Switch. Category: C-Data. Subcategory: Network Switch. Price: 5,400৳5,700৳.
",188,686687,686875
4963,sentence,"Price: 5,400৳5,700৳.

Product: C-Data CS3244GC 24 Ports Gigabit Managed Ethernet Switch. Category: C-Data. Subcategory: Network Switch. Price: 24,000৳.
",152,686854,687006
4964,sentence,"Subcategory: Network Switch. Price: 24,000৳.

Product: C-Data CS4244GX 24 Ports Managed Ethernet Switch. Category: C-Data. Subcategory: Network Switch. Price: 28,000৳.
",168,686961,687129
4965,sentence,"Subcategory: Network Switch. Price: 28,000৳.

Product: C-Data CS3244GS-POE 24 Ports Gigabit Managed Ethernet POE Switch. Category: C-Data. Subcategory: Network Switch. Price: 33,000৳.
",184,687084,687268
4966,sentence,"Subcategory: Network Switch. Price: 33,000৳.

Product: C-Data CS4244GX-POE 24 Ports Gigabit Managed Ethernet POE Switch. Category: C-Data. Subcategory: Network Switch. Price: 38,000৳.
",184,687223,687407
4967,sentence,"Subcategory: Network Switch. Price: 38,000৳.

Product: Huawei eKitEngine S110-8P2ST 8 Port Gigabit PoE+ Unmanaged Switch. Category: Huawei. Subcategory: Network Switch. Price: 16,000৳.
",185,687362,687547
4968,sentence,"Subcategory: Network Switch. Price: 16,000৳.

Product: Huawei eKitEngine S110-16LP2SR 16 Port Gigabit PoE+ Unmanaged Switch. Category: Huawei. Subcategory: Network Switch. Price: 22,000৳.
",188,687502,687690
4969,sentence,"Subcategory: Network Switch. Price: 22,000৳.

Product: Huawei eKitEngine S110-24T2SR 24 Port Gigabit Unmanaged Switch. Category: Huawei. Subcategory: Network Switch. Price: 24,000৳24,500৳.
",189,687645,687834
4970,sentence,"Price: 24,000৳24,500৳.

Product: Huawei CloudEngine S310-24T4S 24 Port Gigabit Managed Switch. Category: Huawei. Subcategory: Network Switch. Price: 32,000৳.
",158,687811,687969
4971,sentence,"Subcategory: Network Switch. Price: 32,000৳.

Product: Huawei eKitEngine S110-24LP2SR 24 Port Gigabit PoE+ Unmanaged Switch. Category: Huawei. Subcategory: Network Switch. Price: 32,000৳40,000৳.
",195,687924,688119
4972,sentence,"Price: 32,000৳40,000৳.

Product: Huawei eKitEngine S220-24T4X 24 Port Gigabit WEB-Managed Switch. Category: Huawei. Subcategory: Network Switch. Price: 40,000৳.
",161,688096,688257
4973,sentence,"Subcategory: Network Switch. Price: 40,000৳.

Product: Huawei eKitEngine S220-48T4S 48 Port Gigabit WEB-Managed Switch. Category: Huawei. Subcategory: Network Switch. Price: 56,000৳.
",183,688212,688395
4974,sentence,"Subcategory: Network Switch. Price: 56,000৳.

Product: Huawei CloudEngine S310-24P4S 24 Port Gigabit PoE Managed Switch. Category: Huawei. Subcategory: Network Switch. Price: 60,000৳.
",184,688350,688534
4975,sentence,"Subcategory: Network Switch. Price: 60,000৳.

Product: Huawei CloudEngine S310-48T4S 48 Port Gigabit Managed Switch. Category: Huawei. Subcategory: Network Switch. Price: 60,000৳.
",180,688489,688669
4976,sentence,"Subcategory: Network Switch. Price: 60,000৳.

Product: Huawei eKitEngine S220-48T4X 48 Port Gigabit WEB-Managed Switch. Category: Huawei. Subcategory: Network Switch. Price: 68,800৳.
",183,688624,688807
4977,sentence,"Subcategory: Network Switch. Price: 68,800৳.

Product: Huawei eKitEngine S220-24P4X 24 Port Gigabit PoE WEB-Managed Switch. Category: Huawei. Subcategory: Network Switch. Price: 70,000৳.
",187,688762,688949
4978,sentence,"Subcategory: Network Switch. Price: 70,000৳.

Product: Huawei eKitEngine S310-48T4X 48 Port Gigabit Managed Switch. Category: Huawei. Subcategory: Network Switch. Price: 85,000৳.
",179,688904,689083
4979,sentence,"Subcategory: Network Switch. Price: 85,000৳.

Product: Huawei eKitEngine S220-48P4S 48 Port Gigabit PoE WEB-Managed Switch. Category: Huawei. Subcategory: Network Switch. Price: 92,000৳.
",187,689038,689225
4980,sentence,"Subcategory: Network Switch. Price: 92,000৳.

Product: Huawei eKitEngine S220-48P4X 48 Port Gigabit PoE WEB-Managed Switch. Category: Huawei. Subcategory: Network Switch. Price: 101,000৳.
",188,689180,689368
4981,sentence,"Subcategory: Network Switch. Price: 101,000৳.

Product: Huawei eKitEngine S310-48P4X 48 Port Gigabit PoE Managed Switch. Category: Huawei. Subcategory: Network Switch. Price: 128,000৳.
",185,689322,689507
4982,sentence,"Subcategory: Network Switch. Price: 128,000৳.

Product: Huawei eKitEngine S310-24T4X 24 Port Gigabit Managed Switch. Category: Huawei. Subcategory: Network Switch. Price: Out Of Stock.
",185,689461,689646
4983,sentence,"Price: Out Of Stock.

Product: Huawei eKitEngine S310-24P4X 24 Port Gigabit PoE Managed Switch. Category: Huawei. Subcategory: Network Switch. Price: Out Of Stock.
",164,689625,689789
4984,sentence,"Price: Out Of Stock.

Product: Huawei eKitEngine S310-48P4S 48 Port Gigabit PoE Managed Switch. Category: Huawei. Subcategory: Network Switch. Price: Out Of Stock.
",164,689768,689932
4985,sentence,"Price: Out Of Stock.

Product: Levelone GEP-0823 8-Port Gigabit PoE Unmanaged Switch. Category: Levelone. Subcategory: Network Switch. Price: 9,800৳.
",150,689911,690061
4986,sentence,"Subcategory: Network Switch. Price: 9,800৳.

Product: Levelone GEP-1221 12-Port Gigabit PoE Unmanaged Switch. Category: Levelone. Subcategory: Network Switch. Price: 15,490৳.
",175,690017,690192
4987,sentence,"Subcategory: Network Switch. Price: 15,490৳.

Product: Vsol V1124-2S 24 Port Unmanaged Gigabit Desktop Switch. Category: VSOL. Subcategory: Network Switch. Price: 9,345৳10,500৳.
",178,690147,690325
4988,sentence,"Price: 9,345৳10,500৳.

Product: Vsol V3528E 28 Port Layer 3 Gigabit Managed Switch With SFP Port. Category: VSOL. Subcategory: Network Switch. Price: 27,000৳.
",159,690303,690462
4989,sentence,"Subcategory: Network Switch. Price: 27,000৳.

Product: Vsol V3528-P 28 Port Layer 3 Gigabit POE Managed Switch With SFP Port. Category: VSOL. Subcategory: Network Switch. Price: Up Coming.
",189,690417,690606
4990,sentence,"Subcategory: Network Switch. Price: Up Coming.

Product: Vsol V3552E 48 Port Layer 3 Gigabit Managed Switch With SFP Port. Category: VSOL. Subcategory: Network Switch. Price: Up Coming.
",186,690559,690745
4991,sentence,"Subcategory: Network Switch. Price: Up Coming.

Product: TP-Link TL-WN725N 150Mbps USB WiFi Adapter. Category: TP-Link. Subcategory: WiFi Adapter. Price: 680৳800৳.
",164,690698,690862
4992,sentence,"Subcategory: WiFi Adapter. Price: 680৳800৳.

Product: TP-Link TL-WN823N 300Mbps Mini Wireless N USB WiFi Adapter. Category: TP-Link. Subcategory: WiFi Adapter. Price: 945৳1,050৳.
",179,690818,690997
4993,sentence,"Subcategory: WiFi Adapter. Price: 945৳1,050৳.

Product: TP-Link Archer T2U Nano AC600 Dual Band Mini USB WiFi Adapter. Category: TP-Link. Subcategory: WiFi Adapter. Price: 1,441৳1,549৳.
",186,690951,691137
4994,sentence,"Subcategory: WiFi Adapter. Price: 1,441৳1,549৳.

Product: TP-Link Archer T3U Nano AC1300 Dual Band MU-MIMO USB WiFi Adapter. Category: TP-Link. Subcategory: WiFi Adapter. Price: 1,599৳.
",186,691089,691275
4995,sentence,"Subcategory: WiFi Adapter. Price: 1,599৳.

Product: TP-Link Archer T2U Plus AC600 Dual Band USB WiFi Adapter. Category: TP-Link. Subcategory: WiFi Adapter. Price: 1,534৳1,649৳.
",177,691233,691410
4996,sentence,"Subcategory: WiFi Adapter. Price: 1,534৳1,649৳.

Product: TP-Link Archer TX20U Nano AX1800 Dual Band USB WiFi Adapter. Category: TP-Link. Subcategory: WiFi Adapter. Price: 1,777৳1,890৳.
",186,691362,691548
4997,sentence,"Subcategory: WiFi Adapter. Price: 1,777৳1,890৳.

Product: TP-Link Archer T4U AC1300 High Gain Dual Band USB WiFi Adapter. Category: TP-Link. Subcategory: WiFi Adapter. Price: 1,886৳2,050৳.
",189,691500,691689
4998,sentence,"Subcategory: WiFi Adapter. Price: 1,886৳2,050৳.

Product: TP-Link WN722N 150Mbps High Gain USB WiFi Adapter. Category: TP-Link. Subcategory: WiFi Adapter. Price: Out Of Stock.
",176,691641,691817
4999,sentence,"Subcategory: WiFi Adapter. Price: Out Of Stock.

Product: TP-Link Archer TX20U AX1800 Dual Band Wi-Fi 6 USB Adapter. Category: TP-Link. Subcategory: WiFi Adapter. Price: Out Of Stock.
",184,691769,691953
5000,sentence,"Subcategory: WiFi Adapter. Price: Out Of Stock.

Product: Cisco Firepower 1010 Next-Generation 8 Port Enterprise Firewall. Category: Firewall. Subcategory: Networking. Price: Call for Price.
",191,691905,692096
5001,sentence,"Subcategory: Networking. Price: Call for Price.

Product: Cisco Firepower 1140 Next-Generation 8 Port Enterprise Firewall. Category: Firewall. Subcategory: Networking. Price: Call for Price.
",191,692048,692239
5002,sentence,"Subcategory: Networking. Price: Call for Price.

Product: Cisco Firepower 1150 Next-Generation 8 Port Enterprise Firewall. Category: Firewall. Subcategory: Networking. Price: Call for Price.
",191,692191,692382
5003,sentence,"Subcategory: Networking. Price: Call for Price.

Product: Cisco Firepower 2110 16 Port NGFW Enterprise Firewall. Category: Firewall. Subcategory: Networking. Price: Call for Price.
",181,692334,692515
5004,sentence,"Subcategory: Networking. Price: Call for Price.

Product: SonicWall NSa 2700 16 Port Essential Edition 3-Year License Firewall. Category: Firewall. Subcategory: Networking. Price: Call for Price.
",196,692467,692663
5005,sentence,"Subcategory: Networking. Price: Call for Price.

Product: SonicWall NSa 3700 24 Port Advanced Edition 5-Year License Firewall. Category: Firewall. Subcategory: Networking. Price: Call for Price.
",195,692615,692810
5006,sentence,"Subcategory: Networking. Price: Call for Price.

Product: SonicWall TZ270 8 Port Entry Level Next-Generation Firewall. Category: Firewall. Subcategory: Networking. Price: Call for Price.
",187,692762,692949
5007,sentence,"Subcategory: Networking. Price: Call for Price.

Product: SonicWall TZ270 8 Port Essential Edition 1-Year License Firewall. Category: Firewall. Subcategory: Networking. Price: Call for Price.
",192,692901,693093
5008,sentence,"Subcategory: Networking. Price: Call for Price.

Product: SonicWall TZ370 8 Port Advanced Edition 1-Year License Firewall. Category: Firewall. Subcategory: Networking. Price: Call for Price.
",191,693045,693236
5009,sentence,"Subcategory: Networking. Price: Call for Price.

Product: Cisco Firepower 1120 Next-Generation 8 Port Enterprise Firewall. Category: Firewall. Subcategory: Networking. Price: Up Coming.
",186,693188,693374
5010,sentence,"Subcategory: Networking. Price: Up Coming.

Product: Cudy WU650 AC650 Dual Band Nano USB WiFi Adapter. Category: Cudy. Subcategory: WiFi Adapter. Price: 880৳1,000৳.
",165,693331,693496
5011,sentence,"Subcategory: WiFi Adapter. Price: 880৳1,000৳.

Product: Cudy WU1300S AC1300 High Gain Dual Band USB WiFi Adapter. Category: Cudy. Subcategory: WiFi Adapter. Price: 1,274৳1,200৳.
",178,693450,693628
5012,sentence,"Subcategory: WiFi Adapter. Price: 1,274৳1,200৳.

Product: Cudy WE3000 V1 AX3000 Dual-Band Wi-Fi 6 PCIe Adapter. Category: Cudy. Subcategory: WiFi Adapter. Price: 3,050৳.
",170,693580,693750
5013,sentence,"Subcategory: WiFi Adapter. Price: 3,050৳.

Product: Cudy WE9300 BE9300 9300Mbps Tri-Band WiFi 7 PCI-E Adapter. Category: Cudy. Subcategory: WiFi Adapter. Price: 6,400৳.
",169,693708,693877
5014,sentence,"Subcategory: WiFi Adapter. Price: 6,400৳.

Product: Cudy WU1400 AC1300 High Gain Dual Band USB WiFi Adapter. Category: Cudy. Subcategory: WiFi Adapter. Price: Out Of Stock.
",173,693835,694008
5015,sentence,"Subcategory: WiFi Adapter. Price: Out Of Stock.

Product: Vention KDRB0 USB Dual Band Wi-Fi Adapter. Category: Vention. Subcategory: WiFi Adapter. Price: 600৳.
",160,693960,694120
5016,sentence,"Subcategory: WiFi Adapter. Price: 600৳.

Product: Vention KDTB0 AC650 USB Dual Band Wi-Fi Adapter. Category: Vention. Subcategory: WiFi Adapter. Price: 1,075৳.
",160,694080,694240
5017,sentence,"Subcategory: WiFi Adapter. Price: 1,075৳.

Product: Mercusys MW150US N150 Nano USB WiFi Adapter. Category: WiFi Adapter. Subcategory: Networking. Price: 400৳500৳.
",163,694198,694361
5018,sentence,"Subcategory: Networking. Price: 400৳500৳.

Product: Tenda W311MI AX300 Nano USB WiFi Adapter. Category: WiFi Adapter. Subcategory: Networking. Price: 446৳550৳.
",160,694319,694479
5019,sentence,"Subcategory: Networking. Price: 446৳550৳.

Product: Mercusys MA14N AX300 Wireless USB Wi-Fi Adapter. Category: WiFi Adapter. Subcategory: Networking. Price: 500৳550৳.
",167,694437,694604
5020,sentence,"Subcategory: Networking. Price: 500৳550৳.

Product: Yuanxin X-5501 150Mbps USB Wi-Fi Adapter. Category: WiFi Adapter. Subcategory: Networking. Price: 498৳600৳.
",160,694562,694722
5021,sentence,"Subcategory: Networking. Price: 498৳600৳.

Product: Mercusys MU6H AC650 Dual Band USB WiFi Adapter. Category: WiFi Adapter. Subcategory: Networking. Price: 792৳900৳.
",166,694680,694846
5022,sentence,"Subcategory: Networking. Price: 792৳900৳.

Product: Yuanxin X-5502 300Mbps Single Band USB Wi-Fi Adapter. Category: WiFi Adapter. Subcategory: Networking. Price: 783৳900৳.
",172,694804,694976
5023,sentence,"Subcategory: Networking. Price: 783৳900৳.

Product: Mercusys MA20N AC650 Nano Dual-Band USB Wi-Fi Adapter. Category: WiFi Adapter. Subcategory: Networking. Price: 750৳770৳.
",173,694934,695107
5024,sentence,"Subcategory: Networking. Price: 750৳770৳.

Product: Tenda U2 AX300 USB High Gain Wi-Fi Adapter. Category: WiFi Adapter. Subcategory: Networking. Price: 990৳1,100৳.
",164,695065,695229
5025,sentence,"Subcategory: Networking. Price: 990৳1,100৳.

Product: Mercusys MA30H AC1300 Dual Band USB Wi-Fi Adapter. Category: WiFi Adapter. Subcategory: Networking. Price: 990৳1,100৳.
",173,695185,695358
5026,sentence,"Subcategory: Networking. Price: 990৳1,100৳.

Product: Yuanxin X-5503 650Mbps Dual Band USB Wi-Fi Adapter. Category: WiFi Adapter. Subcategory: Networking. Price: 1,092৳1,200৳.
",176,695314,695490
5027,sentence,"Subcategory: Networking. Price: 1,092৳1,200৳.

Product: Yuanxin X-5505 1300Mbps Dual Band USB Wi-Fi Adapter. Category: WiFi Adapter. Subcategory: Networking. Price: 1,350৳1,500৳.
",179,695444,695623
5028,sentence,"Subcategory: Networking. Price: 1,350৳1,500৳.

Product: Vention IBEBI 3M Cat.6 UTP Patch Cord Cable. Category: Patch Cord. Subcategory: Networking. Price: 250৳.
",161,695577,695738
5029,sentence,"Subcategory: Networking. Price: 250৳.

Product: Vention IBOBG 1.5M Cat.6 UTP Right Angle Patch Cord Cable. Category: Patch Cord. Subcategory: Networking. Price: 275৳.
",167,695700,695867
5030,sentence,"Subcategory: Networking. Price: 275৳.

Product: Safenet 34-3011YL 1 Meter Cat6 LSZH UTP Patch Cord Yellow. Category: Patch Cord. Subcategory: Networking. Price: 300৳.
",167,695829,695996
5031,sentence,"Subcategory: Networking. Price: 300৳.

Product: Safenet 34-3011PR 1 Meter Cat6 LSZH UTP Patch Cord Purple. Category: Patch Cord. Subcategory: Networking. Price: 300৳.
",167,695958,696125
5032,sentence,"Subcategory: Networking. Price: 300৳.

Product: Safenet 2414-3031YL 3 Meter SM Duplex Fiber LC/APC Patch Cord. Category: Patch Cord. Subcategory: Networking. Price: 300৳.
",171,696087,696258
5033,sentence,"Subcategory: Networking. Price: 300৳.

Product: Safenet 34-5011X-BL 1 Meter Cat6 LSZH UTP Patch Cord Blue. Category: Patch Cord. Subcategory: Networking. Price: 300৳.
",167,696220,696387
5034,sentence,"Subcategory: Networking. Price: 300৳.

Product: Vention IBNBG LSZH 1.5M Cat6 UTP Patch Cord Cable. Category: Patch Cord. Subcategory: Networking. Price: 325৳.
",159,696349,696508
5035,sentence,"Subcategory: Networking. Price: 325৳.

Product: Rosenberger CP61-423-1P0 0.5 Meter Cat 6 UTP Patch Cord Blue. Category: Patch Cord. Subcategory: Networking. Price: 350৳.
",170,696470,696640
5036,sentence,"Subcategory: Networking. Price: 350৳.

Product: Rosenberger CP61-425-1P0 0.5 Meter Cat 6 UTP Patch Cord Red. Category: Patch Cord. Subcategory: Networking. Price: 350৳.
",169,696602,696771
5037,sentence,"Subcategory: Networking. Price: 350৳.

Product: Rosenberger CP61-422-1P0 0.5 Meter Cat 6 UTP Patch Cord Yellow. Category: Patch Cord. Subcategory: Networking. Price: 350৳.
",172,696733,696905
5038,sentence,"Subcategory: Networking. Price: 350৳.

Product: Safenet 44-5551OR 0.5 Meter Cat6A SFTP Stranded LSZH Patch Cord. Category: Patch Cord. Subcategory: Networking. Price: 350৳.
",173,696867,697040
5039,sentence,"Subcategory: Networking. Price: 350৳.

Product: Vention IBHYG 1.5M Cat.6A SFTP Patch Cord Cable Yellow. Category: Patch Cord. Subcategory: Networking. Price: 350৳.
",164,697002,697166
5040,sentence,"Subcategory: Networking. Price: 350৳.

Product: Tenda U1 300Mbps Ultra-Fast USB WiFi Adapter. Category: Tenda. Subcategory: WiFi Adapter. Price: Out Of Stock.
",159,697128,697287
5041,sentence,"Subcategory: WiFi Adapter. Price: Out Of Stock.

Product: Ficer FAOC-40G-QPSP-010 10 Meter OM3 Multi-Mode AOC Cable. Category: Fiber Optic Cable. Subcategory: Networking Cable. Price: 22,000৳.
",193,697239,697432
5042,sentence,"Subcategory: Networking Cable. Price: 22,000৳.

Product: Ficer FAOC-40G-QPQP-010 10 Meter OM3 Multi-Mode AOC Cable. Category: Fiber Optic Cable. Subcategory: Networking Cable. Price: 22,500৳.
",192,697385,697577
5043,sentence,"Subcategory: Networking Cable. Price: 22,500৳.

Product: R&M 12 Port Fiber Rack Mount LIU loaded with Singlemode 6x SC-PC DX Adapters. Category: Fiber Optic Cable. Subcategory: Networking Cable. ",195,697530,697725
5044,sentence,"Subcategory: Networking Cable. Price: Call for Price.

Product: R&M 24 Port Fiber Rack Mount LIU loaded with Singlemode 12x SC-PC DX Adapters. Category: Fiber Optic Cable. ",172,697694,697866
5045,sentence,"Category: Fiber Optic Cable. Subcategory: Networking Cable. Price: Call for Price.

Product: R&M 6 Core Armoured Single Mode Loose Tube Fiber Optic Cable. Category: Fiber Optic Cable. ",184,697837,698021
5046,sentence,"Category: Fiber Optic Cable. Subcategory: Networking Cable. Price: Call for Price.

Product: R&M 12 Port Fiber Rack Mount LIU loaded with Singlemode 6x LC-PC DX Adapters. ",171,697992,698163
5047,sentence,"Category: Fiber Optic Cable. Subcategory: Networking Cable. Price: Call for Price.

Product: R&M 12 Port Fiber Rack Mount LIU loaded with Multimode 6x SC-PC DX Adapters. Category: Fiber Optic Cable. ",199,698163,698362
5048,sentence,"Category: Fiber Optic Cable. Subcategory: Networking Cable. Price: Call for Price.

Product: R&M 6 Port Fiber Rack Mount LIU loaded with Multimode 3x SC-PC DX Adapters. Category: Fiber Optic Cable. ",198,698333,698531
5049,sentence,"Category: Fiber Optic Cable. Subcategory: Networking Cable. Price: Call for Price.

Product: R&M 24 Port Fiber Rack Mount LIU loaded with Singlemode 12x LC-PC DX Adapters. ",172,698502,698674
5050,sentence,"Category: Fiber Optic Cable. Subcategory: Networking Cable. Price: Call for Price.

Product: R&M LCPC-LCPC OS2 Single Mode Fiber Optic Patch Cord 3 Meter. Category: Fiber Optic Cable. ",184,698674,698858
5051,sentence,"Category: Fiber Optic Cable. Subcategory: Networking Cable. Price: Call for Price.

Product: R&M SCPC-SCPC OS2 Single Mode Fiber Optic Patch Cord 3 Meter. Category: Fiber Optic Cable. ",184,698829,699013
5052,sentence,"Category: Fiber Optic Cable. Subcategory: Networking Cable. Price: Call for Price.

Product: R&M LCPC-SCPC OS2 Single Mode Fiber Optic Patch Cord 3 Meter. Category: Fiber Optic Cable. ",184,698984,699168
5053,sentence,"Category: Fiber Optic Cable. Subcategory: Networking Cable. Price: Call for Price.

Product: R&M LCPC-SCPC OM3 Multi Mode Fiber Optic Patch Cord 3 Meter. Category: Fiber Optic Cable. ",183,699139,699322
5054,sentence,"Category: Fiber Optic Cable. Subcategory: Networking Cable. Price: Call for Price.

Product: R&M LCPC-SCPC OM3 Multi Mode Fiber Optic Patch Cord 1 Meter. Category: Fiber Optic Cable. ",183,699293,699476
5055,sentence,"Category: Fiber Optic Cable. Subcategory: Networking Cable. Price: Call for Price.

Product: R&M SCPC-SCPC OM3 Multi Mode Fiber Optic Patch Cord 3 Meter. Category: Fiber Optic Cable. ",183,699447,699630
5056,sentence,"Category: Fiber Optic Cable. Subcategory: Networking Cable. Price: Call for Price.

Product: R&M SCPC-SCPC OM3 Multi Mode Fiber Optic Patch Cord 1 Meter. Category: Fiber Optic Cable. ",183,699601,699784
5057,sentence,"Category: Fiber Optic Cable. Subcategory: Networking Cable. Price: Call for Price.

Product: R&M LCPC OS2 Single Mode Fiber Optic Pigtail 1.5 Meter. Category: Fiber Optic Cable. ",178,699755,699933
5058,sentence,"Category: Fiber Optic Cable. Subcategory: Networking Cable. Price: Call for Price.

Product: R&M SCPC OS2 Single Mode Fiber Optic Pigtail 1.5 Meter. Category: Fiber Optic Cable. ",178,699904,700082
5059,sentence,"Category: Fiber Optic Cable. Subcategory: Networking Cable. Price: Call for Price.

Product: R&M 12 Core Armoured Single Mode Loose Tube Fiber Optic Cable. Category: Fiber Optic Cable. ",185,700053,700238
5060,sentence,"Category: Fiber Optic Cable. Subcategory: Networking Cable. Price: Up Coming.

Product: R&M 6 Core Armoured Multi Mode Loose Tube Fiber Optic Cable. Category: Fiber Optic Cable. ",178,700209,700387
5061,sentence,"Category: Fiber Optic Cable. Subcategory: Networking Cable. Price: Up Coming.

Product: TRENDnet TEW-808UBM Micro AC1200 Dual Band USB WiFi Adapter. Category: TRENDnet. Subcategory: WiFi Adapter. ",196,700358,700554
5062,sentence,"Category: TRENDnet. Subcategory: WiFi Adapter. Price: 2,025৳2,250৳.

Product: TRENDnet TBW-108UB Micro N150 Wireless & Bluetooth USB Adapter. Category: TRENDnet. Subcategory: WiFi Adapter. ",189,700507,700696
5063,sentence,"Category: TRENDnet. Subcategory: WiFi Adapter. Price: Out Of Stock.

Product: Nexakey NX-SL48C6 305 Meter CCA UTP Cable. Category: Networking Cable. Subcategory: Networking. Price: 3,800৳.
",189,700649,700838
5064,sentence,"Subcategory: Networking. Price: 3,800৳.

Product: Pro Tech PTN-C6-CCAM-IN-OR 305M CAT6 UTP Cable Orange. Category: Networking Cable. Subcategory: Networking. Price: 4,200৳.
",173,700798,700971
5065,sentence,"Subcategory: Networking. Price: 4,200৳.

Product: Pro Tech PTN-C6-CCAM-OUT-STD-BK 305M CAT6 UTP Cable Black. Category: Networking Cable. Subcategory: Networking. Price: 6,500৳.
",177,700931,701108
5066,sentence,"Subcategory: Networking. Price: 6,500৳.

Product: Pro Tech PTN-C6-CCAM-IN-WH 305M CAT6 UTP Cable White. Category: Networking Cable. Subcategory: Networking. Price: 4,200৳.
",172,701068,701240
5067,sentence,"Subcategory: Networking. Price: 4,200৳.

Product: D-link NCB-C6UGRYR-100 Cat6 UTP Cable. Category: Networking Cable. Subcategory: Networking. Price: 6,300৳.
",157,701200,701357
5068,sentence,"Subcategory: Networking. Price: 6,300৳.

Product: Safenet 32-3101OR 100 Meter Cat6 23AWG LSZH Solid UTP Cable Orange. Category: Networking Cable. Subcategory: Networking. Price: 6,500৳.
",186,701317,701503
5069,sentence,"Subcategory: Networking. Price: 6,500৳.

Product: Dahua PFM922I-6UN-C CAT6 305 Meter UTP Cable (Orange/White). Category: Networking Cable. Subcategory: Networking. Price: 8,200৳.
",179,701463,701642
5070,sentence,"Subcategory: Networking. Price: 8,200৳.

Product: Hikvision DS-1LN6UU/CCA 305 Meter CAT6 UTP Cable. Category: Networking Cable. Subcategory: Networking. Price: 8,300৳.
",168,701602,701770
5071,sentence,"Subcategory: Networking. Price: 8,300৳.

Product: COTE CC-2306-305M-CCA 305M Cat-6 UTP Cable Blue. Category: Networking Cable. Subcategory: Networking. Price: 7,990৳8,500৳.
",173,701730,701903
5072,sentence,"Subcategory: Networking. Price: 7,990৳8,500৳.

Product: Pro Tech PTN-C6-CCA-IN-GY 305M CAT6 UTP Cable Grey. Category: Networking Cable. Subcategory: Networking. Price: 8,500৳.
",176,701857,702033
5073,sentence,"Subcategory: Networking. Price: 8,500৳.

Product: Hikvision DS-1LN6U-SC0 CAT6 305 Meter UTP Cable (Orange). Category: Networking Cable. Subcategory: Networking. Price: 14,900৳.
",177,701993,702170
5074,sentence,"Subcategory: Networking. Price: 14,900৳.

Product: Dahua DH-PFM920I-6UN-C CAT6 305 Meter UTP Cable Full Box. Category: Networking Cable. Subcategory: Networking. Price: Up Coming.
",180,702129,702309
5075,sentence,"Subcategory: Networking. Price: Up Coming.

Product: D-Link Cat 6 UTP 24AWG Cable Full Box (305 Meters). Category: Networking Cable. Subcategory: Networking. Price: 15,500৳.
",174,702266,702440
5076,sentence,"Subcategory: Networking. Price: 15,500৳.

Product: Safenet 32-3350GR 305 Meter Cat6 23AWG Solid UTP Cable. Category: Networking Cable. Subcategory: Networking. Price: 15,700৳.
",176,702399,702575
5077,sentence,"Subcategory: Networking. Price: 15,700৳.

Product: Safenet 32-3350BL 305 Meter Cat6 23AWG Solid UTP Cable Blue. Category: Networking Cable. Subcategory: Networking. Price: 15,700৳.
",181,702534,702715
5078,sentence,"Subcategory: Networking. Price: 15,700৳.

Product: D-Link CAT 6 UTP Cable 305M 23AWG Grey (Original). Category: Networking Cable. Subcategory: Networking. Price: 16,700৳.
",171,702674,702845
5079,sentence,"Subcategory: Networking. Price: 16,700৳.

Product: Safenet 32-3351OR 305 Meter Cat6 23AWG LSZH Solid UTP Cable Orange. Category: Networking Cable. Subcategory: Networking. Price: 16,550৳16,900৳.
",195,702804,702999
5080,sentence,"Subcategory: Networking. Price: 16,550৳16,900৳.

Product: Safenet 32-3351WT 305 Meter Cat6 23AWG LSZH Solid UTP Cable White. Category: Networking Cable. Subcategory: Networking. Price: 16,900৳.
",194,702951,703145
5081,sentence,"Subcategory: Networking. Price: 16,900৳.

Product: Rosenberger Cat6 UTP LSZH Cable. Category: Networking Cable. Subcategory: Networking. Price: 18,000৳.
",153,703104,703257
5082,sentence,"Subcategory: Networking. Price: 18,000৳.

Product: Safenet 32-3351BK 305 Meter Cat6 23AWG LSZH Solid UTP Cable Black. Category: Networking Cable. Subcategory: Networking. Price: 18,000৳.
",187,703216,703403
5083,sentence,"Subcategory: Networking. Price: 18,000৳.

Product: Cudy PE10 Single Port PCI Express Gigabit Lan Card. Category: LAN Card. Subcategory: Networking. Price: 696৳800৳.

Product: ORICO PTR-SU LAN Card. ",198,703362,703560
5084,sentence,"
Product: ORICO PTR-SU LAN Card. Category: LAN Card. Subcategory: Networking. Price: 680৳800৳.

Product: Yuanxin X-D2501 USB2.0 to RJ45 100Mbps Ethernet Adapter. Category: LAN Card. ",182,703527,703709
5085,sentence,"Category: LAN Card. Subcategory: Networking. Price: 650৳800৳.

Product: TP-Link UE200 USB 2.0 to 100Mbps Ethernet Network Adapter. Category: LAN Card. Subcategory: Networking. Price: 879৳999৳.
",193,703689,703882
5086,sentence,"Subcategory: Networking. Price: 879৳999৳.

Product: TP-Link TL-WN781ND 150Mbps Wireless N PCI Express LAN Card. Category: LAN Card. Subcategory: Networking. Price: 1,034৳1,149৳.
",178,703840,704018
5087,sentence,"Subcategory: Networking. Price: 1,034৳1,149৳.

Product: TP-Link TG-3468 10/100/1000  Pci Express Gigabit LAN Card. Category: LAN Card. Subcategory: Networking. Price: 1,097৳1,219৳.
",181,703972,704153
5088,sentence,"Subcategory: Networking. Price: 1,097৳1,219৳.

Product: TP-Link UE306 USB 3.0 to Gigabit Ethernet Network Adapter. Category: LAN Card. Subcategory: Networking. Price: 1,195৳1,299৳.
",181,704107,704288
5089,sentence,"Subcategory: Networking. Price: 1,195৳1,299৳.

Product: TP-Link Archer T2E AC600 Dual Band Wi-Fi LAN Card. Category: LAN Card. Subcategory: Networking. Price: 1,170৳1,300৳.
",173,704242,704415
5090,sentence,"Subcategory: Networking. Price: 1,170৳1,300৳.

Product: TP-Link UE300C USB Type-C to RJ45 Gigabit Ethernet Network Adapter. Category: LAN Card. Subcategory: Networking. Price: 1,213৳1,319৳.
",190,704369,704559
5091,sentence,"Subcategory: Networking. Price: 1,213৳1,319৳.

Product: Ugreen CM204 1.5M USB-A to RJ45 Ethernet Adapter #50773. Category: LAN Card. Subcategory: Networking. Price: 1,320৳.
",173,704513,704686
5092,sentence,"Subcategory: Networking. Price: 1,320৳.

Product: TP-Link TL-WN881ND 300Mbps Wireless PCI LAN Card. Category: LAN Card. Subcategory: Networking. Price: 1,226৳1,409৳.
",166,704646,704812
5093,sentence,"Subcategory: Networking. Price: 1,226৳1,409৳.

Product: Vention CEHBB USB 3.0 to Gigabit Ethernet Adapter. Category: LAN Card. Subcategory: Networking. Price: 1,365৳1,500৳.
",173,704766,704939
5094,sentence,"Subcategory: Networking. Price: 1,365৳1,500৳.

Product: Baseus Hub Lite Series Type-C To RJ45 Ethernet Adapter. Category: LAN Card. Subcategory: Networking. Price: 1,600৳.
",172,704893,705065
5095,sentence,"Subcategory: Networking. Price: 1,600৳.

Product: Cudy PE25 2.5Gbps PCI Express LAN Card. Category: LAN Card. Subcategory: Networking. Price: 1,700৳.
",150,705025,705175
5096,sentence,"Subcategory: Networking. Price: 1,700৳.

Product: UGREEN CM209 USB-A To Ethernet Adapter #50922. Category: LAN Card. Subcategory: Networking. Price: 1,700৳.
",157,705135,705292
5097,sentence,"Subcategory: Networking. Price: 1,700৳.

Product: Levelone WNC-0601 300Mbps Wireless PCI LAN Card. Category: LAN Card. Subcategory: Networking. Price: 1,799৳.
",159,705252,705411
5098,sentence,"Subcategory: Networking. Price: 1,799৳.

Product: TP-Link Archer T4E AC1200 Dual Band Wi-Fi LAN Card. Category: LAN Card. Subcategory: Networking. Price: 1,786৳1,900৳.
",168,705371,705539
5099,sentence,"Subcategory: Networking. Price: 1,786৳1,900৳.

Product: TRENDnet TEG-10GECTX 10 Gigabit PCIe LAN Card. Category: LAN Card. Subcategory: Networking. Price: 11,700৳.
",164,705493,705657
5100,sentence,"Subcategory: Networking. Price: 11,700৳.

Product: TRENDnet TEG-10GECSFP 10 Gigabit PCIe SFP+ Network Adapter. Category: LAN Card. Subcategory: Networking. Price: 11,700৳.
",172,705616,705788
5101,sentence,"Subcategory: Networking. Price: 11,700৳.

Product: Baseus Lite Series RJ45 LAN Port Ethernet Adapter. Category: LAN Card. Subcategory: Networking. Price: Out Of Stock.
",168,705747,705915
5102,sentence,"Subcategory: Networking. Price: Out Of Stock.

Product: Rosenberger CAT.6 UTP Cable 305M (Original). Category: UTP Cable. Subcategory: Networking Cable. Price: 17,000৳.
",169,705869,706038
5103,sentence,"Subcategory: Networking Cable. Price: 17,000৳.

Product: R&M R795138 Cat-6 U/UTP 305 Meter Network Cable. Category: UTP Cable. Subcategory: Networking Cable. Price: 14,500৳17,500৳.
",181,705991,706172
5104,sentence,"Price: 14,500৳17,500৳.

Product: Solitine SOL2001-SP 1 Port 10G Layer 3 GPON OLT. Category: OLT. Subcategory: Networking. Price: 35,000৳.

Product: Solitine SOL1002-SP 2 Port 10G EPON OLT. ",189,706149,706338
5105,sentence,"Category: OLT. Subcategory: Networking. Price: 36,000৳.

Product: Solitine SOL1004-1G-DP 4 Port 1G EPON OLT. Category: OLT. Subcategory: Networking. Price: 46,500৳.
",165,706338,706503
5106,sentence,"Subcategory: Networking. Price: 46,500৳.

Product: Solitine SOL1004-DP 4 Port 10G EPON OLT. Category: OLT. Subcategory: Networking. Price: 47,000৳49,500৳.
",155,706462,706617
5107,sentence,"Subcategory: Networking. Price: 47,000৳49,500৳.

Product: Solitine SOL1008-DP 8 Port 10G EPON OLT. Category: OLT. Subcategory: Networking. Price: 78,500৳.
",155,706569,706724
5108,sentence,"Subcategory: Networking. Price: 78,500৳.

Product: C-Data FD1604SN-B0-NDA0 G-PON OLT. Category: OLT. Subcategory: Networking. Price: 92,000৳.

Product: Solitine SOL2004-GPON-DP 4 Port 10G GPON OLT. ",198,706683,706881
5109,sentence,"Category: OLT. Subcategory: Networking. Price: 93,000৳.

Product: BDCOM GP3600-04D-2AC 4-Port GPON OLT. Category: OLT. Subcategory: Networking. Price: 94,500৳.
",160,706881,707041
5110,sentence,"Subcategory: Networking. Price: 94,500৳.

Product: BDCOM GP3600-04L-2AC 4-Port GPON OLT. Category: OLT. Subcategory: Networking. Price: 94,500৳.

Product: Vsol V1600G0-B 4 Port GPON OLT. ",187,707000,707187
5111,sentence,"
Product: Vsol V1600G0-B 4 Port GPON OLT. Category: OLT. Subcategory: Networking. Price: 99,000৳.

Product: Solitine SOL2008-GPON-DP 8 Port 10G GPON OLT. Category: OLT. Subcategory: Networking. ",194,707145,707339
5112,sentence,"Category: OLT. Subcategory: Networking. Price: 136,000৳138,500৳.

Product: C-Data FD1616SN-B0-NDA0 16 Port G-PON OLT. Category: OLT. Subcategory: Networking. Price: 235,000৳.
",175,707299,707474
5113,sentence,"Subcategory: Networking. Price: 235,000৳.

Product: Richerlink RL8004EL 4 port EPON OLT. Category: OLT. Subcategory: Networking. Price: Out Of Stock.

Product: BDCOM P3310C-2AC 4-Port EPON OLT. ",194,707432,707626
5114,sentence,"
Product: BDCOM P3310C-2AC 4-Port EPON OLT. Category: OLT. Subcategory: Networking. Price: Out Of Stock.

Product: C-Data FD1104SN-R1-DAP EPON 1U OLT. Category: OLT. Subcategory: Networking. ",191,707582,707773
5115,sentence,"Category: OLT. Subcategory: Networking. Price: Out Of Stock.

Product: C-Data FD1204S-B0-NDA0 4 Port E-PON OLT. Category: OLT. Subcategory: Networking. Price: Out Of Stock.
",173,707733,707906
5116,sentence,"Subcategory: Networking. Price: Out Of Stock.

Product: BDCOM P3600-04-2AC 4-Port 10G EPON OLT. Category: OLT. Subcategory: Networking. Price: Out Of Stock.
",157,707860,708017
5117,sentence,"Subcategory: Networking. Price: Out Of Stock.

Product: Richerlink RL8008ES 8 port EPON OLT. Category: OLT. Subcategory: Networking. Price: Out Of Stock.
",154,707971,708125
5118,sentence,"Subcategory: Networking. Price: Out Of Stock.

Product: Richerlink RL8004GL 4 port GPON OLT. Category: OLT. Subcategory: Networking. Price: Out Of Stock.

Product: Vsol V1600D8 8 Port EPON OLT. ",194,708079,708273
5119,sentence,"
Product: Vsol V1600D8 8 Port EPON OLT. Category: OLT. Subcategory: Networking. Price: Out Of Stock.

Product: UGREEN NW114 RJ45 Ethernet Connector #20390. Category: Connector. ",177,708233,708410
5120,sentence,"Category: Connector. Subcategory: Networking. Price: 250৳.

Product: D-Link NKJ-C6WHI1B21 Cat6 UTP Keystone Jack. Category: Connector. Subcategory: Networking. Price: 320৳.
",173,708389,708562
5121,sentence,"Subcategory: Networking. Price: 320৳.

Product: UGREEN NW116 Anti-thunder RJ45 Ethernet Connector #30837. Category: Connector. Subcategory: Networking. Price: Out Of Stock.
",173,708524,708697
5122,sentence,"Subcategory: Networking. Price: Out Of Stock.

Product: Safenet 35-3010BL Cat6 Modular Jack Blue. Category: Connector. Subcategory: Networking. Price: 350৳.
",157,708651,708808
5123,sentence,"Subcategory: Networking. Price: 350৳.

Product: Safenet 35-3010YL Cat6 Modular Jack Yellow. Category: Connector. Subcategory: Networking. Price: 350৳.
",151,708770,708921
5124,sentence,"Subcategory: Networking. Price: 350৳.

Product: CommScope 1375055-6 SL 110 Cat 6 U/UTP Information Outlet Modular jack. Category: Connector. Subcategory: Networking. Price: 350৳.
",179,708883,709062
5125,sentence,"Subcategory: Networking. Price: 350৳.

Product: Vention IODB0-50 RJ45 Strain Relief Boots. Category: Connector. Subcategory: Networking. Price: 300৳350৳.
",154,709024,709178
5126,sentence,"Subcategory: Networking. Price: 300৳350৳.

Product: Vention IODH0-50 RJ45 Strain Relief Boots. Category: Connector. Subcategory: Networking. Price: 350৳.
",154,709136,709290
5127,sentence,"Subcategory: Networking. Price: 350৳.

Product: Vention IODL0-50 RJ45 Strain Relief Boots Blue. Category: Connector. Subcategory: Networking. Price: 350৳.
",155,709252,709407
5128,sentence,"Subcategory: Networking. Price: 350৳.

Product: Dintek 1305-04017 Cat6 Keystone E-jack. Category: Connector. Subcategory: Networking. Price: 370৳.
",147,709369,709516
5129,sentence,"Subcategory: Networking. Price: 370৳.

Product: Safenet 35-3010WT Cat6 Modular Jack White. Category: Connector. Subcategory: Networking. Price: 390৳.
",150,709478,709628
5130,sentence,"Subcategory: Networking. Price: 390৳.

Product: Hikvision DS-1CK6AP180N Cat6a RJ45 Keystone Jack. Category: Connector. Subcategory: Networking. Price: 390৳.
",157,709590,709747
5131,sentence,"Subcategory: Networking. Price: 390৳.

Product: CommScope SL110-6-BL Cat 6 RJ45 Modular Jack. Category: Connector. Subcategory: Networking. Price: 320৳420৳.
",157,709709,709866
5132,sentence,"Subcategory: Networking. Price: 320৳420৳.

Product: CommScope SL110-6-RD Cat 6 RJ45 Modular Jack. Category: Connector. Subcategory: Networking. Price: 420৳.
",157,709824,709981
5133,sentence,"Subcategory: Networking. Price: 420৳.

Product: CommScope SL110-6-YL Cat 6 RJ45 Modular Jack. Category: Connector. Subcategory: Networking. Price: 420৳.
",153,709943,710096
5134,sentence,"Subcategory: Networking. Price: 420৳.

Product: CommScope SL110-6-GN Cat 6 RJ45 Modular Jack. Category: Connector. Subcategory: Networking. Price: 420৳.
",153,710058,710211
5135,sentence,"Subcategory: Networking. Price: 420৳.

Product: R&M R810598 CAT6 Connection Module for Panel. Category: Connector. Subcategory: Networking. Price: 450৳.
",153,710173,710326
5136,sentence,"Subcategory: Networking. Price: 450৳.

Product: Rosenberger Cat-6 UTP 90 Degree Toolless Ivory Pegasus (Module#CP31-13C-14). Category: Connector. Subcategory: Networking. Price: 450৳.
",184,710288,710472
5137,sentence,"Subcategory: Networking. Price: 450৳.

Product: UGREEN NW116 RJ45 Ethernet Connector #20391. Category: Connector. Subcategory: Networking. Price: 450৳.
",152,710434,710586
5138,sentence,"Subcategory: Networking. Price: 450৳.

Product: Micronet Cat 6 RJ45 Cable Connector-Pack Of 20 Pieces. Category: Connector. Subcategory: Networking. Price: 540৳650৳.
",166,710548,710714
5139,sentence,"Subcategory: Networking. Price: 540৳650৳.

Product: AC Net F-95X Optical Fiber ARC Splicer Machine. Category: Splicer Machine. Subcategory: Networking. Price: 108,000৳.
",169,710672,710841
5140,sentence,"Subcategory: Networking. Price: 108,000৳.

Product: FiberFox Mini 3S Active V-Groov Clade Splicer Machine. Category: Splicer Machine. Subcategory: Networking. Price: 142,000৳143,500৳.
",184,710799,710983
5141,sentence,"Price: 142,000৳143,500৳.

Product: FiberFox Mini 6SI+ Core to Core 6 Motors Set Splicer Machine. Category: Splicer Machine. Subcategory: Networking. Price: 285,000৳.
",166,710958,711124
5142,sentence,"Subcategory: Networking. Price: 285,000৳.

Product: FiberFox Mini 4S+ Active V-Groov Clade Splicer Machine. Category: Splicer Machine. Subcategory: Networking. Price: Out Of Stock.
",181,711082,711263
5143,sentence,"Subcategory: Networking. Price: Out Of Stock.

Product: FiberFox Mini 5C+ Core to Core 6 Motors Set Splicer Machine. Category: Splicer Machine. Subcategory: Networking. Price: Out Of Stock.
",190,711217,711407
5144,sentence,"Subcategory: Networking. Price: Out Of Stock.

Product: TRENDnet TPE-113GI Gigabit PoE Injector. Category: PoE Injector. Subcategory: Networking. Price: 3,000৳.
",161,711361,711522
5145,sentence,"Subcategory: Networking. Price: 3,000৳.

Product: TRENDnet TPE-115GI Gigabit PoE Injector. Category: PoE Injector. Subcategory: Networking. Price: 4,200৳.
",155,711482,711637
5146,sentence,"Subcategory: Networking. Price: 4,200৳.

Product: TRENDnet TPE-E100 Gigabit PoE+ Repeater. Category: PoE Injector. Subcategory: Networking. Price: 5,500৳.
",155,711597,711752
5147,sentence,"Subcategory: Networking. Price: 5,500৳.

Product: Tenda POE15F 10/100Mbps PoE Injector. Category: PoE Injector. Subcategory: Networking. Price: Out Of Stock.
",158,711712,711870
5148,sentence,"Subcategory: Networking. Price: Out Of Stock.

Product: Tplink TL-POE150S Gigabit PoE Injector. Category: PoE Injector. Subcategory: Networking. Price: Out Of Stock.
",166,711824,711990
5149,sentence,"Subcategory: Networking. Price: Out Of Stock.

Product: Tenda PoE30G-AT PoE Injector. Category: PoE Injector. Subcategory: Networking. Price: Out Of Stock.
",156,711944,712100
5150,sentence,"Subcategory: Networking. Price: Out Of Stock.

Product: D-link DEM-310GT 1000 BASE-LX Single-Mode 10 Km LC SFP Module Transceiver (Single Unit). Category: Network Transceivers. ",177,712054,712231
5151,sentence,"Category: Network Transceivers. Subcategory: Networking. Price: 1,550৳1,900৳.

Product: Grandstream F-MM850-550M-1.25G Multi-Mode SFP Fiber Module. Category: Network Transceivers. ",180,712199,712379
5152,sentence,"Category: Network Transceivers. Subcategory: Networking. Price: 1,950৳.

Product: Ficer FSFP-C7-S13-20D LC Duplex SFP Transceiver. Category: Network Transceivers. Subcategory: Networking. ",188,712347,712535
5153,sentence,"Subcategory: Networking. Price: 2,000৳.

Product: IP-COM G311SM Single-Mode Optical Fiber Module. Category: Network Transceivers. Subcategory: Networking. Price: 2,300৳2,600৳.
",176,712510,712686
5154,sentence,"Subcategory: Networking. Price: 2,300৳2,600৳.

Product: BDCOM OLT-GSFP-20+++ EPON Module. Category: Network Transceivers. Subcategory: Networking. Price: 2,625৳.
",162,712640,712802
5155,sentence,"Subcategory: Networking. Price: 2,625৳.

Product: TRENDnet TEG-MGBS20 Single Mode LC SFP Module. Category: Network Transceivers. Subcategory: Networking. Price: 3,000৳.
",169,712762,712931
5156,sentence,"Subcategory: Networking. Price: 3,000৳.

Product: BDCOM OLT-GSFP-C++ GPON Module. Category: Network Transceivers. Subcategory: Networking. Price: 3,360৳.
",154,712891,713045
5157,sentence,"Subcategory: Networking. Price: 3,360৳.

Product: Grandstream F-SM1310-20KM-1.25G Single Mode SFP Fiber Module. Category: Network Transceivers. Subcategory: Networking. Price: 3,500৳.
",184,713005,713189
5158,sentence,"Subcategory: Networking. Price: 3,500৳.

Product: Ficer FSFP-C8-S35-20D Tx1310 Rx1550 SM LC Simplex SFP Transceiver. Category: Network Transceivers. Subcategory: Networking. Price: 5,500৳.
",189,713149,713338
5159,sentence,"Subcategory: Networking. Price: 5,500৳.

Product: Ficer FSFP-C8-S53-20D Tx1550 Rx1310 SM LC Simplex SFP Transceiver. Category: Network Transceivers. Subcategory: Networking. Price: 5,500৳.
",189,713298,713487
5160,sentence,"Subcategory: Networking. Price: 5,500৳.

Product: Ficer FSFP-C2-S35-20D Tx1310 Rx1550 SM LC Simplex SFP Transceiver. Category: Network Transceivers. Subcategory: Networking. Price: 5,500৳.
",189,713447,713636
5161,sentence,"Subcategory: Networking. Price: 5,500৳.

Product: Ficer FSFP-C2-S53-20D Tx1550 Rx1310 SM LC Simplex SFP Transceiver. Category: Network Transceivers. Subcategory: Networking. Price: 5,500৳.
",189,713596,713785
5162,sentence,"Subcategory: Networking. Price: 5,500৳.

Product: Ficer FSPP-H7-M85-X3D 10G-SR Multimode LC Duplex Transceiver. Category: Network Transceivers. Subcategory: Networking. Price: 5,700৳.
",184,713745,713929
5163,sentence,"Subcategory: Networking. Price: 5,700৳.

Product: Grandstream F-MM850-300M-10G Multi-Mode SFP+ Fiber Module. Category: Network Transceivers. Subcategory: Networking. Price: 5,700৳.
",181,713889,714070
5164,sentence,"Subcategory: Networking. Price: 5,700৳.

Product: Ficer FSPP-H7-S13-10D 10G-LR 1310nm SM LC Duplex SFP+ Transceiver. Category: Network Transceivers. Subcategory: Networking. Price: 6,500৳.
",189,714030,714219
5165,sentence,"Subcategory: Networking. Price: 6,500৳.

Product: TRENDnet TEG-10GBS10 Single Mode LC SFP+ Module. Category: Network Transceivers. Subcategory: Networking. Price: 7,200৳.
",171,714179,714350
5166,sentence,"Subcategory: Networking. Price: 7,200৳.

Product: TRENDnet TEG-MGBS10/4 Single Mode LC SFP Module (4-Pack). Category: Network Transceivers. Subcategory: Networking. Price: 10,000৳.
",181,714310,714491
5167,sentence,"Subcategory: Networking. Price: 10,000৳.

Product: Cisco SFP-10G-SR Transceiver Module. Category: Network Transceivers. Subcategory: Networking. Price: 11,000৳.
",161,714450,714611
5168,sentence,"Subcategory: Networking. Price: 11,000৳.

Product: Ficer FSPP-H8-C27-20D 10G-BX-U Tx1270 Rx1330 SM LC Simplex SFP+ Transceiver. Category: Network Transceivers. Subcategory: Networking. ",185,714570,714755
5169,sentence,"Subcategory: Networking. Price: 12,900৳.

Product: Ficer FSPP-H8-C33-20D 10G-BX-D Tx1330 Rx1270 SM LC Simplex SFP+ Transceiver. Category: Network Transceivers. Subcategory: Networking. ",185,714730,714915
5170,sentence,"Subcategory: Networking. Price: 12,900৳.

Product: UGREEN NW136 Crimping Tool #70683. Category: Crimping Tool. Subcategory: Networking. Price: 1,200৳.

Product: TRENDnet TC-CT68 Crimping Tool. ",193,714890,715083
5171,sentence,"
Product: TRENDnet TC-CT68 Crimping Tool. Category: Crimping Tool. Subcategory: Networking. Price: 2,400৳.

Product: Dintek 6102-01002CH RJ12/45 Crimping Tool. Category: Crimping Tool. ",185,715041,715226
5172,sentence,"Category: Crimping Tool. Subcategory: Networking. Price: Out Of Stock.

Product: CommScope 1725150-6 Jack Termination Tool with Lacing Fixture. Category: Crimping Tool. Subcategory: Networking. ",194,715201,715395
5173,sentence,"Subcategory: Networking. Price: 11,500৳.

Product: Informate HT-568R Dual Modular Crimping Tool. Category: Crimping Tool. Subcategory: Networking. Price: Out Of Stock.
",168,715370,715538
5174,sentence,"Subcategory: Networking. Price: Out Of Stock.

Product: Vention KEAB0 3 in 1 Multi-Function Cable Crimping Tool. Category: Crimping Tool. Subcategory: Networking. Price: Out Of Stock.
",184,715492,715676
5175,sentence,"Subcategory: Networking. Price: Out Of Stock.

Product: Cote Networking Toolbox Set. Category: Crimping Tool. Subcategory: Networking. Price: Out Of Stock.
",156,715630,715786
5176,sentence,"Subcategory: Networking. Price: Out Of Stock.

Product: Acnet OTAC-24D Mini Series  OTDR Black (Optical Time Domain Reflectometer). Category: OTDR. Subcategory: Networking. Price: 48,500৳.
",189,715740,715929
5177,sentence,"Subcategory: Networking. Price: 48,500৳.

Product: EXFO Maxtester 715B OTDR. Category: OTDR. Subcategory: Networking. Price: Out Of Stock.

Product: Phyhome P3 Single Port Gigabit Xpon/Gpon Onu. ",195,715888,716083
5178,sentence,"Category: ONU. Subcategory: Networking. Price: 1,199৳1,250৳.

Product: TP-Link XZ000-G7 1 Port Gigabit XPON Terminal. Category: ONU. Subcategory: Networking. Price: 1,250৳.
",173,716083,716256
5179,sentence,"Subcategory: Networking. Price: 1,250৳.

Product: Tenda HG1 Gpon Single Port Gigabit Optical Network Terminal (ONU). Category: ONU. Subcategory: Networking. Price: 1,150৳1,275৳.
",178,716216,716394
5180,sentence,"Subcategory: Networking. Price: 1,150৳1,275৳.

Product: C-Data FD511G-G-F361 Single Port G-PON ONU. Category: ONU. Subcategory: Networking. Price: 1,230৳1,300৳.

Product: BDCOM GP1702-1G GPON ONU. ",197,716348,716545
5181,sentence,"
Product: BDCOM GP1702-1G GPON ONU. Category: ONU. Subcategory: Networking. Price: 1,240৳1,325৳.

Product: C-Data FD511G-G-F680 Single Port G-PON ONU. Category: ONU. Subcategory: Networking. ",191,716509,716700
5182,sentence,"Category: ONU. Subcategory: Networking. Price: 1,210৳1,350৳.

Product: VSOL V2801RD Single Port XPON ONU. Category: ONU. Subcategory: Networking. Price: 1,375৳.
",161,716660,716821
5183,sentence,"Subcategory: Networking. Price: 1,375৳.

Product: BDCOM GP1704-2F-E Dual Port WiFi XPON ONU. Category: ONU. Subcategory: Networking. Price: 2,100৳.

Product: BDCOM GP1705-2G Dual Port WiFi XPON ONU. ",199,716781,716980
5184,sentence,"Category: ONU. Subcategory: Networking. Price: 3,050৳3,450৳.

Product: C-Data FD514GB-PFX-R410 4 Port POE XPON ONU. Category: ONU. Subcategory: Networking. Price: 5,900৳.
",171,716980,717151
5185,sentence,"Subcategory: Networking. Price: 5,900৳.

Product: Phyhome FHR1100GZB EPON 1G ONU. Category: ONU. Subcategory: Networking. Price: Out Of Stock.

Product: Fiber-link JHHL-E801ZB Single Port EPON ONU. ",198,717111,717309
5186,sentence,"Category: ONU. Subcategory: Networking. Price: Out Of Stock.

Product: BDCOM P1501DS 1-Port EPON ONU. Category: ONU. Subcategory: Networking. Price: Out Of Stock.
",163,717309,717472
5187,sentence,"Subcategory: Networking. Price: Out Of Stock.

Product: C-Data FD511G-E-F361 Single Port EPON ONU. Category: ONU. Subcategory: Networking. Price: Out Of Stock.
",160,717426,717586
5188,sentence,"Subcategory: Networking. Price: Out Of Stock.

Product: Vsol V2801SE 1GE Secure EPON ONU. Category: ONU. Subcategory: Networking. Price: Out Of Stock.
",151,717540,717691
5189,sentence,"Subcategory: Networking. Price: Out Of Stock.

Product: C-Data FD511G-E-F680 Single Port EPON ONU. Category: ONU. Subcategory: Networking. Price: Out Of Stock.
",160,717645,717805
5190,sentence,"Subcategory: Networking. Price: Out Of Stock.

Product: VSOL V2801RE Single Port EPON ONU. Category: ONU. Subcategory: Networking. Price: Out Of Stock.
",152,717759,717911
5191,sentence,"Subcategory: Networking. Price: Out Of Stock.

Product: C-Data FD511G-X-F680 Single Port XPON ONU. Category: ONU. Subcategory: Networking. Price: Out Of Stock.
",160,717865,718025
5192,sentence,"Subcategory: Networking. Price: Out Of Stock.

Product: Vsol V2801SG XPON (G/Epon) Single Port ONU. Category: ONU. Subcategory: Networking. Price: Out Of Stock.
",161,717979,718140
5193,sentence,"Subcategory: Networking. Price: Out Of Stock.

Product: Hikvision DS-1CM1U12 12-Slot 1U Patch Panel. Category: Patch Panel. Subcategory: Networking. Price: 1,000৳.
",164,718094,718258
5194,sentence,"Subcategory: Networking. Price: 1,000৳.

Product: Hikvision DS-1CM1U24 24-Slot 1U Patch Panel. Category: Patch Panel. Subcategory: Networking. Price: 1,200৳.
",158,718218,718376
5195,sentence,"Subcategory: Networking. Price: 1,200৳.

Product: Hikvision DS-1CP0U24-1U Unshielded 24-Port Patch Panel. Category: Patch Panel. Subcategory: Networking. Price: 1,350৳.
",169,718336,718505
5196,sentence,"Subcategory: Networking. Price: 1,350৳.

Product: Rosenberger 1U Metal Cable Manager Panel. Category: Patch Panel. Subcategory: Networking. Price: 1,450৳.
",155,718465,718620
5197,sentence,"Subcategory: Networking. Price: 1,450৳.

Product: SafeNet SNPCM1UF0 1U Wire Manager. Category: Patch Panel. Subcategory: Networking. Price: 1,850৳.

Product: R&M R195498 CAT6 24 Port Patch Panel. ",196,718580,718776
5198,sentence,"
Product: R&M R195498 CAT6 24 Port Patch Panel. Category: Patch Panel. Subcategory: Networking. Price: 1,800৳2,000৳.

Product: R&M R195422 CAT6 Wire Manager. Category: Patch Panel. ",181,718728,718909
5199,sentence,"Category: Patch Panel. Subcategory: Networking. Price: 2,100৳.

Product: Vention KGAB0 Cat6 UTP 24 Port Keystone Patch Panel. Category: Patch Panel. Subcategory: Networking. Price: 2,200৳.
",189,718886,719075
5200,sentence,"Subcategory: Networking. Price: 2,200৳.

Product: TRENDnet TC-KP24 24-Port Blank Keystone 1U Patch Panel. Category: Patch Panel. Subcategory: Networking. Price: 2,500৳.
",169,719035,719204
5201,sentence,"Subcategory: Networking. Price: 2,500৳.

Product: Hikvision DS-1CP6U24-1U Cat6 Unshielded 24-Port Patch Panel. Category: Patch Panel. Subcategory: Networking. Price: 2,600৳.
",174,719164,719338
5202,sentence,"Subcategory: Networking. Price: 2,600৳.

Product: CommScope 760237046 Horizontal Cable Manager. Category: Patch Panel. Subcategory: Networking. Price: 3,000৳.
",159,719298,719457
5203,sentence,"Subcategory: Networking. Price: 3,000৳.

Product: CommScope 2269025-1 Horizontal Cable Manager. Category: Patch Panel. Subcategory: Networking. Price: 3,100৳.
",159,719417,719576
5204,sentence,"Subcategory: Networking. Price: 3,100৳.

Product: TRENDnet TC-KP24S 24-Port Blank Keystone Shielded 1U Patch Panel. Category: Patch Panel. Subcategory: Networking. Price: 3,200৳.
",179,719536,719715
5205,sentence,"Subcategory: Networking. Price: 3,200৳.

Product: CommScope 1427632-2 Horizontal Cable Management. Category: Patch Panel. Subcategory: Networking. Price: 3,250৳.
",162,719675,719837
5206,sentence,"Subcategory: Networking. Price: 3,250৳.

Product: TRENDnet TC-KP24SA 24-Port Blank Angled Keystone Shielded 1U Patch Panel. Category: Patch Panel. Subcategory: Networking. Price: 6,500৳.
",187,719797,719984
5207,sentence,"Subcategory: Networking. Price: 6,500৳.

Product: D-Link NPP-AL1BLK241 24 Port without Modular Patch Panel. Category: Patch Panel. Subcategory: Networking. Price: 7,000৳.
",171,719944,720115
5208,sentence,"Subcategory: Networking. Price: 7,000৳.

Product: D-Link NPP-C61BLK241 24 Port Full Loaded Patch Panel. Category: Patch Panel. Subcategory: Networking. Price: 7,500৳.
",167,720075,720242
5209,sentence,"Subcategory: Networking. Price: 7,500৳.

Product: TRENDnet TC-P24C6 24-Port Cat6 Unshielded 1U Patch Panel. Category: Patch Panel. Subcategory: Networking. Price: 7,500৳.
",171,720202,720373
5210,sentence,"Subcategory: Networking. Price: 7,500৳.

Product: Dintek 1406-00011PC6 Cat6 24-Port Modular Patch Panel. Category: Patch Panel. Subcategory: Networking. Price: 9,900৳.
",168,720333,720501
5211,sentence,"Subcategory: Networking. Price: 9,900৳.

Product: Safenet 10-1240BK 24-Port Shielded Patch Panel with Modular. Category: Patch Panel. Subcategory: Networking. Price: 11,500৳.
",175,720461,720636
5212,sentence,"Subcategory: Networking. Price: 11,500৳.

Product: D-Link HTB-3100 (A+B) Fiber Optic Media Converter (Bundle With Full Set). Category: D-Link. Subcategory: Media Converter. Price: 1,850৳2,000৳.
",194,720595,720789
5213,sentence,"Price: 1,850৳2,000৳.

Product: TP-Link MC111CS 10/100Mbps WDM Media Converter. Category: Media Converter. Subcategory: Networking. Price: 2,079৳.
",146,720768,720914
5214,sentence,"Subcategory: Networking. Price: 2,079৳.

Product: TP-Link TL-FC111A-20 10/100 Mbps WDM Media Converter. Category: Media Converter. Subcategory: Networking. Price: Out Of Stock.
",177,720874,721051
5215,sentence,"Subcategory: Networking. Price: Out Of Stock.

Product: TP-Link TL-FC111B-20 10/100 Mbps WDM Media Converter. Category: Media Converter. Subcategory: Networking. Price: Out Of Stock.
",183,721005,721188
5216,sentence,"Subcategory: Networking. Price: Out Of Stock.

Product: TP-Link MC112CS 10/100Mbps WDM Media Converter. Category: Media Converter. Subcategory: Networking. Price: 2,079৳.
",171,721142,721313
5217,sentence,"Subcategory: Networking. Price: 2,079৳.

Product: TP-Link TL-FC311A-20 Gigabit WDM Media Converter. Category: Media Converter. Subcategory: Networking. Price: Out Of Stock.
",173,721273,721446
5218,sentence,"Subcategory: Networking. Price: Out Of Stock.

Product: TP-Link TL-FC311B-20 Gigabit WDM Media Converter. Category: Media Converter. Subcategory: Networking. Price: Out Of Stock.
",179,721400,721579
5219,sentence,"Subcategory: Networking. Price: Out Of Stock.

Product: TP-Link TL-FC1420 14-Slot Rackmount Chassis for Media Converter Modules. Category: Media Converter. Subcategory: Networking. ",181,721533,721714
5220,sentence,"Subcategory: Networking. Price: Out Of Stock.

Product: TP-Link TL-MC1400 14-Slot Rackmount Chassis For Media Conversion Network. Category: Media Converter. Subcategory: Networking. ",182,721689,721871
5221,sentence,"Subcategory: Networking. Price: Out Of Stock.

Product: Vention KEFB0 Network Cable Tester. Category: Cable Tester. Subcategory: Networking. Price: 850৳.
",154,721846,722000
5222,sentence,"Subcategory: Networking. Price: 850৳.

Product: Noyafa NF-468B Network Cable Tester. Category: Cable Tester. Subcategory: Networking. Price: 1,300৳1,500৳.
",155,721962,722117
5223,sentence,"Subcategory: Networking. Price: 1,300৳1,500৳.

Product: TRENDnet TC-NT2 Network Cable Tester. Category: Cable Tester. Subcategory: Networking. Price: 5,300৳5,600৳.
",164,722071,722235
5224,sentence,"Subcategory: Networking. Price: 5,300৳5,600৳.

Product: Noyafa NF-8209S Advanced Network Cable Tracker. Category: Cable Tester. Subcategory: Networking. Price: 8,900৳.
",168,722189,722357
5225,sentence,"Subcategory: Networking. Price: 8,900৳.

Product: Solitine Optical Power Meter with VFL & R45 Tester. Category: Cable Tester. Subcategory: Networking. Price: Out Of Stock.
",172,722317,722489
5226,sentence,"Subcategory: Networking. Price: Out Of Stock.

Product: ORICO TXJ004 Multi-functional Wire Tester. Category: Cable Tester. Subcategory: Networking. Price: Out Of Stock.
",169,722443,722612
5227,sentence,"Subcategory: Networking. Price: Out Of Stock.

Product: ORICO TXJ006 Multi-functional Wire Tracer. Category: Cable Tester. Subcategory: Networking. Price: Out Of Stock.
",169,722566,722735
5228,sentence,"Subcategory: Networking. Price: Out Of Stock.

Product: Noyafa NF-488 PoE Cable Tester. Category: Cable Tester. Subcategory: Networking. Price: Out Of Stock.
",158,722689,722847
5229,sentence,"Subcategory: Networking. Price: Out Of Stock.

Product: Noyafa NF-8601W Cable Length Tester with PoE Ping Functions. Category: Cable Tester. Subcategory: Networking. Price: Out Of Stock.
",187,722801,722988
5230,sentence,"Subcategory: Networking. Price: Out Of Stock.

Product: CommScope FPS-BS-1P-W 1-Port Faceplate Kit. Category: Faceplate. Subcategory: Networking. Price: Out Of Stock.
",167,722942,723109
5231,sentence,"Subcategory: Networking. Price: Out Of Stock.

Product: CommScope M10CF 1-Port Faceplate Kit. Category: Faceplate. Subcategory: Networking. Price: Out Of Stock.
",161,723063,723224
5232,sentence,"Subcategory: Networking. Price: Out Of Stock.

Product: Panduit Pan-Net CFPUKS2SIWY Dual Port Faceplate. Category: Faceplate. Subcategory: Networking. Price: Out Of Stock.
",172,723178,723350
5233,sentence,"Subcategory: Networking. Price: Out Of Stock.

Product: Hikvision DS-1FPA1 1-Port Faceplate. Category: Faceplate. Subcategory: Networking. Price: Out Of Stock.
",160,723304,723464
5234,sentence,"Subcategory: Networking. Price: Out Of Stock.

Product: Hikvision DS-1FPA2 2-Port Faceplate. Category: Faceplate. Subcategory: Networking. Price: Out Of Stock.
",160,723418,723578
5235,sentence,"Subcategory: Networking. Price: Out Of Stock.

Product: Red Hat Enterprise Linux Server Standard (Annual Subscription). Category: Red Hat. Subcategory: Operating System. Price: Call for Price.
",193,723532,723725
5236,sentence,"Price: Call for Price.

Product: Red Hat Enterprise Linux Server Premium (Annual Subscription). Category: Red Hat. Subcategory: Operating System. Price: Call for Price.
",169,723702,723871
5237,sentence,"Price: Call for Price.

Product: Windows Server 2025 - Device CAL. Category: Microsoft Windows. Subcategory: Operating System. Price: 5,480৳.

Product: Windows Server 2025 - User CAL. ",184,723848,724032
5238,sentence,"
Product: Windows Server 2025 - User CAL. Category: Microsoft Windows. Subcategory: Operating System. Price: 7,020৳.

Product: Microsoft Windows 10 Professional 64bit. Category: Microsoft Windows. ",197,723990,724187
5239,sentence,"Category: Microsoft Windows. Subcategory: Operating System. Price: 10,500৳18,500৳.

Product: Microsoft Windows Server 2025 Remote Desktop Services - 1 Device CAL (CSP Perpetual). ",179,724158,724337
5240,sentence,"Category: Microsoft Windows. Subcategory: Operating System. Price: 19,850৳.

Product: Microsoft Windows 11 Professional. Category: Microsoft Windows. Subcategory: Operating System. Price: 20,200৳.
",197,724337,724534
5241,sentence,"Subcategory: Operating System. Price: 20,200৳.

Product: Microsoft Windows Server Standard 2025 - 2 Core License Pack. Category: Microsoft Windows. Subcategory: Operating System. Price: 20,640৳.
",195,724487,724682
5242,sentence,"Subcategory: Operating System. Price: 20,640৳.

Product: Windows GGWA - Windows 11 Professional - Legalization GetGenuine (CSP Perpetual). Category: Microsoft Windows. Subcategory: Operating System. ",199,724635,724834
5243,sentence,"Subcategory: Operating System. Price: 25,875৳.

Product: Microsoft Windows Server 2019 Standard OEI DVD. Category: Microsoft Windows. Subcategory: Operating System. Price: 57,000৳.
",181,724803,724984
5244,sentence,"Subcategory: Operating System. Price: 57,000৳.

Product: Windows Server 2025 Datacenter - 2 Core (CSP Perpetual). Category: Microsoft Windows. Subcategory: Operating System. Price: 118,795৳.
",191,724937,725128
5245,sentence,"Subcategory: Operating System. Price: 118,795৳.

Product: Windows Server 2025 Standard - 16 Core License Pack. Category: Microsoft Windows. Subcategory: Operating System. Price: 165,140৳.
",188,725080,725268
5246,sentence,"Subcategory: Operating System. Price: 165,140৳.

Product: Windows Server 2025 Datacenter - 16 Core License Pack. Category: Microsoft Windows. Subcategory: Operating System. Price: 950,640৳.
",190,725220,725410
5247,sentence,"Subcategory: Operating System. Price: 950,640৳.

Product: Microsoft SQL Server 2022 Standard (CSP Perpetual). Category: Database Server Solution. Subcategory: Software. Price: 135,000৳.
",186,725362,725548
5248,sentence,"Subcategory: Software. Price: 135,000৳.

Product: Microsoft SQL Server 2022 Standard 2 Core License Pack (CSP Perpetual). Category: Database Server Solution. Subcategory: Software. Price: 505,000৳.
",198,725508,725706
5249,sentence,"Subcategory: Software. Price: 505,000৳.

Product: Microsoft SQL Server 2022 Enterprise 2 Core License Pack (CSP Perpetual). Category: Database Server Solution. Subcategory: Software. ",183,725666,725849
5250,sentence,"Subcategory: Software. Price: 2,350,000৳.

Product: Bijoy Bayanno 2025 Bangla Typing Software For Windows. Category: Software. Price: 450৳.

Product: ESET Internet Security One User (Only Key). ",194,725826,726020
5251,sentence,"Category: Software. Price: 650৳750৳.

Product: ESET Home Security Essential Internet Security for 1 User 1 Year. Category: Software. Price: 750৳.

Product: ESET Internet Security 1 User 1 Year. ",194,726020,726214
5252,sentence,"
Product: ESET Internet Security 1 User 1 Year. Category: Software. Price: 750৳.

Product: ESET Internet Security 3 User for 1 Year. Category: Software. Price: 1,800৳2,099৳.
",174,726166,726340
5253,sentence,"Category: Software. Price: 1,800৳2,099৳.

Product: Microsoft 365 F1 (1 Year Subscription). Category: Software. Price: 2,995৳.

Product: Microsoft 365 Business Basic (1 Year Subscription). ",188,726299,726487
5254,sentence,"Category: Software. Price: 4,450৳.

Product: Bijoy Ekattor For Mac Bangla Software. Category: Software. Price: 5,000৳.

Product: Office 365 F3 (1 Year Subscription). Category: Software. ",186,726487,726673
5255,sentence,"Category: Software. Price: 5,250৳.

Product: ESET Small Business Security (1 Server, 5 Windows PC). Category: Software. Price: 5,599৳.
",135,726653,726788
5256,sentence,"Category: Software. Price: 5,599৳.

Product: Microsoft 365 Personal For 1 User (01 Year Subscription). Category: Software. Price: 7,500৳.

Product: Adobe InCopy CC for Teams. Category: Software. ",195,726753,726948
5257,sentence,"Category: Software. Price: 9,295৳.

Product: Microsoft Exchange Server 2019 Standard Device CAL. Category: Software. Price: 9,565৳.

Product: ESET Small Business Security (Server) for 10 users. ",194,726928,727122
5258,sentence,"Category: Software. Price: 9,999৳.

Product: Microsoft 365 F3 (1 Year Subscription). Category: Software. Price: 10,390৳.

Product: Microsoft Exchange Server 2019 Standard User CAL. ",181,727122,727303
5259,sentence,"Category: Software. Price: 12,370৳.

Product: Microsoft Office Professional Plus 2021 English. Category: Software. Price: 13,500৳.

Product: Office 365 Enterprise E1 (1 Year Subscription). ",189,727303,727492
5260,sentence,"Category: Software. Price: 14,055৳.

Product: Office Home and Business 2024 English APAC EM Medialess. Category: Office Application. Subcategory: Software. Price: 35,000৳.
",172,727492,727664
5261,sentence,"Subcategory: Software. Price: 35,000৳.

Product: Office LTSC Standard 2021. Category: Office Application. Subcategory: Software. Price: 61,720৳.

Product: Visual Studio Professional 2022. ",188,727625,727813
5262,sentence,"
Product: Visual Studio Professional 2022. Category: Office Application. Subcategory: Software. Price: 65,500৳.

Product: Office LTSC Professional Plus 2021. Category: Office Application. ",188,727770,727958
5263,sentence,"Category: Office Application. Subcategory: Software. Price: 75,000৳.

Product: Microsoft 365 Family For 6 User (1 Year Subscription). Category: Office Application. Subcategory: Software. ",187,727928,728115
5264,sentence,"Subcategory: Software. Price: Up Coming.

Product: Microsoft Office Home and Business 2016 for Mac. Category: Office Application. Subcategory: Software. Price: Out Of Stock.
",174,728092,728266
5265,sentence,"Subcategory: Software. Price: Out Of Stock.

Product: Microsoft Office Home and Business 2019. Category: Office Application. Subcategory: Software. Price: Out Of Stock.
",169,728222,728391
5266,sentence,"Subcategory: Software. Price: Out Of Stock.

Product: Microsoft 365 Apps for Business (1 Year Subscription). Category: Cloud Solutions. Subcategory: Software. Price: 14,500৳.
",175,728347,728522
5267,sentence,"Subcategory: Software. Price: 14,500৳.

Product: Microsoft 365 Business Standard (1 Year Subscription). Category: Cloud Solutions. Subcategory: Software. Price: 14,800৳.
",170,728483,728653
5268,sentence,"Subcategory: Software. Price: 14,800৳.

Product: Microsoft 365 Apps for Enterprise (1 Year Subscription). Category: Cloud Solutions. Subcategory: Software. Price: 15,080৳.
",172,728614,728786
5269,sentence,"Subcategory: Software. Price: 15,080৳.

Product: Microsoft 365 Business Premium (1 Year Subscription). Category: Cloud Solutions. Subcategory: Software. Price: 31,365৳.
",169,728747,728916
5270,sentence,"Subcategory: Software. Price: 31,365৳.

Product: Office 365 Enterprise E3 (1 Year Subscription). Category: Cloud Solutions. Subcategory: Software. Price: 32,325৳.
",163,728877,729040
5271,sentence,"Subcategory: Software. Price: 32,325৳.

Product: Microsoft 365 Enterprise E3 (1 Year Subscription). Category: Cloud Solutions. Subcategory: Software. Price: 45,620৳.
",166,729001,729167
5272,sentence,"Subcategory: Software. Price: 45,620৳.

Product: Office 365 Enterprise E5 (1 Year Subscription). Category: Cloud Solutions. Subcategory: Software. Price: 52,500৳.
",163,729128,729291
5273,sentence,"Subcategory: Software. Price: 52,500৳.

Product: Microsoft 365 Enterprise E5 (1 Year Subscription). Category: Cloud Solutions. Subcategory: Software. Price: 72,230৳.
",166,729252,729418
5274,sentence,"Subcategory: Software. Price: 72,230৳.

Product: Microsoft Exchange Server 2019 Standard. Category: Mail Server Solution. Subcategory: Software. Price: 106,740৳.
",162,729379,729541
5275,sentence,"Subcategory: Software. Price: 106,740৳.

Product: Microsoft Exchange Server 2019 Enterprise. Category: Mail Server Solution. Subcategory: Software. Price: 532,000৳.
",165,729501,729666
5276,sentence,"Subcategory: Software. Price: 532,000৳.

Product: ESET NOD32 Antivirus One User 1 Year. Category: For Home User. Subcategory: Antivirus. Price: Out Of Stock.
",158,729626,729784
5277,sentence,"Subcategory: Antivirus. Price: Out Of Stock.

Product: ESET Cyber Security Pro Internet Security for Mac. Category: For Home User. Subcategory: Antivirus. Price: Out Of Stock.
",176,729739,729915
5278,sentence,"Subcategory: Antivirus. Price: Out Of Stock.

Product: ESET Internet Security 2 User for 1 Year. Category: For Home User. Subcategory: Antivirus. Price: Out Of Stock.
",167,729870,730037
5279,sentence,"Subcategory: Antivirus. Price: Out Of Stock.

Product: ESET Internet Security Single User with 03 Years License. Category: For Home User. Subcategory: Antivirus. Price: Out Of Stock.
",183,729992,730175
5280,sentence,"Subcategory: Antivirus. Price: Out Of Stock.

Product: ESET Internet Security 5 User 1 Year. Category: For Home User. Subcategory: Antivirus. Price: Out Of Stock.
",163,730130,730293
5281,sentence,"Subcategory: Antivirus. Price: Out Of Stock.

Product: ESET Small Business Security (Server) for 15 users. Category: Antivirus. Subcategory: Software. Price: 14,999৳.
",167,730248,730415
5282,sentence,"Subcategory: Software. Price: 14,999৳.

Product: ESET Small Business Security (Server) for 25 users. Category: Antivirus. Subcategory: Software. Price: 25,999৳.
",161,730376,730537
5283,sentence,"Subcategory: Software. Price: 25,999৳.

Product: Eset Xopero Backup and Recovery Software. Category: Antivirus. Subcategory: Software. Price: Call for Price.
",158,730498,730656
5284,sentence,"Subcategory: Software. Price: Call for Price.

Product: Eset Endpoint Encryption (Volume 05 to As per Customer Requirement). Category: Antivirus. Subcategory: Software. Price: Call for Price.
",192,730610,730802
5285,sentence,"Subcategory: Software. Price: Call for Price.

Product: ESET Protect Entry E-License Subscription. Category: Antivirus. Subcategory: Software. Price: Call for Price.
",166,730756,730922
5286,sentence,"Subcategory: Software. Price: Call for Price.

Product: Eset Endpoint Security E-License (Volume 05 to As per Customer Requirement). Category: Antivirus. Subcategory: Software. ",177,730876,731053
5287,sentence,"Category: Antivirus. Subcategory: Software. Price: Call for Price.

Product: ESET Home Office Security Pack New 1-year 10-user. Category: Antivirus. Subcategory: Software. Price: Out Of Stock.
",193,731009,731202
5288,sentence,"Subcategory: Software. Price: Out Of Stock.

Product: Adobe Acrobat Standard DC for Teams. Category: Adobe. Subcategory: Software. Price: 25,470৳.

Product: Adobe Fresco CC for Teams. ",184,731158,731342
5289,sentence,"
Product: Adobe Fresco CC for Teams. Category: Adobe. Subcategory: Software. Price: 36,695৳.

Product: Adobe Acrobat Pro DC for Teams. Category: Adobe. Subcategory: Software. Price: 38,000৳.
",191,731305,731496
5290,sentence,"Subcategory: Software. Price: 38,000৳.

Product: Adobe XD CC for Teams. Category: Adobe. Subcategory: Software. Price: 42,785৳.

Product: Adobe InDesign CC for Teams. Category: Adobe. ",184,731457,731641
5291,sentence,"Category: Adobe. Subcategory: Software. Price: 56,000৳.

Product: Adobe Audition CC - Pro for Teams. Category: Adobe. Subcategory: Software. Price: 56,000৳.

Product: Adobe Dimension for Teams. ",194,731624,731818
5292,sentence,"
Product: Adobe Dimension for Teams. Category: Adobe. Subcategory: Software. Price: 56,000৳.

Product: Adobe Animate CC - Pro for Teams. Category: Adobe. Subcategory: Software. Price: 57,280৳.
",193,731781,731974
5293,sentence,"Subcategory: Software. Price: 57,280৳.

Product: Adobe Acrobat Sign for Business. Category: Adobe. Subcategory: Software. Price: 60,710৳.

Product: Adobe Premiere Pro for Teams. Category: Adobe. ",195,731935,732130
5294,sentence,"Category: Adobe. Subcategory: Software. Price: 62,000৳.

Product: Adobe After Effects CC for Teams. Category: Adobe. Subcategory: Software. Price: 62,000৳.

Product: Adobe Photoshop CC for Teams. ",196,732113,732309
5295,sentence,"
Product: Adobe Photoshop CC for Teams. Category: Adobe. Subcategory: Software. Price: 64,000৳.

Product: Adobe Illustrator CC for Teams. Category: Adobe. Subcategory: Software. Price: 64,000৳.
",194,732269,732463
5296,sentence,"Subcategory: Software. Price: 64,000৳.

Product: Adobe Dreamweaver CC for Teams. Category: Adobe. Subcategory: Software. Price: 66,715৳.

Product: Adobe Lightroom CC - Pro for Teams. ",183,732424,732607
5297,sentence,"
Product: Adobe Lightroom CC - Pro for Teams. Category: Adobe. Subcategory: Software. Price: 66,715৳.

Product: Adobe FrameMaker for Teams. Category: Adobe. Subcategory: Software. Price: 83,750৳.
",196,732561,732757
5298,sentence,"Subcategory: Software. Price: 83,750৳.

Product: Adobe Creative Cloud for Teams All Apps. Category: Adobe. Subcategory: Software. Price: 150,975৳.

Product: Adobe Substance 3D Collection for Teams. ",198,732718,732916
5299,sentence,"Category: Adobe. Subcategory: Software. Price: 186,125৳.

Product: AnyDesk Solo License 1 User 1 Year. Category: AnyDesk. Subcategory: Software. Price: Up Coming.
",163,732916,733079
5300,sentence,"Subcategory: Software. Price: Up Coming.

Product: AnyDesk Advanced License 2 User 1 Year. Category: AnyDesk. Subcategory: Software. Price: Up Coming.
",151,733038,733189
5301,sentence,"Subcategory: Software. Price: Up Coming.

Product: AnyDesk Standard License 1 User 1 Year. Category: AnyDesk. Subcategory: Software. Price: Up Coming.
",151,733148,733299
5302,sentence,"Subcategory: Software. Price: Up Coming.

Product: Autodesk AutoCAD LT 2025 Commercial New Single-user ELD - Annual Subscription. Category: AutoDesk. Subcategory: Software. Price: 77,970৳.
",189,733258,733447
5303,sentence,"Subcategory: Software. Price: 77,970৳.

Product: Autodesk InfraWorks 2025 Commercial New Single-user ELD - Annual Subscription. Category: AutoDesk. Subcategory: Software. Price: 240,000৳.
",188,733408,733596
5304,sentence,"Subcategory: Software. Price: 240,000৳.

Product: Autodesk 3ds Max 2025 Commercial New Single-user ELD - Annual Subscription. Category: AutoDesk. Subcategory: Software. Price: 273,610৳.
",186,733556,733742
5305,sentence,"Subcategory: Software. Price: 273,610৳.

Product: Autodesk Maya 2025 Commercial New Single-user ELD - Annual Subscription. Category: AutoDesk. Subcategory: Software. Price: 273,610৳.
",183,733702,733885
5306,sentence,"Subcategory: Software. Price: 273,610৳.

Product: AutoCAD - including specialized toolsets AD Commercial New Single-user ELD Annual Subscription. Category: AutoDesk. Subcategory: Software. ",189,733845,734034
5307,sentence,"Category: AutoDesk. Subcategory: Software. Price: 285,695৳.

Product: Autodesk Media & Entertainment Collection Single-user ELD - Annual Subscription. Category: AutoDesk. Subcategory: Software. ",194,733991,734185
5308,sentence,"Category: AutoDesk. Subcategory: Software. Price: 381,295৳.

Product: Autodesk Civil 3D 2025 Commercial New Single-user ELD - Annual Subscription. Category: AutoDesk. Subcategory: Software. ",190,734142,734332
5309,sentence,"Category: AutoDesk. Subcategory: Software. Price: 392,280৳.

Product: Autodesk Product Design & Manufacturing Collection Single-user ELD - Annual Subscription. Category: AutoDesk. ",180,734289,734469
5310,sentence,"Category: AutoDesk. Subcategory: Software. Price: 460,410৳.

Product: Autodesk Architecture Engineering & Construction Collection Single-user ELD - Annual Subscription. Category: AutoDesk. ",189,734449,734638
5311,sentence,"Category: AutoDesk. Subcategory: Software. Price: 502,165৳.

Product: VMware vSphere 6 Essentials Plus Kit for 3 hosts (Max 2 processors per host). Category: VMware. Subcategory: Software. ",189,734618,734807
5312,sentence,"Category: VMware. Subcategory: Software. Price: Call for Price.

Product: ASUS TS100-E11-PI4 Intel Xeon E-2336 6 Core Tower Server. Category: ASUS. Subcategory: Server. Price: Up Coming.
",187,734766,734953
5313,sentence,"Subcategory: Server. Price: Up Coming.

Product: ASUS TS100-E11-PI4 Intel Xeon E-2378 8 Core Tower Server. Category: ASUS. Subcategory: Server. Price: Up Coming.
",162,734914,735076
5314,sentence,"Subcategory: Server. Price: Up Coming.

Product: ASUS TS100-E11-PI4 Intel Xeon E-2334 4 Core Tower Server. Category: ASUS. Subcategory: Server. Price: Out Of Stock.
",165,735037,735202
5315,sentence,"Subcategory: Server. Price: Out Of Stock.

Product: Cisco UCS C240 M6 2U SFF 12 Core Rack Server. Category: Cisco. Subcategory: Server. Price: 710,000৳.
",153,735160,735313
5316,sentence,"Subcategory: Server. Price: 710,000৳.

Product: Cisco UCS C240 M6 2U SFF 16 Core Rack Server. Category: Cisco. Subcategory: Server. Price: 820,000৳.

Product: Cisco UCS C240 M6 26 Core Rack Server. ",198,735275,735473
5317,sentence,"
Product: Cisco UCS C240 M6 26 Core Rack Server. Category: Cisco. Subcategory: Server. Price: 2,400,000৳.

Product: Cisco UCS C240 M6 2U SFF Rack Server (10 Core). Category: Cisco. ",181,735424,735605
5318,sentence,"Category: Cisco. Subcategory: Server. Price: Call for Price.

Product: Dell PowerEdge T150 Tower Server. Category: Dell. Subcategory: Server. Price: 230,000৳.
",159,735588,735747
5319,sentence,"Subcategory: Server. Price: 230,000৳.

Product: Dell PowerEdge T160 Tower Server. Category: Dell. Subcategory: Server. Price: 260,000৳.

Product: Dell PowerEdge T360 Tower Server. Category: Dell. ",196,735709,735905
5320,sentence,"Category: Dell. Subcategory: Server. Price: 435,000৳.

Product: Dell PowerEdge T550 Tower Server. Category: Dell. Subcategory: Server. Price: Call for Price.
",158,735889,736047
5321,sentence,"Subcategory: Server. Price: Call for Price.

Product: Dell PowerEdge R450 Intel Xeon Silver 4309Y 64GB RAM 1U Rack Server. Category: Dell. Subcategory: Server. Price: 724,000৳.
",177,736003,736180
5322,sentence,"Subcategory: Server. Price: 724,000৳.

Product: Dell PowerEdge R750xs 4314 Rack Server. Category: Dell. Subcategory: Server. Price: 833,000৳.
",142,736142,736284
5323,sentence,"Subcategory: Server. Price: 833,000৳.

Product: Dell PowerEdge R760xs Intel Xeon Silver 4510 Rack Server. Category: Dell. Subcategory: Server. Price: 850,000৳.
",160,736246,736406
5324,sentence,"Subcategory: Server. Price: 850,000৳.

Product: Dell PowerEdge R760xs Intel Xeon Silver 4514Y Rack Server. Category: Dell. Subcategory: Server. Price: 1,000,000৳.
",163,736368,736531
5325,sentence,"Subcategory: Server. Price: 1,000,000৳.

Product: Dell PowerEdge R750 Intel Xeon Gold 5320 Rack Server. Category: Dell. Subcategory: Server. Price: Pre Order.
",159,736491,736650
5326,sentence,"Subcategory: Server. Price: Pre Order.

Product: Dell PowerEdge R750 Intel Xeon Silver 4314 Rack Server. Category: Dell. Subcategory: Server. Price: Call for Price.
",165,736611,736776
5327,sentence,"Subcategory: Server. Price: Call for Price.

Product: Dell PowerEdge R750 Intel Xeon Silver 4316 Rack Server. Category: Dell. Subcategory: Server. Price: Call for Price.
",170,736732,736902
5328,sentence,"Subcategory: Server. Price: Call for Price.

Product: Dell PowerEdge R760xs Intel Xeon Silver 4410Y Rack Server. Category: Dell. Subcategory: Server. Price: Call for Price.
",173,736858,737031
5329,sentence,"Subcategory: Server. Price: Call for Price.

Product: Dell PowerEdge R350 Intel Xeon E-2356G Rack Server. Category: Dell. Subcategory: Server. Price: Call for Price.
",166,736987,737153
5330,sentence,"Subcategory: Server. Price: Call for Price.

Product: Dell PowerEdge R660 Intel Xeon Gold 6426Y Rack Server. Category: Dell. Subcategory: Server. Price: Call for Price.
",169,737109,737278
5331,sentence,"Subcategory: Server. Price: Call for Price.

Product: Dell PowerEdge R660xs Intel Xeon Silver 4410Y Rack Server. Category: Dell. Subcategory: Server. Price: Call for Price.
",173,737234,737407
5332,sentence,"Subcategory: Server. Price: Call for Price.

Product: Dell PowerEdge R760 Intel Xeon Silver 4416+ Rack Server. Category: Dell. Subcategory: Server. Price: Call for Price.
",171,737363,737534
5333,sentence,"Subcategory: Server. Price: Call for Price.

Product: Dell PowerEdge R760xa Intel Xeon Gold 6442Y GPU Rack Server. Category: Dell. Subcategory: Server. Price: Call for Price.
",175,737490,737665
5334,sentence,"Subcategory: Server. Price: Call for Price.

Product: Dell PowerEdge R760xa Intel Xeon Platinum 8468 Rack GPU Server. Category: Dell. Subcategory: Server. Price: Call for Price.
",178,737621,737799
5335,sentence,"Subcategory: Server. Price: Call for Price.

Product: Dell PowerEdge R760xa Intel Xeon Silver 4514Y Rack GPU Server. Category: Dell. Subcategory: Server. Price: Call for Price.
",177,737755,737932
5336,sentence,"Subcategory: Server. Price: Call for Price.

Product: Dell PowerEdge R360 Xeon E-2436 Rack Server. Category: Dell. Subcategory: Server. Price: Call for Price.
",159,737888,738047
5337,sentence,"Subcategory: Server. Price: Call for Price.

Product: HPE ProLiant MicroServer Gen10 Plus v2 Ultra Micro Tower Server. Category: HPE. Subcategory: Server. Price: 185,000৳200,000৳.
",180,738003,738183
5338,sentence,"Subcategory: Server. Price: 185,000৳200,000৳.

Product: HPE ProLiant ML30 Gen10 Plus Tower Server. Category: HPE. Subcategory: Server. Price: 190,000৳215,000৳.
",160,738137,738297
5339,sentence,"Subcategory: Server. Price: 190,000৳215,000৳.

Product: HPE ProLiant ML30 Gen 11 4U Tower Server. Category: HPE. Subcategory: Server. Price: 280,000৳.
",151,738251,738402
5340,sentence,"Subcategory: Server. Price: 280,000৳.

Product: HPE ProLiant DL20 Gen10 Plus Rack Server. Category: HPE. Subcategory: Server. Price: 382,500৳400,000৳.
",151,738364,738515
5341,sentence,"Subcategory: Server. Price: 382,500৳400,000৳.

Product: HPE ProLiant DL380 Generation 10 PLUS 64GB RAM 3 X HPE 1.2TB HDD Server. Category: HPE. Subcategory: Server. Price: Call for Price.
",188,738469,738657
5342,sentence,"Subcategory: Server. Price: Call for Price.

Product: HPE ProLiant DL380 Gen11 Intel Xeon Rack GPU Server. Category: HPE. Subcategory: Server. Price: Call for Price.
",166,738613,738779
5343,sentence,"Subcategory: Server. Price: Call for Price.

Product: HPE ProLiant DL380 Gen11 Intel Xeon Silver Rack Server. Category: HPE. Subcategory: Server. Price: Call for Price.
",169,738735,738904
5344,sentence,"Subcategory: Server. Price: Call for Price.

Product: HPE ProLiant DL380 Generation 10 PLUS 2 x Intel Xeon-Silver 4310 64GB RAM 3 x HPE 2.4TB HDD Server. Category: HPE. Subcategory: Server. ",190,738860,739050
5345,sentence,"Category: HPE. Subcategory: Server. Price: Call for Price.

Product: HPE Proliant DL380 Gen 10 Plus 64GB 2x Intel Xeon Silver 4314 2U Rack Server. Category: HPE. Subcategory: Server. ",183,739014,739197
5346,sentence,"Category: HPE. Subcategory: Server. Price: Call for Price.

Product: HPE ProLiant DL380 Gen 10 Plus 2x Intel Xeon Gold 5317 2U Rack Server. Category: HPE. Subcategory: Server. Price: Call for Price.
",199,739161,739360
5347,sentence,"Subcategory: Server. Price: Call for Price.

Product: HPE ProLiant DL380 Gen 10 Plus 2x Intel Xeon Gold 6326 2U Rack Server. Category: HPE. Subcategory: Server. Price: Call for Price.
",184,739316,739500
5348,sentence,"Subcategory: Server. Price: Call for Price.

Product: HPE ProLiant DL380 Generation 10 PLUS 2 x Intel Xeon-Silver 4314 64GB RAM 3 x HPE 2.4TB HDD Server. Category: HPE. Subcategory: Server. ",190,739456,739646
5349,sentence,"Category: HPE. Subcategory: Server. Price: Out Of Stock.

Product: Asus ESC8000A-E13P AMD EPYC 9005 GPU Server. Category: GPU Server. Subcategory: Server & Storage. Price: Pre Order.
",183,739610,739793
5350,sentence,"Price: Pre Order.

Product: Asus ESC N8A-E12 AMD EPYC 9004 GPU Server. Category: GPU Server. Subcategory: Server & Storage. Price: Pre Order.
",142,739775,739917
5351,sentence,"Price: Pre Order.

Product: Asus ESC4000-E11 5th Gen Intel Xeon Scalable GPU Server and ASUS ASMB11-iKVM. Category: GPU Server. Subcategory: Server & Storage. Price: Pre Order.
",177,739899,740076
5352,sentence,"Price: Pre Order.

Product: Asus ESC N8-E11/ESC N8-E11V 5th Gen Intel Xeon Scalable GPU Server. Category: GPU Server. Subcategory: Server & Storage. Price: Pre Order.
",167,740058,740225
5353,sentence,"Price: Pre Order.

Product: Asus ESC8000-E11 5th Gen Intel Xeon Scalable GPU Server and ASUS ASMB11-iKVM. Category: GPU Server. Subcategory: Server & Storage. Price: Pre Order.
",177,740207,740384
5354,sentence,"Price: Pre Order.

Product: Asus ESC8000-E11P 5th Gen Intel Xeon Scalable GPU Server and ASUS ASMB11-iKVM. Category: GPU Server. Subcategory: Server & Storage. Price: Pre Order.
",178,740366,740544
5355,sentence,"Price: Pre Order.

Product: Asus ESC8000A-E12 AMD EPYC 9004 GPU Server and ASUS ASMB11-iKVM. Category: GPU Server. Subcategory: Server & Storage. Price: Pre Order.
",164,740526,740690
5356,sentence,"Price: Pre Order.

Product: Asus ESC8000A-E12P AMD EPYC 9004 GPU Server and ASUS ASMB11-iKVM. Category: GPU Server. Subcategory: Server & Storage. Price: Pre Order.
",165,740672,740837
5357,sentence,"Price: Pre Order.

Product: Asus ESC4000A-E12 AMD EPYC 9004 GPU Server and ASUS ASMB11-iKVM. Category: GPU Server. Subcategory: Server & Storage. Price: Pre Order.
",164,740819,740983
5358,sentence,"Price: Pre Order.

Product: Asus ESC4000-E10S 3rd Gen Intel Xeon Scalable GPU Server and ASUS ASMB10-iKVM. Category: GPU Server. Subcategory: Server & Storage. Price: Pre Order.
",178,740965,741143
5359,sentence,"Price: Pre Order.

Product: Asus ESC4000A-E11 AMD EPYC 7003 & 7002 GPU Server and ASUS ASMB10-iKVM. Category: GPU Server. Subcategory: Server & Storage. Price: Pre Order.
",171,741125,741296
5360,sentence,"Price: Pre Order.

Product: Asus ESC8000A-E11 AMD EPYC 7003 GPU Server and ASUS ASMB10-iKVM. Category: GPU Server. Subcategory: Server & Storage. Price: Pre Order.
",164,741278,741442
5361,sentence,"Price: Pre Order.

Product: Asus ESC N4A-E11 AMD EPYC 7003 GPU Server and ASUS ASMB10-iKVM. Category: GPU Server. Subcategory: Server & Storage. Price: Pre Order.
",163,741424,741587
5362,sentence,"Price: Pre Order.

Product: Asus ESC4000-E10 3rd Gen Intel Xeon Scalable GPU Server and ASUS ASMB10-iKVM. Category: GPU Server. Subcategory: Server & Storage. Price: Pre Order.
",177,741569,741746
5363,sentence,"Price: Pre Order.

Product: Asus ESC8000 G4/10G 2nd Gen Intel Xeon Scalable GPU Server. Category: GPU Server. Subcategory: Server & Storage. Price: Pre Order.
",159,741728,741887
5364,sentence,"Price: Pre Order.

Product: Asus ESC8000 G4 2nd Gen Intel Xeon Scalable GPU Server. Category: GPU Server. Subcategory: Server & Storage. Price: Pre Order.
",155,741869,742024
5365,sentence,"Price: Pre Order.

Product: DateUp 6 Port PDU for Server Rack. Category: Server & Storage. Price: 3,000৳.

Product: DateUp 8 Port PDU for Server Rack. Category: Server & Storage. Price: 3,200৳.
",194,742006,742200
5366,sentence,"Category: Server & Storage. Price: 3,200৳.

Product: DateUp 8 Port PDU With 2 Meter Cable for Server Rack. Category: Server & Storage. Price: 3,500৳.

Product: DATEUP 6U Server Rack (600x450x370). ",197,742157,742354
5367,sentence,"
Product: DATEUP 6U Server Rack (600x450x370). Category: Server & Storage. Price: 11,000৳.

Product: Toten 6U 600 x 450mm Server Rack. Category: Server & Storage. Price: 11,500৳.
",179,742307,742486
5368,sentence,"Category: Server & Storage. Price: 11,500৳.

Product: Toten 9U 600 x 450mm Server Rack. Category: Server & Storage. Price: 12,500৳.

Product: DATEUP 9U Server Rack (600x450x501). ",179,742442,742621
5369,sentence,"
Product: DATEUP 9U Server Rack (600x450x501). Category: Server & Storage. Price: 12,500৳.

Product: Cote 6U 600 x 450mm Server Rack. Category: Server & Storage. Price: 13,000৳.
",178,742574,742752
5370,sentence,"Category: Server & Storage. Price: 13,000৳.

Product: DATEUP 6U Server Rack (600x600x370). Category: Server & Storage. Price: 13,000৳.

Product: Safenet 6U Wall Mount Network Cabinet with PDU. ",193,742708,742901
5371,sentence,"Category: Server & Storage. Price: 13,500৳.

Product: DATEUP 9U Server Rack (600x600x501). Category: Server & Storage. Price: 13,500৳.

Product: Toten 12U 600 x 450mm Server Rack. ",180,742901,743081
5372,sentence,"
Product: Toten 12U 600 x 450mm Server Rack. Category: Server & Storage. Price: 14,500৳.

Product: Safenet 9U Wall Mount Network Cabinet with PDU. Category: Server & Storage. Price: 14,500৳.
",191,743036,743227
5373,sentence,"Category: Server & Storage. Price: 14,500৳.

Product: Cote 6U 600 x 600mm Server Rack. Category: Server & Storage. Price: 14,500৳.

Product: Cote 9U 600 x 450mm Server Rack. ",174,743183,743357
5374,sentence,"
Product: Cote 9U 600 x 450mm Server Rack. Category: Server & Storage. Price: 14,500৳.

Product: Toten 6U 600 x 600mm Server Rack. Category: Server & Storage. Price: 14,500৳.
",175,743314,743489
5375,sentence,"Category: Server & Storage. Price: 14,500৳.

Product: Toten 9U 600 x 600mm Server Rack. Category: Server & Storage. Price: 15,000৳.

Product: DATEUP 12U Server Rack (600x450x635). ",180,743445,743625
5376,sentence,"
Product: DATEUP 12U Server Rack (600x450x635). Category: Server & Storage. Price: 15,000৳.

Product: Cote 9U 600 x 600mm Server Rack. Category: Server & Storage. Price: 15,500৳.
",179,743577,743756
5377,sentence,"Category: Server & Storage. Price: 15,500৳.

Product: DATEUP 12U Server Rack (600x600x635). Category: Server & Storage. Price: Out Of Stock.
",141,743712,743853
5378,sentence,"Price: Out Of Stock.

Product: Safenet 12U Wall Mount Network Cabinet with PDU. Category: Safenet. Subcategory: Server Rack. Price: 18,000৳.
",141,743832,743973
5379,sentence,"Subcategory: Server Rack. Price: 18,000৳.

Product: Safenet 15U Wall Mount Network Cabinet with PDU. Category: Safenet. Subcategory: Server Rack. Price: 20,500৳.
",162,743931,744093
5380,sentence,"Subcategory: Server Rack. Price: 20,500৳.

Product: Safenet 42U Tempered Glass Door Floor Standing Server Cabinet. Category: Safenet. Subcategory: Server Rack. Price: 68,000৳.
",176,744051,744227
5381,sentence,"Subcategory: Server Rack. Price: 68,000৳.

Product: Safenet 42U Perforated Floor Standing Data Center Cabinet. Category: Safenet. Subcategory: Server Rack. Price: 120,000৳.
",173,744185,744358
5382,sentence,"Subcategory: Server Rack. Price: 120,000৳.

Product: Safenet 42U-XL Perforated Floor Standing Data Center Cabinet. Category: Safenet. Subcategory: Server Rack. Price: 125,000৳.
",177,744315,744492
5383,sentence,"Subcategory: Server Rack. Price: 125,000৳.

Product: Safenet 42U-XL Tempered Glass Door Floor Standing Server Cabinet. Category: Safenet. Subcategory: Server Rack. Price: 128,000৳.
",181,744449,744630
5384,sentence,"Subcategory: Server Rack. Price: 128,000৳.

Product: Safenet 32U 2-Post Open Frame Floor Standing Rack. Category: Safenet. Subcategory: Server Rack. Price: Out Of Stock.
",170,744587,744757
5385,sentence,"Subcategory: Server Rack. Price: Out Of Stock.

Product: Safenet 32U 4-Post Open Frame Floor Standing Rack. Category: Safenet. Subcategory: Server Rack. Price: Out Of Stock.
",174,744710,744884
5386,sentence,"Subcategory: Server Rack. Price: Out Of Stock.

Product: Safenet 42U 4-Post Open Frame Floor Standing Rack. Category: Safenet. Subcategory: Server Rack. Price: Out Of Stock.
",174,744837,745011
5387,sentence,"Subcategory: Server Rack. Price: Out Of Stock.

Product: Safenet 22U Tempered Glass Door Floor Standing Server Cabinet. Category: Safenet. Subcategory: Server Rack. Price: Out Of Stock.
",186,744964,745150
5388,sentence,"Subcategory: Server Rack. Price: Out Of Stock.

Product: Safenet 22U-XL Tempered Glass Door Floor Standing Server Cabinet. Category: Safenet. Subcategory: Server Rack. Price: Out Of Stock.
",189,745103,745292
5389,sentence,"Subcategory: Server Rack. Price: Out Of Stock.

Product: Safenet 32U Tempered Glass Door Floor Standing Server Cabinet. Category: Safenet. Subcategory: Server Rack. Price: Out Of Stock.
",186,745245,745431
5390,sentence,"Subcategory: Server Rack. Price: Out Of Stock.

Product: Cote 12U 600 x 600mm Server Rack. Category: Cote. Subcategory: Server Rack. Price: 16,000৳.

Product: Cote 15U 600 x 600mm Server Rack. ",193,745384,745577
5391,sentence,"
Product: Cote 15U 600 x 600mm Server Rack. Category: Cote. Subcategory: Server Rack. Price: 18,000৳.

Product: Cote 22U 600 x 1000mm Server Rack. Category: Cote. Subcategory: Server Rack. ",189,745533,745722
5392,sentence,"Category: Cote. Subcategory: Server Rack. Price: 50,000৳.

Product: Cote 32U 600 x 1000mm Server Rack. Category: Cote. Subcategory: Server Rack. Price: 60,000৳.
",161,745680,745841
5393,sentence,"Subcategory: Server Rack. Price: 60,000৳.

Product: Cote 42U 800 x 1000mm Server Rack. Category: Cote. Subcategory: Server Rack. Price: 80,000৳.

Product: Cote 42U 600 x 1070mm Server Rack. ",190,745799,745989
5394,sentence,"
Product: Cote 42U 600 x 1070mm Server Rack. Category: Cote. Subcategory: Server Rack. Price: 88,000৳.

Product: HP Z2 G9 SFF Core i7 14th Gen Workstation. Category: Workstation. ",179,745944,746123
5395,sentence,"Category: Workstation. Subcategory: Server & Storage. Price: 190,000৳.

Product: HP Z1 G9R Core i7 14th Gen Tower Desktop PC. Category: Workstation. Subcategory: Server & Storage. Price: 255,500৳.
",197,746100,746297
5396,sentence,"Subcategory: Server & Storage. Price: 255,500৳.

Product: HP Z2 G9 Core i9 14th Gen Tower Workstation. Category: Workstation. Subcategory: Server & Storage. Price: 305,000৳.
",174,746249,746423
5397,sentence,"Subcategory: Server & Storage. Price: 305,000৳.

Product: HP Z4 G5 Tower Intel Xeon W5-2445 Workstation. Category: Workstation. Subcategory: Server & Storage. Price: 540,000৳.
",176,746375,746551
5398,sentence,"Subcategory: Server & Storage. Price: 540,000৳.

Product: Dell Precision 3420 Workstation. Category: Workstation. Subcategory: Server & Storage. Price: Call for Price.
",168,746503,746671
5399,sentence,"Price: Call for Price.

Product: Dell Precision 5820 Tower Workstation. Category: Workstation. Subcategory: Server & Storage. Price: Call for Price.

Product: Dell Precision 7820 Tower Workstation. ",198,746648,746846
5400,sentence,"
Product: Dell Precision 7820 Tower Workstation. Category: Workstation. Subcategory: Server & Storage. Price: Call for Price.

Product: Dell Precision 7920 Tower Workstation. Category: Workstation. ",198,746797,746995
5401,sentence,"Category: Workstation. Subcategory: Server & Storage. Price: Call for Price.

Product: Dell Precision 7920 Rack Workstation. Category: Workstation. Subcategory: Server & Storage. ",179,746972,747151
5402,sentence,"Subcategory: Server & Storage. Price: Call for Price.

Product: Dell Precision R3930 Rack Workstation. Category: Workstation. Subcategory: Server & Storage. Price: Call for Price.
",180,747120,747300
5403,sentence,"Price: Call for Price.

Product: Lenovo ThinkStation P620 Ryzen Threadripper PRO 3955WX Workstation. Category: Workstation. Subcategory: Server & Storage. Price: Call for Price.
",178,747277,747455
5404,sentence,"Price: Call for Price.

Product: Lenovo ThinkStation P3 Tower Core i7 13th Gen Workstation. Category: Workstation. Subcategory: Server & Storage. Price: Call for Price.
",169,747432,747601
5405,sentence,"Price: Call for Price.

Product: HP Z2 Tower G9 Core i9 12th Gen Workstation. Category: Workstation. Subcategory: Server & Storage. Price: Call for Price.
",155,747578,747733
5406,sentence,"Price: Call for Price.

Product: HP Z4 G5 Tower Intel Xeon W 2425 Workstation. Category: Workstation. Subcategory: Server & Storage. Price: Call for Price.
",156,747710,747866
5407,sentence,"Price: Call for Price.

Product: Dell Precision 3660 Tower CTO BASE Workstation. Category: Workstation. Subcategory: Server & Storage. Price: Call for Price.
",158,747843,748001
5408,sentence,"Price: Call for Price.

Product: Lenovo ThinkStation P340 Core i5 10th Gen Tower Workstation. Category: Workstation. Subcategory: Server & Storage. Price: Call for Price.
",171,747978,748149
5409,sentence,"Price: Call for Price.

Product: Lenovo ThinkStation P340 Core i7 10th Gen Tower Workstation. Category: Workstation. Subcategory: Server & Storage. Price: Call for Price.
",171,748126,748297
5410,sentence,"Price: Call for Price.

Product: Lenovo ThinkStation P340 Tower Workstation. Category: Workstation. Subcategory: Server & Storage. Price: Call for Price.
",154,748274,748428
5411,sentence,"Price: Call for Price.

Product: Lenovo ThinkStation P350 Tower Workstation. Category: Workstation. Subcategory: Server & Storage. Price: Call for Price.
",154,748405,748559
5412,sentence,"Price: Call for Price.

Product: Dell Precision 5860 Tower Workstation. Category: Workstation. Subcategory: Server & Storage. Price: Up Coming.

Product: Toten 15U 600 x 600mm Server Rack. ",189,748536,748725
5413,sentence,"
Product: Toten 15U 600 x 600mm Server Rack. Category: Toten. Subcategory: Server Rack. Price: 18,500৳.

Product: Toten 32U 600 x 600mm Server Rack. Category: Toten. Subcategory: Server Rack. ",192,748680,748872
5414,sentence,"Category: Toten. Subcategory: Server Rack. Price: 40,000৳.

Product: Toten 22U 600 x 1000mm Server Rack. Category: Toten. Subcategory: Server Rack. Price: 43,000৳.
",164,748829,748993
5415,sentence,"Subcategory: Server Rack. Price: 43,000৳.

Product: Toten 32U 600 x 1000mm Server Rack. Category: Toten. Subcategory: Server Rack. Price: 50,000৳.

Product: Toten 42U 600 x 1000mm Server Rack. ",193,748951,749144
5416,sentence,"
Product: Toten 42U 600 x 1000mm Server Rack. Category: Toten. Subcategory: Server Rack. Price: 59,000৳.

Product: Toten 4U 600 x 450mm Server Rack. Category: Toten. Subcategory: Server Rack. ",192,749098,749290
5417,sentence,"Category: Toten. Subcategory: Server Rack. Price: Up Coming.

Product: Toten 32U 600 x 800mm Server Rack. Category: Toten. Subcategory: Server Rack. Price: Up Coming.
",167,749247,749414
5418,sentence,"Subcategory: Server Rack. Price: Up Coming.

Product: Toten 42U 800 x 1000mm Server Rack. Category: Toten. Subcategory: Server Rack. Price: Up Coming.

Product: Toten 12U 600 x 600mm Server Rack. ",196,749370,749566
5419,sentence,"
Product: Toten 12U 600 x 600mm Server Rack. Category: Toten. Subcategory: Server Rack. Price: Out Of Stock.

Product: Toten 22U 600 x 600mm Server Rack. Category: Toten. Subcategory: Server Rack. ",197,749521,749718
5420,sentence,"Category: Toten. Subcategory: Server Rack. Price: Out Of Stock.

Product: Toten 22U 600 x 800mm Server Rack. Category: Toten. Subcategory: Server Rack. Price: Out Of Stock.
",173,749675,749848
5421,sentence,"Subcategory: Server Rack. Price: Out Of Stock.

Product: HP Z2 Tower G9 Core i7 13th Gen 16GB RAM Workstation. Category: HP. Subcategory: Workstation. Price: Out Of Stock.
",172,749801,749973
5422,sentence,"Subcategory: Workstation. Price: Out Of Stock.

Product: DATEUP 15U Server Rack (600x450x855). Category: DateUP. Subcategory: Server Rack. Price: 16,000৳.
",155,749926,750081
5423,sentence,"Subcategory: Server Rack. Price: 16,000৳.

Product: DATEUP 15U Server Rack (600x600x855). Category: DateUP. Subcategory: Server Rack. Price: 17,000৳.
",150,750039,750189
5424,sentence,"Subcategory: Server Rack. Price: 17,000৳.

Product: DateUp 32U Glass Door Server Rack (800x1000x1610). Category: DateUP. Subcategory: Server Rack. Price: 52,000৳.
",163,750147,750310
5425,sentence,"Subcategory: Server Rack. Price: 52,000৳.

Product: DateUp 42U Glass Door Server Rack (600x800x2055). Category: DateUP. Subcategory: Server Rack. Price: 52,500৳.
",162,750268,750430
5426,sentence,"Subcategory: Server Rack. Price: 52,500৳.

Product: DateUp 42U Glass Door Server Rack (600x1000x2055). Category: DateUP. Subcategory: Server Rack. Price: 56,000৳.
",163,750388,750551
5427,sentence,"Subcategory: Server Rack. Price: 56,000৳.

Product: DateUp 42U Mesh Door Server Rack (600x1000x2055). Category: DateUP. Subcategory: Server Rack. Price: 59,000৳.
",162,750509,750671
5428,sentence,"Subcategory: Server Rack. Price: 59,000৳.

Product: DateUp 42U Glass Door Server Rack (800x1000x2055). Category: DateUP. Subcategory: Server Rack. Price: 60,000৳.
",163,750629,750792
5429,sentence,"Subcategory: Server Rack. Price: 60,000৳.

Product: DateUp 42U Mesh Door Server Rack (800x1000x2055). Category: DateUP. Subcategory: Server Rack. Price: 65,000৳.
",162,750750,750912
5430,sentence,"Subcategory: Server Rack. Price: 65,000৳.

Product: DateUp 22U Glass Door Server Rack (600mmx800x1610). Category: DateUP. Subcategory: Server Rack. Price: Up Coming.
",166,750870,751036
5431,sentence,"Subcategory: Server Rack. Price: Up Coming.

Product: DateUp 32U Server Rack (600x1000x1610). Category: DateUP. Subcategory: Server Rack. Price: Out Of Stock.
",159,750992,751151
5432,sentence,"Subcategory: Server Rack. Price: Out Of Stock.

Product: Asustor DRIVESTOR 2 Lite AS1102T 2-Bays NAS Storage. Category: Asustor. Subcategory: NAS Storage. Price: 30,500৳.
",171,751104,751275
5433,sentence,"Subcategory: NAS Storage. Price: 30,500৳.

Product: Asustor FLASHSTOR 6 FS6706T NAS Storage. Category: Asustor. Subcategory: NAS Storage. Price: 75,000৳.
",154,751233,751387
5434,sentence,"Subcategory: NAS Storage. Price: 75,000৳.

Product: Asustor LOCKERSTOR 4 GEN-2 AS6704T 4-Bays NAS Storage. Category: Asustor. Subcategory: NAS Storage. Price: 98,000৳.
",168,751345,751513
5435,sentence,"Subcategory: NAS Storage. Price: 98,000৳.

Product: Asustor LOCKERSTOR 6 Gen2 AS6706T 6-Bays NAS Storage. Category: Asustor. Subcategory: NAS Storage. Price: 135,000৳.
",168,751471,751639
5436,sentence,"Subcategory: NAS Storage. Price: 135,000৳.

Product: Asustor AS6504RS Lockerstor 4RS 4-Bays NAS Enclosure. Category: Asustor. Subcategory: NAS Storage. Price: 150,000৳.
",169,751596,751765
5437,sentence,"Subcategory: NAS Storage. Price: 150,000৳.

Product: Asustor LOCKERSTOR 8 AS6508T 8-Bays NAS Storage. Category: Asustor. Subcategory: NAS Storage. Price: 175,000৳.
",164,751722,751886
5438,sentence,"Subcategory: NAS Storage. Price: 175,000৳.

Product: Asustor LOCKERSTOR 12RD AS6512RD 12-Bays NAS Storage. Category: Asustor. Subcategory: NAS Storage. Price: 335,000৳.
",169,751843,752012
5439,sentence,"Subcategory: NAS Storage. Price: 335,000৳.

Product: Asustor LOCKERSTOR 12R Pro AS7112RDX 12-Bays NAS Storage. Category: Asustor. Subcategory: NAS Storage. Price: Call for Price.
",179,751969,752148
5440,sentence,"Price: Call for Price.

Product: Asustor AS7116RDX Lockerstor 16R Pro 16-Bays NAS Enclosure. Category: Asustor. Subcategory: NAS Storage. Price: Call for Price.
",161,752125,752286
5441,sentence,"Price: Call for Price.

Product: Asustor DRIVESTOR 4 Pro AS3304T 4-Bays NAS Storage. Category: Asustor. Subcategory: NAS Storage. Price: Out Of Stock.
",151,752263,752414
5442,sentence,"Subcategory: NAS Storage. Price: Out Of Stock.

Product: Asustor DRIVESTOR 4 Pro Gen2 AS3304T V2 4-Bays NAS Storage. Category: Asustor. Subcategory: NAS Storage. Price: Out Of Stock.
",183,752367,752550
5443,sentence,"Subcategory: NAS Storage. Price: Out Of Stock.

Product: Asustor AS6602T NAS Storage. Category: Asustor. Subcategory: NAS Storage. Price: Out Of Stock.

Product: Asustor AS6604T NAS Storage. ",191,752503,752694
5444,sentence,"
Product: Asustor AS6604T NAS Storage. Category: Asustor. Subcategory: NAS Storage. Price: Out Of Stock.

Product: Dell Precision 7960 Tower Workstation. Category: Dell. Subcategory: Workstation. ",196,752655,752851
5445,sentence,"Category: Dell. Subcategory: Workstation. Price: Up Coming.

Product: Dell Precision Tower 3620 XCTO BASE Workstation. Category: Dell. Subcategory: Workstation. Price: Out Of Stock.
",182,752809,752991
5446,sentence,"Subcategory: Workstation. Price: Out Of Stock.

Product: Dell Precision T3650 Core i7 11th Gen Workstation. Category: Dell. Subcategory: Workstation. Price: Out Of Stock.
",171,752944,753115
5447,sentence,"Subcategory: Workstation. Price: Out Of Stock.

Product: Dell Precision T3660 Core i7 12th Gen Workstation. Category: Dell. Subcategory: Workstation. Price: Out Of Stock.
",171,753068,753239
5448,sentence,"Subcategory: Workstation. Price: Out Of Stock.

Product: ORICO MetaBox Pro 2 Bay NAS Storage. Category: Orico. Subcategory: NAS Storage. Price: 32,000৳.
",153,753192,753345
5449,sentence,"Subcategory: NAS Storage. Price: 32,000৳.

Product: ORICO MetaCube Pro 5 Bay NAS Storage. Category: Orico. Subcategory: NAS Storage. Price: 47,000৳.

Product: ORICO MetaBox Pro 5 Bay NAS Storage. ",196,753303,753499
5450,sentence,"
Product: ORICO MetaBox Pro 5 Bay NAS Storage. Category: Orico. Subcategory: NAS Storage. Price: 57,000৳.

Product: ORICO 9858U3 5 Bay USB 3.0 DAS Enclosure. Category: DAS Storage. ",181,753452,753633
5451,sentence,"Category: DAS Storage. Subcategory: Server & Storage. Price: 26,900৳.

Product: ORICO 9758C3 5 Bay USB3.1 Type-C DAS Enclosure. Category: DAS Storage. Subcategory: Server & Storage. Price: 28,500৳.
",198,753610,753808
5452,sentence,"Subcategory: Server & Storage. Price: 28,500৳.

Product: Dell EMC ME4024 Storage Array. Category: DELL. Subcategory: SAN Storage. Price: Call for Price.

Product: Dell EMC PowerStore 3000T Storage. ",198,753761,753959
5453,sentence,"
Product: Dell EMC PowerStore 3000T Storage. Category: DELL. Subcategory: SAN Storage. Price: Call for Price.

Product: Dell EMC Unity XT 480F All-Flash Storage. Category: DELL. ",178,753914,754092
5454,sentence,"Category: DELL. Subcategory: SAN Storage. Price: Call for Price.

Product: Dell SCv3020 Storage Array. Category: DELL. Subcategory: SAN Storage. Price: Call for Price.
",168,754076,754244
5455,sentence,"Price: Call for Price.

Product: Dell EMC PowerStore 500T Storage. Category: DELL. Subcategory: SAN Storage. Price: Call for Price.
",132,754221,754353
5456,sentence,"Price: Call for Price.

Product: Dell PowerVault ME5024 25Gb iSCSI Dual Controller Storage Array. Category: DELL. Subcategory: SAN Storage. Price: Call for Price.
",163,754330,754493
5457,sentence,"Price: Call for Price.

Product: Dell PowerVault ME5024 12Gb SAS 8 Port Dual Controller Storage Array. Category: DELL. Subcategory: SAN Storage. Price: Call for Price.
",168,754470,754638
5458,sentence,"Price: Call for Price.

Product: Dell PowerVault ME5024 32Gb FC Type-B 8 Port Dual Controller Storage Array. Category: DELL. Subcategory: SAN Storage. Price: Call for Price.
",174,754615,754789
5459,sentence,"Price: Call for Price.

Product: Dell PowerVault ME5012 32Gb FC Type-B 8 Port Dual Controller Storage Array. Category: DELL. Subcategory: SAN Storage. Price: Call for Price.
",174,754766,754940
5460,sentence,"Price: Call for Price.

Product: Dell PowerVault ME5012 25Gb iSCSI 8 Port Dual Controller Storage Array. Category: DELL. Subcategory: SAN Storage. Price: Call for Price.
",170,754917,755087
5461,sentence,"Price: Call for Price.

Product: Dell EMC Unity XT 380 Hybrid Flash Storage Array. Category: DELL. Subcategory: SAN Storage. Price: Call for Price.
",148,755064,755212
5462,sentence,"Price: Call for Price.

Product: Dell EMC Unity XT 380F Hybrid Flash Storage Array. Category: DELL. Subcategory: SAN Storage. Price: Call for Price.
",149,755189,755338
5463,sentence,"Price: Call for Price.

Product: Dell EMC Unity XT 480 Hybrid Flash Storage Array. Category: DELL. Subcategory: SAN Storage. Price: Call for Price.
",148,755315,755463
5464,sentence,"Price: Call for Price.

Product: Dell Powerflex Appliance R650 Storage Array. Category: DELL. Subcategory: SAN Storage. Price: Call for Price.
",143,755440,755583
5465,sentence,"Price: Call for Price.

Product: Dell Powerflex Appliance R650 Storage Array With Jumper Cord. Category: DELL. Subcategory: SAN Storage. Price: Call for Price.
",160,755560,755720
5466,sentence,"Price: Call for Price.

Product: Dell Powerflex Appliance R650 HCI Storage Array. Category: DELL. Subcategory: SAN Storage. Price: Call for Price.

Product: Dell EMC PowerStore 1000T Storage Array. ",198,755697,755895
5467,sentence,"Category: DELL. Subcategory: SAN Storage. Price: Call for Price.

Product: Dell EMC PowerStore 1200T Storage Array. Category: DELL. Subcategory: SAN Storage. Price: Call for Price.
",181,755895,756076
5468,sentence,"Price: Call for Price.

Product: Dell PowerVault ME5012 12Gb SAS 8 Port Dual Controller Storage Array. Category: DELL. Subcategory: SAN Storage. Price: Call for Price.
",168,756053,756221
5469,sentence,"Price: Call for Price.

Product: Dell PowerStore 500T SAS Storage Array. Category: DELL. Subcategory: SAN Storage. Price: Call for Price.
",138,756198,756336
5470,sentence,"Price: Call for Price.

Product: Synology RKS-02 Sliding Rail Kit for Synology Rackmount Servers. Category: NAS Storage. Subcategory: Server & Storage. Price: 18,500৳.
",168,756313,756481
5471,sentence,"Subcategory: Server & Storage. Price: 18,500৳.

Product: Synology DiskStation DS124 1-Bay NAS Enclosure. Category: NAS Storage. Subcategory: Server & Storage. Price: 24,000৳.
",175,756434,756609
5472,sentence,"Subcategory: Server & Storage. Price: 24,000৳.

Product: Synology DiskStation DS223j 2-Bays NAS Enclosure. Category: NAS Storage. Subcategory: Server & Storage. Price: 30,000৳.
",177,756562,756739
5473,sentence,"Subcategory: Server & Storage. Price: 30,000৳.

Product: Synology DiskStation DS223 2-Bays NAS Enclosure. Category: NAS Storage. Subcategory: Server & Storage. Price: 43,000৳.
",176,756692,756868
5474,sentence,"Subcategory: Server & Storage. Price: 43,000৳.

Product: Synology DiskStation DS224+ 2-Bays NAS Enclosure. Category: NAS Storage. Subcategory: Server & Storage. Price: 50,000৳52,000৳.
",184,756821,757005
5475,sentence,"Price: 50,000৳52,000৳.

Product: Synology DiskStation DS423+ 4-Bays NAS Enclosure. Category: NAS Storage. Subcategory: Server & Storage. Price: 79,500৳.
",153,756982,757135
5476,sentence,"Subcategory: Server & Storage. Price: 79,500৳.

Product: Synology DiskStation DS923+ 4-Bays NAS Enclosure. Category: NAS Storage. Subcategory: Server & Storage. Price: 95,500৳.
",177,757088,757265
5477,sentence,"Subcategory: Server & Storage. Price: 95,500৳.

Product: Synology DiskStation DS1525+ 5-Bays NAS Enclosure. Category: NAS Storage. Subcategory: Server & Storage. Price: 130,500৳.
",179,757218,757397
5478,sentence,"Subcategory: Server & Storage. Price: 130,500৳.

Product: Synology DiskStation DS1621+ 6-Bays NAS Enclosure. Category: NAS Storage. Subcategory: Server & Storage. Price: 148,000৳.
",180,757349,757529
5479,sentence,"Subcategory: Server & Storage. Price: 148,000৳.

Product: Synology DiskStation DS1823xs+ 8-Bays NAS Enclosure. Category: NAS Storage. Subcategory: Server & Storage. Price: 245,000৳.
",182,757481,757663
5480,sentence,"Subcategory: Server & Storage. Price: 245,000৳.

Product: HP 600GB 10K RPM SAS 2.5"" Server HDD. Category: Server HDD. Subcategory: Server & Storage. Price: Call for Price.
",172,757615,757787
5481,sentence,"Price: Call for Price.

Product: Dell 12TB 7.2K RPM SATA 6Gbps 512e 3.5"" Hot-Plug Server HDD. Category: Server HDD. Subcategory: Server & Storage. Price: Call for Price.
",170,757764,757934
5482,sentence,"Price: Call for Price.

Product: HPE 900GB SAS 12G MC 15K SFF BC Server HDD. Category: Server HDD. Subcategory: Server & Storage. Price: Call for Price.
",153,757911,758064
5483,sentence,"Price: Call for Price.

Product: HPE 2.4TB SAS 12G MC 10K SFF SC 512e Server HDD. Category: Server HDD. Subcategory: Server & Storage. Price: Call for Price.
",158,758041,758199
5484,sentence,"Price: Call for Price.

Product: HP 300GB 6G 10K RPM 2.5-inch SFF SC Server SAS HDD. Category: Server HDD. Subcategory: Server & Storage. Price: Call for Price.
",161,758176,758337
5485,sentence,"Price: Call for Price.

Product: Cisco UCS-HD4T7KS3-E 4TB 7.2K RPM SAS 3.5"" Hot Plug HDD. Category: Server HDD. Subcategory: Server & Storage. Price: Call for Price.
",166,758314,758480
5486,sentence,"Price: Call for Price.

Product: DELL 1.2TB 10K RPM SAS 12Gbps 2.5"" Hot Plug HDD. Category: Server HDD. Subcategory: Server & Storage. Price: Call for Price.
",158,758457,758615
5487,sentence,"Price: Call for Price.

Product: Cisco UCS-HD12TB10K12N 1.2TB 10K RPM 12Gbps SAS 2.5"" SFF Server HDD. Category: Server HDD. Subcategory: Server & Storage. Price: Call for Price.
",178,758592,758770
5488,sentence,"Price: Call for Price.

Product: HPE P28352-B21 2.4TB 10K RPM MC SAS 2.5"" SFF Server HDD. Category: Server HDD. Subcategory: Server & Storage. Price: Call for Price.
",166,758747,758913
5489,sentence,"Price: Call for Price.

Product: HPE LTO-6 Ultrium 6.25TB RW Data Cartridge. Category: Server HDD. Subcategory: Server & Storage. Price: Call for Price.
",153,758890,759043
5490,sentence,"Price: Call for Price.

Product: Dell Server 2.5"" 300 GB 10000 Rpm HDD SAS. Category: Server HDD. Subcategory: Server & Storage. Price: Call for Price.
",152,759020,759172
5491,sentence,"Price: Call for Price.

Product: Dell Server 2.5"" 600 GB 15000 Rpm HDD SAS. Category: Server HDD. Subcategory: Server & Storage. Price: Call for Price.
",152,759149,759301
5492,sentence,"Price: Call for Price.

Product: Dell Server 300 GB 3.5"" 10000 Rpm HDD SAS. Category: Server HDD. Subcategory: Server & Storage. Price: Call for Price.
",152,759278,759430
5493,sentence,"Price: Call for Price.

Product: Dell Server 600 GB 3.5"" 15000 Rpm HDD SAS. Category: Server HDD. Subcategory: Server & Storage. Price: Call for Price.
",152,759407,759559
5494,sentence,"Price: Call for Price.

Product: HP Server 600 GB 2.5"" 10000 Rpm G8 And G9 HDD SAS. Category: Server HDD. Subcategory: Server & Storage. Price: Call for Price.
",160,759536,759696
5495,sentence,"Price: Call for Price.

Product: HP Server 1.2TB 2.5"" 10000 Rpm G8 And G9 HDD SAS. Category: Server HDD. Subcategory: Server & Storage. Price: Call for Price.
",159,759673,759832
5496,sentence,"Price: Call for Price.

Product: Dell 1TB 7.2K RPM Near-Line SAS 512n 3.5"" Hot Plug Hard Drive, CusKit. Category: Server HDD. Subcategory: Server & Storage. Price: Call for Price.
",180,759809,759989
5497,sentence,"Price: Call for Price.

Product: Dell 2TB 7.2K RPM Near-Line SAS 512n 3.5"" Hot Plug Hard Drive, CusKit. Category: Server HDD. Subcategory: Server & Storage. Price: Call for Price.
",180,759966,760146
5498,sentence,"Price: Call for Price.

Product: Dell 4TB 7.2K RPM Near-Line SAS 512n 3.5"" Hot Plug Hard Drive, CusKit. Category: Server HDD. Subcategory: Server & Storage. Price: Call for Price.
",180,760123,760303
5499,sentence,"Price: Call for Price.

Product: Dell 8TB 7.2K RPM Near-Line SAS 512n 3.5"" Hot Plug Hard Drive, CusKit. Category: Server HDD. Subcategory: Server & Storage. Price: Call for Price.
",180,760280,760460
5500,sentence,"Price: Call for Price.

Product: Dell Server 2.5"" HDD Bay. Category: Server HDD Bay. Subcategory: Server & Storage. Price: Call for Price.

Product: Dell Server 3.5"" HDD Bay. ",175,760437,760612
5501,sentence,"
Product: Dell Server 3.5"" HDD Bay. Category: Server HDD Bay. Subcategory: Server & Storage. Price: Call for Price.

Product: Samsung 16GB DDR4 3200MHz UDIMM ECC Server RAM. Category: Server RAM. ",196,760576,760772
5502,sentence,"Category: Server RAM. Subcategory: Server & Storage. Price: Call for Price.

Product: DELL 64GB DDR4 3200MHz RDIMM Server RAM. Category: Server RAM. Subcategory: Server & Storage. ",180,760750,760930
5503,sentence,"Subcategory: Server & Storage. Price: Call for Price.

Product: Samsung 32GB DDR4 3200MHz UDIMM ECC Server RAM. Category: Server RAM. Subcategory: Server & Storage. Price: Call for Price.
",188,760899,761087
5504,sentence,"Price: Call for Price.

Product: Samsung 16GB DDR4 2666MHz SODIMM Server RAM. Category: Server RAM. Subcategory: Server & Storage. Price: Call for Price.
",154,761064,761218
5505,sentence,"Price: Call for Price.

Product: Samsung 32GB DDR4 3200MHz RDIMM ECC Server RAM. Category: Server RAM. Subcategory: Server & Storage. Price: Call for Price.
",157,761195,761352
5506,sentence,"Price: Call for Price.

Product: HPE 32GB DDR4 2933MHz RDIMM Server RAM. Category: Server RAM. Subcategory: Server & Storage. Price: Call for Price.

Product: HPE 16GB DDR4 2666MHz RDIMM Server RAM. ",199,761329,761528
5507,sentence,"Category: Server RAM. Subcategory: Server & Storage. Price: Call for Price.

Product: HPE 16GB DDR4 2933MHz RDIMM Server RAM. Category: Server RAM. Subcategory: Server & Storage. ",179,761528,761707
5508,sentence,"Subcategory: Server & Storage. Price: Call for Price.

Product: HPE 16GB DDR4 2666MHz UDIMM Server RAM. Category: Server RAM. Subcategory: Server & Storage. Price: Call for Price.
",180,761676,761856
5509,sentence,"Price: Call for Price.

Product: Synology 16GB DDR4 2666MHz ECC SO-DIMM RAM. Category: Server RAM. Subcategory: Server & Storage. Price: Call for Price.
",153,761833,761986
5510,sentence,"Price: Call for Price.

Product: Intel D3-S4610 960GB 2.5"" Server SSD. Category: Server SSD. Subcategory: Server & Storage. Price: Call for Price.
",147,761963,762110
5511,sentence,"Price: Call for Price.

Product: HPE 960GB SAS 12G RI SFF 2.5"" SAS Server SSD. Category: Server SSD. Subcategory: Server & Storage. Price: Call for Price.
",155,762087,762242
5512,sentence,"Price: Call for Price.

Product: Dell 800GB SAS MU 12Gbps 2.5"" Hot-Plug SSD. Category: Server SSD. Subcategory: Server & Storage. Price: Call for Price.
",153,762219,762372
5513,sentence,"Price: Call for Price.

Product: Samsung PM893 960GB SATA 6Gbps 2.5"" Server SSD. Category: Server SSD. Subcategory: Server & Storage. Price: Call for Price.
",157,762349,762506
5514,sentence,"Price: Call for Price.

Product: Samsung PM893 480GB SATA 6Gbps 2.5"" Server SSD. Category: Server SSD. Subcategory: Server & Storage. Price: Call for Price.
",157,762483,762640
5515,sentence,"Price: Call for Price.

Product: HPE 1.92TB SAS 12G RI SFF SC Server SSD. Category: Server SSD. Subcategory: Server & Storage. Price: Call for Price.

Product: Intel D3-S4510 1.92TB 2.5"" Server SSD. ",199,762617,762816
5516,sentence,"
Product: Intel D3-S4510 1.92TB 2.5"" Server SSD. Category: Server SSD. Subcategory: Server & Storage. Price: Call for Price.

Product: Dell 240GB SSD SATA Mix Use TLC 6Gbps 512e 2.5in Drive S4600. ",197,762767,762964
5517,sentence,"Category: Server SSD. Subcategory: Server & Storage. Price: Call for Price.

Product: Dell 400GB SSD SATA, Mix Use MLC 6Gbps 2.5in Drive, THNSF8. Category: Server SSD. Subcategory: Server & Storage. ",199,762964,763163
5518,sentence,"Subcategory: Server & Storage. Price: Call for Price.

Product: Synology SNV3410 400GB M.2 2280 NVMe PCIe SSD. Category: Server SSD. Subcategory: Server & Storage. Price: Call for Price.
",187,763132,763319
5519,sentence,"Price: Call for Price.

Product: Synology SAT5210 960GB 2.5” Enterprise SATA SSD. Category: Server SSD. Subcategory: Server & Storage. Price: Call for Price.
",158,763296,763454
5520,sentence,"Price: Call for Price.

Product: Dell 1.92TB SSD SAS Read Intensive 24Gbps 512e 2.5inch Drive. Category: Server SSD. Subcategory: Server & Storage. Price: Call for Price.
",171,763431,763602
5521,sentence,"Price: Call for Price.

Product: Dell 960GB SATA RI SFF 2.5"" Hot Plug SSD. Category: Server SSD. Subcategory: Server & Storage. Price: Out Of Stock.
",149,763579,763728
5522,sentence,"Price: Out Of Stock.

Product: Samsung PM893 1.92TB SATA 6Gbps 2.5"" Server SSD. Category: Server SSD. Subcategory: Server & Storage. Price: Out Of Stock.
",154,763707,763861
5523,sentence,"Price: Out Of Stock.

Product: Dell 480GB MU 2.5"" SATA Hot-plug SSD. Category: Server SSD. Subcategory: Server & Storage. Price: Out Of Stock.

Product: Dell 1.92TB SAS RI 12Gbps 2.5"" Hot-Plug SSD. ",198,763840,764038
5524,sentence,"Category: Server SSD. Subcategory: Server & Storage. Price: Call for Price.

Product: Synology DiskStation DS3622xs+ 12 Bays Desktop NAS Storage. Category: Synology. Subcategory: NAS Storage. ",192,764038,764230
5525,sentence,"Category: Synology. Subcategory: NAS Storage. Price: Pre Order.

Product: Synology RackStation RS1619xs+ 4-Bays NAS Enclosure. Category: Synology. Subcategory: NAS Storage. Price: Call for Price.
",196,764184,764380
5526,sentence,"Price: Call for Price.

Product: Synology FlashStation FS6400 24 Bays NAS Storage. Category: Synology. Subcategory: NAS Storage. Price: Call for Price.
",152,764357,764509
5527,sentence,"Price: Call for Price.

Product: Synology RackStation RS1221RP+ 8-Bays NAS Enclosure. Category: Synology. Subcategory: NAS Storage. Price: Up Coming.
",150,764486,764636
5528,sentence,"Subcategory: NAS Storage. Price: Up Coming.

Product: Synology DiskStation DS120j 1-Bay NAS Server. Category: Synology. Subcategory: NAS Storage. Price: Out Of Stock.
",167,764592,764759
5529,sentence,"Subcategory: NAS Storage. Price: Out Of Stock.

Product: Synology DiskStation DS220J 2-Bays NAS Enclosure. Category: Synology. Subcategory: NAS Storage. Price: Out Of Stock.
",174,764712,764886
5530,sentence,"Subcategory: NAS Storage. Price: Out Of Stock.

Product: Synology DiskStation DS218 2-Bays NAS Server. Category: Synology. Subcategory: NAS Storage. Price: Out Of Stock.
",170,764839,765009
5531,sentence,"Subcategory: NAS Storage. Price: Out Of Stock.

Product: Synology DiskStation DS220+ 2-Bays NAS Enclosure. Category: Synology. Subcategory: NAS Storage. Price: Out Of Stock.
",174,764962,765136
5532,sentence,"Subcategory: NAS Storage. Price: Out Of Stock.

Product: Synology DiskStation DS920+ 4-Bays NAS Enclosure. Category: Synology. Subcategory: NAS Storage. Price: Out Of Stock.
",174,765089,765263
5533,sentence,"Subcategory: NAS Storage. Price: Out Of Stock.

Product: Synology RackStation RS822+ 4-Bays NAS Enclosure. Category: Synology. Subcategory: NAS Storage. Price: 168,500৳.
",170,765216,765386
5534,sentence,"Subcategory: NAS Storage. Price: 168,500৳.

Product: Dell 550-Watt Hot-Plug Server Power Supply. Category: Server Power Supply. Subcategory: Server & Storage. Price: 27,000৳.
",175,765343,765518
5535,sentence,"Subcategory: Server & Storage. Price: 27,000৳.

Product: Dell Server Redundant Power Supply. Category: Server Power Supply. Subcategory: Server & Storage. Price: Pre Order.
",173,765471,765644
5536,sentence,"Price: Pre Order.

Product: TwinMOS EzeeHUB-23P 4-Port USB Hub. Category: Accessories. Price: 575৳750৳.

Product: UGREEN CM195 6-in-1 Type-C Hub #70410. Category: Accessories. Price: 3,300৳.
",191,765626,765817
5537,sentence,"Category: Accessories. Price: 3,300৳.

Product: SanDisk Ultra Dual Drive Luxe 512GB Type-C Pen Drive. Category: Accessories. Price: 6,000৳.

Product: CHARG C1B 1 Meter USB to Micro USB Cable. ",192,765779,765971
5538,sentence,"Category: Accessories. Price: 95৳.

Product: Oraimo OCD-114M 1 Meter USB To Micro USB Cable. Category: Accessories. Price: 100৳.

Product: CHARG C1C 1 Meter USB to Type C Cable. ",178,765971,766149
5539,sentence,"
Product: CHARG C1C 1 Meter USB to Type C Cable. Category: Accessories. Price: 100৳.

Product: Ugreen US133 Micro USB Male to USB Female OTG Cable #10396. Category: Accessories. Price: 120৳.
",191,766100,766291
5540,sentence,"Category: Accessories. Price: 120৳.

Product: Ugreen AV162 Cannon XLR Male to 6.5mm Female Converter #80439. Category: Accessories. Price: 120৳.
",145,766255,766400
5541,sentence,"Category: Accessories. Price: 120৳.

Product: Ugreen AV162 6.5mm Female to Cannon XLR Male Converter #80440. Category: Accessories. Price: 120৳.
",145,766364,766509
5542,sentence,"Category: Accessories. Price: 120৳.

Product: Yison Celebrat CB-33 A-M 1 Meter USB to Micro USB Cable. Category: Accessories. Price: 125৳.
",139,766473,766612
5543,sentence,"Category: Accessories. Price: 125৳.

Product: Yison Celebrat CB-33 A-M-White 1 Meter USB to Micro USB Cable. Category: Accessories. Price: 125৳.
",145,766576,766721
5544,sentence,"Category: Accessories. Price: 125৳.

Product: Yison Celebrat CB-31 A-M 1 Meter USB to Micro USB Cable. Category: Accessories. Price: 131৳.
",139,766685,766824
5545,sentence,"Category: Accessories. Price: 131৳.

Product: Yison Celebrat CB-31 A-M-White 1 Meter USB to Micro USB Cable. Category: Accessories. Price: 131৳.
",145,766788,766933
5546,sentence,"Category: Accessories. Price: 131৳.

Product: Oraimo OCD-114C 1 Meter USB to Type C Cable. Category: Accessories. Price: 135৳.

Product: Yison Celebrat CB-33 A-C 1 Meter USB to USB Type-C Cable. ",195,766897,767092
5547,sentence,"Category: Accessories. Price: 145৳.

Product: Yison Celebrat CB-33 A-C-White 1 Meter USB to USB Type-C Cable. Category: Accessories. Price: 145৳.

Product: Havit HV-MP838 Gaming Mouse Pad. ",189,767092,767281
5548,sentence,"
Product: Havit HV-MP838 Gaming Mouse Pad. Category: Accessories. Price: 119৳150৳.

Product: Havit HV-MP837 Gaming Mouse Pad. Category: Accessories. Price: 150৳.
",162,767238,767400
5549,sentence,"Category: Accessories. Price: 150৳.

Product: Havit HV-MP839 Gaming Mouse Pad. Category: Accessories. Price: 150৳.

Product: Non-brand Apple Mouse Pad. Category: Accessories. Price: 150৳.
",188,767364,767552
5550,sentence,"Category: Accessories. Price: 150৳.

Product: Havit HV-MP846 Gaming Mouse Pad. Category: Mouse Pad. Subcategory: Accessories. Price: 119৳150৳.

Product: Fantech MP256 Gaming Mouse Pad. ",185,767516,767701
5551,sentence,"
Product: Fantech MP256 Gaming Mouse Pad. Category: Mouse Pad. Subcategory: Accessories. Price: 170৳.

Product: FANTECH Vigil MP292 Gaming Mousepad. Category: Mouse Pad. Subcategory: Accessories. ",196,767659,767855
5552,sentence,"Category: Mouse Pad. Subcategory: Accessories. Price: 260৳.

Product: Xtrike Me MP-005 Gaming Mouse Pad. Category: Mouse Pad. Subcategory: Accessories. Price: 300৳.
",165,767808,767973
5553,sentence,"Subcategory: Accessories. Price: 300৳.

Product: Onikuma MP002 RGB Gaming Mousepad. Category: Mouse Pad. Subcategory: Accessories. Price: 300৳.

Product: Fantech Sven MP35 Gaming Mouse Pad. ",190,767934,768124
5554,sentence,"
Product: Fantech Sven MP35 Gaming Mouse Pad. Category: Mouse Pad. Subcategory: Accessories. Price: 350৳.

Product: Fantech MP356 Gaming Mouse Pad. Category: Mouse Pad. Subcategory: Accessories. ",195,768078,768273
5555,sentence,"Category: Mouse Pad. Subcategory: Accessories. Price: 397৳410৳.

Product: Fantech Sven MP44 Gaming Mousepad. Category: Mouse Pad. Subcategory: Accessories. Price: 530৳.
",169,768226,768395
5556,sentence,"Subcategory: Accessories. Price: 530৳.

Product: Fantech MP456 Gaming Mouse Pad. Category: Mouse Pad. Subcategory: Accessories. Price: 650৳.

Product: Fantech AGILE MP353 SE Mouse Pad. ",185,768356,768541
5557,sentence,"
Product: Fantech AGILE MP353 SE Mouse Pad. Category: Mouse Pad. Subcategory: Accessories. Price: 660৳.

Product: Rapoo VPRO V10S Anti-Skid Compact Mouse Pad. Category: Mouse Pad. ",180,768497,768677
5558,sentence,"Category: Mouse Pad. Subcategory: Accessories. Price: 700৳.

Product: A4tech Bloody BP-45 Gaming Mouse Pad. Category: Mouse Pad. Subcategory: Accessories. Price: 799৳.
",168,768656,768824
5559,sentence,"Subcategory: Accessories. Price: 799৳.

Product: Havit MP903 RGB Gaming Mouse Pad. Category: Mouse Pad. Subcategory: Accessories. Price: 799৳820৳.
",147,768785,768932
5560,sentence,"Subcategory: Accessories. Price: 799৳820৳.

Product: A4tech Bloody BP-45W Nyx Mirage X Savage Gaming Mouse Pad. Category: Mouse Pad. Subcategory: Accessories. Price: 849৳.
",172,768889,769061
5561,sentence,"Subcategory: Accessories. Price: 849৳.

Product: Fantech AGILE MP904 Mint Edition Gaming Mousepad. Category: Mouse Pad. Subcategory: Accessories. Price: 850৳1,000৳.
",165,769022,769187
5562,sentence,"Subcategory: Accessories. Price: 850৳1,000৳.

Product: MSI Agility GD21 DRAGON TIAMAT Gaming Mouse Pad. Category: Mouse Pad. Subcategory: Accessories. Price: 1,000৳.
",166,769142,769308
5563,sentence,"Subcategory: Accessories. Price: 1,000৳.

Product: Fantech GO K211 Bangla Keyboard. Category: Keyboard. Subcategory: Accessories. Price: 449৳.

Product: T-WOLF T15 104 Keys USB Wired Keyboard. ",193,769267,769460
5564,sentence,"Category: Keyboard. Subcategory: Accessories. Price: 450৳.

Product: PC Power 403 Wired Keyboard with Bangla. Category: Keyboard. Subcategory: Accessories. Price: 450৳.
",169,769460,769629
5565,sentence,"Subcategory: Accessories. Price: 450৳.

Product: Havit KB271 USB Exquisite Keyboard with Bangla. Category: Keyboard. Subcategory: Accessories. Price: 399৳480৳.
",160,769590,769750
5566,sentence,"Subcategory: Accessories. Price: 399৳480৳.

Product: Havit KB2006 USB Exquisite Keyboard. Category: Keyboard. Subcategory: Accessories. Price: 500৳.

Product: Havit KB376 USB Multimedia Keyboard. ",196,769707,769903
5567,sentence,"
Product: Havit KB376 USB Multimedia Keyboard. Category: Keyboard. Subcategory: Accessories. Price: 520৳.

Product: PC Power PCGKY601 Wired Keyboard with Bangla. Category: Keyboard. ",182,769856,770038
5568,sentence,"Category: Keyboard. Subcategory: Accessories. Price: 550৳.

Product: PC Power 604 Wired Keyboard with Bangla. Category: Keyboard. Subcategory: Accessories. Price: 550৳.
",169,770018,770187
5569,sentence,"Subcategory: Accessories. Price: 550৳.

Product: Jedel K15 Wired Keyboard. Category: Keyboard. Subcategory: Accessories. Price: 550৳.

Product: T-WOLF K220 Wired Keyboard with Bangla. ",184,770148,770332
5570,sentence,"Category: Keyboard. Subcategory: Accessories. Price: 550৳.

Product: Havit KB241 USB Wired Keyboard. Category: Keyboard. Subcategory: Accessories. Price: 550৳.
",160,770332,770492
5571,sentence,"Subcategory: Accessories. Price: 550৳.

Product: Micropack K203 Basic USB Keyboard. Category: Keyboard. Subcategory: Accessories. Price: 590৳.

Product: HAVIT KB224 USB Mini Keyboard. ",184,770453,770637
5572,sentence,"
Product: HAVIT KB224 USB Mini Keyboard. Category: Keyboard. Subcategory: Accessories. Price: 590৳.

Product: PC Power 602 Wired Keyboard with Bangla. Category: Keyboard. Subcategory: Accessories. ",197,770596,770793
5573,sentence,"Category: Keyboard. Subcategory: Accessories. Price: 600৳.

Product: Jedel K26 Wired Keyboard. Category: Keyboard. Subcategory: Accessories. Price: 600৳.
",154,770747,770901
5574,sentence,"Subcategory: Accessories. Price: 600৳.

Product: PC Power 603 Wired Keyboard with Bangla. Category: Keyboard. Subcategory: Accessories. Price: 650৳.
",149,770862,771011
5575,sentence,"Subcategory: Accessories. Price: 650৳.

Product: PC Power PCK-161 Wired Keyboard with Bangla. Category: Keyboard. Subcategory: Accessories. Price: 650৳.
",153,770972,771125
5576,sentence,"Subcategory: Accessories. Price: 650৳.

Product: PC Power PCK-126 Mini Bangla Keyboard. Category: Keyboard. Subcategory: Accessories. Price: 650৳.

Product: Jedel KB-1000 Wired Mini Keyboard. ",192,771086,771278
5577,sentence,"
Product: Jedel KB-1000 Wired Mini Keyboard. Category: Keyboard. Subcategory: Accessories. Price: 499৳650৳.

Product: Rapoo NK2600 Spill- Resistant Wired Keyboard with Bangla. Category: Keyboard. ",196,771233,771429
5578,sentence,"Category: Keyboard. Subcategory: Accessories. Price: 700৳.

Product: Havit 2218D 3.5mm Single Port Headphone. Category: Headphone. Subcategory: Accessories. Price: 800৳.
",170,771409,771579
5579,sentence,"Subcategory: Accessories. Price: 800৳.

Product: HAVIT HV-H2178D 3.5mm Wired Headphone. Category: Headphone. Subcategory: Accessories. Price: 699৳800৳.

Product: Havit H220D Wired Headphone. ",191,771540,771731
5580,sentence,"
Product: Havit H220D Wired Headphone. Category: Headphone. Subcategory: Accessories. Price: 770৳800৳.

Product: Havit H206D 3.5mm double plug Stereo with Mic Headset. Category: Headphone. ",189,771692,771881
5581,sentence,"Category: Headphone. Subcategory: Accessories. Price: 850৳.

Product: Havit H2263D 3.5mm Metal Decoration Single Port Headphone. Category: Headphone. Subcategory: Accessories. Price: 900৳.
",189,771860,772049
5582,sentence,"Subcategory: Accessories. Price: 900৳.

Product: Havit HV-H100d Wired Headphone. Category: Headphone. Subcategory: Accessories. Price: 900৳.

Product: Rapoo H101 Wired Stereo Headphone. ",186,772010,772196
5583,sentence,"
Product: Rapoo H101 Wired Stereo Headphone. Category: Headphone. Subcategory: Accessories. Price: 900৳.

Product: Rapoo H102 Wired Stereo Headphone. Category: Headphone. Subcategory: Accessories. ",197,772151,772348
5584,sentence,"Category: Headphone. Subcategory: Accessories. Price: 799৳900৳.

Product: Microlab K250 Stereo Wired Headphone. Category: Headphone. Subcategory: Accessories. Price: 975৳.
",172,772301,772473
5585,sentence,"Subcategory: Accessories. Price: 975৳.

Product: Fantech MARS II HQ54 Wired Gaming Headset. Category: Headphone. Subcategory: Accessories. Price: 980৳.
",152,772434,772586
5586,sentence,"Subcategory: Accessories. Price: 980৳.

Product: Logitech H110 STEREO Headset (Two port). Category: Headphone. Subcategory: Accessories. Price: 1,000৳.
",152,772547,772699
5587,sentence,"Subcategory: Accessories. Price: 1,000৳.

Product: Logitech H111 STEREO Headset (One port). Category: Headphone. Subcategory: Accessories. Price: 1,000৳.
",154,772658,772812
5588,sentence,"Subcategory: Accessories. Price: 1,000৳.

Product: Xtrike Me HP-318 RGB Gaming Headphone. Category: Headphone. Subcategory: Accessories. Price: 850৳1,000৳.
",156,772771,772927
5589,sentence,"Subcategory: Accessories. Price: 850৳1,000৳.

Product: Hoco W46 Charm Bluetooth Wireless Headphone. Category: Headphone. Subcategory: Accessories. Price: 850৳1,000৳.
",166,772882,773048
5590,sentence,"Subcategory: Accessories. Price: 850৳1,000৳.

Product: Fantech TONE II HQ56 Gaming Headphone. Category: Headphone. Subcategory: Accessories. Price: 1,020৳.
",156,773003,773159
5591,sentence,"Subcategory: Accessories. Price: 1,020৳.

Product: Havit Gamenote H754d RGB Gaming Headphone. Category: Headphone. Subcategory: Accessories. Price: 1,050৳.
",156,773118,773274
5592,sentence,"Subcategory: Accessories. Price: 1,050৳.

Product: AULA S605 3.5 mm Wired RGB Gaming Headphone. Category: Headphone. Subcategory: Accessories. Price: 949৳1,100৳.
",162,773233,773395
5593,sentence,"Subcategory: Accessories. Price: 949৳1,100৳.

Product: Microlab K280 Supra-Aural Wired Headphone. Category: Headphone. Subcategory: Accessories. Price: 1,100৳.
",160,773350,773510
5594,sentence,"Subcategory: Accessories. Price: 1,100৳.

Product: Havit Gamenote HV-H2032D Gaming Headphone. Category: Headphone. Subcategory: Accessories. Price: 1,150৳.
",156,773469,773625
5595,sentence,"Subcategory: Accessories. Price: 1,150৳.

Product: Havit Gamenote H767d RGB Gaming Headphone. Category: Headphone. Subcategory: Accessories. Price: 1,150৳.
",156,773584,773740
5596,sentence,"Subcategory: Accessories. Price: 1,150৳.

Product: Razer Goliathus Mobile Stealth Edition Gaming Mouse Pad. Category: RAZER. Subcategory: Mouse Pad. Price: 1,300৳.
",164,773699,773863
5597,sentence,"Subcategory: Mouse Pad. Price: 1,300৳.

Product: Razer GIGANTUS V2 Medium Soft Gaming Mouse Mat. Category: RAZER. Subcategory: Mouse Pad. Price: 1,500৳.
",153,773824,773977
5598,sentence,"Subcategory: Mouse Pad. Price: 1,500৳.

Product: Razer GIGANTUS V2 Large Gaming Mouse Mat. Category: RAZER. Subcategory: Mouse Pad. Price: Up Coming.
",150,773938,774088
5599,sentence,"Subcategory: Mouse Pad. Price: Up Coming.

Product: Razer Pro Glide Medium Soft Productivity Mouse Mat. Category: RAZER. Subcategory: Mouse Pad. Price: Out Of Stock.
",166,774046,774212
5600,sentence,"Subcategory: Mouse Pad. Price: Out Of Stock.

Product: Razer Gigantus Elite Edition Large Gaming Mouse Mat for Esports (Global). Category: RAZER. Subcategory: Mouse Pad. Price: Out Of Stock.
",191,774167,774358
5601,sentence,"Subcategory: Mouse Pad. Price: Out Of Stock.

Product: Razer GIGANTUS V2 XXL Gaming Mouse Mat. Category: RAZER. Subcategory: Mouse Pad. Price: Out Of Stock.
",157,774313,774470
5602,sentence,"Subcategory: Mouse Pad. Price: Out Of Stock.

Product: Razer Goliathus Storm Trooper Gaming Mouse Mat Extended. Category: RAZER. Subcategory: Mouse Pad. Price: Out Of Stock.
",174,774425,774599
5603,sentence,"Subcategory: Mouse Pad. Price: Out Of Stock.

Product: Razer Firefly-Hard Gaming Mouse Mat (Global). Category: RAZER. Subcategory: Mouse Pad. Price: Out Of Stock.
",163,774554,774717
5604,sentence,"Subcategory: Mouse Pad. Price: Out Of Stock.

Product: Razer Firefly V2 Hard Razer Chroma RGB lighting Gaming Mouse Mat. Category: RAZER. Subcategory: Mouse Pad. Price: Out Of Stock.
",183,774672,774855
5605,sentence,"Subcategory: Mouse Pad. Price: Out Of Stock.

Product: Razer DeathAdder Essential Mouse + Razer Goliathus Speed Pikachu Limited Edition Mat Bundle. Category: RAZER. Subcategory: Mouse Pad. ",189,774810,774999
5606,sentence,"Category: RAZER. Subcategory: Mouse Pad. Price: Out Of Stock.

Product: Razer Pro Glide XXL Soft Gaming Mouse Mat. Category: RAZER. Subcategory: Mouse Pad. Price: Out Of Stock.
",177,774958,775135
5607,sentence,"Subcategory: Mouse Pad. Price: Out Of Stock.

Product: Razer Strider XXL Hybrid Gaming Mouse Mat. Category: RAZER. Subcategory: Mouse Pad. Price: Out Of Stock.
",160,775090,775250
5608,sentence,"Subcategory: Mouse Pad. Price: Out Of Stock.

Product: Razer Level Up Bundle- Cynosa Lite, Viper Mini, Gigantus V2 Combo. Category: RAZER. Subcategory: Mouse Pad. Price: Out Of Stock.
",184,775205,775389
5609,sentence,"Subcategory: Mouse Pad. Price: Out Of Stock.

Product: Razer Naga Trinity - Multi-color Wired MMO Gaming Mouse (Global). Category: Mouse. Subcategory: Accessories. Price: 8,800৳.
",179,775344,775523
5610,sentence,"Subcategory: Accessories. Price: 8,800৳.

Product: Havit HV-MS753 Optical Mouse. Category: Mouse. Subcategory: Accessories. Price: 280৳.

Product: Pc Power PCGMY01 Wired Mouse. Category: Mouse. ",194,775482,775676
5611,sentence,"Category: Mouse. Subcategory: Accessories. Price: 280৳.

Product: T-WOLF V12 Wired Mouse. Category: Mouse. Subcategory: Accessories. Price: 300৳.

Product: T-WOLF V13 Wired Mouse. Category: Mouse. ",197,775659,775856
5612,sentence,"Category: Mouse. Subcategory: Accessories. Price: 300৳.

Product: Rapoo N100 Wired Optical Mouse. Category: Mouse. Subcategory: Accessories. Price: 350৳.

Product: Lenovo 300 Wired USB Mouse. ",192,775839,776031
5613,sentence,"
Product: Lenovo 300 Wired USB Mouse. Category: Mouse. Subcategory: Accessories. Price: 350৳370৳.

Product: Havit MS70 Wired Optical Mouse. Category: Mouse. Subcategory: Accessories. Price: 380৳.
",196,775993,776189
5614,sentence,"Subcategory: Accessories. Price: 380৳.

Product: Havit MS72 Cool RGB LED USB Gaming Mouse Black. Category: Mouse. Subcategory: Accessories. Price: 368৳400৳.
",157,776150,776307
5615,sentence,"Subcategory: Accessories. Price: 368৳400৳.

Product: Xtrike Me GM-124 USB Wired Optical Mouse. Category: Mouse. Subcategory: Accessories. Price: 299৳400৳.

Product: Pc Power PCM-315 Wired Mouse. ",195,776264,776459
5616,sentence,"
Product: Pc Power PCM-315 Wired Mouse. Category: Mouse. Subcategory: Accessories. Price: 400৳.

Product: Pc Power PCM-316 Wired Mouse. Category: Mouse. Subcategory: Accessories. Price: 410৳.
",192,776419,776611
5617,sentence,"Subcategory: Accessories. Price: 410৳.

Product: Logitech B100 Optical USB Mouse. Category: Mouse. Subcategory: Accessories. Price: 420৳.

Product: Logitech M90 USB Mouse. Category: Mouse. ",189,776572,776761
5618,sentence,"Category: Mouse. Subcategory: Accessories. Price: 420৳.

Product: A4TECH OP-720 USB Wired Mouse. Category: Mouse. Subcategory: Accessories. Price: 425৳.

Product: A4TECH OP-330 USB Wired Mouse. ",194,776744,776938
5619,sentence,"
Product: A4TECH OP-330 USB Wired Mouse. Category: Mouse. Subcategory: Accessories. Price: 425৳.

Product: HAVIT HV-MS989GT Wireless Mouse. Category: Mouse. Subcategory: Accessories. Price: 450৳.
",196,776897,777093
5620,sentence,"Subcategory: Accessories. Price: 450৳.

Product: Pc Power PCM-378 Wired Mouse. Category: Mouse. Subcategory: Accessories. Price: 450৳.

Product: T-WOLF Q2 Optical Wireless Mouse. Category: Mouse. ",196,777054,777250
5621,sentence,"Category: Mouse. Subcategory: Accessories. Price: 480৳.

Product: Dareu LM106G Wireless Office Mouse. Category: Mouse. Subcategory: Accessories. Price: 490৳.
",158,777233,777391
5622,sentence,"Subcategory: Accessories. Price: 490৳.

Product: Corsair MM300 PRO Splash-Proof Gaming Mouse Pad. Category: Corsair. Subcategory: Mouse Pad. Price: Out Of Stock.
",162,777352,777514
5623,sentence,"Subcategory: Mouse Pad. Price: Out Of Stock.

Product: Xtrike Me GX01 Extra Large Chair Floor Mat. Category: Xtrike Me. Subcategory: Mouse Pad. Price: 800৳1,400৳.
",163,777469,777632
5624,sentence,"Subcategory: Mouse Pad. Price: 800৳1,400৳.

Product: Xtrike Me MP-606 RGB Gaming Large Mouse Pad. Category: Xtrike Me. Subcategory: Mouse Pad. Price: 1,300৳.
",158,777589,777747
5625,sentence,"Subcategory: Mouse Pad. Price: 1,300৳.

Product: Xtrike Me MP-002 Cloth Surface Mouse Pad. Category: Xtrike Me. Subcategory: Mouse Pad. Price: Out Of Stock.
",157,777708,777865
5626,sentence,"Subcategory: Mouse Pad. Price: Out Of Stock.

Product: Xtrike Me MP-204 Cloth Surface Mouse Pad. Category: Xtrike Me. Subcategory: Mouse Pad. Price: Out Of Stock.
",163,777820,777983
5627,sentence,"Subcategory: Mouse Pad. Price: Out Of Stock.

Product: Xtrike Me MP-206 Large Mouse Pad. Category: Xtrike Me. Subcategory: Mouse Pad. Price: Out Of Stock.

Product: Xtrike Me MP-605 RGB Mouse Pad. ",197,777938,778135
5628,sentence,"
Product: Xtrike Me MP-605 RGB Mouse Pad. Category: Xtrike Me. Subcategory: Mouse Pad. Price: Out Of Stock.

Product: Xtrike Me HD-214 Bluetooth Wireless Headset. Category: Bluetooth Headphone. ",194,778093,778287
5629,sentence,"Category: Bluetooth Headphone. Subcategory: Accessories. Price: 550৳850৳.

Product: Xtrike Me HD-215 Bluetooth Wireless Headset. Category: Bluetooth Headphone. Subcategory: Accessories. ",186,778256,778442
5630,sentence,"Subcategory: Accessories. Price: 650৳1,050৳.

Product: Havit H2590BT PRO Multi-Function Wireless Headphone. Category: Bluetooth Headphone. Subcategory: Accessories. Price: 1,200৳.
",180,778416,778596
5631,sentence,"Subcategory: Accessories. Price: 1,200৳.

Product: Awei AT6 Stereo Wireless Bluetooth Headphone. Category: Bluetooth Headphone. Subcategory: Accessories. Price: 1,049৳1,200৳.
",175,778555,778730
5632,sentence,"Subcategory: Accessories. Price: 1,049৳1,200৳.

Product: Hoco W35 Air Bluetooth Wireless Headphone. Category: Bluetooth Headphone. Subcategory: Accessories. Price: 1,099৳1,250৳.
",178,778683,778861
5633,sentence,"Subcategory: Accessories. Price: 1,099৳1,250৳.

Product: Havit H628BT Bluetooth Headphone. Category: Bluetooth Headphone. Subcategory: Accessories. Price: 1,150৳1,300৳.
",169,778814,778983
5634,sentence,"Subcategory: Accessories. Price: 1,150৳1,300৳.

Product: Awei AT8 Wireless Bluetooth Headphone. Category: Bluetooth Headphone. Subcategory: Accessories. Price: 1,199৳1,300৳.
",174,778936,779110
5635,sentence,"Subcategory: Accessories. Price: 1,199৳1,300৳.

Product: Hoco W35 Max Bluetooth Wireless Headphone. Category: Bluetooth Headphone. Subcategory: Accessories. Price: 1,275৳1,375৳.
",178,779063,779241
5636,sentence,"Subcategory: Accessories. Price: 1,275৳1,375৳.

Product: Awei AT7 Stereo Wireless Bluetooth Headphone. Category: Bluetooth Headphone. Subcategory: Accessories. Price: 1,060৳1,390৳.
",181,779194,779375
5637,sentence,"Subcategory: Accessories. Price: 1,060৳1,390৳.

Product: Hoco W35 Wireless Bluetooth Headphone. Category: Bluetooth Headphone. Subcategory: Accessories. Price: 1,099৳1,450৳.
",174,779328,779502
5638,sentence,"Subcategory: Accessories. Price: 1,099৳1,450৳.

Product: Havit H626BT Wireless Foldable Bluetooth Kids Headphone. Category: Bluetooth Headphone. Subcategory: Accessories. Price: 1,450৳.
",186,779455,779641
5639,sentence,"Subcategory: Accessories. Price: 1,450৳.

Product: Awei A997BL Stereo Wireless Bluetooth Headphone. Category: Bluetooth Headphone. Subcategory: Accessories. Price: 1,299৳1,500৳.
",178,779600,779778
5640,sentence,"Subcategory: Accessories. Price: 1,299৳1,500৳.

Product: Hoco W35 Pro Max Bluetooth Headphone. Category: Bluetooth Headphone. Subcategory: Accessories. Price: 1,450৳1,550৳.
",173,779731,779904
5641,sentence,"Subcategory: Accessories. Price: 1,450৳1,550৳.

Product: Havit i62 Bluetooth 90 Degree Ergonomic Design Headphone. Category: Bluetooth Headphone. Subcategory: Accessories. Price: 1,440৳1,590৳.
",193,779857,780050
5642,sentence,"Subcategory: Accessories. Price: 1,440৳1,590৳.

Product: Hoco W52 Bluetooth Headphone With AUX Mode. Category: Bluetooth Headphone. Subcategory: Accessories. Price: 1,470৳1,600৳.
",179,780003,780182
5643,sentence,"Subcategory: Accessories. Price: 1,470৳1,600৳.

Product: Joyroom JR-OH1 Bluetooth Wireless Headphone. Category: Bluetooth Headphone. Subcategory: Accessories. Price: 1,399৳1,650৳.
",180,780135,780315
5644,sentence,"Subcategory: Accessories. Price: 1,399৳1,650৳.

Product: Microlab HB21 Bluetooth Headphone. Category: Bluetooth Headphone. Subcategory: Accessories. Price: 1,690৳.
",164,780268,780432
5645,sentence,"Subcategory: Accessories. Price: 1,690৳.

Product: Hoco W45 Bluetooth Wireless Headphone. Category: Bluetooth Headphone. Subcategory: Accessories. Price: 1,499৳1,700৳.
",168,780391,780559
5646,sentence,"Subcategory: Accessories. Price: 1,499৳1,700৳.

Product: Havit H612BT Wireless Bluetooth Headphone. Category: Bluetooth Headphone. Subcategory: Accessories. Price: 1,750৳.
",172,780512,780684
5647,sentence,"Subcategory: Accessories. Price: 1,750৳.

Product: Fantech AGILE MP453 Anti-Slip Base Mouse pad. Category: Fantech. Subcategory: Mouse Pad. Price: 1,045৳.
",155,780643,780798
5648,sentence,"Subcategory: Mouse Pad. Price: 1,045৳.

Product: Fantech ZERO-G MPC450 Gaming Mouse Pad. Category: Fantech. Subcategory: Mouse Pad. Price: 1,299৳1,350৳.
",153,780759,780912
5649,sentence,"Subcategory: Mouse Pad. Price: 1,299৳1,350৳.

Product: FANTECH MPR800s Firefly RGB Mousepad. Category: Fantech. Subcategory: Mouse Pad. Price: 1,750৳.

Product: Fantech ATO MP905 Mousepad. ",189,780867,781056
5650,sentence,"
Product: Fantech ATO MP905 Mousepad. Category: Fantech. Subcategory: Mouse Pad. Price: 1,815৳.

Product: Fantech P31 Keyboard, Mouse & Mousepad Combo. Category: Fantech. Subcategory: Mouse Pad. ",195,781018,781213
5651,sentence,"Category: Fantech. Subcategory: Mouse Pad. Price: 1,849৳1,900৳.

Product: Fantech Strikepad MST901 Anti-Slip Rubber Gaming Mouse Pad. Category: Fantech. Subcategory: Mouse Pad. Price: 2,915৳.
",192,781170,781362
5652,sentence,"Subcategory: Mouse Pad. Price: 2,915৳.

Product: Fantech P51 Sakura Edition 5 In 1 Gaming Combo Pink. Category: Fantech. Subcategory: Mouse Pad. Price: 3,550৳4,000৳.
",166,781323,781489
5653,sentence,"Subcategory: Mouse Pad. Price: 3,550৳4,000৳.

Product: Fantech Strikepad Pro MST491P Gaming Mouse pad. Category: Fantech. Subcategory: Mouse Pad. Price: 4,100৳.
",161,781444,781605
5654,sentence,"Subcategory: Mouse Pad. Price: 4,100৳.

Product: Fantech P51 5 In 1 Gaming Combo - Hitam. Category: Fantech. Subcategory: Mouse Pad. Price: 4,400৳4,850৳.
",154,781566,781720
5655,sentence,"Subcategory: Mouse Pad. Price: 4,400৳4,850৳.

Product: Fantech ATO MP905 GE01 Gaming Mouse Pad. Category: Fantech. Subcategory: Mouse Pad. Price: Up Coming.

Product: FANTECH MPR351 RGB Mousepad. ",196,781675,781871
5656,sentence,"
Product: FANTECH MPR351 RGB Mousepad. Category: Fantech. Subcategory: Mouse Pad. Price: Out Of Stock.

Product: Fantech Sven MP25 Gaming Mouse Pad. Category: Fantech. Subcategory: Mouse Pad. ",192,781832,782024
5657,sentence,"Category: Fantech. Subcategory: Mouse Pad. Price: Out Of Stock.

Product: Asus NC03 ROG Strix Edge Call of Duty Edition Gaming Mouse Pad. Category: Asus. Subcategory: Mouse Pad. Price: 2,650৳.
",193,781981,782174
5658,sentence,"Subcategory: Mouse Pad. Price: 2,650৳.

Product: Asus ROG Hone Ace Aim Lab Edition Gaming Mouse Pad. Category: Asus. Subcategory: Mouse Pad. Price: 3,699৳4,000৳.
",162,782135,782297
5659,sentence,"Subcategory: Mouse Pad. Price: 3,699৳4,000৳.

Product: Asus ROG NC03 Strix Edge Vertical Gaming Mouse Pad. Category: Asus. Subcategory: Mouse Pad. Price: Out Of Stock.
",168,782252,782420
5660,sentence,"Subcategory: Mouse Pad. Price: Out Of Stock.

Product: Asus Cerberus Mouse Pad. Category: Asus. Subcategory: Mouse Pad. Price: Out Of Stock.

Product: Asus ROG Scabbard II Medium Gaming Mouse Pad. ",197,782375,782572
5661,sentence,"Category: Asus. Subcategory: Mouse Pad. Price: Out Of Stock.

Product: Asus ROG Whetston Mouse Pad. Category: Asus. Subcategory: Mouse Pad. Price: Out Of Stock.
",161,782572,782733
5662,sentence,"Subcategory: Mouse Pad. Price: Out Of Stock.

Product: Asus ROG NC02 SCABBARD Mouse Pad. Category: Asus. Subcategory: Mouse Pad. Price: Out Of Stock.
",150,782688,782838
5663,sentence,"Subcategory: Mouse Pad. Price: Out Of Stock.

Product: Asus ROG Sheath Extended Gaming Mouse Pad. Category: Asus. Subcategory: Mouse Pad. Price: Out Of Stock.
",159,782793,782952
5664,sentence,"Subcategory: Mouse Pad. Price: Out Of Stock.

Product: Asus NC07 ROG Sheath Electro Punk Gaming Mouse Pad. Category: Asus. Subcategory: Mouse Pad. Price: Out Of Stock.
",168,782907,783075
5665,sentence,"Subcategory: Mouse Pad. Price: Out Of Stock.

Product: Asus ROG Sheath BLK LTD Gaming Mouse Pad. Category: Asus. Subcategory: Mouse Pad. Price: Out Of Stock.
",158,783030,783188
5666,sentence,"Subcategory: Mouse Pad. Price: Out Of Stock.

Product: Asus ROG Scabbard II Extended Gaming Mouse Pad. Category: Asus. Subcategory: Mouse Pad. Price: Out Of Stock.
",164,783143,783307
5667,sentence,"Subcategory: Mouse Pad. Price: Out Of Stock.

Product: Asus ROG Hone Ace XXL Gaming Mouse Pad. Category: Asus. Subcategory: Mouse Pad. Price: Out Of Stock.
",156,783262,783418
5668,sentence,"Subcategory: Mouse Pad. Price: Out Of Stock.

Product: ASUS NH01 ROG Balteus Qi Wireless-Charging RGB Gaming Mouse Pad. Category: Asus. Subcategory: Mouse Pad. Price: Out Of Stock.
",181,783373,783554
5669,sentence,"Subcategory: Mouse Pad. Price: Out Of Stock.

Product: SteelSeries QcK Low Profile Gaming Mouse Pad. Category: SteelSeries. Subcategory: Mouse Pad. Price: 1,600৳.
",163,783509,783672
5670,sentence,"Subcategory: Mouse Pad. Price: 1,600৳.

Product: SteelSeries QcK Medium Low Profile Gaming Mouse Pad. Category: SteelSeries. Subcategory: Mouse Pad. Price: 2,100৳.
",164,783633,783797
5671,sentence,"Subcategory: Mouse Pad. Price: 2,100৳.

Product: SteelSeries QcK Heavy Anti Slip Rubber Gaming Mouse Pad. Category: SteelSeries. Subcategory: Mouse Pad. Price: 2,399৳2,600৳.
",174,783758,783932
5672,sentence,"Subcategory: Mouse Pad. Price: 2,399৳2,600৳.

Product: SteelSeries QcK Large Low Profile Gaming Mouse Pad. Category: SteelSeries. Subcategory: Mouse Pad. Price: 2,600৳.
",169,783887,784056
5673,sentence,"Subcategory: Mouse Pad. Price: 2,600৳.

Product: SteelSeries QcK XXL Micro Woven Cloth Gaming Mouse Pad. Category: SteelSeries. Subcategory: Mouse Pad. Price: 5,200৳.
",167,784017,784184
5674,sentence,"Subcategory: Mouse Pad. Price: 5,200৳.

Product: SteelSeries QcK Prism Medium Micro Woven Cloth Gaming Mouse Pad. Category: SteelSeries. Subcategory: Mouse Pad. Price: 6,600৳.
",176,784145,784321
5675,sentence,"Subcategory: Mouse Pad. Price: 6,600৳.

Product: SteelSeries QcK Prism XL Micro Woven Cloth Gaming Mouse Pad. Category: SteelSeries. Subcategory: Mouse Pad. Price: 9,700৳.
",172,784282,784454
5676,sentence,"Subcategory: Mouse Pad. Price: 9,700৳.

Product: SteelSeries QcK Edge Gaming Mouse Pad. Category: SteelSeries. Subcategory: Mouse Pad. Price: Out Of Stock.
",156,784415,784571
5677,sentence,"Subcategory: Mouse Pad. Price: Out Of Stock.

Product: SteelSeries QcK Edge Large Gaming Mouse Pad. Category: SteelSeries. Subcategory: Mouse Pad. Price: Out Of Stock.
",168,784526,784694
5678,sentence,"Subcategory: Mouse Pad. Price: Out Of Stock.

Product: SteelSeries QcK Heavy Large Anti Slip Rubber Gaming Mouse Pad. Category: SteelSeries. Subcategory: Mouse Pad. Price: Out Of Stock.
",186,784649,784835
5679,sentence,"Subcategory: Mouse Pad. Price: Out Of Stock.

Product: Havit H.KRAKEN Stellarisforce-1 Gaming Mouse Pad. Category: Havit. Subcategory: Mouse Pad. Price: 1,950৳.
",161,784790,784951
5680,sentence,"Subcategory: Mouse Pad. Price: 1,950৳.

Product: Havit HV-KB501CM 4 in 1 Gaming Combo. Category: Havit. Subcategory: Mouse Pad. Price: 1,989৳2,200৳.

Product: Havit HV-MP850 Gaming Mouse Pad. ",192,784912,785104
5681,sentence,"
Product: Havit HV-MP850 Gaming Mouse Pad. Category: Havit. Subcategory: Mouse Pad. Price: Out Of Stock.

Product: Havit MP843 Gaming Mouse Pad. Category: Havit. Subcategory: Mouse Pad. Price: 150৳.
",199,785061,785260
5682,sentence,"Subcategory: Mouse Pad. Price: 150৳.

Product: Havit HV-MP860 Gaming Mouse Pad. Category: Havit. Subcategory: Mouse Pad. Price: Out Of Stock.

Product: Havit HV-MP861 Gaming Mousepad. ",184,785223,785407
5683,sentence,"
Product: Havit HV-MP861 Gaming Mousepad. Category: Havit. Subcategory: Mouse Pad. Price: 500৳.

Product: Havit MP901 RGB Gaming Mouse Pad. Category: Havit. Subcategory: Mouse Pad. ",181,785365,785546
5684,sentence,"Category: Havit. Subcategory: Mouse Pad. Price: Out Of Stock.

Product: Havit MP901-Pro RGB Gaming Mouse Pad. Category: Havit. Subcategory: Mouse Pad. Price: Out Of Stock.
",172,785505,785677
5685,sentence,"Subcategory: Mouse Pad. Price: Out Of Stock.

Product: Havit HV-MP905 RGB Gaming Mouse Pad. Category: Havit. Subcategory: Mouse Pad. Price: Out Of Stock.
",154,785632,785786
5686,sentence,"Subcategory: Mouse Pad. Price: Out Of Stock.

Product: Havit KB868CM 4 in 1 Gamenote Wired Gaming Combo. Category: Havit. Subcategory: Mouse Pad. Price: Out Of Stock.
",167,785741,785908
5687,sentence,"Subcategory: Mouse Pad. Price: Out Of Stock.

Product: Havit KB511L RGB Wired Mechanical Gaming Keyboard, Mouse & Mouse Pad 3-in-1 Combo. Category: Havit. Subcategory: Mouse Pad. ",179,785863,786042
5688,sentence,"Category: Havit. Subcategory: Mouse Pad. Price: Out Of Stock.

Product: Rapoo V1000 E-sports Gaming Mouse Pad. Category: Rapoo. Subcategory: Mouse Pad. Price: Out Of Stock.
",173,786001,786174
5689,sentence,"Subcategory: Mouse Pad. Price: Out Of Stock.

Product: Rapoo VPRO V1L Anti-Skid Large Gaming Mouse Pad. Category: Rapoo. Subcategory: Mouse Pad. Price: Out Of Stock.
",166,786129,786295
5690,sentence,"Subcategory: Mouse Pad. Price: Out Of Stock.

Product: Rapoo V1XL Extra Large Mouse Pad. Category: Rapoo. Subcategory: Mouse Pad. Price: Out Of Stock.
",151,786250,786401
5691,sentence,"Subcategory: Mouse Pad. Price: Out Of Stock.

Product: Logitech Desk Mat Studio Series Mouse Pad. Category: Logitech. Subcategory: Mouse Pad. Price: 2,000৳.
",157,786356,786513
5692,sentence,"Subcategory: Mouse Pad. Price: 2,000৳.

Product: Logitech G440 Hard Gaming Mouse Pad. Category: Logitech. Subcategory: Mouse Pad. Price: Out Of Stock.

Product: Logitech G240 Cloth Gaming Mouse Pad. ",199,786474,786673
5693,sentence,"
Product: Logitech G240 Cloth Gaming Mouse Pad. Category: Logitech. Subcategory: Mouse Pad. Price: Out Of Stock.

Product: Logitech Studio Series Mouse Pad. Category: Logitech. ",177,786625,786802
5694,sentence,"Category: Logitech. Subcategory: Mouse Pad. Price: 900৳.

Product: MSI Agility GD22 GLEAM EDITION Gaming Mouse Pad. Category: MSI. Subcategory: Mouse Pad. Price: 1,400৳.
",170,786782,786952
5695,sentence,"Subcategory: Mouse Pad. Price: 1,400৳.

Product: MSI Agility GD60 Gaming RGB Mouse Pad. Category: MSI. Subcategory: Mouse Pad. Price: 2,800৳.
",142,786913,787055
5696,sentence,"Subcategory: Mouse Pad. Price: 2,800৳.

Product: MSI Agility GD72 GLEAM EDITION Gaming Mouse Pad. Category: MSI. Subcategory: Mouse Pad. Price: 3,900৳.

Product: MSI Agility GD21 Gaming Mouse Pad. ",197,787016,787213
5697,sentence,"
Product: MSI Agility GD21 Gaming Mouse Pad. Category: MSI. Subcategory: Mouse Pad. Price: Up Coming.

Product: Redragon P041 Xeon Large Premium XL Mouse Pad. Category: Redragon. ",179,787168,787347
5698,sentence,"Category: Redragon. Subcategory: Mouse Pad. Price: 1,250৳.

Product: Redragon P032 FLICK XL Mouse Pad. Category: Redragon. Subcategory: Mouse Pad. Price: 1,549৳1,600৳.
",168,787327,787495
5699,sentence,"Subcategory: Mouse Pad. Price: 1,549৳1,600৳.

Product: Redragon P040 Flick 3XL Mouse Pad. Category: Redragon. Subcategory: Mouse Pad. Price: 2,799৳2,850৳.
",155,787450,787605
5700,sentence,"Subcategory: Mouse Pad. Price: 2,799৳2,850৳.

Product: Redragon PISCES P016 Gaming Mouse Mat. Category: Redragon. Subcategory: Mouse Pad. Price: Out Of Stock.
",159,787560,787719
5701,sentence,"Subcategory: Mouse Pad. Price: Out Of Stock.

Product: Redragon Capricorn P012 Gaming Mouse Pad. Category: Redragon. Subcategory: Mouse Pad. Price: Out Of Stock.
",162,787674,787836
5702,sentence,"Subcategory: Mouse Pad. Price: Out Of Stock.

Product: Redragon P029 Flick S Gaming Mouse Pad. Category: Redragon. Subcategory: Mouse Pad. Price: Out Of Stock.
",160,787791,787951
5703,sentence,"Subcategory: Mouse Pad. Price: Out Of Stock.

Product: Redragon Aquarius P015 Mouse Pad. Category: Redragon. Subcategory: Mouse Pad. Price: Out Of Stock.
",154,787906,788060
5704,sentence,"Subcategory: Mouse Pad. Price: Out Of Stock.

Product: Redragon Suzaku P003 Gaming Mouse Pad. Category: Redragon. Subcategory: Mouse Pad. Price: Out Of Stock.
",159,788015,788174
5705,sentence,"Subcategory: Mouse Pad. Price: Out Of Stock.

Product: Redragon TAURUS P018 Gaming Mouse Pad. Category: Redragon. Subcategory: Mouse Pad. Price: Out Of Stock.
",159,788129,788288
5706,sentence,"Subcategory: Mouse Pad. Price: Out Of Stock.

Product: Redragon KUNLUN P006A Gaming Mouse Pad. Category: Redragon. Subcategory: Mouse Pad. Price: Out Of Stock.
",160,788243,788403
5707,sentence,"Subcategory: Mouse Pad. Price: Out Of Stock.

Product: Redragon NEPTUNE P027 RGB Gaming Extended Mouse Pad. Category: Redragon. Subcategory: Mouse Pad. Price: Out Of Stock.
",173,788358,788531
5708,sentence,"Subcategory: Mouse Pad. Price: Out Of Stock.

Product: Redragon P033 NEPTUNE X  RGB Gaming Mouse Pad. Category: Redragon. Subcategory: Mouse Pad. Price: Out Of Stock.
",167,788486,788653
5709,sentence,"Subcategory: Mouse Pad. Price: Out Of Stock.

Product: Redragon S137 4 in 1 Gaming Combo. Category: Redragon. Subcategory: Mouse Pad. Price: Out Of Stock.

Product: Elgato Green Screen Mouse Mat. ",196,788608,788804
5710,sentence,"
Product: Elgato Green Screen Mouse Mat. Category: Elgato. Subcategory: Mouse Pad. Price: 3,500৳.

Product: DeepCool GM800 Gaming Mouse Pad. Category: DeepCool. Subcategory: Mouse Pad. ",185,788763,788948
5711,sentence,"Category: DeepCool. Subcategory: Mouse Pad. Price: Out Of Stock.

Product: Deepcool GM810 Gaming Mouse Pad. Category: DeepCool. Subcategory: Mouse Pad. Price: Out Of Stock.
",173,788904,789077
5712,sentence,"Subcategory: Mouse Pad. Price: Out Of Stock.

Product: DeepCool GT930 CORDURA XXL Gaming Mouse Pad. Category: DeepCool. Subcategory: Mouse Pad. Price: Out Of Stock.
",165,789032,789197
5713,sentence,"Subcategory: Mouse Pad. Price: Out Of Stock.

Product: Meetion MT-PD120 Rubber LED RGB Gaming Mouse Pad. Category: MeeTion. Subcategory: Mouse Pad. Price: 1,650৳1,790৳.
",169,789152,789321
5714,sentence,"Subcategory: Mouse Pad. Price: 1,650৳1,790৳.

Product: MeeTion MT-C011 Wired Gaming Mouse and Mouse Pad Combo. Category: MeeTion. Subcategory: Mouse Pad. Price: 2,250৳.
",169,789276,789445
5715,sentence,"Subcategory: Mouse Pad. Price: 2,250৳.

Product: Meetion MT-PD015 Anti Slip Gaming Mouse Pad. Category: MeeTion. Subcategory: Mouse Pad. Price: Out Of Stock.
",158,789406,789564
5716,sentence,"Subcategory: Mouse Pad. Price: Out Of Stock.

Product: Meetion MT-PD121 Large RGB Backlit Keyboard and Mouse Pad for Gaming. Category: MeeTion. Subcategory: Mouse Pad. Price: Out Of Stock.
",189,789519,789708
5717,sentence,"Subcategory: Mouse Pad. Price: Out Of Stock.

Product: X-raypad Aqua Control Plus XL Gaming Mouse Pad. Category: X-Raypad. Subcategory: Mouse Pad. Price: 2,300৳.
",162,789663,789825
5718,sentence,"Subcategory: Mouse Pad. Price: 2,300৳.

Product: X-raypad ROB Aqua Control Plus XL Gaming Mouse Pad. Category: X-Raypad. Subcategory: Mouse Pad. Price: 2,300৳.
",160,789786,789946
5719,sentence,"Subcategory: Mouse Pad. Price: 2,300৳.

Product: X-raypad White Aqua Control plus XL Gaming Mouse Pad. Category: X-Raypad. Subcategory: Mouse Pad. Price: 2,099৳2,300৳.
",168,789907,790075
5720,sentence,"Subcategory: Mouse Pad. Price: 2,099৳2,300৳.

Product: X-raypad Aqua Control II XL Gaming Mouse Pad White. Category: X-Raypad. Subcategory: Mouse Pad. Price: 2,600৳.
",166,790030,790196
5721,sentence,"Subcategory: Mouse Pad. Price: 2,600৳.

Product: X-raypad Aqua Control II Sakura Green Gaming Mouse Pad. Category: X-Raypad. Subcategory: Mouse Pad. Price: 2,600৳.
",164,790157,790321
5722,sentence,"Subcategory: Mouse Pad. Price: 2,600৳.

Product: X-raypad Aqua Control II Sakura Blue Gaming Mouse Pad. Category: X-Raypad. Subcategory: Mouse Pad. Price: 2,600৳.
",163,790282,790445
5723,sentence,"Subcategory: Mouse Pad. Price: 2,600৳.

Product: X-raypad Aqua Control Zero Orange Gaming Mouse Pad. Category: X-Raypad. Subcategory: Mouse Pad. Price: 2,900৳.
",160,790406,790566
5724,sentence,"Subcategory: Mouse Pad. Price: 2,900৳.

Product: X-raypad Aqua Control plus XXL Gaming Mouse Pad White. Category: X-Raypad. Subcategory: Mouse Pad. Price: 3,900৳.
",163,790527,790690
5725,sentence,"Subcategory: Mouse Pad. Price: 3,900৳.

Product: X-raypad Aqua Control Plus XL Gaming Mouse Pad (Grey-Black). Category: X-Raypad. Subcategory: Mouse Pad. Price: Out Of Stock.
",175,790651,790826
5726,sentence,"Subcategory: Mouse Pad. Price: Out Of Stock.

Product: X-raypad Aqua Control II XL Gaming Mouse Pad. Category: X-Raypad. Subcategory: Mouse Pad. Price: Out Of Stock.
",166,790781,790947
5727,sentence,"Subcategory: Mouse Pad. Price: Out Of Stock.

Product: X-raypad Aqua Control II Sakura Night Gaming Mouse Pad. Category: X-Raypad. Subcategory: Mouse Pad. Price: Out Of Stock.
",176,790902,791078
5728,sentence,"Subcategory: Mouse Pad. Price: Out Of Stock.

Product: X-raypad Aqua Control II Sakura Pink Gaming Mouse Pad. Category: X-Raypad. Subcategory: Mouse Pad. Price: Out Of Stock.
",175,791033,791208
5729,sentence,"Subcategory: Mouse Pad. Price: Out Of Stock.

Product: X-raypad Aqua Control Zero Black Gaming Mouse Pad. Category: X-Raypad. Subcategory: Mouse Pad. Price: Out Of Stock.
",171,791163,791334
5730,sentence,"Subcategory: Mouse Pad. Price: Out Of Stock.

Product: X-raypad Aqua Control Plus XXL Gaming Mouse Pad (Grey-Black). Category: X-Raypad. Subcategory: Mouse Pad. Price: Out Of Stock.
",182,791289,791471
5731,sentence,"Subcategory: Mouse Pad. Price: Out Of Stock.

Product: X-raypad ROB Aqua Control Plus XXL Gaming Mouse Pad. Category: X-Raypad. Subcategory: Mouse Pad. Price: Out Of Stock.
",173,791426,791599
5732,sentence,"Subcategory: Mouse Pad. Price: Out Of Stock.

Product: X-raypad Aqua Control Plus XXL Gaming Mouse Pad. Category: X-Raypad. Subcategory: Mouse Pad. Price: Out Of Stock.
",169,791554,791723
5733,sentence,"Subcategory: Mouse Pad. Price: Out Of Stock.

Product: T-WOLF TF950 5 In 1 Wired Gaming Combo. Category: T-Wolf. Subcategory: Mouse Pad. Price: 2,450৳.

Product: Onikuma MP006 RGB Gaming Mousepad. ",197,791678,791875
5734,sentence,"
Product: Onikuma MP006 RGB Gaming Mousepad. Category: Onikuma. Subcategory: Mouse Pad. Price: 1,350৳.

Product: Onikuma MP005 RGB Gaming Mousepad. Category: Onikuma. Subcategory: Mouse Pad. ",191,791830,792021
5735,sentence,"Category: Onikuma. Subcategory: Mouse Pad. Price: 1,400৳.

Product: MSI VIGOR WR01 Keyboard Wrist Rest. Category: Wrist Rest. Subcategory: Accessories. Price: 1,600৳.
",167,791978,792145
5736,sentence,"Subcategory: Accessories. Price: 1,600৳.

Product: Asus AC01 ROG Gaming Wrist Rest. Category: Wrist Rest. Subcategory: Accessories. Price: Up Coming.
",150,792104,792254
5737,sentence,"Subcategory: Accessories. Price: Up Coming.

Product: Fantech AC4101M PILO Ergonomic Black Keyboard Wristpad. Category: Wrist Rest. Subcategory: Accessories. Price: Out Of Stock.
",179,792210,792389
5738,sentence,"Subcategory: Accessories. Price: Out Of Stock.

Product: Fantech AC4101L Keyboard Wristpad Large Black. Category: Wrist Rest. Subcategory: Accessories. Price: Out Of Stock.
",173,792342,792515
5739,sentence,"Subcategory: Accessories. Price: Out Of Stock.

Product: Redragon P023 Wrist Rest Pad. Category: Wrist Rest. Subcategory: Accessories. Price: Out Of Stock.
",156,792468,792624
5740,sentence,"Subcategory: Accessories. Price: Out Of Stock.

Product: AULA MP-W Mouse Pad with Sewing Edge. Category: AULA. Subcategory: Mouse Pad. Price: Up Coming.
",153,792577,792730
5741,sentence,"Subcategory: Mouse Pad. Price: Up Coming.

Product: AULA MP-WFFM Gaming Mouse Pad with Sewing Edge. Category: AULA. Subcategory: Mouse Pad. Price: Up Coming.
",158,792688,792846
5742,sentence,"Subcategory: Mouse Pad. Price: Up Coming.

Product: AULA F-X5 RGB Backlight Gaming Mouse Pad. Category: AULA. Subcategory: Mouse Pad. Price: Up Coming.
",152,792804,792956
5743,sentence,"Subcategory: Mouse Pad. Price: Up Coming.

Product: AULA MP-XL Speed Type Gaming Mouse Pad. Category: AULA. Subcategory: Mouse Pad. Price: Out Of Stock.
",153,792914,793067
5744,sentence,"Subcategory: Mouse Pad. Price: Out Of Stock.

Product: Onikuma ST-1 Stable Anti-Slip ABS Gaming Headphone Stand. Category: Headphone Stand. Subcategory: Accessories. Price: 450৳.
",179,793022,793201
5745,sentence,"Subcategory: Accessories. Price: 450৳.

Product: Fantech TOWER II AC304 Headphone Stand. Category: Headphone Stand. Subcategory: Accessories. Price: 850৳.
",155,793162,793317
5746,sentence,"Subcategory: Accessories. Price: 850৳.

Product: Fantech AC3001S RGB Tower Headphone Stand. Category: Headphone Stand. Subcategory: Accessories. Price: 1,450৳.

Product: MSI HS01 Headset Stand. ",194,793278,793472
5747,sentence,"
Product: MSI HS01 Headset Stand. Category: Headphone Stand. Subcategory: Accessories. Price: 3,000৳.

Product: Asus ROG Throne with 7.1 Surround Sound RGB Headphone Stand. ",173,793438,793611
5748,sentence,"Category: Headphone Stand. Subcategory: Accessories. Price: 8,699৳9,000৳.

Product: Fantech AC3001 Tower Headphone Stand. Category: Headphone Stand. Subcategory: Accessories. Price: Out Of Stock.
",196,793611,793807
5749,sentence,"Subcategory: Accessories. Price: Out Of Stock.

Product: Fantech AC3004 Gaming Headset Stand. Category: Headphone Stand. Subcategory: Accessories. Price: Out Of Stock.
",168,793760,793928
5750,sentence,"Subcategory: Accessories. Price: Out Of Stock.

Product: Redragon HA300 Scepter Pro RGB Backlit Gaming Headphone Stand. Category: Headphone Stand. Subcategory: Accessories. Price: Out Of Stock.
",194,793881,794075
5751,sentence,"Subcategory: Accessories. Price: Out Of Stock.

Product: Redragon SCEPTER ELITE HA311 RGB Headphone Stand with Mouse Bungee. Category: Headphone Stand. Subcategory: Accessories. Price: Out Of Stock.
",199,794028,794227
5752,sentence,"Subcategory: Accessories. Price: Out Of Stock.

Product: Havit TH650 RGB Headphone Stand with Dual Hanger & 2 USB Ports. Category: Headphone Stand. Subcategory: Accessories. Price: Out Of Stock.
",195,794180,794375
5753,sentence,"Subcategory: Accessories. Price: Out Of Stock.

Product: Fantech TOWER II AC304 PRO RGB Headphone Stand. Category: Headphone Stand. Subcategory: Accessories. Price: Out Of Stock.
",179,794328,794507
5754,sentence,"Subcategory: Accessories. Price: Out Of Stock.

Product: Corsair ST100 RGB Premium Headset Stand. Category: Headphone Stand. Subcategory: Accessories. Price: Out Of Stock.
",172,794460,794632
5755,sentence,"Subcategory: Accessories. Price: Out Of Stock.

Product: Asus ROG Throne Qi with 7.1 Surround Sound RGB Wireless Charging Headphone Stand. Category: Headphone Stand. Subcategory: Accessories. ",192,794585,794777
5756,sentence,"Subcategory: Accessories. Price: Out Of Stock.

Product: Jedel S-562 RGB 2-in-1 Wired Soundbar. Category: Soundbar. Subcategory: Accessories. Price: 1,450৳.
",157,794751,794908
5757,sentence,"Subcategory: Accessories. Price: 1,450৳.

Product: Onikuma L1 RGB Bluetooth Portable Soundbar. Category: Soundbar. Subcategory: Accessories. Price: 1,750৳.

Product: Havit SK854BT Bluetooth Speaker. ",199,794867,795066
5758,sentence,"
Product: Havit SK854BT Bluetooth Speaker. Category: Soundbar. Subcategory: Accessories. Price: 1,780৳.

Product: Xtrike Me SK-604 2.0 Soundbar. Category: Soundbar. Subcategory: Accessories. ",191,795023,795214
5759,sentence,"Category: Soundbar. Subcategory: Accessories. Price: 2,100৳.

Product: Microlab MS212 Portable Bluetooth Soundbar. Category: Soundbar. Subcategory: Accessories. Price: 2,200৳.
",176,795168,795344
5760,sentence,"Subcategory: Accessories. Price: 2,200৳.

Product: Havit SK215 2.0 RGB Bluetooth Soundbar. Category: Soundbar. Subcategory: Accessories. Price: 2,350৳.
",152,795303,795455
5761,sentence,"Subcategory: Accessories. Price: 2,350৳.

Product: Havit SF149BT Portable Bluetooth Bar Speaker. Category: Soundbar. Subcategory: Accessories. Price: 2,700৳.
",158,795414,795572
5762,sentence,"Subcategory: Accessories. Price: 2,700৳.

Product: Xtrike Me SP-211BT RGB Bluetooth Sound Bar. Category: Soundbar. Subcategory: Accessories. Price: 2,299৳2,700৳.
",162,795531,795693
5763,sentence,"Subcategory: Accessories. Price: 2,299৳2,700৳.

Product: Redragon GS570 Darknets RGB Bluetooth Stereo Soundbar. Category: Soundbar. Subcategory: Accessories. Price: 2,799৳2,900৳.
",179,795646,795825
5764,sentence,"Subcategory: Accessories. Price: 2,799৳2,900৳.

Product: Xiaomi Redmi MDZ-34-DA TV Soundbar Bluetooth & Wired Speaker. Category: Soundbar. Subcategory: Accessories. Price: 4,050৳4,500৳.
",186,795778,795964
5765,sentence,"Subcategory: Accessories. Price: 4,050৳4,500৳.

Product: Xtreme Race 2:1 Bluetooth Multimedia Soundbar with Remote. Category: Soundbar. Subcategory: Accessories. Price: 5,200৳.
",177,795917,796094
5766,sentence,"Subcategory: Accessories. Price: 5,200৳.

Product: Awei Y999 Home Theater Bluetooth Soundbar Speaker. Category: Soundbar. Subcategory: Accessories. Price: 5,300৳5,799৳.
",169,796053,796222
5767,sentence,"Subcategory: Accessories. Price: 5,300৳5,799৳.

Product: Xtreme Glory 2:1 Bluetooth Multimedia Soundbar. Category: Soundbar. Subcategory: Accessories. Price: 6,400৳.
",166,796175,796341
5768,sentence,"Subcategory: Accessories. Price: 6,400৳.

Product: Xtreme Falcon 5:1 Multimedia Bluetooth Soundbar. Category: Soundbar. Subcategory: Accessories. Price: 7,500৳.
",161,796300,796461
5769,sentence,"Subcategory: Accessories. Price: 7,500৳.

Product: Microlab ONEBAR04 Stereo Bluetooth Soundbar. Category: Soundbar. Subcategory: Accessories. Price: 6,999৳7,900৳.
",163,796420,796583
5770,sentence,"Subcategory: Accessories. Price: 6,999৳7,900৳.

Product: Thonet & Vander BALKEN Bluetooth Soundbar. Category: Soundbar. Subcategory: Accessories. Price: 8,800৳.
",161,796536,796697
5771,sentence,"Subcategory: Accessories. Price: 8,800৳.

Product: F&D HT-230 Soundbar Bluetooth Speaker. Category: Soundbar. Subcategory: Accessories. Price: 9,000৳.

Product: Wiwu S1 Bluetooth Soundbar Speaker. ",197,796656,796853
5772,sentence,"
Product: Wiwu S1 Bluetooth Soundbar Speaker. Category: Soundbar. Subcategory: Accessories. Price: 7,740৳9,000৳.

Product: Xtreme Harmony 5:1 Multimedia Soundbar with Remote. Category: Soundbar. ",195,796807,797002
5773,sentence,"Category: Soundbar. Subcategory: Accessories. Price: 9,200৳.

Product: Thonet & Vander GUT Bluetooth Soundbar. Category: Soundbar. Subcategory: Accessories. Price: 10,000৳.
",173,796982,797155
5774,sentence,"Subcategory: Accessories. Price: 10,000৳.

Product: Havit HV-SK473 USB 2.0 Speaker. Category: Speaker & Home Theater. Subcategory: Accessories. Price: 499৳530৳.
",161,797113,797274
5775,sentence,"Subcategory: Accessories. Price: 499৳530৳.

Product: Havit HV-SK486 USB 2.0 Speaker. Category: Speaker & Home Theater. Subcategory: Accessories. Price: 530৳.

Product: T-WOLF S2 Dual Wired Speaker. ",198,797231,797429
5776,sentence,"
Product: T-WOLF S2 Dual Wired Speaker. Category: Speaker & Home Theater. Subcategory: Accessories. Price: 598৳.

Product: Havit SK704 2:0 USB Speaker. Category: Speaker & Home Theater. ",186,797389,797575
5777,sentence,"Category: Speaker & Home Theater. Subcategory: Accessories. Price: 549৳600৳.

Product: Havit SK717 USB Stereo Speaker with LED Backlit. Category: Speaker & Home Theater. Subcategory: Accessories. ",196,797541,797737
5778,sentence,"Subcategory: Accessories. Price: 599৳650৳.

Product: Jedel S-511 USB Mini Speaker. Category: Speaker & Home Theater. Subcategory: Accessories. Price: 650৳.

Product: HAVIT SK764 USB Stereo Speaker. ",198,797711,797909
5779,sentence,"
Product: HAVIT SK764 USB Stereo Speaker. Category: Speaker & Home Theater. Subcategory: Accessories. Price: 690৳.

Product: Havit SK210 Mini Pro 2.0 RGB Gaming Speaker. ",170,797867,798037
5780,sentence,"Category: Speaker & Home Theater. Subcategory: Accessories. Price: 649৳690৳.

Product: T-Wolf S3 Portable Wired RGB Gaming Speaker. Category: Speaker & Home Theater. Subcategory: Accessories. ",192,798037,798229
5781,sentence,"Subcategory: Accessories. Price: 700৳.

Product: Havit SK715 2.0 USB Stereo Speaker. Category: Speaker & Home Theater. Subcategory: Accessories. Price: 750৳.
",158,798203,798361
5782,sentence,"Subcategory: Accessories. Price: 750৳.

Product: Havit SK706 Stereo LED Backlit USB Speaker. Category: Speaker & Home Theater. Subcategory: Accessories. Price: 800৳.
",166,798322,798488
5783,sentence,"Subcategory: Accessories. Price: 800৳.

Product: Havit SK708 2:0 RGB USB Gaming Speaker. Category: Speaker & Home Theater. Subcategory: Accessories. Price: 779৳850৳.
",166,798449,798615
5784,sentence,"Subcategory: Accessories. Price: 779৳850৳.

Product: Havit SK709 LED USB Speaker. Category: Speaker & Home Theater. Subcategory: Accessories. Price: 850৳.

Product: Jedel S-554 RGB USB Speaker. ",194,798572,798766
5785,sentence,"
Product: Jedel S-554 RGB USB Speaker. Category: Speaker & Home Theater. Subcategory: Accessories. Price: 900৳.

Product: Jedel S-553 RGB USB Speaker. Category: Speaker & Home Theater. ",185,798727,798912
5786,sentence,"Category: Speaker & Home Theater. Subcategory: Accessories. Price: 900৳.

Product: Havit SK518 2.0 USB Speaker. Category: Speaker & Home Theater. Subcategory: Accessories. Price: 950৳.
",185,798878,799063
5787,sentence,"Subcategory: Accessories. Price: 950৳.

Product: Havit SK599 2.0 USB Speaker. Category: Speaker & Home Theater. Subcategory: Accessories. Price: 960৳.
",151,799024,799175
5788,sentence,"Subcategory: Accessories. Price: 960৳.

Product: Xtrike Me SK-405 2.0 Channel Stereo RGB Gaming Speaker. Category: Speaker & Home Theater. Subcategory: Accessories. Price: 799৳1,000৳.
",184,799136,799320
5789,sentence,"Subcategory: Accessories. Price: 799৳1,000৳.

Product: Jedel S-527 RGB Wired USB Speaker. Category: Speaker & Home Theater. Subcategory: Accessories. Price: 1,000৳.
",165,799275,799440
5790,sentence,"Subcategory: Accessories. Price: 1,000৳.

Product: Jedel S-526 RGB USB Mini Speaker. Category: Speaker & Home Theater. Subcategory: Accessories. Price: 1,000৳.

Product: Logitech C270 HD Webcam. ",195,799399,799594
5791,sentence,"
Product: Logitech C270 HD Webcam. Category: Logitech. Subcategory: Webcam. Price: 2,300৳.

Product: Logitech Brio 100 Full HD Privacy Shutter Webcam. Category: Logitech. Subcategory: Webcam. ",192,799559,799751
5792,sentence,"Category: Logitech. Subcategory: Webcam. Price: 3,900৳.

Product: Logitech BRIO 300 Full HD 1080p 2MP Webcam. Category: Logitech. Subcategory: Webcam. Price: 7,300৳.
",166,799710,799876
5793,sentence,"Subcategory: Webcam. Price: 7,300৳.

Product: Logitech C920 HD PRO Full HD Webcam. Category: Logitech. Subcategory: Webcam. Price: 12,500৳.
",140,799840,799980
5794,sentence,"Subcategory: Webcam. Price: 12,500৳.

Product: Logitech BRIO 500 Full HD 1080p 4MP Auto-framing Webcam. Category: Logitech. Subcategory: Webcam. Price: 12,500৳.
",161,799943,800104
5795,sentence,"Subcategory: Webcam. Price: 12,500৳.

Product: Logitech C922 Pro Full HD Webcam. Category: Logitech. Subcategory: Webcam. Price: 12,499৳13,000৳.

Product: Logitech MX Brio Ultra HD 4K Webcam. ",192,800067,800259
5796,sentence,"
Product: Logitech MX Brio Ultra HD 4K Webcam. Category: Logitech. Subcategory: Webcam. Price: 21,800৳.

Product: Logitech C930E Full HD Video Conferencing Webcam. Category: Logitech. ",184,800212,800396
5797,sentence,"Category: Logitech. Subcategory: Webcam. Price: Out Of Stock.

Product: A4tech PK-825P 720P HD Webcam. Category: A4TECH. Subcategory: Webcam. Price: 1,999৳2,150৳.
",163,800376,800539
5798,sentence,"Subcategory: Webcam. Price: 1,999৳2,150৳.

Product: A4TECH Pk-910H 1080p Full-HD Webcam. Category: A4TECH. Subcategory: Webcam. Price: 2,299৳2,500৳.

Product: A4Tech PK-935HL 1080p Full HD Webcam. ",197,800497,800694
5799,sentence,"
Product: A4Tech PK-935HL 1080p Full HD Webcam. Category: A4TECH. Subcategory: Webcam. Price: 3,199৳3,400৳.

Product: A4TECH PK-1000HA UHD 4K Pro Auto Focus Webcam. Category: A4TECH. ",183,800646,800829
5800,sentence,"Category: A4TECH. Subcategory: Webcam. Price: 12,999৳13,500৳.

Product: A4Tech Pk-910P 720P High-HD Webcam. Category: A4TECH. Subcategory: Webcam. Price: Out Of Stock.
",168,800811,800979
5801,sentence,"Subcategory: Webcam. Price: Out Of Stock.

Product: A4tech PK-940HA FHD 1080P AF Webcam. Category: A4TECH. Subcategory: Webcam. Price: Out Of Stock.
",149,800937,801086
5802,sentence,"Subcategory: Webcam. Price: Out Of Stock.

Product: Xtreme Ikarao Waterproof Travel Bag for Break X2 Speaker. Category: Bluetooth Speakers. Subcategory: Accessories. Price: 2,300৳.
",181,801044,801225
5803,sentence,"Subcategory: Accessories. Price: 2,300৳.

Product: Xtreme Ikarao Waterproof Travel Trolley Bag for Break X1 Speaker. Category: Bluetooth Speakers. Subcategory: Accessories. Price: 6,300৳.
",188,801184,801372
5804,sentence,"Subcategory: Accessories. Price: 6,300৳.

Product: F&D F380 X 2.1 Channel Multimedia Bluetooth Speakers. Category: Bluetooth Speakers. Subcategory: Accessories. Price: 8,600৳.
",176,801331,801507
5805,sentence,"Subcategory: Accessories. Price: 8,600৳.

Product: F&D W4 Wireless Portable Bluetooth Speaker. Category: Bluetooth Speakers. Subcategory: Accessories. Price: Up Coming.
",169,801466,801635
5806,sentence,"Subcategory: Accessories. Price: Up Coming.

Product: Awei Y385 Mini Portable Bluetooth Speaker. Category: Bluetooth Speakers. Subcategory: Accessories. Price: 891৳990৳.
",170,801591,801761
5807,sentence,"Subcategory: Accessories. Price: 891৳990৳.

Product: Hoco HC22 Stereo Bluetooth Wireless Speaker. Category: Bluetooth Speakers. Subcategory: Accessories. Price: 972৳1,080৳.
",173,801718,801891
5808,sentence,"Subcategory: Accessories. Price: 972৳1,080৳.

Product: Hoco BS60 Portable Bluetooth Speaker. Category: Bluetooth Speakers. Subcategory: Accessories. Price: 1,020৳1,102৳.
",170,801846,802016
5809,sentence,"Subcategory: Accessories. Price: 1,020৳1,102৳.

Product: Yison Celebrat SP-3 Portable Bluetooth Speaker. Category: Bluetooth Speakers. Subcategory: Accessories. Price: 900৳1,150৳.
",180,801969,802149
5810,sentence,"Subcategory: Accessories. Price: 900৳1,150৳.

Product: Hoco BS47 UNO Bluetooth Wireless Speaker. Category: Bluetooth Speakers. Subcategory: Accessories. Price: 1,050৳1,150৳.
",174,802104,802278
5811,sentence,"Subcategory: Accessories. Price: 1,050৳1,150৳.

Product: Yison Celebrat SP-8 Portable Bluetooth Speaker. Category: Bluetooth Speakers. Subcategory: Accessories. Price: 1,090৳1,160৳.
",182,802231,802413
5812,sentence,"Subcategory: Accessories. Price: 1,090৳1,160৳.

Product: Hoco HC1 True Wireless Waterproof Bluetooth Speaker. Category: Bluetooth Speakers. Subcategory: Accessories. Price: 1,080৳1,180৳.
",187,802366,802553
5813,sentence,"Subcategory: Accessories. Price: 1,080৳1,180৳.

Product: JOYROOM JR-ML03 Transparent RGB Bluetooth Wireless Speaker. Category: Bluetooth Speakers. Subcategory: Accessories. Price: 960৳1,200৳.
",192,802506,802698
5814,sentence,"Subcategory: Accessories. Price: 960৳1,200৳.

Product: Yison Celebrat SKY-3 Portable Bluetooth Speaker. Category: Bluetooth Speakers. Subcategory: Accessories. Price: 1,190৳1,290৳.
",181,802653,802834
5815,sentence,"Subcategory: Accessories. Price: 1,190৳1,290৳.

Product: Havit SK838BT Portable Bluetooth Speaker. Category: Bluetooth Speakers. Subcategory: Accessories. Price: 1,175৳1,350৳.
",176,802787,802963
5816,sentence,"Subcategory: Accessories. Price: 1,175৳1,350৳.

Product: Megastar Avengers Gaming G002 Wireless Neck Speaker. Category: Bluetooth Speakers. Subcategory: Accessories. Price: 1,250৳1,350৳.
",187,802916,803103
5817,sentence,"Subcategory: Accessories. Price: 1,250৳1,350৳.

Product: Yison Celebrat SP-19 Portable Bluetooth Speaker. Category: Bluetooth Speakers. Subcategory: Accessories. Price: 1,237৳1,390৳.
",183,803056,803239
5818,sentence,"Subcategory: Accessories. Price: 1,237৳1,390৳.

Product: Hoco HC16 True Wireless Bluetooth Speaker. Category: Bluetooth Speakers. Subcategory: Accessories. Price: 1,259৳1,399৳.
",177,803192,803369
5819,sentence,"Subcategory: Accessories. Price: 1,259৳1,399৳.

Product: Havit HV-M3 Portable Alarm Clock Bluetooth Speaker. Category: Bluetooth Speakers. Subcategory: Accessories. Price: 1,250৳1,450৳.
",186,803322,803508
5820,sentence,"Subcategory: Accessories. Price: 1,250৳1,450৳.

Product: Havit SK800BT Portable Bluetooth Speaker. Category: Bluetooth Speakers. Subcategory: Accessories. Price: 1,240৳1,450৳.
",176,803461,803637
5821,sentence,"Subcategory: Accessories. Price: 1,240৳1,450৳.

Product: Recci RSK-W09 Portable Bluetooth Speaker. Category: Bluetooth Speakers. Subcategory: Accessories. Price: 1,360৳1,450৳.
",176,803590,803766
5822,sentence,"Subcategory: Accessories. Price: 1,360৳1,450৳.

Product: Havit N5086 HD Webcam. Category: Havit. Subcategory: Webcam. Price: 1,150৳.

Product: Havit HN25G HD Webcam With Beauty Light. ",184,803719,803903
5823,sentence,"Category: Havit. Subcategory: Webcam. Price: 1,450৳.

Product: Havit HV-HN11P 1080P Webcam. Category: Havit. Subcategory: Webcam. Price: 1,900৳.

Product: ASUS C3 Full HD Streaming USB Webcam. ",193,803903,804096
5824,sentence,"
Product: ASUS C3 Full HD Streaming USB Webcam. Category: Asus. Subcategory: Webcam. Price: 6,499৳6,900৳.

Product: Asus ROG Eye S Full HD 60fps Webcam. Category: Asus. Subcategory: Webcam. ",190,804048,804238
5825,sentence,"Category: Asus. Subcategory: Webcam. Price: 9,599৳10,000৳.

Product: Rapoo C200 720P HD Webcam. Category: Webcam. Subcategory: Accessories. Price: 2,199৳2,500৳.
",161,804201,804362
5826,sentence,"Subcategory: Accessories. Price: 2,199৳2,500৳.

Product: Redragon GW600 FOBOS 720P Webcam. Category: Webcam. Subcategory: Accessories. Price: 2,850৳.
",150,804315,804465
5827,sentence,"Subcategory: Accessories. Price: 2,850৳.

Product: Fantech Luminous C30 USB 2K Quad HD 4MP Webcam. Category: Webcam. Subcategory: Accessories. Price: 3,250৳3,500৳.

Product: Rapoo C280 2K Webcam. ",196,804424,804620
5828,sentence,"
Product: Rapoo C280 2K Webcam. Category: Webcam. Subcategory: Accessories. Price: 4,400৳.

Product: Magpie MG-WC05NC3 5.0 MP Privacy Shutter Webcam. Category: Webcam. Subcategory: Accessories. ",194,804588,804782
5829,sentence,"Category: Webcam. Subcategory: Accessories. Price: 4,199৳4,500৳.

Product: Redragon GW910 ONESHOT 1080P PC Webcam. Category: Webcam. Subcategory: Accessories. Price: 4,599৳4,900৳.
",180,804738,804918
5830,sentence,"Subcategory: Accessories. Price: 4,599৳4,900৳.

Product: Redragon GW900 APEX 1080P Webcam. Category: Webcam. Subcategory: Accessories. Price: 5,149৳5,300৳.

Product: Fantech Luminous C50 Webcam. ",195,804871,805066
5831,sentence,"
Product: Fantech Luminous C50 Webcam. Category: Webcam. Subcategory: Accessories. Price: 5,800৳.

Product: Elgato Facecam Neo. Category: Webcam. Subcategory: Accessories. Price: 10,000৳.
",188,805027,805215
5832,sentence,"Subcategory: Accessories. Price: 10,000৳.

Product: Elgato Facecam Premium 1080p Webcam. Category: Elgato. Subcategory: Webcam. Price: 18,499৳19,500৳.

Product: Rapoo C260 USB Full HD Webcam. ",192,805173,805365
5833,sentence,"
Product: Rapoo C260 USB Full HD Webcam. Category: Rapoo. Subcategory: Webcam. Price: Out Of Stock.

Product: Redragon GW800 HITMAN 1080P Webcam. Category: Redragon. Subcategory: Webcam. ",187,805324,805511
5834,sentence,"Category: Redragon. Subcategory: Webcam. Price: Out Of Stock.

Product: Oraimo RobustLine 1M USB to Lightning Cable #OCD-114L. Category: USB Cable. Subcategory: Cable. Price: 155৳.
",181,805470,805651
5835,sentence,"Subcategory: Cable. Price: 155৳.

Product: Awei CL-115M 1 Meter USB to Micro USB 2.4A Fast Charging Cable. Category: USB Cable. Subcategory: Cable. Price: 170৳.
",161,805618,805779
5836,sentence,"Subcategory: Cable. Price: 170৳.

Product: FJGEAR 1.5 Meter USB Extension Cable. Category: USB Cable. Subcategory: Cable. Price: 195৳.

Product: Riversong CM85 Beta 09 Micro USB Data Cable. ",190,805746,805936
5837,sentence,"Category: USB Cable. Subcategory: Cable. Price: 140৳199৳.

Product: Foneng XS01 1 Meter USB to Type-C Cable. Category: USB Cable. Subcategory: Cable. Price: 199৳.
",163,805936,806099
5838,sentence,"Subcategory: Cable. Price: 199৳.

Product: Megastar FC-M001 2 Meter Micro USB Fast Charging Cable. Category: USB Cable. Subcategory: Cable. Price: 140৳250৳.
",157,806066,806223
5839,sentence,"Subcategory: Cable. Price: 140৳250৳.

Product: Yuanxin YUX-003 USB Male to Micro USB 0.8 Meter Cable. Category: USB Cable. Subcategory: Cable. Price: 230৳250৳.
",160,806186,806346
5840,sentence,"Subcategory: Cable. Price: 230৳250৳.

Product: Yuanxin YUX-003 USB Male to Male 1.5 Meter Cable. Category: USB Cable. Subcategory: Cable. Price: 250৳.
",151,806309,806460
5841,sentence,"Subcategory: Cable. Price: 250৳.

Product: Awei CL-10 0.3 Meter USB to Micro USB Fast Charging Cable. Category: USB Cable. Subcategory: Cable. Price: 199৳250৳.
",160,806427,806587
5842,sentence,"Subcategory: Cable. Price: 199৳250৳.

Product: Megastar FC-C001 2 Meter USB to Type C Fast Charging Cable. Category: USB Cable. Subcategory: Cable. Price: 190৳299৳.
",165,806550,806715
5843,sentence,"Subcategory: Cable. Price: 190৳299৳.

Product: Vention CCSBB USB 2.0 Type C Male to USB A Female OTG Cable 0.15M. Category: USB Cable. Subcategory: Cable. Price: 280৳325৳.
",172,806678,806850
5844,sentence,"Subcategory: Cable. Price: 280৳325৳.

Product: Yuanxin X-KC801 USB Male to Type-C Male 1 Meter Data & Charging Cable. Category: USB Cable. Subcategory: Cable. Price: 290৳350৳.
",176,806813,806989
5845,sentence,"Subcategory: Cable. Price: 290৳350৳.

Product: WiWU TITAN LINK Series Wi-C055 1 Meter USB A to Lightning Cable. Category: USB Cable. Subcategory: Cable. Price: 350৳.
",166,806952,807118
5846,sentence,"Subcategory: Cable. Price: 350৳.

Product: Vyvylabs VCSUC-02 Crystal Series USB to Type-C 1M Fast Charging Cable. Category: USB Cable. Subcategory: Cable. Price: 320৳357৳.
",172,807085,807257
5847,sentence,"Subcategory: Cable. Price: 320৳357৳.

Product: Yuanxin YAX-006 1.5 Meter 3.5mm Male to Male Audio Cable. Category: Cable. Subcategory: Accessories. Price: 150৳.
",161,807220,807381
5848,sentence,"Subcategory: Accessories. Price: 150৳.

Product: Yison Celebrat CB-31 A-C 1 Meter USB to USB Type-C Cable. Category: Cable. Subcategory: Accessories. Price: 158৳.
",163,807342,807505
5849,sentence,"Subcategory: Accessories. Price: 158৳.

Product: Yison Celebrat CB-31 A-C-White 1 Meter USB to USB Type-C Cable. Category: Cable. Subcategory: Accessories. Price: 158৳.
",169,807466,807635
5850,sentence,"Subcategory: Accessories. Price: 158৳.

Product: CHARG C3L 1 Meter USB to Lightning Cable. Category: Cable. Subcategory: Accessories. Price: 160৳.

Product: CHARG C3CC 1 Meter Type C Cable. ",190,807596,807786
5851,sentence,"
Product: CHARG C3CC 1 Meter Type C Cable. Category: Cable. Subcategory: Accessories. Price: 175৳.

Product: Yuanxin YAX-008 1.5 Meter 3.5mm Male to Male Audio Cable. Category: Cable. ",184,807743,807927
5852,sentence,"Category: Cable. Subcategory: Accessories. Price: 190৳.

Product: Havit 5 Meter VGA Male to Male Cable. Category: VGA Cable. Subcategory: Cable. Price: 400৳.
",158,807910,808068
5853,sentence,"Subcategory: Cable. Price: 400৳.

Product: Yuanxin YVX-001 VGA Male to Male 1.5 Meter Cable. Category: VGA Cable. Subcategory: Cable. Price: 400৳500৳.
",151,808035,808186
5854,sentence,"Subcategory: Cable. Price: 400৳500৳.

Product: Yuanxin YVX-002 VGA Male to Male 3 Meter Cable. Category: VGA Cable. Subcategory: Cable. Price: 560৳580৳.
",153,808149,808302
5855,sentence,"Subcategory: Cable. Price: 560৳580৳.

Product: Ugreen VG101 2 Meter VGA Male to Male Cable #11646. Category: VGA Cable. Subcategory: Cable. Price: 630৳.
",153,808265,808418
5856,sentence,"Subcategory: Cable. Price: 630৳.

Product: HAVIT Male to Male 10 Meter VGA Cable. Category: VGA Cable. Subcategory: Cable. Price: 680৳740৳.

Product: Yuanxin YVX-005 VGA Male to Male 5 Meter Cable. ",198,808385,808583
5857,sentence,"Category: VGA Cable. Subcategory: Cable. Price: 650৳750৳.

Product: UGREEN VG101 VGA Male to Male 5m Cable #11632. Category: VGA Cable. Subcategory: Cable. Price: 1,050৳.
",171,808583,808754
5858,sentence,"Subcategory: Cable. Price: 1,050৳.

Product: Ugreen DP105 1.5 Meter DisplayPort to VGA Cable #10247. Category: VGA Cable. Subcategory: Cable. Price: 1,050৳.
",157,808719,808876
5859,sentence,"Subcategory: Cable. Price: 1,050৳.

Product: HAVIT Male to Male 20 Meter VGA Cable. Category: VGA Cable. Subcategory: Cable. Price: 1,120৳.

Product: FJGEAR 15 Meter VGA Cable. Category: VGA Cable. ",198,808841,809039
5860,sentence,"Category: VGA Cable. Subcategory: Cable. Price: 890৳1,150৳.

Product: VENTION DAEBL VGA(3+6) Male to Male Cable with ferrite cores 10M. Category: VGA Cable. Subcategory: Cable. Price: 1,190৳1,400৳.
",198,809018,809216
5861,sentence,"Subcategory: Cable. Price: 1,190৳1,400৳.

Product: Yuanxin YVX-010 VGA Male to Male 10 Meter Cable. Category: VGA Cable. Subcategory: Cable. Price: 1,400৳.
",156,809175,809331
5862,sentence,"Subcategory: Cable. Price: 1,400৳.

Product: HAVIT Male to Male 30 Meter VGA Cable. Category: VGA Cable. Subcategory: Cable. Price: 1,990৳.

Product: Yuanxin YVX-015 VGA Male to Male 15 Meter Cable. ",199,809296,809495
5863,sentence,"Category: VGA Cable. Subcategory: Cable. Price: 2,000৳.

Product: FJGEAR 30 Meter VGA Cable. Category: VGA Cable. Subcategory: Cable. Price: 2,200৳.
",149,809495,809644
5864,sentence,"Subcategory: Cable. Price: 2,200৳.

Product: UGREEN VG101 15m Male to Male VGA Cable #11634. Category: VGA Cable. Subcategory: Cable. Price: 2,520৳.
",149,809609,809758
5865,sentence,"Subcategory: Cable. Price: 2,520৳.

Product: Yuanxin YVX-020 VGA Male to Male 20 Meter Cable. Category: VGA Cable. Subcategory: Cable. Price: 2,700৳.

Product: FJGEAR 40 Meter VGA Cable. ",187,809723,809910
5866,sentence,"
Product: FJGEAR 40 Meter VGA Cable. Category: VGA Cable. Subcategory: Cable. Price: 3,100৳.

Product: UGREEN VG101 20m Male to Male VGA Cable #11635. Category: VGA Cable. Subcategory: Cable. ",192,809873,810065
5867,sentence,"Category: VGA Cable. Subcategory: Cable. Price: 3,120৳.

Product: Dtech DT-V011 50 Meter VGA Cable. Category: VGA Cable. Subcategory: Cable. Price: Up Coming.
",159,810024,810183
5868,sentence,"Subcategory: Cable. Price: Up Coming.

Product: VENTION VAB-B06-B150-M 1.5 Meter 3.5mm Audio Extension Cable. Category: Audio Cable. Subcategory: Cable. Price: 280৳.
",166,810145,810311
5869,sentence,"Subcategory: Cable. Price: 280৳.

Product: UGREEN AV141 3.5mm Male To Dual 3.5mm Female Headphone Splitter Cable. Category: Audio Cable. Subcategory: Cable. Price: 350৳.
",170,810278,810448
5870,sentence,"Subcategory: Cable. Price: 350৳.

Product: Vention BBVBY Dual 3.5mm Female to 3.5mm Male Stereo Splitter Audio Cable. Category: Audio Cable. Subcategory: Cable. Price: 350৳.
",174,810415,810589
5871,sentence,"Subcategory: Cable. Price: 350৳.

Product: Hoco UPA26 1 Meter Type-C to 3.5mm Aux Audio Cable. Category: Audio Cable. Subcategory: Cable. Price: 350৳.
",151,810556,810707
5872,sentence,"Subcategory: Cable. Price: 350৳.

Product: Hoco UPA26 1 Meter Lightning to 3.5mm Aux Audio Cable. Category: Audio Cable. Subcategory: Cable. Price: 350৳.
",154,810674,810828
5873,sentence,"Subcategory: Cable. Price: 350৳.

Product: Hoco UPA21 One Female to Dual Male 3.5mm Splitter Audio Cable. Category: Audio Cable. Subcategory: Cable. Price: 290৳350৳.
",166,810795,810961
5874,sentence,"Subcategory: Cable. Price: 290৳350৳.

Product: Hoco UPA21 one Male to Dual Female 3.5mm Splitter Audio Cable. Category: Audio Cable. Subcategory: Cable. Price: 290৳350৳.
",170,810924,811094
5875,sentence,"Subcategory: Cable. Price: 290৳350৳.

Product: UGREEN AV119 5M 3.5mm Audio Extension Cable #10729. Category: Audio Cable. Subcategory: Cable. Price: 430৳.
",155,811057,811212
5876,sentence,"Subcategory: Cable. Price: 430৳.

Product: UGREEN AV119 3M 3.5mm Audio Extension Cable #10728. Category: Audio Cable. Subcategory: Cable. Price: 390৳.
",151,811179,811330
5877,sentence,"Subcategory: Cable. Price: 390৳.

Product: UGREEN AV140 3.5mm Female To Dual 3.5mm Male Audio Splitter Cable #20897. Category: Audio Cable. Subcategory: Cable. Price: 350৳.
",173,811297,811470
5878,sentence,"Subcategory: Cable. Price: 350৳.

Product: Ugreen AV112 2M 3.5mm Audio Cable #10687. Category: Audio Cable. Subcategory: Cable. Price: 360৳.
",141,811437,811578
5879,sentence,"Subcategory: Cable. Price: 360৳.

Product: Ugreen AV118 3M 3.5mm Male to Female Audio Extension Cable #10595. Category: Audio Cable. Subcategory: Cable. Price: 380৳.
",166,811545,811711
5880,sentence,"Subcategory: Cable. Price: 380৳.

Product: Ugreen AV122 1.5 Meter Toslink Optical Audio Cable #70891. Category: Audio Cable. Subcategory: Cable. Price: 390৳.
",158,811678,811836
5881,sentence,"Subcategory: Cable. Price: 390৳.

Product: VENTION VAB-B06-B300-M 3 Meter 3.5mm Audio Extension Cable. Category: Audio Cable. Subcategory: Cable. Price: 400৳.
",159,811803,811962
5882,sentence,"Subcategory: Cable. Price: 400৳.

Product: UGREEN AV122 Toslink Optical Male To Male Audio Cable #70892. Category: Audio Cable. Subcategory: Cable. Price: 440৳.
",161,811929,812090
5883,sentence,"Subcategory: Cable. Price: 440৳.

Product: Ugreen AV112 3.5mm Male to Male 3 Meter Audio Cable #10688. Category: Audio Cable. Subcategory: Cable. Price: 450৳.
",159,812057,812216
5884,sentence,"Subcategory: Cable. Price: 450৳.

Product: UGREEN AV134 3.5mm Male to Dual Female Headphone Splitter Cable #20816. Category: Audio Cable. Subcategory: Cable. Price: 390৳450৳.
",175,812183,812358
5885,sentence,"Subcategory: Cable. Price: 390৳450৳.

Product: Yuanxin YAX-003 3 Meter 3.5mm Male to Male Audio Cable. Category: Audio Cable. Subcategory: Cable. Price: 250৳450৳.
",163,812321,812484
5886,sentence,"Subcategory: Cable. Price: 250৳450৳.

Product: Vention AACBF 1Meter High-Speed HDMI Cable. Category: HDMI Cable. Subcategory: Cable. Price: 240৳250৳.
",150,812447,812597
5887,sentence,"Subcategory: Cable. Price: 240৳250৳.

Product: VENTION VAA-D02-B150 1.5 Meter Mini HDMI to HDMI Cable. Category: HDMI Cable. Subcategory: Cable. Price: 350৳.
",158,812560,812718
5888,sentence,"Subcategory: Cable. Price: 350৳.

Product: Vention AACBH 2Meter High-Speed HDMI Cable. Category: HDMI Cable. Subcategory: Cable. Price: 320৳375৳.
",146,812685,812831
5889,sentence,"Subcategory: Cable. Price: 320৳375৳.

Product: Vention AACBG 1.5M Male to Male HDMI Cable. Category: HDMI Cable. Subcategory: Cable. Price: 290৳450৳.
",150,812794,812944
5890,sentence,"Subcategory: Cable. Price: 290৳450৳.

Product: Yuanxin YHX-002 HDMI Male to Male 1.5 Meter Cable. Category: HDMI Cable. Subcategory: Cable. Price: 390৳450৳.
",157,812907,813064
5891,sentence,"Subcategory: Cable. Price: 390৳450৳.

Product: Yuanxin YHD-001 HDMI Male to DVI Male 1.8 Meter Cable. Category: HDMI Cable. Subcategory: Cable. Price: 490৳.
",157,813027,813184
5892,sentence,"Subcategory: Cable. Price: 490৳.

Product: Vention AACBI 3Meter High-Speed HDMI Cable. Category: HDMI Cable. Subcategory: Cable. Price: 450৳499৳.
",146,813151,813297
5893,sentence,"Subcategory: Cable. Price: 450৳499৳.

Product: Vention VAA-B06-B300 HDMI Male to Female 3M Extension Cable. Category: HDMI Cable. Subcategory: Cable. Price: 500৳.
",163,813260,813423
5894,sentence,"Subcategory: Cable. Price: 500৳.

Product: UGREEN HD107 HDMI Male to Female 2m Cable #10142. Category: HDMI Cable. Subcategory: Cable. Price: 490৳550৳.
",152,813390,813542
5895,sentence,"Subcategory: Cable. Price: 490৳550৳.

Product: Yuanxin YHX-003 Male to Male 3 Meter HDMI Cable. Category: HDMI Cable. Subcategory: Cable. Price: 430৳550৳.
",155,813505,813660
5896,sentence,"Subcategory: Cable. Price: 430৳550৳.

Product: UGREEN HD118 2M HDMI Cable #40410. Category: HDMI Cable. Subcategory: Cable. Price: 580৳650৳.
",141,813623,813764
5897,sentence,"Subcategory: Cable. Price: 580৳650৳.

Product: UGREEN HD103 Right Angle 90° 2M HDMI Cable #10173. Category: HDMI Cable. Subcategory: Cable. Price: 520৳650৳.
",157,813727,813884
5898,sentence,"Subcategory: Cable. Price: 520৳650৳.

Product: Ugreen HD163 2 Meter Mini HDMI to HDMI 8K Cable #15515. Category: HDMI Cable. Subcategory: Cable. Price: 780৳.
",158,813847,814005
5899,sentence,"Subcategory: Cable. Price: 780৳.

Product: FJGEAR 10 Meter 1.4 Version HDMI Cable. Category: HDMI Cable. Subcategory: Cable. Price: 800৳.

Product: Yuanxin YHX-020 HDMI Male to Male 5 Meter Cable. ",197,813972,814169
5900,sentence,"Category: HDMI Cable. Subcategory: Cable. Price: 740৳800৳.

Product: Belkin F3Y020bt1M High-Speed HDMI Cable with Ethernet. Category: HDMI Cable. Subcategory: Cable. Price: 600৳850৳.
",183,814169,814352
5901,sentence,"Subcategory: Cable. Price: 600৳850৳.

Product: Yuanxin YHX-022 HDMI Male to Male 3 Meter Cable. Category: HDMI Cable. Subcategory: Cable. Price: 750৳850৳.
",155,814315,814470
5902,sentence,"Subcategory: Cable. Price: 750৳850৳.

Product: Baseus High Definition Series HDMI To HDMI Graphene 4K Adapter Cable 2 Meter. Category: HDMI Cable. Subcategory: Cable. Price: 780৳899৳.
",184,814433,814617
5903,sentence,"Subcategory: Cable. Price: 780৳899৳.

Product: Vention AACBK 8Meter High-Speed HDMI Cable. Category: HDMI Cable. Subcategory: Cable. Price: 850৳925৳.
",150,814580,814730
5904,sentence,"Subcategory: Cable. Price: 850৳925৳.

Product: Belkin F3Y021bt1M HDMI Male to HDMI Male Cable. Category: HDMI Cable. Subcategory: Cable. Price: 880৳950৳.
",154,814693,814847
5905,sentence,"Subcategory: Cable. Price: 880৳950৳.

Product: Riversong CT56 Alpha 03 Premium Nylon Braided Fast Charging Type-C Cable. Category: Type-C Cable. Subcategory: Cable. Price: 199৳.
",178,814810,814988
5906,sentence,"Subcategory: Cable. Price: 199৳.

Product: CHARG C3C 1 Meter USB to Type C Cable. Category: Type-C Cable. Subcategory: Cable. Price: 200৳.

Product: Awei CL-115T USB to Type-C Fast Charging Cable. ",197,814955,815152
5907,sentence,"Category: Type-C Cable. Subcategory: Cable. Price: 149৳300৳.

Product: Vention TRCSF 1M Type-C to Type-C Cable. Category: Type-C Cable. Subcategory: Cable. Price: 300৳.
",169,815152,815321
5908,sentence,"Subcategory: Cable. Price: 300৳.

Product: Vention TRDWF 1M Type-C to Type-C Cable. Category: Type-C Cable. Subcategory: Cable. Price: 300৳.
",141,815288,815429
5909,sentence,"Subcategory: Cable. Price: 300৳.

Product: Wiwu Titan Link Series Wi-C054 1 Meter USB A to Type C Cable. Category: Type-C Cable. Subcategory: Cable. Price: 350৳.
",162,815396,815558
5910,sentence,"Subcategory: Cable. Price: 350৳.

Product: WiWU Titan Link Series Wi-C057 1.2 Meter Type-C Cable. Category: Type-C Cable. Subcategory: Cable. Price: 350৳.
",155,815525,815680
5911,sentence,"Subcategory: Cable. Price: 350৳.

Product: Vention TRCSH 2M Type-C to Type-C Cable. Category: Type-C Cable. Subcategory: Cable. Price: 350৳.
",141,815647,815788
5912,sentence,"Subcategory: Cable. Price: 350৳.

Product: Yuanxin YDP-002 Mini DisplayPort Male to Male 1.8 Meter Cable. Category: DisplayPort Cable. Subcategory: Cable. Price: 490৳650৳.
",172,815755,815927
5913,sentence,"Subcategory: Cable. Price: 490৳650৳.

Product: Yuanxin YDH-001 Mini DisplayPort Male to HDMI Male 1.8 Meter Cable. Category: DisplayPort Cable. Subcategory: Cable. Price: 590৳650৳.
",181,815890,816071
5914,sentence,"Subcategory: Cable. Price: 590৳650৳.

Product: Vention HAABG 1.5 Meter Mini DisplayPort to DisplayPort Cable. Category: DisplayPort Cable. Subcategory: Cable. Price: 660৳.
",172,816034,816206
5915,sentence,"Subcategory: Cable. Price: 660৳.

Product: Dtech DT-CU0308 1.8M DP To DP Cable. Category: DisplayPort Cable. Subcategory: Cable. Price: 550৳.

Product: Dtech DT-CU0308 3M DP To DP Cable. ",187,816173,816360
5916,sentence,"
Product: Dtech DT-CU0308 3M DP To DP Cable. Category: DisplayPort Cable. Subcategory: Cable. Price: 690৳.

Product: Yuanxin YDH-002 DisplayPort Male to HDMI Male 1.8 Meter Cable. ",180,816315,816495
5917,sentence,"Category: DisplayPort Cable. Subcategory: Cable. Price: 740৳800৳.

Product: Yuanxin YDP-003 3 Meter DisplayPort Cable. Category: DisplayPort Cable. Subcategory: Cable. Price: 800৳.
",181,816495,816676
5918,sentence,"Subcategory: Cable. Price: 800৳.

Product: Yuanxin YDP-001 DisplayPort Male to Male 1.8 Meter Cable. Category: DisplayPort Cable. Subcategory: Cable. Price: 600৳890৳.
",167,816643,816810
5919,sentence,"Subcategory: Cable. Price: 600৳890৳.

Product: Yuanxin YDP-003 Mini DisplayPort Male to DisplayPort Male 1.8 Meter Cable. Category: DisplayPort Cable. Subcategory: Cable. Price: 790৳890৳.
",188,816773,816961
5920,sentence,"Subcategory: Cable. Price: 790৳890৳.

Product: Vention HCDBI 3 Meter 8K DisplayPort 1.4 Cable. Category: DisplayPort Cable. Subcategory: Cable. Price: 800৳900৳.
",161,816924,817085
5921,sentence,"Subcategory: Cable. Price: 800৳900৳.

Product: Yuanxin X-3214 DisplayPort Male to USB Type-C Male 1.8 Meter Cable. Category: DisplayPort Cable. Subcategory: Cable. Price: 950৳1,050৳.
",183,817048,817231
5922,sentence,"Subcategory: Cable. Price: 950৳1,050৳.

Product: UGREEN DP103 2 Meter DP to DVI Cable #10221. Category: DisplayPort Cable. Subcategory: Cable. Price: 990৳1,200৳.
",162,817192,817354
5923,sentence,"Subcategory: Cable. Price: 990৳1,200৳.

Product: UGREEN DP101 5 Meter DisplayPort to HDMI Cable #10204. Category: DisplayPort Cable. Subcategory: Cable. Price: 1,550৳.
",168,817315,817483
5924,sentence,"Subcategory: Cable. Price: 1,550৳.

Product: Vention HCELI 3 Meter 8K Male to Male DisplayPort Cable. Category: DisplayPort Cable. Subcategory: Cable. Price: 1,330৳1,600৳.
",172,817448,817620
5925,sentence,"Subcategory: Cable. Price: 1,330৳1,600৳.

Product: Ugreen DP119 3 Meter 4K DisplayPort To HDMI Cable #25491. Category: DisplayPort Cable. Subcategory: Cable. Price: 1,800৳.
",173,817579,817752
5926,sentence,"Subcategory: Cable. Price: 1,800৳.

Product: UGREEN MM139 USB Type-C to DP Cable #50994. Category: DisplayPort Cable. Subcategory: Cable. Price: 1,690৳1,860৳.
",159,817717,817876
5927,sentence,"Subcategory: Cable. Price: 1,690৳1,860৳.

Product: Ugreen DP114 1.5 Meter DisplayPort Cable #80391. Category: DisplayPort Cable. Subcategory: Cable. Price: Out Of Stock.
",170,817835,818005
5928,sentence,"Subcategory: Cable. Price: Out Of Stock.

Product: Vention HCELG 1.5M 8K Male to Male DisplayPort Cable. Category: DisplayPort Cable. Subcategory: Cable. Price: Out Of Stock.
",175,817964,818139
5929,sentence,"Subcategory: Cable. Price: Out Of Stock.

Product: Vention HBLBG DP to VGA Cable 1.5M. Category: DisplayPort Cable. Subcategory: Cable. Price: Out Of Stock.
",157,818098,818255
5930,sentence,"Subcategory: Cable. Price: Out Of Stock.

Product: Awei CL-115L 1 Meter USB to Lightning 2.4A Fast Charging Cable. Category: Lightning Cable. Subcategory: Cable. Price: 149৳250৳.
",179,818214,818393
5931,sentence,"Subcategory: Cable. Price: 149৳250৳.

Product: Yuanxin X-KC802 USB Male to Lightning Male 1 Meter Data & Charging Cable. Category: Lightning Cable. Subcategory: Cable. Price: 275৳350৳.
",185,818356,818541
5932,sentence,"Subcategory: Cable. Price: 275৳350৳.

Product: Foneng XS02 1.2M 60W & PD 27W Type-C Cable. Category: Lightning Cable. Subcategory: Cable. Price: 399৳449৳.
",155,818504,818659
5933,sentence,"Subcategory: Cable. Price: 399৳449৳.

Product: Baseus Rapid Series 3-in-1 Micro+Dual Lightning 3A Cable 1.2 Meter. Category: Lightning Cable. Subcategory: Cable. Price: 389৳450৳.
",179,818622,818801
5934,sentence,"Subcategory: Cable. Price: 389৳450৳.

Product: Hoco U125 Benefit USB-A to Lightning 12W Data Cable With Display. Category: Lightning Cable. Subcategory: Cable. Price: 450৳.
",173,818764,818937
5935,sentence,"Subcategory: Cable. Price: 450৳.

Product: Awei CL-206L USB to Lightning Fast Charging Cable. Category: Lightning Cable. Subcategory: Cable. Price: 350৳450৳.
",158,818904,819062
5936,sentence,"Subcategory: Cable. Price: 350৳450৳.

Product: Yison Celebrat CB-22 A-L 1.2 Meter USB to Lightning Cable. Category: Lightning Cable. Subcategory: Cable. Price: 429৳469৳.
",170,819025,819195
5937,sentence,"Subcategory: Cable. Price: 429৳469৳.

Product: Yuanxin X-KC805 USB Type-C Male to Lightning Male Data & Charging Cable. Category: Lightning Cable. Subcategory: Cable. Price: 450৳500৳.
",184,819158,819342
5938,sentence,"Subcategory: Cable. Price: 450৳500৳.

Product: Vyvylabs VCSCL-02 Fast Charging Type-C to Lightning Cable. Category: Lightning Cable. Subcategory: Cable. Price: 470৳508৳.
",170,819305,819475
5939,sentence,"Subcategory: Cable. Price: 470৳508৳.

Product: ZOOOK Fastlink i Lightning Rapid Charge & Sync Cable. Category: Lightning Cable. Subcategory: Cable. Price: 390৳550৳.
",165,819438,819603
5940,sentence,"Subcategory: Cable. Price: 390৳550৳.

Product: Foneng X92 60W 4-in-1 Fast Charging Cable. Category: Lightning Cable. Subcategory: Cable. Price: 499৳599৳.
",154,819566,819720
5941,sentence,"Subcategory: Cable. Price: 499৳599৳.

Product: Vention H16BF 1M Type-C to Lightning Cable. Category: Lightning Cable. Subcategory: Cable. Price: 550৳600৳.
",155,819683,819838
5942,sentence,"Subcategory: Cable. Price: 550৳600৳.

Product: Vention H17BAV 1.2M 2-in-1 Type-C to Lightning Cable. Category: Lightning Cable. Subcategory: Cable. Price: 550৳600৳.
",165,819801,819966
5943,sentence,"Subcategory: Cable. Price: 550৳600৳.

Product: Riversong C58 Infinity 05 3 in 1 Data Cable. Category: Lightning Cable. Subcategory: Cable. Price: 390৳639৳.
",156,819929,820085
5944,sentence,"Subcategory: Cable. Price: 390৳639৳.

Product: ZOOOK MagicLight i USB A to Lightning Smart LED Fast Charging Cable. Category: Lightning Cable. Subcategory: Cable. Price: 590৳700৳.
",180,820048,820228
5945,sentence,"Subcategory: Cable. Price: 590৳700৳.

Product: Foneng X80 100W 3-in-1 USB Fast Charging Cable. Category: Lightning Cable. Subcategory: Cable. Price: 699৳749৳.
",159,820191,820350
5946,sentence,"Subcategory: Cable. Price: 699৳749৳.

Product: VENTION AIOB0 HDMI 90 Degree Male to Female Adapter. Category: Converter. Subcategory: Accessories. Price: 120৳180৳.
",164,820313,820477
5947,sentence,"Subcategory: Accessories. Price: 120৳180৳.

Product: Hoco UA17 Type-C Male to USB 3.0 Female Adapter. Category: Converter. Subcategory: Accessories. Price: 240৳.
",162,820434,820596
5948,sentence,"Subcategory: Accessories. Price: 240৳.

Product: UGREEN Mini HDMI Male to HDMI Female Adapter. Category: Converter. Subcategory: Accessories. Price: 250৳.
",155,820557,820712
5949,sentence,"Subcategory: Accessories. Price: 250৳.

Product: UGREEN US157 USB Type-C to Micro USB Adapter #30391. Category: Converter. Subcategory: Accessories. Price: 190৳250৳.
",166,820673,820839
5950,sentence,"Subcategory: Accessories. Price: 190৳250৳.

Product: VENTION AIRB0 HDMI Female to Female Coupler Adapter. Category: Converter. Subcategory: Accessories. Price: 180৳250৳.
",170,820796,820966
5951,sentence,"Subcategory: Accessories. Price: 180৳250৳.

Product: UGREEN HD112 HDMI Male to Female Down HDMI Converter #20109. Category: Converter. Subcategory: Accessories. Price: 220৳250৳.
",178,820923,821101
5952,sentence,"Subcategory: Accessories. Price: 220৳250৳.

Product: UGREEN HD112 HDMI Male to Female UP HDMI Converter #20110. Category: Converter. Subcategory: Accessories. Price: 300৳.
",172,821058,821230
5953,sentence,"Subcategory: Accessories. Price: 300৳.

Product: VENTION BDBW0 3.5mm Male to Dual Female Audio Converter. Category: Converter. Subcategory: Accessories. Price: 250৳300৳.
",170,821191,821361
5954,sentence,"Subcategory: Accessories. Price: 250৳300৳.

Product: Ugreen HD159 8K Female to Female HDMI Converter #90592. Category: Converter. Subcategory: Accessories. Price: 300৳.
",169,821318,821487
5955,sentence,"Subcategory: Accessories. Price: 300৳.

Product: Vention AGFB0 2-in-1 Micro & Mini HDMI Male to HDMI Female Converter. Category: Converter. Subcategory: Accessories. Price: 280৳325৳.
",183,821448,821631
5956,sentence,"Subcategory: Accessories. Price: 280৳325৳.

Product: UGREEN US282 Type-C Female to Micro USB Male Adapter #50590. Category: Converter. Subcategory: Accessories. Price: 329৳.
",174,821588,821762
5957,sentence,"Subcategory: Accessories. Price: 329৳.

Product: UGREEN US154 Type-C To USB Female Cable #30701. Category: Converter. Subcategory: Accessories. Price: 350৳.
",157,821723,821880
5958,sentence,"Subcategory: Accessories. Price: 350৳.

Product: UGREEN US381 Female to Female USB 3.0 Converter #20119. Category: Converter. Subcategory: Accessories. Price: 350৳.
",165,821841,822006
5959,sentence,"Subcategory: Accessories. Price: 350৳.

Product: WiWU Wi-C052 A-C USB to Type-C PD Fast Charging Converter. Category: Converter. Subcategory: Accessories. Price: 350৳.
",168,821967,822135
5960,sentence,"Subcategory: Accessories. Price: 350৳.

Product: WiWU Wi-C052 C-L Type-C to Lightning PD Fast Charging Converter. Category: Converter. Subcategory: Accessories. Price: 350৳.
",174,822096,822270
5961,sentence,"Subcategory: Accessories. Price: 350৳.

Product: VENTION CDIB0 OTG Adapter For Android. Category: Converter. Subcategory: Accessories. Price: 325৳380৳.
",152,822231,822383
5962,sentence,"Subcategory: Accessories. Price: 325৳380৳.

Product: UGREEN 30453 Micro USB+ USB-C to USB 3.0 Adapter. Category: Converter. Subcategory: Accessories. Price: 450৳.
",163,822340,822503
5963,sentence,"Subcategory: Accessories. Price: 450৳.

Product: Yuanxin YDX-001 DVI Male to Male 1.5 Meter Cable. Category: DVI Cable. Subcategory: Cable. Price: 500৳550৳.
",157,822464,822621
5964,sentence,"Subcategory: Cable. Price: 500৳550৳.

Product: Yuanxin YDX-015 DVI Male to Male 3 Meter Cable. Category: DVI Cable. Subcategory: Cable. Price: 700৳.
",149,822584,822733
5965,sentence,"Subcategory: Cable. Price: 700৳.

Product: Vention COQBG USB 2.0 Type-A To Type-B Printer Cable 1.5M. Category: Printer Cable. Subcategory: Cable. Price: 299৳.
",160,822700,822860
5966,sentence,"Subcategory: Cable. Price: 299৳.

Product: Yuanxin YUX-002 USB Type-A Male to Type-B Male 3 Meter Printer Cable. Category: Printer Cable. Subcategory: Cable. Price: 350৳390৳.
",175,822827,823002
5967,sentence,"Subcategory: Cable. Price: 350৳390৳.

Product: Vention COQBJ 5M USB 2.0 Type-A To Type-B Printer Cable. Category: Printer Cable. Subcategory: Cable. Price: 400৳.
",162,822965,823127
5968,sentence,"Subcategory: Cable. Price: 400৳.

Product: Vention COOBG USB 3.0 Type-A To Type-B Printer Cable 1.5M. Category: Printer Cable. Subcategory: Cable. Price: 390৳440৳.
",164,823094,823258
5969,sentence,"Subcategory: Cable. Price: 390৳440৳.

Product: Yuanxin YUX-002 USB Type-A Male to Type-B Male 1.5 Meter Printer Cable. Category: Printer Cable. Subcategory: Cable. Price: 200৳450৳.
",181,823221,823402
5970,sentence,"Subcategory: Cable. Price: 200৳450৳.

Product: Yuanxin YUX-008 USB Type-A Male to Type-B Male Printer Cable. Category: Printer Cable. Subcategory: Cable. Price: 315৳450৳.
",171,823365,823536
5971,sentence,"Subcategory: Cable. Price: 315৳450৳.

Product: Vention VAS-A16-B500 Flat USB2.0 A Male to B Male 5M Print Cable. Category: Printer Cable. Subcategory: Cable. Price: 440৳499৳.
",175,823499,823674
5972,sentence,"Subcategory: Cable. Price: 440৳499৳.

Product: Ugreen US135 USB Type-B Male & USB 2.0 Male Printer Cable #10350. Category: Printer Cable. Subcategory: Cable. Price: 300৳500৳.
",175,823637,823812
5973,sentence,"Subcategory: Cable. Price: 300৳500৳.

Product: Yuanxin YUX-012 5 Meter USB Type-A Male to Type-B Male Printer Cable. Category: Printer Cable. Subcategory: Cable. Price: 600৳700৳.
",179,823775,823954
5974,sentence,"Subcategory: Cable. Price: 600৳700৳.

Product: Yuanxin YXB-13 1.5 Meter USB Male To Parallel Female Printer Cable. Category: Printer Cable. Subcategory: Cable. Price: 770৳900৳.
",177,823917,824094
5975,sentence,"Subcategory: Cable. Price: 770৳900৳.

Product: Yuanxin YUX-025 10 Meter USB Type-A Male to Type-B Male Printer Cable. Category: Printer Cable. Subcategory: Cable. Price: 850৳1,000৳.
",182,824057,824239
5976,sentence,"Subcategory: Cable. Price: 850৳1,000৳.

Product: UGREEN US122 15 Meter Type-A Male to Type-B Male Printer Cable #10362. Category: Printer Cable. Subcategory: Cable. Price: 1,800৳2,100৳.
",186,824200,824386
5977,sentence,"Subcategory: Cable. Price: 1,800৳2,100৳.

Product: Vention VAS-A16-B150 1.5M USB Type-A to USB Type-B Printer Cable. Category: Printer Cable. Subcategory: Cable. Price: Out Of Stock.
",183,824345,824528
5978,sentence,"Subcategory: Cable. Price: Out Of Stock.

Product: Vention COQBI USB 2.0 Type-A To Type-B Printer Cable 3M. Category: Printer Cable. Subcategory: Cable. Price: Out Of Stock.
",174,824487,824661
5979,sentence,"Subcategory: Cable. Price: Out Of Stock.

Product: UGREEN US241 1.5M Type-C Male to Type-B Male Printer Cable #40417. Category: Printer Cable. Subcategory: Cable. Price: Out Of Stock.
",184,824620,824804
5980,sentence,"Subcategory: Cable. Price: Out Of Stock.

Product: Vention COOBI USB 3.0 Type-A To Type-B Printer Cable 3M. Category: Printer Cable. Subcategory: Cable. Price: Out Of Stock.
",174,824763,824937
5981,sentence,"Subcategory: Cable. Price: Out Of Stock.

Product: VENTION KAABH 2 Meter Cable Tie. Category: Cable Organizer. Subcategory: Cable. Price: 190৳.
",144,824896,825040
5982,sentence,"Subcategory: Cable. Price: 190৳.

Product: UGREEN LP121 25mm 3M Mask Cable Organizer #30819. Category: Cable Organizer. Subcategory: Cable. Price: 450৳.
",153,825007,825160
5983,sentence,"Subcategory: Cable. Price: 450৳.

Product: UGREEN LP114 Cable Organizer 2 Pack #30762. Category: Cable Organizer. Subcategory: Cable. Price: 390৳499৳.
",151,825127,825278
5984,sentence,"Subcategory: Cable. Price: 390৳499৳.

Product: UGREEN LP121 25mm 5m Mask Cable Organizer #30820. Category: Cable Organizer. Subcategory: Cable. Price: 576৳.
",157,825241,825398
5985,sentence,"Subcategory: Cable. Price: 576৳.

Product: UGREEN 30398 Universal Cable Management Box White L Size. Category: Cable Organizer. Subcategory: Cable. Price: 2,250৳.

Product: Cable Management Tray. ",196,825365,825561
5986,sentence,"Price: 2,250৳.

Product: Cable Management Tray. Category: Cable Organizer. Subcategory: Cable. Price: Up Coming.

Product: UGREEN Data Cable Tail Protection Sleeve 10pcs/bag #40705. ",182,825513,825695
5987,sentence,"Category: Cable Organizer. Subcategory: Cable. Price: Out Of Stock.

Product: UGREEN LP127 Charging Cable Protector #40705. Category: Cable Organizer. Subcategory: Cable. Price: Out Of Stock.
",192,825695,825887
5988,sentence,"Subcategory: Cable. Price: Out Of Stock.

Product: Orico CBT-1S 1M Reusable & Dividable Hook and Loop Cable Ties. Category: Cable Organizer. Subcategory: Cable. Price: Out Of Stock.
",182,825846,826028
5989,sentence,"Subcategory: Cable. Price: Out Of Stock.

Product: VENTION KAABJ 5 Meter Cable Tie. Category: Cable Organizer. Subcategory: Cable. Price: Out Of Stock.
",152,825987,826139
5990,sentence,"Subcategory: Cable. Price: Out Of Stock.

Product: Orico CBT-5S 1M Reusable & Dividable Hook and Loop Cable Ties. Category: Cable Organizer. Subcategory: Cable. Price: Out Of Stock.
",182,826098,826280
5991,sentence,"Subcategory: Cable. Price: Out Of Stock.

Product: Yuanxin YHV-011 HDMI Male to VGA Female Converter. Category: HDMI Converter. Subcategory: Converter. Price: 490৳.
",165,826239,826404
5992,sentence,"Subcategory: Converter. Price: 490৳.

Product: Yuanxin YHV-010 HDMI Male to VGA Female Converter with Audio. Category: HDMI Converter. Subcategory: Converter. Price: 450৳520৳.
",176,826367,826543
5993,sentence,"Subcategory: Converter. Price: 450৳520৳.

Product: Yuanxin YHV-012 HDMI Male to VGA Female Converter with Audio. Category: HDMI Converter. Subcategory: Converter. Price: 550৳600৳.
",180,826502,826682
5994,sentence,"Subcategory: Converter. Price: 550৳600৳.

Product: Ugreen HDMI to VGA Converter 40253. Category: HDMI Converter. Subcategory: Converter. Price: 750৳.
",150,826641,826791
5995,sentence,"Subcategory: Converter. Price: 750৳.

Product: VENTION ACPBB HDMI to VGA 0.15M Converter. Category: HDMI Converter. Subcategory: Converter. Price: 650৳750৳.
",157,826754,826911
5996,sentence,"Subcategory: Converter. Price: 650৳750৳.

Product: VENTION 42154 HDMI to VGA 0.15M Converter. Category: HDMI Converter. Subcategory: Converter. Price: 700৳850৳.
",161,826870,827031
5997,sentence,"Subcategory: Converter. Price: 700৳850৳.

Product: Orico DHTV-C20 HDMI A to VGA Adapter. Category: HDMI Converter. Subcategory: Converter. Price: 1,100৳.
",154,826990,827144
5998,sentence,"Subcategory: Converter. Price: 1,100৳.

Product: Ugreen CM513 VGA to HDMI Converter # 50945. Category: HDMI Converter. Subcategory: Converter. Price: 1,100৳1,200৳.
",164,827105,827269
5999,sentence,"Subcategory: Converter. Price: 1,100৳1,200৳.

Product: Vention AKOB0 2-Port HDMI Bi-Direction 4K Switcher. Category: HDMI Converter. Subcategory: Converter. Price: 1,190৳1,299৳.
",178,827224,827402
6000,sentence,"Subcategory: Converter. Price: 1,190৳1,299৳.

Product: VENTION CREBC Cotton Braided Type-C to HDMI Converter. Category: HDMI Converter. Subcategory: Converter. Price: 1,150৳1,340৳.
",181,827357,827538
6001,sentence,"Subcategory: Converter. Price: 1,150৳1,340৳.

Product: VENTION AFUH0 2-Port HDMI Bi-Direction Switcher. Category: HDMI Converter. Subcategory: Converter. Price: 1,150৳1,400৳.
",175,827493,827668
6002,sentence,"Subcategory: Converter. Price: 1,150৳1,400৳.

Product: Ugreen CM429 Female to Female HDMI Extension Adapter #10943. Category: HDMI Converter. Subcategory: Converter. Price: 1,440৳.
",181,827623,827804
6003,sentence,"Subcategory: Converter. Price: 1,440৳.

Product: Ugreen MM137 DisplayPort to HDMI Converter #70694. Category: HDMI Converter. Subcategory: Converter. Price: 1,440৳.
",165,827765,827930
6004,sentence,"Subcategory: Converter. Price: 1,440৳.

Product: Ugreen US320 Type-C to HDMI Adapter #70450. Category: HDMI Converter. Subcategory: Converter. Price: 1,590৳1,740৳.
",164,827891,828055
6005,sentence,"Subcategory: Converter. Price: 1,590৳1,740৳.

Product: Vention AFVHB HDMI to HDMI and VGA Converter. Category: HDMI Converter. Subcategory: Converter. Price: 2,000৳.
",166,828010,828176
6006,sentence,"Subcategory: Converter. Price: 2,000৳.

Product: Boya BY-EA2L USB Sound Adapter. Category: Audio Converter. Subcategory: Converter. Price: 480৳580৳.
",149,828137,828286
6007,sentence,"Subcategory: Converter. Price: 480৳580৳.

Product: Ugreen CM383 3.5mm Female to USB Male Audio Converter #80864. Category: Audio Converter. Subcategory: Converter. Price: 900৳.
",177,828245,828422
6008,sentence,"Subcategory: Converter. Price: 900৳.

Product: BOYA 35C-XLR Pro Mini-Jack to XLR Adapter with Power Converter. Category: Audio Converter. Subcategory: Converter. Price: 1,200৳1,300৳.
",183,828385,828568
6009,sentence,"Subcategory: Converter. Price: 1,200৳1,300৳.

Product: Apple Lightning to 3.5mm Headphone Jack Adapter #MMX62ZM/A. Category: Audio Converter. Subcategory: Converter. Price: 1,400৳1,750৳.
",187,828523,828710
6010,sentence,"Subcategory: Converter. Price: 1,400৳1,750৳.

Product: VENTION CDRBB USB 2.0 External Stereo Sound Adapter with Volume Control. Category: Audio Converter. Subcategory: Converter. ",179,828665,828844
6011,sentence,"Subcategory: Converter. Price: 1,290৳1,500৳.

Product: Ugreen US212 3.5mm to Lightning Audio Converter #30759. Category: Audio Converter. Subcategory: Converter. Price: 1,350৳1,500৳.
",183,828820,829003
6012,sentence,"Subcategory: Converter. Price: 1,350৳1,500৳.

Product: BOYA BY-K3 TRS to Male Lightning Adapter. Category: Audio Converter. Subcategory: Converter. Price: 1,390৳1,650৳.
",169,828958,829127
6013,sentence,"Subcategory: Converter. Price: 1,390৳1,650৳.

Product: UGREEN AV161 USB Type-C to 3.5mm Cable #80154. Category: Audio Converter. Subcategory: Converter. Price: 1,300৳1,650৳.
",174,829082,829256
6014,sentence,"Subcategory: Converter. Price: 1,300৳1,650৳.

Product: GoPro Pro 3.5mm Mic Adapter For Hero10/9/8/7/6/5. Category: Audio Converter. Subcategory: Converter. Price: 7,400৳.
",171,829211,829382
6015,sentence,"Subcategory: Converter. Price: 7,400৳.

Product: Vention VAB-S01-L 3.5mm Female to 6.5mm Male Audio Converter. Category: Audio Converter. Subcategory: Converter. Price: Out Of Stock.
",183,829343,829526
6016,sentence,"Subcategory: Converter. Price: Out Of Stock.

Product: Oraimo OAA-310 Type C to 3.5mm  Audio Converter. Category: Audio Converter. Subcategory: Converter. Price: Out Of Stock.
",176,829481,829657
6017,sentence,"Subcategory: Converter. Price: Out Of Stock.

Product: QGeeM QG-UA15 Type-C Male to 3.5mm Female Converter. Category: Audio Converter. Subcategory: Converter. Price: Out Of Stock.
",180,829612,829792
6018,sentence,"Subcategory: Converter. Price: Out Of Stock.

Product: VENTION BGWH0 Type-C Male to 3.5mm Female Audio Adapter. Category: Audio Converter. Subcategory: Converter. Price: Out Of Stock.
",184,829747,829931
6019,sentence,"Subcategory: Converter. Price: Out Of Stock.

Product: UGREEN AV142 USB Type-C to 3.5mm Female Cable Converter 10CM #30632. Category: Audio Converter. Subcategory: Converter. Price: Out Of Stock.
",196,829886,830082
6020,sentence,"Subcategory: Converter. Price: Out Of Stock.

Product: VENTION BDAW0 3.5mm Male to 2x3.5mm Female Audio Splitter. Category: Audio Converter. Subcategory: Converter. Price: Out Of Stock.
",186,830037,830223
6021,sentence,"Subcategory: Converter. Price: Out Of Stock.

Product: Hoco LS31 Adapter Dual Lightning Audio Converter. Category: Audio Converter. Subcategory: Converter. Price: Out Of Stock.
",177,830178,830355
6022,sentence,"Subcategory: Converter. Price: Out Of Stock.

Product: Baseus L54 Type-C Male to 3.5mm Female Adapter. Category: Audio Converter. Subcategory: Converter. Price: Out Of Stock.
",175,830310,830485
6023,sentence,"Subcategory: Converter. Price: Out Of Stock.

Product: Yuanxin X-3562 USB Male to LAN Female Converter. Category: USB Converter. Subcategory: Converter. Price: 980৳1,050৳.
",172,830440,830612
6024,sentence,"Subcategory: Converter. Price: 980৳1,050৳.

Product: Yuanxin X-3519 USB Male to Lan Female Converter. Category: USB Converter. Subcategory: Converter. Price: 1,100৳1,150৳.
",172,830569,830741
6025,sentence,"Subcategory: Converter. Price: 1,100৳1,150৳.

Product: Yuanxin X-3518 USB Male to Lan Female Converter. Category: USB Converter. Subcategory: Converter. Price: 1,160৳1,250৳.
",174,830696,830870
6026,sentence,"Subcategory: Converter. Price: 1,160৳1,250৳.

Product: Cudy UE10C Type-C to RJ45 Gigabit LAN Converter. Category: USB Converter. Subcategory: Converter. Price: 1,450৳.
",168,830825,830993
6027,sentence,"Subcategory: Converter. Price: 1,450৳.

Product: Redragon ERIS GA-200 Keyboard and Mouse Converter. Category: USB Converter. Subcategory: Converter. Price: 1,600৳.
",164,830954,831118
6028,sentence,"Subcategory: Converter. Price: 1,600৳.

Product: Vention CEWHB USB 3.0 Gigabit Ethernet Adapter. Category: USB Converter. Subcategory: Converter. Price: 1,530৳1,700৳.
",167,831079,831246
6029,sentence,"Subcategory: Converter. Price: 1,530৳1,700৳.

Product: TRENDnet TU-S9 USB to Serial Converter. Category: USB Converter. Subcategory: Converter. Price: 2,000৳.
",159,831201,831360
6030,sentence,"Subcategory: Converter. Price: 2,000৳.

Product: Linksys USB3GIG USB 3.0 Gigabit Ethernet Adapter. Category: USB Converter. Subcategory: Converter. Price: Up Coming.
",166,831321,831487
6031,sentence,"Subcategory: Converter. Price: Up Coming.

Product: Cudy UE10A USB to RJ45 Gigabit LAN Converter. Category: USB Converter. Subcategory: Converter. Price: Up Coming.
",165,831445,831610
6032,sentence,"Subcategory: Converter. Price: Up Coming.

Product: UGREEN US280 USB Male to Type-C Female Converter #50568. Category: USB Converter. Subcategory: Converter. Price: Out Of Stock.
",179,831568,831747
6033,sentence,"Subcategory: Converter. Price: Out Of Stock.

Product: Vention CDWB0 USB 2.0 Male to USB-Type C Female Adapter. Category: USB Converter. Subcategory: Converter. Price: Out Of Stock.
",182,831702,831884
6034,sentence,"Subcategory: Converter. Price: Out Of Stock.

Product: UGREEN US701 USB Type-A to Type C Adapter #45275. Category: USB Converter. Subcategory: Converter. Price: Out Of Stock.
",175,831839,832014
6035,sentence,"Subcategory: Converter. Price: Out Of Stock.

Product: VENTION CCVBB Type-C to USB Type-A 0.15M OTG Cable. Category: USB Converter. Subcategory: Converter. Price: Out Of Stock.
",177,831969,832146
6036,sentence,"Subcategory: Converter. Price: Out Of Stock.

Product: Orico 20UTS 2.5 inch Hard Drive Adapter. Category: USB Converter. Subcategory: Converter. Price: Out Of Stock.
",166,832101,832267
6037,sentence,"Subcategory: Converter. Price: Out Of Stock.

Product: VENTION CDQH0 USB Type-C Male to USB 3.0 Female OTG Adapter. Category: Type-C Converter. Subcategory: Converter. Price: 290৳450৳.
",185,832222,832407
6038,sentence,"Subcategory: Converter. Price: 290৳450৳.

Product: Ugreen US382 Type-B Male to Type-C Female Converter #20120. Category: Type-C Converter. Subcategory: Converter. Price: 450৳.
",176,832366,832542
6039,sentence,"Subcategory: Converter. Price: 450৳.

Product: Hoco LS36 Type-C To 3.5mm Digital Audio Converter. Category: Type-C Converter. Subcategory: Converter. Price: 350৳450৳.
",167,832505,832672
6040,sentence,"Subcategory: Converter. Price: 350৳450৳.

Product: Hoco UA17 Lightning Male to Type A Female Adapter. Category: Type-C Converter. Subcategory: Converter. Price: 499৳.
",167,832631,832798
6041,sentence,"Subcategory: Converter. Price: 499৳.

Product: QGeeM QG-UH02-2 Type C to PD Charger and 3.5mm Audio adapter. Category: Type-C Converter. Subcategory: Converter. Price: 500৳.
",174,832761,832935
6042,sentence,"Subcategory: Converter. Price: 500৳.

Product: Yuanxin X-3212 Type-C Male to VGA Female Converter. Category: Type-C Converter. Subcategory: Converter. Price: 600৳700৳.
",168,832898,833066
6043,sentence,"Subcategory: Converter. Price: 600৳700৳.

Product: Hoco UA19 Easy flow 4K Type-C to HDMI Adapter Converter. Category: Type-C Converter. Subcategory: Converter. Price: 750৳.
",173,833025,833198
6044,sentence,"Subcategory: Converter. Price: 750৳.

Product: Yuanxin X-3130H Type-C Male to HDMI Female Converter. Category: Type-C Converter. Subcategory: Converter. Price: 850৳900৳.
",170,833161,833331
6045,sentence,"Subcategory: Converter. Price: 850৳900৳.

Product: ORICO AXCP-02 Type-C to 3.5mm & Charge Adapter Converter. Category: Type-C Converter. Subcategory: Converter. Price: 900৳.
",174,833290,833464
6046,sentence,"Subcategory: Converter. Price: 900৳.

Product: Yuanxin X-3215 Type-C Male to HDMI USB PD Female Converter. Category: Type-C Converter. Subcategory: Converter. Price: 850৳920৳.
",176,833427,833603
6047,sentence,"Subcategory: Converter. Price: 850৳920৳.

Product: Yuanxin X-3232 Type-C Male to Mini DisplayPort Male Converter. Category: Type-C Converter. Subcategory: Converter. Price: 950৳1,000৳.
",185,833562,833747
6048,sentence,"Subcategory: Converter. Price: 950৳1,000৳.

Product: UGREEN MM137 DisplayPort Male to HDMI Female Converter #40363. Category: Type-C Converter. Subcategory: Converter. Price: 950৳1,040৳.
",187,833704,833891
6049,sentence,"Subcategory: Converter. Price: 950৳1,040৳.

Product: UGREEN US372 1M USB Type-C Male to Female Extension Cable #30205. Category: Type-C Converter. Subcategory: Converter. Price: 1,050৳.
",186,833848,834034
6050,sentence,"Subcategory: Converter. Price: 1,050৳.

Product: Yuanxin X-3562T Type-C Male to Lan Female Converter. Category: Type-C Converter. Subcategory: Converter. Price: 1,099৳.
",169,833995,834164
6051,sentence,"Subcategory: Converter. Price: 1,099৳.

Product: Yuanxin YDP-010 Mini DisplayPort Male to HDMI Female Converter. Category: DisplayPort Converter. Subcategory: Converter. Price: 520৳.
",183,834125,834308
6052,sentence,"Subcategory: Converter. Price: 520৳.

Product: Yuanxin YDP-012 Mini DisplayPort Male to VGA Female Converter. Category: DisplayPort Converter. Subcategory: Converter. Price: 580৳.
",180,834271,834451
6053,sentence,"Subcategory: Converter. Price: 580৳.

Product: Yuanxin YDP-013 DisplayPort Male to VGA Female Converter. Category: DisplayPort Converter. Subcategory: Converter. Price: 600৳.
",175,834414,834589
6054,sentence,"Subcategory: Converter. Price: 600৳.

Product: Yuanxin YDP-011 Mini DisplayPort Male to DVI Female Converter. Category: DisplayPort Converter. Subcategory: Converter. Price: 490৳600৳.
",184,834552,834736
6055,sentence,"Subcategory: Converter. Price: 490৳600৳.

Product: Yuanxin YDP-014 DisplayPort Male to HDMI Female Converter. Category: DisplayPort Converter. Subcategory: Converter. Price: 450৳700৳.
",184,834695,834879
6056,sentence,"Subcategory: Converter. Price: 450৳700৳.

Product: Yuanxin YDP-015 DisplayPort Male to DVI Female Converter. Category: DisplayPort Converter. Subcategory: Converter. Price: 500৳750৳.
",183,834838,835021
6057,sentence,"Subcategory: Converter. Price: 500৳750৳.

Product: Vention HBFBB DP to VGA Adapter Converter. Category: DisplayPort Converter. Subcategory: Converter. Price: 1,030৳1,100৳.
",172,834980,835152
6058,sentence,"Subcategory: Converter. Price: 1,030৳1,100৳.

Product: Ugreen HDMI To VGA + HDMI + 3.5mm Converter #40744. Category: DisplayPort Converter. Subcategory: Converter. Price: 1,450৳.
",179,835107,835286
6059,sentence,"Subcategory: Converter. Price: 1,450৳.

Product: Belkin F2CD079BT Mini DisplayPort to HDMI Converter. Category: DisplayPort Converter. Subcategory: Converter. Price: 2,150৳2,400৳.
",180,835247,835427
6060,sentence,"Subcategory: Converter. Price: 2,150৳2,400৳.

Product: Ugreen CM449 USB-A to HDMI/VGAConverter #20518. Category: DisplayPort Converter. Subcategory: Converter. Price: 3,050৳3,700৳.
",181,835382,835563
6061,sentence,"Subcategory: Converter. Price: 3,050৳3,700৳.

Product: Dtech DT-6508 Mini Display Port To HDMI Adapter. Category: DisplayPort Converter. Subcategory: Converter. Price: Out Of Stock.
",182,835518,835700
6062,sentence,"Subcategory: Converter. Price: Out Of Stock.

Product: Vention HBOB0 DisplayPort Male to HDMI Female Adapter Converter. Category: DisplayPort Converter. Subcategory: Converter. Price: Out Of Stock.
",198,835655,835853
6063,sentence,"Subcategory: Converter. Price: Out Of Stock.

Product: Ugreen MD112 Mini DisplayPort to HDMI Converter #10461. Category: DisplayPort Converter. Subcategory: Converter. Price: Out Of Stock.
",189,835808,835997
6064,sentence,"Subcategory: Converter. Price: Out Of Stock.

Product: Ugreen DP109 DP Male to VGA Female Converter #20415. Category: DisplayPort Converter. Subcategory: Converter. Price: Out Of Stock.
",186,835952,836138
6065,sentence,"Subcategory: Converter. Price: Out Of Stock.

Product: Vention HBGBB DisplayPort Male to HDMI Female Converter. Category: DisplayPort Converter. Subcategory: Converter. Price: Out Of Stock.
",190,836093,836283
6066,sentence,"Subcategory: Converter. Price: Out Of Stock.

Product: FJGEAR FJ-2004 4 Port VGA Splitter. Category: VGA Converter. Subcategory: Converter. Price: 670৳850৳.
",157,836238,836395
6067,sentence,"Subcategory: Converter. Price: 670৳850৳.

Product: Yuanxin YVH-001 VGA Male to HDMI Female Converter with Audio. Category: VGA Converter. Subcategory: Converter. Price: 800৳1,000৳.
",181,836354,836535
6068,sentence,"Subcategory: Converter. Price: 800৳1,000৳.

Product: Vention ACNBB VGA to HDMI Converter with Female Micro USB and Audio Port. Category: VGA Converter. Subcategory: Converter. Price: 1,250৳1,450৳.
",197,836492,836689
6069,sentence,"Subcategory: Converter. Price: 1,250৳1,450৳.

Product: FJGEAR FJ-201AS 2 Port VGA Switch with Remote. Category: VGA Converter. Subcategory: Converter. Price: 3,250৳.
",166,836644,836810
6070,sentence,"Subcategory: Converter. Price: 3,250৳.

Product: FJGEAR FJ-2504A 250Mhz 1 to 4 Port VGA Splitter. Category: VGA Converter. Subcategory: Converter. Price: Out Of Stock.

Product: VGA SPLITTER 4 PORT. ",199,836771,836970
6071,sentence,"
Product: VGA SPLITTER 4 PORT. Category: VGA Converter. Subcategory: Converter. Price: Out Of Stock.

Product: Dtech DT-7254 1 to 4 Port VGA Splitter. Category: VGA Converter. ",176,836939,837115
6072,sentence,"Category: VGA Converter. Subcategory: Converter. Price: Out Of Stock.

Product: Ugreen MM102 HDMI Male to VGA Female Converter with Audio #40233. Category: VGA Converter. Subcategory: Converter. ",195,837090,837285
6073,sentence,"Subcategory: Converter. Price: Out Of Stock.

Product: Vention ACEB0 VGA Male to HDMI Female Converter. Category: VGA Converter. Subcategory: Converter. Price: Out Of Stock.
",174,837261,837435
6074,sentence,"Subcategory: Converter. Price: Out Of Stock.

Product: Yuanxin X-3220 DVI Male to VGA Female Converter. Category: DVI Converter. Subcategory: Converter. Price: 600৳690৳.
",170,837390,837560
6075,sentence,"Subcategory: Converter. Price: 600৳690৳.

Product: VENTION ECDB0 DVI Male to HDMI Female Converter. Category: DVI Converter. Subcategory: Converter. Price: Up Coming.
",167,837519,837686
6076,sentence,"Subcategory: Converter. Price: Up Coming.

Product: Vention AIKB0 HDMI Male to DVI (24+5) Female Converter Adapter. Category: DVI Converter. Subcategory: Converter. Price: Out Of Stock.
",186,837644,837830
6077,sentence,"Subcategory: Converter. Price: Out Of Stock.

Product: ORICO FL02 4 Port USB 2.0 HUB. Category: Hubs & Docks. Subcategory: Accessories. Price: 350৳.

Product: ORICO FL02 4 Port USB 2.0 HUB White. ",196,837785,837981
6078,sentence,"
Product: ORICO FL02 4 Port USB 2.0 HUB White. Category: Hubs & Docks. Subcategory: Accessories. Price: 350৳.

Product: Havit H18 4-Port USB 2.0 HUB. Category: Hubs & Docks. ",174,837934,838108
6079,sentence,"Category: Hubs & Docks. Subcategory: Accessories. Price: 380৳.

Product: Yuanxin X-2328 Multiport 4-in-1 USB Hub. Category: Hubs & Docks. Subcategory: Accessories. Price: 400৳.
",177,838084,838261
6080,sentence,"Subcategory: Accessories. Price: 400৳.

Product: Yuanxin YXH-55 Multiport 4-in-1 USB Hub. Category: Hubs & Docks. Subcategory: Accessories. Price: 380৳400৳.

Product: ORICO MINI-U32 3-in-1 USB Hub. ",198,838222,838420
6081,sentence,"
Product: ORICO MINI-U32 3-in-1 USB Hub. Category: Hubs & Docks. Subcategory: Accessories. Price: 450৳.

Product: HAVIT H91 4-PORT USB2.0 HUB. Category: Hubs & Docks. Subcategory: Accessories. ",193,838379,838572
6082,sentence,"Subcategory: Accessories. Price: 500৳.

Product: Yuanxin X-2328T Multiport 4-in-1 USB Type-C Hub. Category: Hubs & Docks. Subcategory: Accessories. Price: 440৳500৳.
",165,838546,838711
6083,sentence,"Subcategory: Accessories. Price: 440৳500৳.

Product: Orico W5P-U2-030-BK-BP 4 Port USB 2.0 Hub Black. Category: Hubs & Docks. Subcategory: Accessories. Price: 550৳.
",165,838668,838833
6084,sentence,"Subcategory: Accessories. Price: 550৳.

Product: ORICO AH-12F 4 Port USB 3.0 HUB. Category: Hubs & Docks. Subcategory: Accessories. Price: 550৳.
",145,838794,838939
6085,sentence,"Subcategory: Accessories. Price: 550৳.

Product: ORICO PAPW4A-U3 PW SERIES 4-PORT USB 3.0 HUB. Category: Hubs & Docks. Subcategory: Accessories. Price: 550৳.
",158,838900,839058
6086,sentence,"Subcategory: Accessories. Price: 550৳.

Product: Yuanxin YXH-52 Multiport 4-in-1 USB Hub. Category: Hubs & Docks. Subcategory: Accessories. Price: 500৳550৳.
",157,839019,839176
6087,sentence,"Subcategory: Accessories. Price: 500৳550৳.

Product: Havit H08 4-Port High-Speed USB 2.0 HUB. Category: Hubs & Docks. Subcategory: Accessories. Price: 600৳.
",157,839133,839290
6088,sentence,"Subcategory: Accessories. Price: 600৳.

Product: Yuanxin X-3328L USB Male to Tri USB 2.0 & USB 3.0 Female Hub. Category: Hubs & Docks. Subcategory: Accessories. Price: 600৳.
",174,839251,839425
6089,sentence,"Subcategory: Accessories. Price: 600৳.

Product: Orico AH-A13 USB A to USB 3.0 4 Port  Hub. Category: Hubs & Docks. Subcategory: Accessories. Price: 675৳.
",155,839386,839541
6090,sentence,"Subcategory: Accessories. Price: 675৳.

Product: Yuanxin YXH-56 USB & Type-C Male to Quad USB Female Hub. Category: Hubs & Docks. Subcategory: Accessories. Price: 600৳690৳.
",173,839502,839675
6091,sentence,"Subcategory: Accessories. Price: 600৳690৳.

Product: Havit H40 4-Port High-Speed USB Hub. Category: Hubs & Docks. Subcategory: Accessories. Price: 699৳.
",153,839632,839785
6092,sentence,"Subcategory: Accessories. Price: 699৳.

Product: Havit H94 4-Port High-Speed USB Hub. Category: Hubs & Docks. Subcategory: Accessories. Price: 700৳.
",149,839746,839895
6093,sentence,"Subcategory: Accessories. Price: 700৳.

Product: Hoco HB45 Spirit Single Mode Type-C 2.0 Card Reader. Category: Card Reader. Subcategory: Accessories. Price: 300৳.
",164,839856,840020
6094,sentence,"Subcategory: Accessories. Price: 300৳.

Product: Hoco HB45 Spirit 2-in-1 USB & Type-C 2.0 Card Reader. Category: Card Reader. Subcategory: Accessories. Price: 365৳450৳.
",169,839981,840150
6095,sentence,"Subcategory: Accessories. Price: 365৳450৳.

Product: Hoco HB45 Spirit USB Card Reader. Category: Card Reader. Subcategory: Accessories. Price: 437৳475৳.
",153,840107,840260
6096,sentence,"Subcategory: Accessories. Price: 437৳475৳.

Product: Hoco HB45 Spirit 2-in-1 USB & Type-C 3.0 Card Reader. Category: Card Reader. Subcategory: Accessories. Price: 430৳550৳.
",173,840217,840390
6097,sentence,"Subcategory: Accessories. Price: 430৳550৳.

Product: Transcend TS-RDF5R USB 3.1 Card Reader. Category: Card Reader. Subcategory: Accessories. Price: 875৳.
",155,840347,840502
6098,sentence,"Subcategory: Accessories. Price: 875৳.

Product: Transcend TS-RDF8K2 USB 3.1 Gen1 All-In-One Multi Memory Card Reader. Category: Card Reader. Subcategory: Accessories. Price: 1,565৳1,799৳.
",189,840463,840652
6099,sentence,"Subcategory: Accessories. Price: 1,565৳1,799৳.

Product: Transcend TS-RDC8K2 USB-3.1 Card Reader. Category: Card Reader. Subcategory: Accessories. Price: 1,656৳1,800৳.
",168,840605,840773
6100,sentence,"Subcategory: Accessories. Price: 1,656৳1,800৳.

Product: Transcend TS-RDF9K2 USB-3.1 Multi Memory Card Reader. Category: Card Reader. Subcategory: Accessories. Price: 1,758৳1,850৳.
",181,840726,840907
6101,sentence,"Subcategory: Accessories. Price: 1,758৳1,850৳.

Product: Transcend TS-RDP9K USB 2.0 OTG Card Reader. Category: Card Reader. Subcategory: Accessories. Price: Up Coming.
",168,840860,841028
6102,sentence,"Subcategory: Accessories. Price: Up Coming.

Product: Hoco HB20 Mindful 2-in-1 USB 2.0 Card Reader. Category: Card Reader. Subcategory: Accessories. Price: Out Of Stock.
",170,840984,841154
6103,sentence,"Subcategory: Accessories. Price: Out Of Stock.

Product: Hoco HB20 Mindful 2-in-1 USB 3.0 Card Reader. Category: Card Reader. Subcategory: Accessories. Price: Out Of Stock.
",173,841107,841280
6104,sentence,"Subcategory: Accessories. Price: Out Of Stock.

Product: Transcend TS-RDF5K USB 3.1 Card Reader. Category: Card Reader. Subcategory: Accessories. Price: Out Of Stock.
",167,841233,841400
6105,sentence,"Subcategory: Accessories. Price: Out Of Stock.

Product: Hoco HB39 2-in-1 USB & Type-C 3.0 Card Reader. Category: Card Reader. Subcategory: Accessories. Price: Out Of Stock.
",174,841353,841527
6106,sentence,"Subcategory: Accessories. Price: Out Of Stock.

Product: Ugreen CR125 3-in-1 Type-A Male to SD-TF Card Reader #30333. Category: Card Reader. Subcategory: Accessories. Price: Out Of Stock.
",188,841480,841668
6107,sentence,"Subcategory: Accessories. Price: Out Of Stock.

Product: ORICO CL4T-A3 4-in-1 USB Type-C Multifunction Card Reader. Category: Card Reader. Subcategory: Accessories. Price: Out Of Stock.
",186,841621,841807
6108,sentence,"Subcategory: Accessories. Price: Out Of Stock.

Product: Sony ICD-PX470 4GB Digital Voice Recorder. Category: Sony. Subcategory: Digital Voice Recorder. Price: 8,300৳9,000৳.
",174,841760,841934
6109,sentence,"Price: 8,300৳9,000৳.

Product: Sony UX570F 4GB Digital Voice Recorder. Category: Sony. Subcategory: Digital Voice Recorder. Price: 12,400৳15,500৳.

Product: Sony TX660 Digital Voice Recorder. ",192,841913,842105
6110,sentence,"
Product: Sony TX660 Digital Voice Recorder. Category: Sony. Subcategory: Digital Voice Recorder. Price: 14,500৳17,000৳.

Product: Sony PCM-A10 High-Resolution Portable Digital Voice Recorder. ",193,842060,842253
6111,sentence,"Category: Sony. Subcategory: Digital Voice Recorder. Price: 23,500৳27,000৳.

Product: Sony ICD-PX370 4GB Digital Voice Recorder. Category: Sony. Subcategory: Digital Voice Recorder. ",182,842253,842435
6112,sentence,"Subcategory: Digital Voice Recorder. Price: Out Of Stock.

Product: Sony ICD-PX240 4GB Digital Voice Recorder. Category: Sony. Subcategory: Digital Voice Recorder. Price: Out Of Stock.
",185,842398,842583
6113,sentence,"Price: Out Of Stock.

Product: Ugreen LP479 Wireless Presenter. Category: Presenter. Subcategory: Accessories. Price: 1,170৳.

Product: Rapoo XR100 Wireless Laser Presenter. Category: Presenter. ",195,842562,842757
6114,sentence,"Category: Presenter. Subcategory: Accessories. Price: 1,650৳.

Product: Baseus Orange Dot Red Laser Wireless Presenter. Category: Presenter. Subcategory: Accessories. Price: 1,860৳1,999৳.
",188,842736,842924
6115,sentence,"Subcategory: Accessories. Price: 1,860৳1,999৳.

Product: Rapoo XR200 Wireless Laser Presenter. Category: Presenter. Subcategory: Accessories. Price: 2,300৳.
",157,842877,843034
6116,sentence,"Subcategory: Accessories. Price: 2,300৳.

Product: Baseus Orange Dot Green Laser Wireless Presenter. Category: Presenter. Subcategory: Accessories. Price: 3,000৳.
",163,842993,843156
6117,sentence,"Subcategory: Accessories. Price: 3,000৳.

Product: Logitech R400 Wireless Presenter. Category: Presenter. Subcategory: Accessories. Price: 3,800৳4,200৳.
",153,843115,843268
6118,sentence,"Subcategory: Accessories. Price: 3,800৳4,200৳.

Product: Logitech R800 Wireless Professional Presenter. Category: Presenter. Subcategory: Accessories. Price: 9,500৳.
",166,843221,843387
6119,sentence,"Subcategory: Accessories. Price: 9,500৳.

Product: Logitech Spotlight Wireless Presenter (910-004863). Category: Presenter. Subcategory: Accessories. Price: 15,000৳.
",166,843346,843512
6120,sentence,"Subcategory: Accessories. Price: 15,000৳.

Product: Targus AMP16AP-53 Wireless Presenter with Laser Pointer. Category: Presenter. Subcategory: Accessories. Price: Up Coming.
",174,843470,843644
6121,sentence,"Subcategory: Accessories. Price: Up Coming.

Product: Targus AMP32 Dual Mode Presenter with Laser Pointer. Category: Presenter. Subcategory: Accessories. Price: Up Coming.
",172,843600,843772
6122,sentence,"Subcategory: Accessories. Price: Up Coming.

Product: TARGUS AMP17AP Wireless Presenter with Cursor Control (Black Rubberized). Category: Presenter. Subcategory: Accessories. Price: Out Of Stock.
",196,843728,843924
6123,sentence,"Subcategory: Accessories. Price: Out Of Stock.

Product: A4tech LP15 Wireless Laser Presenter. Category: Presenter. Subcategory: Accessories. Price: Out Of Stock.
",163,843877,844040
6124,sentence,"Subcategory: Accessories. Price: Out Of Stock.

Product: Micropack WPM-06 Black Pocket Wireless Red laser 100M Range Presenter. Category: Presenter. Subcategory: Accessories. Price: Out Of Stock.
",196,843993,844189
6125,sentence,"Subcategory: Accessories. Price: Out Of Stock.

Product: Targus AMP30GL-50 Wireless Presenter With Pointer (Black). Category: Presenter. Subcategory: Accessories. Price: Out Of Stock.
",184,844142,844326
6126,sentence,"Subcategory: Accessories. Price: Out Of Stock.

Product: Targus AMP16AP-60 Presenter with Laser Pointer (Black). Category: Presenter. Subcategory: Accessories. Price: Out Of Stock.
",181,844279,844460
6127,sentence,"Subcategory: Accessories. Price: Out Of Stock.

Product: Micropack WPM-03 Multimedia Wireless Red laser Presenter. Category: Presenter. Subcategory: Accessories. Price: Out Of Stock.
",183,844413,844596
6128,sentence,"Subcategory: Accessories. Price: Out Of Stock.

Product: PROLiNK PWP102G 2.4GHz Wireless Presenter with Air Mouse. Category: Presenter. Subcategory: Accessories. Price: Out Of Stock.
",183,844549,844732
6129,sentence,"Subcategory: Accessories. Price: Out Of Stock.

Product: PROLiNK PWP106G 2.4GHz Wireless Presenter with Green Laser. Category: Presenter. Subcategory: Accessories. Price: Out Of Stock.
",185,844685,844870
6130,sentence,"Subcategory: Accessories. Price: Out Of Stock.

Product: Targus AMP09 Wireless USB Presenter. Category: Presenter. Subcategory: Accessories. Price: Out Of Stock.
",162,844823,844985
6131,sentence,"Subcategory: Accessories. Price: Out Of Stock.

Product: Zoom H1 Essential 2-Track Handy Audio Recorder. Category: Digital Voice Recorder. Subcategory: Accessories. Price: 15,500৳20,000৳.
",188,844938,845126
6132,sentence,"Price: 15,500৳20,000৳.

Product: Zoom H2n Handy Recorder. Category: Digital Voice Recorder. Subcategory: Accessories. Price: 21,500৳23,500৳.
",141,845103,845244
6133,sentence,"Price: 21,500৳23,500৳.

Product: Zoom Q2N-4K Handy Video Recorder with X/Y Microphone. Category: Digital Voice Recorder. Subcategory: Accessories. Price: 27,700৳29,000৳.
",170,845221,845391
6134,sentence,"Price: 27,700৳29,000৳.

Product: Zoom H4n Pro 4-Track Portable Audio Recorder. Category: Digital Voice Recorder. Subcategory: Accessories. Price: 28,800৳31,000৳.
",162,845368,845530
6135,sentence,"Price: 28,800৳31,000৳.

Product: Zoom H5 4-Track Portable Recorder. Category: Digital Voice Recorder. Subcategory: Accessories. Price: 31,500৳32,000৳.

Product: Zoom H6 Handy Recorder. ",185,845507,845692
6136,sentence,"
Product: Zoom H6 Handy Recorder. Category: Digital Voice Recorder. Subcategory: Accessories. Price: 36,100৳39,500৳.

Product: Zoom H4 Essential 4-Track Handy Audio Recorder. ",175,845658,845833
6137,sentence,"Category: Digital Voice Recorder. Subcategory: Accessories. Price: 31,500৳40,000৳.

Product: Zoom H8 8-Input, 12-Track Portable Handy Recorder. Category: Digital Voice Recorder. ",178,845833,846011
6138,sentence,"Category: Digital Voice Recorder. Subcategory: Accessories. Price: 44,000৳.

Product: Zoom H6 Essential 6-Track Handy Audio Recorder. Category: Digital Voice Recorder. Subcategory: Accessories. ",194,845977,846171
6139,sentence,"Subcategory: Accessories. Price: 39,500৳45,000৳.

Product: ZOOM H1n Professional Audio Recorder. Category: Digital Voice Recorder. Subcategory: Accessories. Price: Out Of Stock.
",178,846145,846323
6140,sentence,"Subcategory: Accessories. Price: Out Of Stock.

Product: Boya BY-M1 Omnidirectional Lavalier Microphone (Original). Category: Microphone. Subcategory: Accessories. Price: 890৳1,150৳.
",183,846276,846459
6141,sentence,"Subcategory: Accessories. Price: 890৳1,150৳.

Product: Boya BY-MM1 Compact On Camera Video Microphone. Category: Microphone. Subcategory: Accessories. Price: 1,800৳2,050৳.
",172,846414,846586
6142,sentence,"Subcategory: Accessories. Price: 1,800৳2,050৳.

Product: Takstar CH-58 Microphone Clamp. Category: Microphone. Subcategory: Accessories. Price: 700৳750৳.
",154,846539,846693
6143,sentence,"Subcategory: Accessories. Price: 700৳750৳.

Product: Takstar W-10 Microphone Windscreen. Category: Microphone. Subcategory: Accessories. Price: 550৳900৳.
",154,846650,846804
6144,sentence,"Subcategory: Accessories. Price: 550৳900৳.

Product: Havit GK58B GAMENOTE RGB USB Microphone. Category: Microphone. Subcategory: Accessories. Price: 850৳950৳.
",159,846761,846920
6145,sentence,"Subcategory: Accessories. Price: 850৳950৳.

Product: Hoco L15 Lightning Lavalier Wireless Microphone For iPhone. Category: Microphone. Subcategory: Accessories. Price: 870৳1,050৳.
",180,846877,847057
6146,sentence,"Subcategory: Accessories. Price: 870৳1,050৳.

Product: Hoco L15 Type-C Crystal Lavalier Wireless Digital Microphone. Category: Microphone. Subcategory: Accessories. Price: 870৳1,050৳.
",184,847012,847196
6147,sentence,"Subcategory: Accessories. Price: 870৳1,050৳.

Product: Havit GK56B RGB USB Gaming Microphone. Category: Microphone. Subcategory: Accessories. Price: 900৳1,100৳.
",161,847151,847312
6148,sentence,"Subcategory: Accessories. Price: 900৳1,100৳.

Product: K&F Concept KF 10.010 M1 Lavalier Microphone. Category: Microphone. Subcategory: Accessories. Price: 1,100৳1,150৳.
",170,847267,847437
6149,sentence,"Subcategory: Accessories. Price: 1,100৳1,150৳.

Product: Xtrike Me XMC-03 Omnidirectional RGB Gaming Microphone. Category: Microphone. Subcategory: Accessories. Price: 1,250৳.
",176,847390,847566
6150,sentence,"Subcategory: Accessories. Price: 1,250৳.

Product: BOYA BY-M1S Universal Lavalier Microphone. Category: Microphone. Subcategory: Accessories. Price: 1,120৳1,300৳.
",163,847525,847688
6151,sentence,"Subcategory: Accessories. Price: 1,120৳1,300৳.

Product: Redragon GM93 Athan Wireless Lavalier Microphone. Category: Microphone. Subcategory: Accessories. Price: 1,150৳1,400৳.
",176,847641,847817
6152,sentence,"Subcategory: Accessories. Price: 1,150৳1,400৳.

Product: Onikuma M830 USB Gaming Microphone. Category: Microphone. Subcategory: Accessories. Price: 1,400৳.
",156,847770,847926
6153,sentence,"Subcategory: Accessories. Price: 1,400৳.

Product: Redragon GM99 STIX USB Microphone. Category: Microphone. Subcategory: Accessories. Price: 1,300৳1,500৳.
",155,847885,848040
6154,sentence,"Subcategory: Accessories. Price: 1,300৳1,500৳.

Product: Saramonic SmartMic Condenser Basic Microphone. Category: Microphone. Subcategory: Accessories. Price: 1,700৳1,750৳.
",173,847993,848166
6155,sentence,"Subcategory: Accessories. Price: 1,700৳1,750৳.

Product: Boya BY-M1DM Dual Omni Directional Lavalier Microphone. Category: Microphone. Subcategory: Accessories. Price: 1,640৳1,800৳.
",182,848119,848301
6156,sentence,"Subcategory: Accessories. Price: 1,640৳1,800৳.

Product: Boya BY-M1 Pro II 3.5mm Lavalier Microphone. Category: Microphone. Subcategory: Accessories. Price: 1,650৳1,900৳.
",171,848254,848425
6157,sentence,"Subcategory: Accessories. Price: 1,650৳1,900৳.

Product: MIRFAK MC1P Lavalier Microphone with Lightning Port. Category: Microphone. Subcategory: Accessories. Price: 1,900৳2,000৳.
",179,848378,848557
6158,sentence,"Subcategory: Accessories. Price: 1,900৳2,000৳.

Product: Panasonic EM-2800A Boom Microphone. Category: Microphone. Subcategory: Accessories. Price: 2,000৳2,100৳.
",162,848510,848672
6159,sentence,"Subcategory: Accessories. Price: 2,000৳2,100৳.

Product: Hoco L15 Type C & Lightning Dual Mic Lavalier Wireless Microphone Black. Category: Microphone. Subcategory: Accessories. Price: 1,690৳2,100৳.
",199,848625,848824
6160,sentence,"Subcategory: Accessories. Price: 1,690৳2,100৳.

Product: PNY Elite 64GB Class-10 UHS-I Micro SD Memory Card With SD Adapter. Category: PNY. Subcategory: Memory Card. Price: 650৳850৳.
",183,848777,848960
6161,sentence,"Subcategory: Memory Card. Price: 650৳850৳.

Product: PNY Elite 128GB Class-10 Micro SD Memory Card With Adapter. Category: PNY. Subcategory: Memory Card. Price: 1,250৳.
",169,848917,849086
6162,sentence,"Subcategory: Memory Card. Price: 1,250৳.

Product: PNY Elite 256GB Class-10 Micro SD Memory Card. Category: PNY. Subcategory: Memory Card. Price: 2,800৳3,200৳.
",160,849045,849205
6163,sentence,"Subcategory: Memory Card. Price: 2,800৳3,200৳.

Product: PNY 32 GB microSDHC Class-10 Flash Memory Card. Category: PNY. Subcategory: Memory Card. Price: Out Of Stock.
",167,849158,849325
6164,sentence,"Subcategory: Memory Card. Price: Out Of Stock.

Product: PNY Elite 64GB Class-10 Micro SD Memory Card. Category: PNY. Subcategory: Memory Card. Price: Out Of Stock.
",165,849278,849443
6165,sentence,"Subcategory: Memory Card. Price: Out Of Stock.

Product: PNY 64 GB microSDXC Class-10 Flash Memory Card. Category: PNY. Subcategory: Memory Card. Price: Out Of Stock.
",167,849396,849563
6166,sentence,"Subcategory: Memory Card. Price: Out Of Stock.

Product: Dahua C100 64GB UHS-I Class 10 microSDXC Memory Card. Category: Memory Card. Subcategory: Accessories. Price: 600৳.
",173,849516,849689
6167,sentence,"Subcategory: Accessories. Price: 600৳.

Product: Dahua ST2-64-S1 64GB MicroSD Memory Card. Category: Memory Card. Subcategory: Accessories. Price: 600৳.
",153,849650,849803
6168,sentence,"Subcategory: Accessories. Price: 600৳.

Product: Hiksemi HS-TF-C1 NEO-AD 64GB UHS-I Class 10 microSDXC Memory Card. Category: Memory Card. Subcategory: Accessories. Price: 600৳.
",178,849764,849942
6169,sentence,"Subcategory: Accessories. Price: 600৳.

Product: Apacer R100 MicroSDHC/SDXC UHS-1 U1 V10 A1 32GB Memory Card with Adapter. Category: Memory Card. Subcategory: Accessories. Price: 650৳.
",185,849903,850088
6170,sentence,"Subcategory: Accessories. Price: 650৳.

Product: Smart Eagle Eye 64GB Micro SDXC UHS-I U3 Class10 Memory Card with Adapter. Category: Memory Card. Subcategory: Accessories. Price: 700৳.
",186,850049,850235
6171,sentence,"Subcategory: Accessories. Price: 700৳.

Product: Transcend 64GB MicroSDXC/SDHC 300S Class 10 Memory Card (TS64GUSD300S). Category: Memory Card. Subcategory: Accessories. Price: 750৳.
",183,850196,850379
6172,sentence,"Subcategory: Accessories. Price: 750৳.

Product: Apacer R100 MicroSDXC UHS-I U1 V10 A1 64GB Class-10 Memory Card with Adapter. Category: Memory Card. Subcategory: Accessories. Price: 750৳.
",189,850340,850529
6173,sentence,"Subcategory: Accessories. Price: 750৳.

Product: SanDisk Ultra 32GB Class-10 100mbps Micro SDHC UHS-I Memory Card (SDSQUNR-032G-GN3MN). Category: Memory Card. Subcategory: Accessories. ",185,850490,850675
6174,sentence,"Subcategory: Accessories. Price: 700৳1,000৳.

Product: Lexar High-Performance 633x 64GB MicroSDXC UHS-I Memory Card. Category: Memory Card. Subcategory: Accessories. Price: 800৳1,000৳.
",185,850649,850834
6175,sentence,"Subcategory: Accessories. Price: 800৳1,000৳.

Product: Smart Eagle Eye 128GB Micro SDXC UHS-I U3 Class10 Memory Card with Adapter. Category: Memory Card. Subcategory: Accessories. Price: 1,000৳.
",195,850789,850984
6176,sentence,"Subcategory: Accessories. Price: 1,000৳.

Product: ADATA High-Endurance 64GB UHS-I Class 10 microSDXC Memory Card. Category: Memory Card. Subcategory: Accessories. Price: 1,100৳.
",179,850943,851122
6177,sentence,"Subcategory: Accessories. Price: 1,100৳.

Product: Adata 128GB Micro SD Class-10 (SDXC-UHX-I) Memory Card With Adapter. Category: Memory Card. Subcategory: Accessories. Price: 1,150৳.
",184,851081,851265
6178,sentence,"Subcategory: Accessories. Price: 1,150৳.

Product: Transcend 64GB 100Mbps SDXC/SDHC UHS-I SD 300S Memory Card (TS64GSDC300S). Category: Memory Card. Subcategory: Accessories. Price: 1,100৳1,200৳.
",196,851224,851420
6179,sentence,"Subcategory: Accessories. Price: 1,100৳1,200৳.

Product: SanDisk Extreme 32GB 100mbps SDHC UHS-I Memory Card (SDSDXVT-032G-GNCIN). Category: Memory Card. Subcategory: Accessories. Price: 1,250৳.
",195,851373,851568
6180,sentence,"Subcategory: Accessories. Price: 1,250৳.

Product: SanDisk Ultra 64GB Class-10 100mbps Micro SDXC UHS-I Memory Card (SDSQUNR-064G-GN3MN). Category: Memory Card. Subcategory: Accessories. ",187,851527,851714
6181,sentence,"Subcategory: Accessories. Price: 1,200৳1,300৳.

Product: SanDisk Ultra SQUAB 64GB MicroSDXC UHS-I Memory Card (SDSQUAB-064G-GN6MN). Category: Memory Card. Subcategory: Accessories. ",181,851688,851869
6182,sentence,"Subcategory: Accessories. Price: 1,130৳1,300৳.

Product: Hiksemi HS-TF-C1 NEO-AD 128GB UHS-I Class 10 microSDXC Memory Card. Category: Memory Card. Subcategory: Accessories. Price: 1,300৳.
",189,851843,852032
6183,sentence,"Subcategory: Accessories. Price: 1,300৳.

Product: Kingston Canvas Select Plus 128GB Memory Card. Category: Memory Card. Subcategory: Accessories. Price: 1,300৳.
",162,851991,852153
6184,sentence,"Subcategory: Accessories. Price: 1,300৳.

Product: TEAM 32GB MicroSDHC/SDXC UHS-I U1 C10 Memory Card with Adapter. Category: TEAM. Subcategory: Memory Card. Price: Out Of Stock.
",178,852112,852290
6185,sentence,"Subcategory: Memory Card. Price: Out Of Stock.

Product: TEAM 32GB MicroSDHC/SDXC UHS-I U1 Memory Card with Adapter. Category: TEAM. Subcategory: Memory Card. Price: Out Of Stock.
",180,852243,852423
6186,sentence,"Subcategory: Memory Card. Price: Out Of Stock.

Product: TEAM 64GB MicroSDHC/SDXC UHS-I U1 C10 Memory Card with Adapter. Category: TEAM. Subcategory: Memory Card. Price: Out Of Stock.
",184,852376,852560
6187,sentence,"Subcategory: Memory Card. Price: Out Of Stock.

Product: TEAM 128GB MicroSDHC/SDXC UHS-I U1 C10 Memory Card with Adapter. Category: TEAM. Subcategory: Memory Card. Price: Out Of Stock.
",185,852513,852698
6188,sentence,"Subcategory: Memory Card. Price: Out Of Stock.

Product: TEAM A2 PRO+ 128GB MicroSDXC UHS-I U3 V30 Memory Card with Adapter. Category: TEAM. Subcategory: Memory Card. Price: Out Of Stock.
",188,852651,852839
6189,sentence,"Subcategory: Memory Card. Price: Out Of Stock.

Product: TEAM PRO 128GB SDXC UHS-I U3 V30 4K Memory Card. Category: TEAM. Subcategory: Memory Card. Price: Out Of Stock.
",169,852792,852961
6190,sentence,"Subcategory: Memory Card. Price: Out Of Stock.

Product: TEAM ELITE A1 256GB U3 Micro SDXC UHS-I V30 Memory Card with Adapter. Category: TEAM. Subcategory: Memory Card. Price: Out Of Stock.
",190,852914,853104
6191,sentence,"Subcategory: Memory Card. Price: Out Of Stock.

Product: TEAM A2 PRO+ 256GB MicroSDXC UHS-I U3 V30 Memory Card with Adapter. Category: TEAM. Subcategory: Memory Card. Price: Out Of Stock.
",188,853057,853245
6192,sentence,"Subcategory: Memory Card. Price: Out Of Stock.

Product: TEAM PRO 256GB SDXC UHS-I U3 V30 4K Memory Card. Category: TEAM. Subcategory: Memory Card. Price: Out Of Stock.
",169,853198,853367
6193,sentence,"Subcategory: Memory Card. Price: Out Of Stock.

Product: TEAM A2 PRO+ 512GB MicroSDXC UHS-I U3 V30 Memory Card with Adapter. Category: TEAM. Subcategory: Memory Card. Price: Out Of Stock.
",188,853320,853508
6194,sentence,"Subcategory: Memory Card. Price: Out Of Stock.

Product: TEAM A2 PRO+ 1TB MicroSDXC UHS-I U3 V30 Memory Card with Adapter. Category: TEAM. Subcategory: Memory Card. Price: Out Of Stock.
",186,853461,853647
6195,sentence,"Subcategory: Memory Card. Price: Out Of Stock.

Product: Sandisk Ultra 64GB 140Mbps SDXC UHS-I Memory Card (SDSDUNB-064G-GN6IN). Category: SanDisk. Subcategory: Memory Card. Price: 1,300৳1,350৳.
",195,853600,853795
6196,sentence,"Subcategory: Memory Card. Price: 1,300৳1,350৳.

Product: SanDisk Extreme PRO 64GB 200mbps microSDXC UHS-I Memory Card with Adapter (SDSQXCU-064G-GN6MA). Category: SanDisk. Subcategory: Memory Card. ",198,853748,853946
6197,sentence,"Category: SanDisk. Subcategory: Memory Card. Price: 1,400৳1,600৳.

Product: SanDisk Ultra 128GB Class-10 100mbps Micro SDXC UHS-I Memory Card (SDSQUNR-128G-GN6MN). Category: SanDisk. ",183,853901,854084
6198,sentence,"Category: SanDisk. Subcategory: Memory Card. Price: 1,600৳1,900৳.

Product: SanDisk Extreme PRO 64GB 200mbps SDXC UHS-I Memory Card ( SDSDXXU-064G-GN4IN ). Category: SanDisk. ",175,854065,854240
6199,sentence,"Category: SanDisk. Subcategory: Memory Card. Price: 1,900৳2,200৳.

Product: Sandisk Extreme Pro 128GB 200mbps MicroSDXC UHS-1 Memory Card With Adapter (SDSQXCD-128G-GN6MA). Category: SanDisk. ",192,854221,854413
6200,sentence,"Category: SanDisk. Subcategory: Memory Card. Price: 2,100৳2,400৳.

Product: SanDisk Extreme 128GB 190mbps microSDXC UHS-I Memory Card (SDSQXAA-128G-GN6MN). Category: SanDisk. ",175,854394,854569
6201,sentence,"Category: SanDisk. Subcategory: Memory Card. Price: 2,400৳2,500৳.

Product: SanDisk Extreme PRO 128GB 200mbps SDXC UHS-I Memory Card (SDSDXXD-128G-GN4IN). Category: SanDisk. ",174,854550,854724
6202,sentence,"Category: SanDisk. Subcategory: Memory Card. Price: 2,600৳3,000৳.

Product: SanDisk Ultra 256GB Class-10 100mbps Micro SDXC UHS-I Memory Card (SDSQUNR-256G-GN3MN). Category: SanDisk. ",183,854705,854888
6203,sentence,"Category: SanDisk. Subcategory: Memory Card. Price: 3,000৳3,200৳.

Product: Sandisk Extreme PRO 256GB 200mbps MicroSDXC UHS-I Memory Card With Adapter (SDSQXCD-256G-GN6MA). Category: SanDisk. ",192,854869,855061
6204,sentence,"Category: SanDisk. Subcategory: Memory Card. Price: 3,500৳4,100৳.

Product: SanDisk Extreme Pro 32GB Compact Flash Memory Card (SDCFXPS-032G-X46). Category: SanDisk. Subcategory: Memory Card. ",192,855042,855234
6205,sentence,"Category: SanDisk. Subcategory: Memory Card. Price: 5,400৳5,600৳.

Product: SanDisk Ultra 512GB MicroSDXC UHS-I Memory Card (SDSQUAC-512G-GN6MN). Category: SanDisk. Subcategory: Memory Card. ",191,855189,855380
6206,sentence,"Category: SanDisk. Subcategory: Memory Card. Price: 5,700৳.

Product: SanDisk Extreme PRO 256GB 200mbps SDHC And SDXC UHS-I Memory Card (SDSDXXD-256G-GN4IN). Category: SanDisk. ",177,855335,855512
6207,sentence,"Category: SanDisk. Subcategory: Memory Card. Price: 5,400৳6,250৳.

Product: SanDisk Extreme 512GB 190mbps microSDXC UHS-I Memory Card (SDSQXAV-512G-GN6MN). Category: SanDisk. ",175,855493,855668
6208,sentence,"Category: SanDisk. Subcategory: Memory Card. Price: 6,600৳7,000৳.

Product: Sandisk Extreme PRO 512GB 200mbps MicroSDXC UHS-1 Memory Card With Adapter (SDSQXCD-512G-GN6MA). Category: SanDisk. ",192,855649,855841
6209,sentence,"Category: SanDisk. Subcategory: Memory Card. Price: 7,000৳7,400৳.

Product: SanDisk Extreme PRO 64GB 300mbps SDXC UHS-II Memory Card (SDSDXDK-064G-GN4IN). Category: SanDisk. ",174,855822,855996
6210,sentence,"Category: SanDisk. Subcategory: Memory Card. Price: 13,500৳16,500৳.

Product: SanDisk Extreme PRO CFexpress Type B 128GB Memory Card. Category: SanDisk. Subcategory: Memory Card. ",179,855977,856156
6211,sentence,"Category: SanDisk. Subcategory: Memory Card. Price: 21,800৳25,000৳.

Product: Apacer 128GB Micro SD Class-10 Memory Card with Adapter. Category: Apacer. Subcategory: Memory Card. ",179,856111,856290
6212,sentence,"Category: Apacer. Subcategory: Memory Card. Price: 1,350৳1,450৳.

Product: Apacer R100 MicroSDXC UHS-I U1 V10 128GB Class-10 Memory Card with Adapter. Category: Apacer. Subcategory: Memory Card. ",195,856246,856441
6213,sentence,"Category: Apacer. Subcategory: Memory Card. Price: 1,350৳1,500৳.

Product: Apacer R100 SDXC/SDHC UHS-I U1 V10 256GB A1 Class 10 Memory Card with Adapter. Category: Apacer. Subcategory: Memory Card. ",198,856397,856595
6214,sentence,"Category: Apacer. Subcategory: Memory Card. Price: 3,400৳.

Product: Apacer R100 MicroSDXC UHS-I U3 V30 A2 512GB Class-10 Memory Card with Adapter. Category: Apacer. Subcategory: Memory Card. ",192,856551,856743
6215,sentence,"Category: Apacer. Subcategory: Memory Card. Price: 5,550৳6,200৳.

Product: Apacer R100 MicroSDXC UHS-I U3 V30 A1 32GB Class-10 Memory Card with Adapter. Category: Apacer. Subcategory: Memory Card. ",197,856699,856896
6216,sentence,"Category: Apacer. Subcategory: Memory Card. Price: Out Of Stock.

Product: Apacer R100 SDXC/SDHC UHS-I U3 V30 256GB A2 Class 10 Memory Card with Adapter. Category: Apacer. Subcategory: Memory Card. ",198,856852,857050
6217,sentence,"Category: Apacer. Subcategory: Memory Card. Price: Out Of Stock.

Product: Apacer 256GB MicroSDXC UHS-I U3 V30 R100 A1 Class-10 Memory Card with Adapter. Category: Apacer. Subcategory: Memory Card. ",198,857006,857204
6218,sentence,"Category: Apacer. Subcategory: Memory Card. Price: Out Of Stock.

Product: Nikon XQD 64GB Memory Card. Category: Nikon. Subcategory: Memory Card. Price: 15,000৳18,000৳.
",169,857160,857329
6219,sentence,"Price: 15,000৳18,000৳.

Product: Dahua Imou ST2-128-S1 128GB MicroSD Memory Card. Category: Dahua. Subcategory: Memory Card. Price: 1,450৳.
",140,857306,857446
6220,sentence,"Subcategory: Memory Card. Price: 1,450৳.

Product: Dahua C100 256GB UHS-I Class 10 microSDXC Memory Card. Category: Dahua. Subcategory: Memory Card. Price: 2,650৳.
",164,857405,857569
6221,sentence,"Subcategory: Memory Card. Price: 2,650৳.

Product: Dahua Imou ST2-256-S1 256GB MicroSD Memory Card. Category: Dahua. Subcategory: Memory Card. Price: 3,000৳.
",158,857528,857686
6222,sentence,"Subcategory: Memory Card. Price: 3,000৳.

Product: Dahua C100 512GB UHS-I Class 10 microSDXC Memory Card. Category: Dahua. Subcategory: Memory Card. Price: 5,400৳.
",164,857645,857809
6223,sentence,"Subcategory: Memory Card. Price: 5,400৳.

Product: Dahua C100 128GB UHS-I Class 10 microSDXC Memory Card. Category: Dahua. Subcategory: Memory Card. Price: Out Of Stock.
",170,857768,857938
6224,sentence,"Subcategory: Memory Card. Price: Out Of Stock.

Product: Samsung EVO Select 256GB microSDXC Memory Card with Adapter. Category: Samsung. Subcategory: Memory Card. Price: Out Of Stock.
",184,857891,858075
6225,sentence,"Subcategory: Memory Card. Price: Out Of Stock.

Product: Transcend 128GB 100Mbps UHS-I SD 300S Memory Card. Category: Transcend. Subcategory: Memory Card. Price: 1,400৳.
",170,858028,858198
6226,sentence,"Subcategory: Memory Card. Price: 1,400৳.

Product: Transcend 128GB Micro SD Class 10 With Adapter. Category: Transcend. Subcategory: Memory Card. Price: 1,400৳1,500৳.
",167,858157,858324
6227,sentence,"Subcategory: Memory Card. Price: 1,400৳1,500৳.

Product: Transcend 128GB MicroSDXC/SDHC 300S Class 10 Memory Card (TS128GUSD300S). Category: Transcend. Subcategory: Memory Card. Price: 1,500৳.
",193,858277,858470
6228,sentence,"Subcategory: Memory Card. Price: 1,500৳.

Product: Transcend 32GB Micro SD UHS-I U1-Class-10-Memory Card with Adapter (TS32GUSD300S-A). Category: Transcend. Subcategory: Memory Card. ",183,858429,858612
6229,sentence,"Category: Transcend. Subcategory: Memory Card. Price: Out Of Stock.

Product: Transcend 64GB Micro SD UHS-I U1 Memory Card with Adapter (TS64GUSD300S-A). Category: Transcend. ",175,858565,858740
6230,sentence,"Category: Transcend. Subcategory: Memory Card. Price: Out Of Stock.

Product: Transcend USD350V U1 64GB High Endurance MicroSD Memory Card with Adapter. Category: Transcend. ",174,858719,858893
6231,sentence,"Category: Transcend. Subcategory: Memory Card. Price: Out Of Stock.

Product: Transcend 256GB Micro SD UHS-I U3 Memory Card with Adapter (TS256GUSD300S-A). Category: Transcend. ",177,858872,859049
6232,sentence,"Category: Transcend. Subcategory: Memory Card. Price: Out Of Stock.

Product: Transcend 512GB 300S UHS-I microSDXC U3A1 Memory Card with Adapter. Category: Transcend. Subcategory: Memory Card. ",193,859028,859221
6233,sentence,"Category: Transcend. Subcategory: Memory Card. Price: Out Of Stock.

Product: Lexar High-Endurance 64GB MicroSD UHS-I Memory Card. Category: Lexar. Subcategory: Memory Card. Price: 1,300৳1,650৳.
",195,859174,859369
6234,sentence,"Subcategory: Memory Card. Price: 1,300৳1,650৳.

Product: Lexar High-Performance 633x 128GB MicroSDXC UHS-I Memory Card with Adapter. Category: Lexar. Subcategory: Memory Card. Price: 1,600৳1,850৳.
",197,859322,859519
6235,sentence,"Subcategory: Memory Card. Price: 1,600৳1,850৳.

Product: Lexar High-Endurance 128GB MicroSD UHS-I Memory Card. Category: Lexar. Subcategory: Memory Card. Price: 1,700৳2,000৳.
",175,859472,859647
6236,sentence,"Subcategory: Memory Card. Price: 1,700৳2,000৳.

Product: Lexar High-Performance 633x 256GB MicroSDXC UHS-I Memory Card with Adapter. Category: Lexar. Subcategory: Memory Card. Price: 2,800৳3,300৳.
",197,859600,859797
6237,sentence,"Subcategory: Memory Card. Price: 2,800৳3,300৳.

Product: Lexar Professional CFexpress Type B 512GB Memory Card. Category: Lexar. Subcategory: Memory Card. Price: 37,900৳39,000৳.
",178,859750,859928
6238,sentence,"Price: 37,900৳39,000৳.

Product: Lexar High-Performance 633x 512GB MicroSDXC UHS-I Memory Card with Adapter. Category: Lexar. Subcategory: Memory Card. Price: Out Of Stock.
",173,859905,860078
6239,sentence,"Subcategory: Memory Card. Price: Out Of Stock.

Product: TwinMOS 32GB MicroSDXC Class-10 UHS-I Memory Card. Category: TwinMOS. Subcategory: Memory Card. Price: Out Of Stock.
",174,860031,860205
6240,sentence,"Subcategory: Memory Card. Price: Out Of Stock.

Product: TwinMOS 64GB MicroSDXC Class-10 UHS-I Memory Card. Category: TwinMOS. Subcategory: Memory Card. Price: Out Of Stock.
",174,860158,860332
6241,sentence,"Subcategory: Memory Card. Price: Out Of Stock.

Product: TwinMOS 128GB MicroSDXC Class-10 Memory Card. Category: TwinMOS. Subcategory: Memory Card. Price: Out Of Stock.
",169,860285,860454
6242,sentence,"Subcategory: Memory Card. Price: Out Of Stock.

Product: ADATA High-Endurance 128GB UHS-I Class 10 microSDXC Memory Card. Category: Adata. Subcategory: Memory Card. Price: 1,650৳.
",180,860407,860587
6243,sentence,"Subcategory: Memory Card. Price: 1,650৳.

Product: Adata Premier 256GB MicroSDXC UHS-I Memory Card. Category: Adata. Subcategory: Memory Card. Price: 2,600৳.
",158,860546,860704
6244,sentence,"Subcategory: Memory Card. Price: 2,600৳.

Product: ADATA High-Endurance 256GB UHS-I Class 10 microSDXC Memory Card. Category: Adata. Subcategory: Memory Card. Price: 3,150৳3,300৳.
",180,860663,860843
6245,sentence,"Subcategory: Memory Card. Price: 3,150৳3,300৳.

Product: ADATA High-Endurance 512GB UHS-I Class 10 microSDXC Memory Card. Category: Adata. Subcategory: Memory Card. Price: 5,650৳5,800৳.
",186,860796,860982
6246,sentence,"Subcategory: Memory Card. Price: 5,650৳5,800৳.

Product: Adata 32GB Micro SD Class-10 (SDHC-UHS-I) Memory Card With Adapter. Category: Adata. Subcategory: Memory Card. Price: Out Of Stock.
",189,860935,861124
6247,sentence,"Subcategory: Memory Card. Price: Out Of Stock.

Product: Adata 64GB Micro SD Class-10 (SDXC-UHX-I) Memory Card With Adapter. Category: Adata. Subcategory: Memory Card. Price: Out Of Stock.
",189,861077,861266
6248,sentence,"Subcategory: Memory Card. Price: Out Of Stock.

Product: Sony SF-E Series UHS-II SDXC 64GB Memory Card. Category: Sony. Subcategory: Memory Card. Price: 3,000৳3,500৳.
",167,861219,861386
6249,sentence,"Subcategory: Memory Card. Price: 3,000৳3,500৳.

Product: Sony SF-M Tough Series UHS-II SDXC 64GB Memory Card. Category: Sony. Subcategory: Memory Card. Price: 5,400৳6,500৳.
",173,861339,861512
6250,sentence,"Subcategory: Memory Card. Price: 5,400৳6,500৳.

Product: Sony SF-M Tough Series UHS-II SDXC 128GB Memory Card. Category: Sony. Subcategory: Memory Card. Price: 13,400৳15,000৳.
",176,861465,861641
6251,sentence,"Price: 13,400৳15,000৳.

Product: Sony SF-G Tough Series UHS-II SDXC 64GB Memory Card. Category: Sony. Subcategory: Memory Card. Price: 15,400৳17,000৳.

Product: Sony G Series XQD 64GB Memory Card. ",197,861618,861815
6252,sentence,"
Product: Sony G Series XQD 64GB Memory Card. Category: Sony. Subcategory: Memory Card. Price: 15,500৳18,000৳.

Product: Sony SF-G Tough Series UHS-II SDXC 128GB Memory Card. Category: Sony. ",191,861769,861960
6253,sentence,"Category: Sony. Subcategory: Memory Card. Price: 26,700৳28,500৳.

Product: Sony CFexpress Type A TOUGH 80GB Memory Card. Category: Sony. Subcategory: Memory Card. Price: 25,900৳29,000৳.
",186,861944,862130
6254,sentence,"Price: 25,900৳29,000৳.

Product: Sony CFexpress Type A TOUGH 160GB Memory Card. Category: Sony. Subcategory: Memory Card. Price: 43,900৳47,000৳.
",145,862107,862252
6255,sentence,"Price: 43,900৳47,000৳.

Product: Sony CFexpress Type A TOUGH 640GB Memory Card. Category: Sony. Subcategory: Memory Card. Price: 149,000৳155,000৳.
",147,862229,862376
6256,sentence,"Price: 149,000৳155,000৳.

Product: Sony SF-M Tough Series UHS-II SDXC 256GB Memory Card. Category: Sony. Subcategory: Memory Card. Price: Out Of Stock.
",152,862351,862503
6257,sentence,"Subcategory: Memory Card. Price: Out Of Stock.

Product: Sony CFexpress Type A TOUGH 320GB Memory Card. Category: Sony. Subcategory: Memory Card. Price: Out Of Stock.
",167,862456,862623
6258,sentence,"Subcategory: Memory Card. Price: Out Of Stock.

Product: Asus XONAR DGX PCI Express Sound Card. Category: Sound Card. Subcategory: Accessories. Price: Out Of Stock.
",165,862576,862741
6259,sentence,"Subcategory: Accessories. Price: Out Of Stock.

Product: Orico SC2 USB 2.0 External Sound Card. Category: Sound Card. Subcategory: Accessories. Price: 1,050৳.
",159,862694,862853
6260,sentence,"Subcategory: Accessories. Price: 1,050৳.

Product: UGREEN CM129 USB External Sound Card #40964. Category: Sound Card. Subcategory: Accessories. Price: Up Coming.
",162,862812,862974
6261,sentence,"Subcategory: Accessories. Price: Up Coming.

Product: Orico SKT2 USB 2.0 External Sound Card. Category: Sound Card. Subcategory: Accessories. Price: Out Of Stock.
",163,862930,863093
6262,sentence,"Subcategory: Accessories. Price: Out Of Stock.

Product: Fantech Tunnel AC3002 7.1 Surround Sound Audio Sound Card. Category: Sound Card. Subcategory: Accessories. Price: Out Of Stock.
",185,863046,863231
6263,sentence,"Subcategory: Accessories. Price: Out Of Stock.

Product: HyperX AMP Virtual 7.1 Surround USB Sound Card. Category: Sound Card. Subcategory: Accessories. Price: Out Of Stock.
",174,863184,863358
6264,sentence,"Subcategory: Accessories. Price: Out Of Stock.

Product: Asus Xonar SE 5.1 PCIe 192kHz Gaming Sound Card. Category: Sound Card. Subcategory: Accessories. Price: Out Of Stock.
",175,863311,863486
6265,sentence,"Subcategory: Accessories. Price: Out Of Stock.

Product: Orico SKT3 USB 2.0 External Sound Card. Category: Sound Card. Subcategory: Accessories. Price: Out Of Stock.
",166,863439,863605
6266,sentence,"Subcategory: Accessories. Price: Out Of Stock.

Product: Asus XONAR AE PCI Express Gaming Sound Card. Category: Sound Card. Subcategory: Accessories. Price: Out Of Stock.
",171,863558,863729
6267,sentence,"Subcategory: Accessories. Price: Out Of Stock.

Product: Avermedia GC311 Micro USB Full HD Live Gamer Mini Game Capture Card (Black). Category: AVerMedia. Subcategory: Capture Card. ",182,863682,863864
6268,sentence,"Category: AVerMedia. Subcategory: Capture Card. Price: 10,250৳10,400৳.

Product: Avermedia GC551 Type C Live Gamer Extreme 2 Full HD Game Capture Card (Black). Category: AVerMedia. ",181,863816,863997
6269,sentence,"Category: AVerMedia. Subcategory: Capture Card. Price: 12,400৳.

Product: AVerMedia Live Gamer Duo GC570D PCI-Express Internal Game Capture Card. Category: AVerMedia. Subcategory: Capture Card. ",194,863976,864170
6270,sentence,"Category: AVerMedia. Subcategory: Capture Card. Price: 18,700৳19,000৳.

Product: AVerMedia BU110 USB ExtremeCap UVC Video Capture Card. Category: AVerMedia. Subcategory: Capture Card. ",184,864122,864306
6271,sentence,"Category: AVerMedia. Subcategory: Capture Card. Price: Out Of Stock.

Product: AVerMedia Live Gamer HD 2 GC570 PCI-Express Internal Game Capture Card. Category: AVerMedia. Subcategory: Capture Card. ",199,864258,864457
6272,sentence,"Category: AVerMedia. Subcategory: Capture Card. Price: Out Of Stock.

Product: Avermedia GC513 Micro USB Full HD Live Gamer Mini Game Capture Card (Black). Category: AVerMedia. ",177,864409,864586
6273,sentence,"Category: AVerMedia. Subcategory: Capture Card. Price: Out Of Stock.

Product: Elgato Cam Link 4K USB Compact HDMI Capture Card. Category: Capture Card. Subcategory: Accessories. ",179,864565,864744
6274,sentence,"Subcategory: Accessories. Price: 11,900৳13,000৳.

Product: Elgato Game Capture Neo Game Capture Card White. Category: Capture Card. Subcategory: Accessories. Price: 12,200৳14,500৳.
",181,864718,864899
6275,sentence,"Price: 12,200৳14,500৳.

Product: Elgato HD60 X External Capture Card. Category: Capture Card. Subcategory: Accessories. Price: 19,000৳.

Product: Elgato Cam Link Pro Capture Card. ",180,864876,865056
6276,sentence,"
Product: Elgato Cam Link Pro Capture Card. Category: Capture Card. Subcategory: Accessories. Price: 35,100৳36,000৳.
",117,865012,865129
6277,sentence,"Price: 35,100৳36,000৳.

Product: Ugreen CM489 Type-C & USB Male to HDMI Female 4K Video Capture Card #40189. Category: Capture Card. Subcategory: Accessories. Price: Out Of Stock.
",180,865106,865286
6278,sentence,"Subcategory: Accessories. Price: Out Of Stock.

Product: Vention ACWHA Type-C & USB Male to HDMI Female Video Capture Card. Category: Capture Card. Subcategory: Accessories. Price: Out Of Stock.
",195,865239,865434
6279,sentence,"Subcategory: Accessories. Price: Out Of Stock.

Product: ORICO HVC-1080 HDMI to USB3.0 Video Capture Card. Category: Capture Card. Subcategory: Accessories. Price: Out Of Stock.
",178,865387,865565
6280,sentence,"Subcategory: Accessories. Price: Out Of Stock.

Product: ORICO 2.5 to 3.5 inch Hard Drive Caddy (1125SS). Category: HDD-SSD Enclosure. Subcategory: Accessories. Price: 600৳.
",174,865518,865692
6281,sentence,"Subcategory: Accessories. Price: 600৳.

Product: ORICO 25PW1-U3 2.5 inch USB3.0 Micro-B Hard Drive Enclosure. Category: HDD-SSD Enclosure. Subcategory: Accessories. Price: 650৳690৳.
",182,865653,865835
6282,sentence,"Subcategory: Accessories. Price: 650৳690৳.

Product: ORICO-2020U3 2.5 Inch SATA USB 3.0 HDD Enclosure. Category: HDD-SSD Enclosure. Subcategory: Accessories. Price: 650৳700৳.
",175,865792,865967
6283,sentence,"Subcategory: Accessories. Price: 650৳700৳.

Product: Orico 2520U3 2.5 inch USB 3.0 SATA HDD & SSD Enclosure. Category: HDD-SSD Enclosure. Subcategory: Accessories. Price: 750৳.
",177,865924,866101
6284,sentence,"Subcategory: Accessories. Price: 750৳.

Product: Yuanxin YPH-023 2.5 Inch SATA HDD SSD Enclosure. Category: HDD-SSD Enclosure. Subcategory: Accessories. Price: 799৳850৳.
",170,866062,866232
6285,sentence,"Subcategory: Accessories. Price: 799৳850৳.

Product: Yuanxin YPH-024 2.5 inch USB HDD Enclosure. Category: HDD-SSD Enclosure. Subcategory: Accessories. Price: 950৳.
",165,866189,866354
6286,sentence,"Subcategory: Accessories. Price: 950৳.

Product: Yuanxin YPH-025 2.5 Inch SATA HDD Enclosure. Category: HDD-SSD Enclosure. Subcategory: Accessories. Price: 800৳990৳.
",166,866315,866481
6287,sentence,"Subcategory: Accessories. Price: 800৳990৳.

Product: Yuanxin YPH-027 2.5 inch SATA HDD Enclosure. Category: HDD-SSD Enclosure. Subcategory: Accessories. Price: 800৳1,000৳.
",172,866438,866610
6288,sentence,"Subcategory: Accessories. Price: 800৳1,000৳.

Product: Ugreen 2.5"" SATA USB 3.0 Hard Disk Enclosure #60353. Category: HDD-SSD Enclosure. Subcategory: Accessories. Price: 1,300৳.
",178,866565,866743
6289,sentence,"Subcategory: Accessories. Price: 1,300৳.

Product: Vention KPAB0 2.5 Inch USB 3.0 SATA Hard Drive Enclosure. Category: HDD-SSD Enclosure. Subcategory: Accessories. Price: 1,090৳1,500৳.
",185,866702,866887
6290,sentence,"Subcategory: Accessories. Price: 1,090৳1,500৳.

Product: Yuanxin YPH-037 M.2 NVMe SSD Enclosure. Category: HDD-SSD Enclosure. Subcategory: Accessories. Price: 1,700৳1,800৳.
",173,866840,867013
6291,sentence,"Subcategory: Accessories. Price: 1,700৳1,800৳.

Product: Yuanxin YPH-038 M.2 NVMe/SATA SSD Enclosure. Category: HDD-SSD Enclosure. Subcategory: Accessories. Price: 1,800৳.
",172,866966,867138
6292,sentence,"Subcategory: Accessories. Price: 1,800৳.

Product: Yuanxin YPH-050 3.5 Inch SATA HDD Enclosure with Power Adapter. Category: HDD-SSD Enclosure. Subcategory: Accessories. Price: 1,800৳.
",185,867097,867282
6293,sentence,"Subcategory: Accessories. Price: 1,800৳.

Product: Yuanxin YPH-033 3.5 Inch SATA HDD Enclosure with Power Adapter. Category: HDD-SSD Enclosure. Subcategory: Accessories. Price: 1,750৳1,850৳.
",191,867241,867432
6294,sentence,"Subcategory: Accessories. Price: 1,750৳1,850৳.

Product: UGREEN CM400 USB-C to M.2 NGFF 5Gbps SATA SSD Enclosure #10903. Category: HDD-SSD Enclosure. Subcategory: Accessories. Price: 1,700৳1,900৳.
",197,867385,867582
6295,sentence,"Subcategory: Accessories. Price: 1,700৳1,900৳.

Product: Vention KPBB0 2.5 Inch USB 3.0 SATA Hard Drive Enclosure. Category: HDD-SSD Enclosure. Subcategory: Accessories. Price: 1,680৳2,000৳.
",191,867535,867726
6296,sentence,"Subcategory: Accessories. Price: 1,680৳2,000৳.

Product: UGREEN CM300 Type-C to 2.5"" SATA Hard Drive Enclosure #70499. Category: HDD-SSD Enclosure. Subcategory: Accessories. Price: 2,150৳.
",189,867679,867868
6297,sentence,"Subcategory: Accessories. Price: 2,150৳.

Product: UGREEN CM300 Type-C to 2.5"" SATA Hard Drive Enclosure #70498. Category: HDD-SSD Enclosure. Subcategory: Accessories. Price: 2,180৳.
",183,867827,868010
6298,sentence,"Subcategory: Accessories. Price: 2,180৳.

Product: Ugreen CM642 M.2 NVMe SSD Enclosure #15976. Category: HDD-SSD Enclosure. Subcategory: Accessories. Price: 9,500৳.
",165,867969,868134
6299,sentence,"Subcategory: Accessories. Price: 9,500৳.

Product: Orico M2PV-C3 M.2 Type-C NVMe SSD Enclosure. Category: HDD-SSD Enclosure. Subcategory: Accessories. Price: 2,250৳.
",166,868093,868259
6300,sentence,"Subcategory: Accessories. Price: 2,250৳.

Product: DeepCool EK720-L-1.0 High Performance Thermal Pad. Category: Thermal Paste. Subcategory: Accessories. Price: 750৳.
",166,868218,868384
6301,sentence,"Subcategory: Accessories. Price: 750৳.

Product: DeepCool EK720-L-1.5 High Performance Thermal Pad. Category: Thermal Paste. Subcategory: Accessories. Price: 850৳.
",164,868345,868509
6302,sentence,"Subcategory: Accessories. Price: 850৳.

Product: Gamdias XC5 4g High-Performance Thermal Paste. Category: Thermal Paste. Subcategory: Accessories. Price: 900৳.
",160,868470,868630
6303,sentence,"Subcategory: Accessories. Price: 900৳.

Product: DeepCool EK720-XL-0.5 High Performance Thermal Pad. Category: Thermal Paste. Subcategory: Accessories. Price: 1,000৳.
",167,868591,868758
6304,sentence,"Subcategory: Accessories. Price: 1,000৳.

Product: DeepCool EK720-L-2.0 High Performance Thermal Pad. Category: Thermal Paste. Subcategory: Accessories. Price: 1,100৳.
",168,868717,868885
6305,sentence,"Subcategory: Accessories. Price: 1,100৳.

Product: DeepCool DM9 4g Professional Grade Thermal Paste. Category: Thermal Paste. Subcategory: Accessories. Price: 1,100৳.
",167,868844,869011
6306,sentence,"Subcategory: Accessories. Price: 1,100৳.

Product: DeepCool EK720-XL-1.0 High Performance Thermal Pad. Category: Thermal Paste. Subcategory: Accessories. Price: 1,400৳.
",169,868970,869139
6307,sentence,"Subcategory: Accessories. Price: 1,400৳.

Product: DeepCool EK720-XL-1.5 High Performance Thermal Pad. Category: Thermal Paste. Subcategory: Accessories. Price: 1,800৳.
",169,869098,869267
6308,sentence,"Subcategory: Accessories. Price: 1,800৳.

Product: Cryorig CP5 CRYO-PASTE. Category: Thermal Paste. Subcategory: Accessories. Price: Up Coming.

Product: Thermal Grizzly Kryonaut 1g Thermal Paste. ",197,869226,869423
6309,sentence,"Category: Thermal Paste. Subcategory: Accessories. Price: Up Coming.

Product: Thermal Grizzly Hydronaut 1g Thermal Paste. Category: Thermal Paste. Subcategory: Accessories. Price: Up Coming.
",192,869423,869615
6310,sentence,"Subcategory: Accessories. Price: Up Coming.

Product: Thermal Grizzly Duronaut 2g Thermal Paste. Category: Thermal Paste. Subcategory: Accessories. Price: Up Coming.
",166,869571,869737
6311,sentence,"Subcategory: Accessories. Price: Up Coming.

Product: Thermal Grizzly Aeronaut 1g Thermal Paste. Category: Thermal Paste. Subcategory: Accessories. Price: Up Coming.
",166,869693,869859
6312,sentence,"Subcategory: Accessories. Price: Up Coming.

Product: Arctic MX-4 4G Premium Performance Thermal Paste with Spatula. Category: Thermal Paste. Subcategory: Accessories. Price: Up Coming.
",186,869815,870001
6313,sentence,"Subcategory: Accessories. Price: Up Coming.

Product: DeepCool EX750 5g High-Performance Thermal Paste. Category: Thermal Paste. Subcategory: Accessories. Price: Up Coming.
",173,869957,870130
6314,sentence,"Subcategory: Accessories. Price: Up Coming.

Product: Thermal Grease (30gm) Paste Compound Silicone Syringe Gray. Category: Thermal Paste. Subcategory: Accessories. Price: Out Of Stock.
",186,870086,870272
6315,sentence,"Subcategory: Accessories. Price: Out Of Stock.

Product: Deepcool G15 Thermal Paste. Category: Thermal Paste. Subcategory: Accessories. Price: Out Of Stock.

Product: DeepCool Z3 Thermal Paste. ",194,870225,870419
6316,sentence,"
Product: DeepCool Z3 Thermal Paste. Category: Thermal Paste. Subcategory: Accessories. Price: Out Of Stock.

Product: Deepcool Z5 Thermal Paste. Category: Thermal Paste. Subcategory: Accessories. ",197,870382,870579
6317,sentence,"Subcategory: Accessories. Price: Out Of Stock.

Product: DeepCool Z10 Thermal Paste. Category: Thermal Paste. Subcategory: Accessories. Price: Out Of Stock.
",157,870553,870710
6318,sentence,"Subcategory: Accessories. Price: Out Of Stock.

Product: Hiksemi Pully HS-USB-M210S 32GB USB 3.2 Pen Drive. Category: Pen Drive. Subcategory: Accessories. Price: 450৳500৳.
",172,870663,870835
6319,sentence,"Subcategory: Accessories. Price: 450৳500৳.

Product: Hiksemi Cap HS-USB-M220P 32GB USB 3.2 Pen Drive. Category: Pen Drive. Subcategory: Accessories. Price: 525৳.
",162,870792,870954
6320,sentence,"Subcategory: Accessories. Price: 525৳.

Product: Apacer AH25C 32GB USB 3.2 Gen 1 Flash Drive. Category: Pen Drive. Subcategory: Accessories. Price: 590৳.
",154,870915,871069
6321,sentence,"Subcategory: Accessories. Price: 590৳.

Product: Apacer AH355 32GB USB 3.1 Flash Drive. Category: Pen Drive. Subcategory: Accessories. Price: 550৳600৳.
",152,871030,871182
6322,sentence,"Subcategory: Accessories. Price: 550৳600৳.

Product: Apacer AH353 32GB USB 3.2 Flash Drive. Category: Pen Drive. Subcategory: Accessories. Price: 650৳.
",152,871139,871291
6323,sentence,"Subcategory: Accessories. Price: 650৳.

Product: Adata UV150 64GB USB 3.2 Gen 1 Pen Drive. Category: Pen Drive. Subcategory: Accessories. Price: 610৳650৳.
",155,871252,871407
6324,sentence,"Subcategory: Accessories. Price: 610৳650৳.

Product: Apacer AH357 32GB USB 3.2 Gen 1 Flash Drive. Category: Pen Drive. Subcategory: Accessories. Price: 550৳650৳.
",162,871364,871526
6325,sentence,"Subcategory: Accessories. Price: 550৳650৳.

Product: Kingston DataTraveler Exodia 64GB USB 3.2 Gen 1 Pen Drive. Category: Pen Drive. Subcategory: Accessories. Price: 553৳650৳.
",176,871483,871659
6326,sentence,"Subcategory: Accessories. Price: 553৳650৳.

Product: Hiksemi HS-USB-E307C 32GB USB 3.2 Pen Drive. Category: Pen Drive. Subcategory: Accessories. Price: 650৳.
",158,871616,871774
6327,sentence,"Subcategory: Accessories. Price: 650৳.

Product: Hiksemi Sync HS-USB-E327C 32GB USB 3.2 Pen Drive. Category: Pen Drive. Subcategory: Accessories. Price: 650৳.
",159,871735,871894
6328,sentence,"Subcategory: Accessories. Price: 650৳.

Product: Hiksemi Blade HS-USB-E301 64GB USB 3.2 Pen Drive. Category: Pen Drive. Subcategory: Accessories. Price: 553৳650৳.
",163,871855,872018
6329,sentence,"Subcategory: Accessories. Price: 553৳650৳.

Product: Hiksemi Pully HS-USB-M210S 64GB USB 3.2 Pen Drive. Category: Pen Drive. Subcategory: Accessories. Price: 650৳.
",164,871975,872139
6330,sentence,"Subcategory: Accessories. Price: 650৳.

Product: Hiksemi Cap HS-USB-M220P 64GB USB 3.2 Pen Drive. Category: Pen Drive. Subcategory: Accessories. Price: 553৳650৳.
",162,872100,872262
6331,sentence,"Subcategory: Accessories. Price: 553৳650৳.

Product: Eaget ET-X1 32GB USB 3.2 Gen1 Pen Drive. Category: Pen Drive. Subcategory: Accessories. Price: 650৳.
",154,872219,872373
6332,sentence,"Subcategory: Accessories. Price: 650৳.

Product: Apacer AH355 64GB USB 3.2 Gen 1 Flash Drive. Category: Pen Drive. Subcategory: Accessories. Price: 700৳.
",154,872334,872488
6333,sentence,"Subcategory: Accessories. Price: 700৳.

Product: Apacer AH356 64GB USB 3.2 Gen 1 Flash Drive. Category: Pen Drive. Subcategory: Accessories. Price: 665৳700৳.
",158,872449,872607
6334,sentence,"Subcategory: Accessories. Price: 665৳700৳.

Product: Dahua U156 64GB USB 3.2 Pen Drive. Category: Pen Drive. Subcategory: Accessories. Price: 650৳700৳.
",152,872564,872716
6335,sentence,"Subcategory: Accessories. Price: 650৳700৳.

Product: ADATA UC310 ECO 64GB USB 3.2 Pen Drive. Category: Pen Drive. Subcategory: Accessories. Price: 600৳700৳.
",157,872673,872830
6336,sentence,"Subcategory: Accessories. Price: 600৳700৳.

Product: ADATA UC320 64GB USB 3.2 Pen Drive. Category: Pen Drive. Subcategory: Accessories. Price: 650৳700৳.
",153,872787,872940
6337,sentence,"Subcategory: Accessories. Price: 650৳700৳.

Product: Orico AXM2S-G2-GY M.2 Type-C SSD Enclosure. Category: Orico. Subcategory: HDD-SSD Enclosure. Price: 2,500৳.
",161,872897,873058
6338,sentence,"Subcategory: HDD-SSD Enclosure. Price: 2,500৳.

Product: ORICO PVM2F-C3 NGFF M.2 Type-C Hard Drive Enclosure. Category: Orico. Subcategory: HDD-SSD Enclosure. Price: 2,200৳2,600৳.
",180,873011,873191
6339,sentence,"Price: 2,200৳2,600৳.

Product: Orico 6829C3 2.5 3.5 inch SATA HDD SSD Offline Clone Dual Bay Dock. Category: Orico. Subcategory: HDD-SSD Enclosure. Price: 3,850৳4,100৳.
",169,873170,873339
6340,sentence,"Price: 3,850৳4,100৳.

Product: Orico 2577U3-BK 2.5"" USB3.0 to SATA III Hard Drive Enclosure. Category: Orico. Subcategory: HDD-SSD Enclosure. Price: Out Of Stock.
",163,873318,873481
6341,sentence,"Price: Out Of Stock.

Product: ORICO 2189U3 2.5 inch USB3.0 Hard Drive Enclosure. Category: Orico. Subcategory: HDD-SSD Enclosure. Price: Out Of Stock.
",152,873460,873612
6342,sentence,"Price: Out Of Stock.

Product: ORICO 2139U3 2.5 inch Transparent USB 3.0 Hard Drive Enclosure. Category: Orico. Subcategory: HDD-SSD Enclosure. Price: Out Of Stock.
",165,873591,873756
6343,sentence,"Price: Out Of Stock.

Product: ORICO 2577C3-V1 USB 3.0 to Type-C 2.5 inch HDD Enclosure. Category: Orico. Subcategory: HDD-SSD Enclosure. Price: Out Of Stock.
",159,873735,873894
6344,sentence,"Price: Out Of Stock.

Product: ORICO TX25C3-GY 2.5 inch Type-C Transparent Enclosure. Category: Orico. Subcategory: HDD-SSD Enclosure. Price: Out Of Stock.
",156,873873,874029
6345,sentence,"Price: Out Of Stock.

Product: Orico 2129U3 2.5"" SATA HDD/SSD USB 3.0 Transparent Enclosure. Category: Orico. Subcategory: HDD-SSD Enclosure. Price: Out Of Stock.
",163,874008,874171
6346,sentence,"Price: Out Of Stock.

Product: Orico NGFF M.2 Hard Drive Enclosure. Category: Orico. Subcategory: HDD-SSD Enclosure. Price: Out Of Stock.
",138,874150,874288
6347,sentence,"Price: Out Of Stock.

Product: Orico 1106SS 3.5 inch 5.25 Bay Stainless Internal Hard Drive Mounting Bracket Adapter. Category: Orico. Subcategory: HDD-SSD Enclosure. Price: Out Of Stock.
",188,874267,874455
6348,sentence,"Price: Out Of Stock.

Product: Orico PDM2 M.2 NVME to PCI-E3.0 X4 Expansion Card. Category: Orico. Subcategory: HDD-SSD Enclosure. Price: Out Of Stock.
",152,874434,874586
6349,sentence,"Price: Out Of Stock.

Product: Orico M2PF-C3 M.2 Type-C SSD Enclosure. Category: Orico. Subcategory: HDD-SSD Enclosure. Price: Out Of Stock.
",141,874565,874706
6350,sentence,"Price: Out Of Stock.

Product: Orico PWM2 Type-C 5Gbps M.2 NGFF SATA SSD Enclosure. Category: Orico. Subcategory: HDD-SSD Enclosure. Price: Out Of Stock.
",154,874685,874839
6351,sentence,"Price: Out Of Stock.

Product: Orico TCM2-C3 M.2 Sata SSD Enclosure. Category: Orico. Subcategory: HDD-SSD Enclosure. Price: Out Of Stock.

Product: Ugreen 30848 2.5 Inch Hard Drive Box Enclosure. ",197,874818,875015
6352,sentence,"Category: UGREEN. Subcategory: HDD-SSD Enclosure. Price: Out Of Stock.

Product: UGREEN CM471 2.5 Inch USB Hard Drive Enclosure #30719. Category: UGREEN. Subcategory: HDD-SSD Enclosure. ",186,875015,875201
6353,sentence,"Subcategory: HDD-SSD Enclosure. Price: Out Of Stock.

Product: Ugreen USB Type-C 2.5 Inch SATA III Hard Drive Enclosure (Case Only) #50743. Category: UGREEN. Subcategory: HDD-SSD Enclosure. ",190,875169,875359
6354,sentence,"Subcategory: HDD-SSD Enclosure. Price: Out Of Stock.

Product: UGREEN US221 2.5 inch USB 3.1 Hard Drive Enclosure #60735. Category: UGREEN. Subcategory: HDD-SSD Enclosure. Price: Out Of Stock.
",193,875327,875520
6355,sentence,"Price: Out Of Stock.

Product: UGREEN US222 USB 3.0 SATA Hard Drive Enclosure #50422. Category: UGREEN. Subcategory: HDD-SSD Enclosure. Price: Out Of Stock.
",157,875499,875656
6356,sentence,"Price: Out Of Stock.

Product: UGREEN CM578 M.2 NVMe SSD Enclosure #15512. Category: UGREEN. Subcategory: HDD-SSD Enclosure. Price: Out Of Stock.
",146,875635,875781
6357,sentence,"Price: Out Of Stock.

Product: UGREEN CM400 M.2 SATA and NVMe SSD Enclosure #90264. Category: UGREEN. Subcategory: HDD-SSD Enclosure. Price: Out Of Stock.
",155,875760,875915
6358,sentence,"Price: Out Of Stock.

Product: Ugreen M2 Sata SSD Case Enclosure USB Type A to Type C 3.1. Category: UGREEN. Subcategory: HDD-SSD Enclosure. Price: Out Of Stock.
",162,875894,876056
6359,sentence,"Price: Out Of Stock.

Product: VENTION KPKH0 M.2 NVMe SSD Enclosure. Category: Vention. Subcategory: HDD-SSD Enclosure. Price: 2,700৳.

Product: Cooler Master Oracle Air M.2 NVMe SSD Enclosure. ",194,876035,876229
6360,sentence,"Category: Cooler Master. Subcategory: HDD-SSD Enclosure. Price: Out Of Stock.

Product: Deli CT703 2 Pin 4 Port 3 Meter Power Strip. Category: Deli. Subcategory: Power Strip. Price: 650৳750৳.
",192,876229,876421
6361,sentence,"Subcategory: Power Strip. Price: 650৳750৳.

Product: Deli CT704 2 Pin 4 Port 5 Meter Power Strip. Category: Deli. Subcategory: Power Strip. Price: 850৳950৳.
",157,876378,876535
6362,sentence,"Subcategory: Power Strip. Price: 850৳950৳.

Product: Deli CT705 2 Pin 6 Port 3 Meter Power Strip. Category: Deli. Subcategory: Power Strip. Price: 850৳950৳.
",157,876492,876649
6363,sentence,"Subcategory: Power Strip. Price: 850৳950৳.

Product: Deli CT703ES 3 Pin 4 Port 3 Meter Power Strip With Surge Protection. Category: Deli. Subcategory: Power Strip. Price: 1,050৳1,200৳.
",185,876606,876791
6364,sentence,"Subcategory: Power Strip. Price: 1,050৳1,200৳.

Product: Deli CT705ES 3 Pin 6 Port 3 Meter Power Strip With Surge Protection. Category: Deli. Subcategory: Power Strip. Price: 1,199৳1,300৳.
",189,876744,876933
6365,sentence,"Subcategory: Power Strip. Price: 1,199৳1,300৳.

Product: Deli ET410 2 Pin 3 Port 2 Meter Power Strip. Category: Deli. Subcategory: Power Strip. Price: 1,650৳1,700৳.
",165,876886,877051
6366,sentence,"Subcategory: Power Strip. Price: 1,650৳1,700৳.

Product: Deli CT711 4 Port 2 Meter Power Strip. Category: Deli. Subcategory: Power Strip. Price: 1,699৳1,800৳.
",159,877004,877163
6367,sentence,"Subcategory: Power Strip. Price: 1,699৳1,800৳.

Product: Deli ET404 Universal Hole Extension Cord 2 Pin 4 Port 5 Meter Power Strip. Category: Deli. Subcategory: Power Strip. Price: Out Of Stock.
",195,877116,877311
6368,sentence,"Subcategory: Power Strip. Price: Out Of Stock.

Product: Deli ET403 Universal Hole Extension Cord 2 Pin 4 Port 3 Meter Power Strip. Category: Deli. Subcategory: Power Strip. Price: Out Of Stock.
",195,877264,877459
6369,sentence,"Subcategory: Power Strip. Price: Out Of Stock.

Product: Deli ET405 2 Pin 6 Port 3 Meter Power Strip. Category: Deli. Subcategory: Power Strip. Price: Out Of Stock.
",165,877412,877577
6370,sentence,"Subcategory: Power Strip. Price: Out Of Stock.

Product: Deli CT411 2 Pin 4 Port 2 Meter Power Strip. Category: Deli. Subcategory: Power Strip. Price: Out Of Stock.
",165,877530,877695
6371,sentence,"Subcategory: Power Strip. Price: Out Of Stock.

Product: Deli ET411 2 Pin 4 Port 2 Meter Power Strip. Category: Deli. Subcategory: Power Strip. Price: Out Of Stock.
",165,877648,877813
6372,sentence,"Subcategory: Power Strip. Price: Out Of Stock.

Product: Nano NPS 205 5-Port 2-Pin White Power Strip. Category: Power Strip. Subcategory: Accessories. Price: 399৳650৳.
",168,877766,877934
6373,sentence,"Subcategory: Accessories. Price: 399৳650৳.

Product: Havit HV-SP8813 3AC Slot+3 USB Switch Power Strip. Category: Power Strip. Subcategory: Accessories. Price: 749৳800৳.
",170,877891,878061
6374,sentence,"Subcategory: Accessories. Price: 749৳800৳.

Product: Huntkey SZM401 4 Port Socket 2Core Cable Power Strip. Category: Power Strip. Subcategory: Accessories. Price: 680৳850৳.
",173,878018,878191
6375,sentence,"Subcategory: Accessories. Price: 680৳850৳.

Product: Nano MBS 405 5-Port Power Strip White (3 Pin Power Plug). Category: Power Strip. Subcategory: Accessories. Price: 550৳1,000৳.
",179,878148,878327
6376,sentence,"Subcategory: Accessories. Price: 550৳1,000৳.

Product: Nano MBS 405 5-Port Power Strip White (2 Pin Power Plug). Category: Power Strip. Subcategory: Accessories. Price: 600৳1,000৳.
",181,878282,878463
6377,sentence,"Subcategory: Accessories. Price: 600৳1,000৳.

Product: Nano NPS 709 8-Port Power Strip White (3 Pin Power Plug). Category: Power Strip. Subcategory: Accessories. Price: 700৳1,000৳.
",181,878418,878599
6378,sentence,"Subcategory: Accessories. Price: 700৳1,000৳.

Product: Huntkey SZM604 6 Ports Power Strip With Surge Protection. Category: Power Strip. Subcategory: Accessories. Price: 930৳1,550৳.
",181,878554,878735
6379,sentence,"Subcategory: Accessories. Price: 930৳1,550৳.

Product: Hoco AC12A Reise 6-Ports Multifunctional Power Strip. Category: Power Strip. Subcategory: Accessories. Price: 1,350৳1,650৳.
",179,878690,878869
6380,sentence,"Subcategory: Accessories. Price: 1,350৳1,650৳.

Product: Belkin Economy Series 3-Socket Surge Protector 1.5 Meter Power Strip (F9E300ZB). Category: Power Strip. Subcategory: Accessories. ",187,878822,879009
6381,sentence,"Subcategory: Accessories. Price: 1,550৳1,700৳.

Product: Huntkey SZM804 Eight Port Surge Protection Power Strip. Category: Power Strip. Subcategory: Accessories. Price: 1,599৳1,800৳.
",183,878983,879166
6382,sentence,"Subcategory: Accessories. Price: 1,599৳1,800৳.

Product: LDNIO SC3412 3 AC Outlets Universal Power Strip. Category: Power Strip. Subcategory: Accessories. Price: 1,690৳2,000৳.
",176,879119,879295
6383,sentence,"Subcategory: Accessories. Price: 1,690৳2,000৳.

Product: Huntkey SZN601 6 Port 3 Pin Power Strip with Surge Protection. Category: Power Strip. Subcategory: Accessories. Price: 1,899৳2,100৳.
",190,879248,879438
6384,sentence,"Subcategory: Accessories. Price: 1,899৳2,100৳.

Product: Belkin Economy Series 4-Socket Surge Protector 1.5 Meter Power Strip (F9E400ZB). Category: Power Strip. Subcategory: Accessories. ",187,879391,879578
6385,sentence,"Subcategory: Accessories. Price: 1,850৳2,200৳.

Product: Huntkey PZC504 FivePorts 3 Line Surge Protection PowerStrip. Category: Huntkey. Subcategory: Power Strip. Price: 2,080৳2,700৳.
",184,879552,879736
6386,sentence,"Subcategory: Power Strip. Price: 2,080৳2,700৳.

Product: Huntkey SZN507 Power Strip. Category: Huntkey. Subcategory: Power Strip. Price: 2,099৳2,800৳.
",151,879689,879840
6387,sentence,"Subcategory: Power Strip. Price: 2,099৳2,800৳.

Product: Huntkey PZA402 4 AC Ports with 4 Switch Surge Protection PowerStrip. Category: Huntkey. Subcategory: Power Strip. Price: Out Of Stock.
",192,879793,879985
6388,sentence,"Subcategory: Power Strip. Price: Out Of Stock.

Product: Huntkey SZN501 5 Port 3 Pin Power Strip with Surge protection. Category: Huntkey. Subcategory: Power Strip. Price: Out Of Stock.
",186,879938,880124
6389,sentence,"Subcategory: Power Strip. Price: Out Of Stock.

Product: Maxline ML Q455 2 Pin 4 Port Multiplug Power Strip with 10 Meter Cable. Category: Maxline. Subcategory: Power Strip. Price: Up Coming.
",192,880077,880269
6390,sentence,"Subcategory: Power Strip. Price: Up Coming.

Product: Maxline ML Q455 2 Pin 4 Port Multiplug Power Strip with 2 Meter Cable. Category: Maxline. Subcategory: Power Strip. Price: Out Of Stock.
",191,880225,880416
6391,sentence,"Subcategory: Power Strip. Price: Out Of Stock.

Product: Maxline ML Q455 2 Pin 4 Port Multiplug Power Strip with 5 Meter Cable. Category: Maxline. Subcategory: Power Strip. Price: Out Of Stock.
",194,880369,880563
6392,sentence,"Subcategory: Power Strip. Price: Out Of Stock.

Product: Maxline ML-254-3M 2 Pin Plug 4 Gang Multi Extension Socket Power Strip. Category: Maxline. Subcategory: Power Strip. Price: Out Of Stock.
",195,880516,880711
6393,sentence,"Subcategory: Power Strip. Price: Out Of Stock.

Product: Maxline ML-255-5M 2 Pin Plug 5 Gang Multi Extension Socket Power-Strip. Category: Maxline. Subcategory: Power Strip. Price: Out Of Stock.
",195,880664,880859
6394,sentence,"Subcategory: Power Strip. Price: Out Of Stock.

Product: Maxline ML-804 USB Fast Charging Multiplug Power Strip. Category: Maxline. Subcategory: Power Strip. Price: Out Of Stock.
",179,880812,880991
6395,sentence,"Subcategory: Power Strip. Price: Out Of Stock.

Product: Maxline Ml-604 4 USB Fast Charging Multiplug Power Strip. Category: Maxline. Subcategory: Power Strip. Price: Out Of Stock.
",181,880944,881125
6396,sentence,"Subcategory: Power Strip. Price: Out Of Stock.

Product: MaxLine ML-704 4 USB Port 3 Socket Multiplug Power Strip. Category: Maxline. Subcategory: Power Strip. Price: Out Of Stock.
",181,881078,881259
6397,sentence,"Subcategory: Power Strip. Price: Out Of Stock.

Product: Maxline ML-825-5M 10 Port Multi Extension Socket Power-Strip. Category: Maxline. Subcategory: Power Strip. Price: Out Of Stock.
",185,881212,881397
6398,sentence,"Subcategory: Power Strip. Price: Out Of Stock.

Product: Maxline ML-254-5M 2 Pin Plug 4 Gang Multi Extension Socket Power-Strip. Category: Maxline. Subcategory: Power Strip. Price: Out Of Stock.
",195,881350,881545
6399,sentence,"Subcategory: Power Strip. Price: Out Of Stock.

Product: Maxline ML-358-3M Wire 5 Gang Multiplug Power Strip. Category: Maxline. Subcategory: Power Strip. Price: Out Of Stock.
",176,881498,881674
6400,sentence,"Subcategory: Power Strip. Price: Out Of Stock.

Product: ORICO HPC-4A5U-V1-EU 4 AC Outlet Surge Protector with 5 USB Charging Port Smart Power Strip. Category: ORICO. Subcategory: Power Strip. ",193,881627,881820
6401,sentence,"Category: ORICO. Subcategory: Power Strip. Price: 2,650৳3,100৳.

Product: Baseus PowerCombo Lite 6 Ports Power Strip. Category: Baseus. Subcategory: Power Strip. Price: 3,890৳4,270৳.
",183,881777,881960
6402,sentence,"Subcategory: Power Strip. Price: 3,890৳4,270৳.

Product: Anker 615 USB Power Strip (GaNPrime 65W). Category: Anker. Subcategory: Power Strip. Price: Up Coming.
",160,881913,882073
6403,sentence,"Subcategory: Power Strip. Price: Up Coming.

Product: Anker PowerExtend 3 Plug USB Type-C Power Strip. Category: Anker. Subcategory: Power Strip. Price: Out Of Stock.
",167,882029,882196
6404,sentence,"Subcategory: Power Strip. Price: Out Of Stock.

Product: Belkin Economy Series 6-Socket Surge Protector 2 Meter Power Strip (F9E600ZB2M). Category: Belkin. Subcategory: Power Strip. ",182,882149,882331
6405,sentence,"Category: Belkin. Subcategory: Power Strip. Price: 2,150৳2,400৳.

Product: Belkin Economy Series 8-Socket Surge Protector 2 Meter Power Strip (F9E800ZB). Category: Belkin. Subcategory: Power Strip. ",198,882287,882485
6406,sentence,"Category: Belkin. Subcategory: Power Strip. Price: 2,699৳3,000৳.

Product: Hoco UA18 Bluetooth 5.0 USB Adapter Black. Category: Bluetooth Adapter. Subcategory: Accessories. Price: 340৳370৳.
",190,882441,882631
6407,sentence,"Subcategory: Accessories. Price: 340৳370৳.

Product: Hoco UA28 Bluetooth 5.1 USB Adapter. Category: Bluetooth Adapter. Subcategory: Accessories. Price: 350৳380৳.
",162,882588,882750
6408,sentence,"Subcategory: Accessories. Price: 350৳380৳.

Product: Baseus BA04 5.0 Bluetooth Receiver Adapter. Category: Bluetooth Adapter. Subcategory: Accessories. Price: 460৳500৳.
",169,882707,882876
6409,sentence,"Subcategory: Accessories. Price: 460৳500৳.

Product: Orico BTA-508 USB Bluetooth 5.0 Adapter. Category: Bluetooth Adapter. Subcategory: Accessories. Price: 500৳540৳.
",166,882833,882999
6410,sentence,"Subcategory: Accessories. Price: 500৳540৳.

Product: Vention NAFB0 USB Apt-X Bluetooth 5.1 Adapter. Category: Bluetooth Adapter. Subcategory: Accessories. Price: 650৳710৳.
",172,882956,883128
6411,sentence,"Subcategory: Accessories. Price: 650৳710৳.

Product: UGREEN CM591 USB Bluetooth 5.3 Adapter. Category: Bluetooth Adapter. Subcategory: Accessories. Price: 720৳.
",161,883085,883246
6412,sentence,"Subcategory: Accessories. Price: 720৳.

Product: Yuanxin YLY-021 USB Bluetooth 5.4 Adapter. Category: Bluetooth Adapter. Subcategory: Accessories. Price: 680৳730৳.
",164,883207,883371
6413,sentence,"Subcategory: Accessories. Price: 680৳730৳.

Product: UGREEN CM748 USB Bluetooth v5.4 Adapter #35058. Category: Bluetooth Adapter. Subcategory: Accessories. Price: 730৳800৳.
",173,883328,883501
6414,sentence,"Subcategory: Accessories. Price: 730৳800৳.

Product: TP-Link UB400 Bluetooth 4.0 Nano USB Adapter. Category: Bluetooth Adapter. Subcategory: Accessories. Price: 740৳810৳.
",171,883458,883629
6415,sentence,"Subcategory: Accessories. Price: 740৳810৳.

Product: TP-Link UB500 Bluetooth 5.0 Nano USB Adapter. Category: Bluetooth Adapter. Subcategory: Accessories. Price: 790৳850৳.
",171,883586,883757
6416,sentence,"Subcategory: Accessories. Price: 790৳850৳.

Product: Ugreen BT301 USB Bluetooth Adapter #35994. Category: Bluetooth Adapter. Subcategory: Accessories. Price: 840৳910৳.
",168,883714,883882
6417,sentence,"Subcategory: Accessories. Price: 840৳910৳.

Product: Vention NAHB0 USB Bluetooth 5.3 Adapter. Category: Bluetooth Adapter. Subcategory: Accessories. Price: 890৳960৳.
",166,883839,884005
6418,sentence,"Subcategory: Accessories. Price: 890৳960৳.

Product: Baseus BA07 5.3 Bluetooth Receiver Adapter. Category: Bluetooth Adapter. Subcategory: Accessories. Price: 950৳1,040৳.
",171,883962,884133
6419,sentence,"Subcategory: Accessories. Price: 950৳1,040৳.

Product: TRENDnet TBW-107UB Micro Bluetooth USB Adapter. Category: Bluetooth Adapter. Subcategory: Accessories. Price: 1,140৳1,250৳.
",179,884088,884267
6420,sentence,"Subcategory: Accessories. Price: 1,140৳1,250৳.

Product: TRENDnet TBW-110UB USB Bluetooth 5.0 Adapter. Category: Bluetooth Adapter. Subcategory: Accessories. Price: 1,450৳1,550৳.
",179,884220,884399
6421,sentence,"Subcategory: Accessories. Price: 1,450৳1,550৳.

Product: UGREEN CM276 Bluetooth Audio Receiver #70303. Category: Bluetooth Adapter. Subcategory: Accessories. Price: 1,720৳1,850৳.
",179,884352,884531
6422,sentence,"Subcategory: Accessories. Price: 1,720৳1,850৳.

Product: Ugreen CM106 Wireless Bluetooth Audio Receiver 5.0 with 3.5mm and 2RCA Adapter #40759. Category: Bluetooth Adapter. Subcategory: Accessories. ",199,884484,884683
6423,sentence,"Subcategory: Accessories. Price: 2,050৳2,199৳.

Product: Ugreen CM123 Wireless Bluetooth Audio Receiver 5.0 with 3.5mm and 2RCA Adapter with SRRC #30445. Category: Bluetooth Adapter. ",183,884657,884840
6424,sentence,"Category: Bluetooth Adapter. Subcategory: Accessories. Price: 2,090৳2,199৳.

Product: UGREEN CM123 Wireless Bluetooth Audio Receiver #30445. Category: Bluetooth Adapter. Subcategory: Accessories. ",196,884811,885007
6425,sentence,"Subcategory: Accessories. Price: 2,200৳.

Product: Ugreen CM279 3.5mm Bluetooth Audio Receiver #70304. Category: Bluetooth Adapter. Subcategory: Accessories. Price: 2,340৳2,550৳.
",179,884981,885160
6426,sentence,"Subcategory: Accessories. Price: 2,340৳2,550৳.

Product: Hoco AC7A Storm 7-Ports Power Strip. Category: Hoco. Subcategory: Power Strip. Price: Up Coming.
",154,885113,885267
6427,sentence,"Subcategory: Power Strip. Price: Up Coming.

Product: Hoco AC11A Voyage 6-Ports Expansion Power Strip. Category: Hoco. Subcategory: Power Strip. Price: Out Of Stock.
",166,885223,885389
6428,sentence,"Subcategory: Power Strip. Price: Out Of Stock.

Product: Hoco AC8A Storm 7-Ports PD30W Power Strip. Category: Hoco. Subcategory: Power Strip. Price: Out Of Stock.
",163,885342,885505
6429,sentence,"Subcategory: Power Strip. Price: Out Of Stock.

Product: Xiaomi Mi Smart LED Bulb Essential (White and Color). Category: Gadget. Price: 1,400৳1,499৳.
",150,885458,885608
6430,sentence,"Category: Gadget. Price: 1,400৳1,499৳.

Product: Xiaomi Portable Electric Air Compressor 2. Category: Gadget. Price: 4,950৳5,199৳.

Product: Yison Celebrat G35 3.5mm Wired Earphone. ",182,885569,885751
6431,sentence,"Category: Gadget. Price: 130৳.

Product: Yison Celebrat G3 3.5mm Wired Earphone. Category: Gadget. Price: 140৳.

Product: CHARG DME63 3.5MM Wired Earphone. Category: Gadget. Price: 140৳.
",187,885751,885938
6432,sentence,"Category: Gadget. Price: 140৳.

Product: CHARG DME62 3.5MM Wired Earphone. Category: Gadget. Price: 160৳.

Product: Yison Celebrat G13 3.5mm Wired Earphone. Category: Gadget. Price: 170৳.
",188,885907,886095
6433,sentence,"Category: Gadget. Price: 170৳.

Product: FONENG T15 Half-In-Ear 3.5mm Heavy Bass Earphone. Category: Gadget. Price: 170৳.

Product: Yison Celebrat G28 3.5mm Wired Earphone. Category: Gadget. ",191,886064,886255
6434,sentence,"Category: Gadget. Price: 172৳.

Product: Yison Celebrat FLY-1 In-Ear Wired Earphone. Category: Gadget. Price: 190৳.

Product: FONENG EP200 3.5mm In-Ear Wired Earphone. Category: Gadget. Price: 190৳.
",199,886237,886436
6435,sentence,"Category: Gadget. Price: 190৳.

Product: Yison Celebrat D2 3.5mm Wired Premium Earphone. Category: Gadget. Price: 195৳.

Product: Oraimo OEP-320S In-Ear Wired Earphone. Category: Gadget. ",187,886405,886592
6436,sentence,"Category: Gadget. Price: 200৳.

Product: Oraimo Halo Lite In-Ear Wired Earphone. Category: Gadget. Price: 215৳.

Product: Hoco M97 Enjoy 3.5mm Wired Earphone. Category: Gadget. Price: 230৳.
",190,886574,886764
6437,sentence,"Category: Gadget. Price: 230৳.

Product: Riversong SEED+ EA64 Wired Earphone. Category: Gadget. Price: 180৳235৳.

Product: Yison Celebrat G9 Wired 3.5mm Earphone. Category: Gadget. Price: 240৳.
",194,886733,886927
6438,sentence,"Category: Gadget. Price: 240৳.

Product: Yison CX620 In-Ear Wired Earphone. Category: Gadget. Price: 240৳.

Product: FONENG T52 3.5mm In-Ear Wired Earphone. Category: Gadget. Price: 190৳249৳.
",192,886896,887088
6439,sentence,"Category: Gadget. Price: 190৳249৳.

Product: Recci REP-L15 3.5mm Wired Earphone. Category: Gadget. Price: 250৳.

Product: COLMI P81 Smart Watch. Category: Smart Watch. Subcategory: Gadget. ",189,887053,887242
6440,sentence,"Category: Smart Watch. Subcategory: Gadget. Price: 1,426৳1,550৳.

Product: Yison Celebrat SW2Pro Smart Watch. Category: Smart Watch. Subcategory: Gadget. Price: 1,520৳1,650৳.
",175,887198,887373
6441,sentence,"Subcategory: Gadget. Price: 1,520৳1,650৳.

Product: COLMI P71 Smart Watch. Category: Smart Watch. Subcategory: Gadget. Price: 1,518৳1,650৳.
",140,887331,887471
6442,sentence,"Subcategory: Gadget. Price: 1,518৳1,650৳.

Product: Oraimo Watch 5 Max Bluetooth Calling Smart Watch (Tahilalats Edition). Category: Smart Watch. Subcategory: Gadget. Price: 1,590৳1,699৳.
",188,887429,887617
6443,sentence,"Subcategory: Gadget. Price: 1,590৳1,699৳.

Product: Zeblaze GTS 3. Category: Smart Watch. Subcategory: Gadget. Price: 1,590৳1,699৳.

Product: Oraimo Watch 5 Lite Smart Watch. Category: Smart Watch. ",198,887575,887773
6444,sentence,"Category: Smart Watch. Subcategory: Gadget. Price: 1,565৳1,799৳.

Product: Yison Celebrat SW6Pro Smart Watch. Category: Smart Watch. Subcategory: Gadget. Price: 1,690৳1,820৳.
",175,887750,887925
6445,sentence,"Subcategory: Gadget. Price: 1,690৳1,820৳.

Product: COLMI P76 Smart Watch. Category: Smart Watch. Subcategory: Gadget. Price: 1,701৳1,890৳.

Product: Zeblaze Btalk 3 Plus. Category: Smart Watch. ",195,887883,888078
6446,sentence,"Category: Smart Watch. Subcategory: Gadget. Price: 1,760৳1,899৳.

Product: COLMI P73 Smart Watch. Category: Smart Watch. Subcategory: Gadget. Price: 1,791৳1,990৳.
",163,888055,888218
6447,sentence,"Subcategory: Gadget. Price: 1,791৳1,990৳.

Product: Riversong Motive 6 Pro Smart Watch. Category: Smart Watch. Subcategory: Gadget. Price: 1,779৳1,999৳.

Product: Haylou Watch S6 Smart Watch. ",192,888176,888368
6448,sentence,"
Product: Haylou Watch S6 Smart Watch. Category: Smart Watch. Subcategory: Gadget. Price: 1,800৳1,999৳.

Product: Riversong Motive 3C SW31 Smart Watch. Category: Smart Watch. Subcategory: Gadget. ",196,888329,888525
6449,sentence,"Category: Smart Watch. Subcategory: Gadget. Price: 1,868৳2,099৳.

Product: XTRA Active S5 Pro+ Smart Watch. Category: Smart Watch. Subcategory: Gadget. Price: 1,920৳2,099৳.
",173,888481,888654
6450,sentence,"Subcategory: Gadget. Price: 1,920৳2,099৳.

Product: Havit M9035 Smart Watch. Category: Smart Watch. Subcategory: Gadget. Price: 1,978৳2,150৳.

Product: Awei H21 Smart Watch. Category: Smart Watch. ",197,888612,888809
6451,sentence,"Category: Smart Watch. Subcategory: Gadget. Price: 2,050৳2,190৳.

Product: Riversong Motive 3 SW30 Smart Watch. Category: Smart Watch. Subcategory: Gadget. Price: 2,090৳2,199৳.
",177,888786,888963
6452,sentence,"Subcategory: Gadget. Price: 2,090৳2,199৳.

Product: QCY Watch GS Bluetooth Calling Smart Watch. Category: Smart Watch. Subcategory: Gadget. Price: 2,138৳2,299৳.
",161,888921,889082
6453,sentence,"Subcategory: Gadget. Price: 2,138৳2,299৳.

Product: Imilab IMIKI Frame 2 Lite Smart Watch. Category: Smart Watch. Subcategory: Gadget. Price: 1,931৳2,299৳.

Product: COLMI V73 Smart Watch. ",189,889040,889229
6454,sentence,"
Product: COLMI V73 Smart Watch. Category: Smart Watch. Subcategory: Gadget. Price: 2,090৳2,322৳.

Product: Fantech PAC1 Portable Handheld Charger Fan. Category: Mini Fan. Subcategory: Gadget. ",193,889196,889389
6455,sentence,"Category: Mini Fan. Subcategory: Gadget. Price: 510৳560৳.

Product: Yison Celebrat F6 Portable Fan. Category: Mini Fan. Subcategory: Gadget. Price: 590৳645৳.
",158,889348,889506
6456,sentence,"Subcategory: Gadget. Price: 590৳645৳.

Product: Vyvylabs VKL01 Babbit Handheld Fan. Category: Mini Fan. Subcategory: Gadget. Price: 720৳790৳.

Product: Yison Celebrat F4 Clip-on Portable Fan. ",192,889468,889660
6457,sentence,"Category: Mini Fan. Subcategory: Gadget. Price: 890৳960৳.

Product: Xiaomi Qualitell Y2 Portable Fan. Category: Mini Fan. Subcategory: Gadget. Price: 920৳999৳.
",160,889660,889820
6458,sentence,"Subcategory: Gadget. Price: 920৳999৳.

Product: Awei F32 Portable Rechargeable Mini Fan. Category: Mini Fan. Subcategory: Gadget. Price: 990৳1,080৳.
",149,889782,889931
6459,sentence,"Subcategory: Gadget. Price: 990৳1,080৳.

Product: Fantech PAC2 Portable Handheld Charger Fan. Category: Mini Fan. Subcategory: Gadget. Price: 1,180৳1,280৳.
",156,889891,890047
6460,sentence,"Subcategory: Gadget. Price: 1,180৳1,280৳.

Product: Vyvylabs D02 Handheld Foldable Clip Fan. Category: Mini Fan. Subcategory: Gadget. Price: 1,350৳1,450৳.
",155,890005,890160
6461,sentence,"Subcategory: Gadget. Price: 1,350৳1,450৳.

Product: Vyvylabs VKH01 Babbit High Speed Handheld Fan. Category: Mini Fan. Subcategory: Gadget. Price: 1,840৳1,990৳.
",161,890118,890279
6462,sentence,"Subcategory: Gadget. Price: 1,840৳1,990৳.

Product: Remax F23 Bladeless Rechargeable Neck Fan. Category: Mini Fan. Subcategory: Gadget. Price: 1,900৳2,050৳.

Product: Jisulife Neck Fan Pro1. ",191,890237,890428
6463,sentence,"
Product: Jisulife Neck Fan Pro1. Category: Mini Fan. Subcategory: Gadget. Price: 5,400৳5,899৳.

Product: Oraimo SmartHandheldfan 2 Rechargeable Fan. Category: Mini Fan. Subcategory: Gadget. ",191,890394,890585
6464,sentence,"Category: Mini Fan. Subcategory: Gadget. Price: Up Coming.

Product: Hoco HX60 Nimble Portable Handheld Rechargeable Mini Fan. Category: Mini Fan. Subcategory: Gadget. Price: Up Coming.
",186,890544,890730
6465,sentence,"Subcategory: Gadget. Price: Up Coming.

Product: Hoco HX61 Handheld Rechargeable Mini Fan. Category: Mini Fan. Subcategory: Gadget. Price: Up Coming.
",150,890691,890841
6466,sentence,"Subcategory: Gadget. Price: Up Coming.

Product: Hoco HX63 Handheld Mini Fan With Display. Category: Mini Fan. Subcategory: Gadget. Price: Up Coming.
",150,890802,890952
6467,sentence,"Subcategory: Gadget. Price: Up Coming.

Product: Hoco HX62 Handheld Mini Fan With Display. Category: Mini Fan. Subcategory: Gadget. Price: Up Coming.
",150,890913,891063
6468,sentence,"Subcategory: Gadget. Price: Up Coming.

Product: Hoco HX64 Handheld Mini Fan With Display. Category: Mini Fan. Subcategory: Gadget. Price: Up Coming.

Product: Yison Celebrat F1 Rechargeable Fan. ",196,891024,891220
6469,sentence,"
Product: Yison Celebrat F1 Rechargeable Fan. Category: Mini Fan. Subcategory: Gadget. Price: Out Of Stock.

Product: Plextone F2 Portable Handheld Charger Fan. Category: Mini Fan. ",181,891174,891355
6470,sentence,"Category: Mini Fan. Subcategory: Gadget. Price: Out Of Stock.

Product: Xiaomi Solove N9P Mini 2000mAh Portable Fan. Category: Mini Fan. Subcategory: Gadget. Price: Out Of Stock.
",179,891335,891514
6471,sentence,"Subcategory: Gadget. Price: Out Of Stock.

Product: Lenovo HT18 True Wireless Earbuds. Category: Earbuds. Subcategory: Gadget. Price: 650৳750৳.

Product: Awei T71 True Wireless Earbuds. ",186,891472,891658
6472,sentence,"
Product: Awei T71 True Wireless Earbuds. Category: Earbuds. Subcategory: Gadget. Price: 837৳910৳.

Product: FONENG BL135 Wireless Earbuds. Category: Earbuds. Subcategory: Gadget. Price: 900৳980৳.
",197,891616,891813
6473,sentence,"Subcategory: Gadget. Price: 900৳980৳.

Product: Hoco EQ24 Estrella Wireless Earbuds. Category: Earbuds. Subcategory: Gadget. Price: 950৳1,030৳.

Product: FONENG BL138 True Wireless Earbuds. ",190,891775,891965
6474,sentence,"
Product: FONENG BL138 True Wireless Earbuds. Category: Earbuds. Subcategory: Gadget. Price: 965৳1,049৳.

Product: Onikuma T308 Bluetooth Earbuds. Category: Earbuds. Subcategory: Gadget. ",187,891919,892106
6475,sentence,"Category: Earbuds. Subcategory: Gadget. Price: 1,040৳1,140৳.

Product: Awei T13 Pro TWS Waterproof Touch Sports Earbuds. Category: Earbuds. Subcategory: Gadget. Price: 972৳1,080৳.
",180,892066,892246
6476,sentence,"Subcategory: Gadget. Price: 972৳1,080৳.

Product: HOCO EQ2 Plus True Wireless Earbuds. Category: Earbuds. Subcategory: Gadget. Price: 990৳1,080৳.

Product: Hoco EW25 TWS Wireless Bluetooth Earbuds. ",198,892206,892404
6477,sentence,"Category: Earbuds. Subcategory: Gadget. Price: 934৳1,099৳.

Product: XTRA Buds T2 Wireless Bluetooth Earbuds. Category: Earbuds. Subcategory: Gadget. Price: 999৳1,099৳.
",169,892404,892573
6478,sentence,"Subcategory: Gadget. Price: 999৳1,099৳.

Product: Hoco EW201 True Wireless Earbuds. Category: Earbuds. Subcategory: Gadget. Price: 1,009৳1,134৳.

Product: Hoco EQ2 True Wireless Earbuds. ",187,892533,892720
6479,sentence,"
Product: Hoco EQ2 True Wireless Earbuds. Category: Earbuds. Subcategory: Gadget. Price: 1,050৳1,149৳.

Product: FONENG BL151 Half-In-Ear TWS Earbuds. Category: Earbuds. Subcategory: Gadget. ",191,892678,892869
6480,sentence,"Category: Earbuds. Subcategory: Gadget. Price: 1,050৳1,150৳.

Product: Yison Celebrat W52 True Wireless Earbuds. Category: Earbuds. Subcategory: Gadget. Price: 1,090৳1,190৳.
",174,892829,893003
6481,sentence,"Subcategory: Gadget. Price: 1,090৳1,190৳.

Product: Havit TW976 True Wireless Stereo Earbuds. Category: Earbuds. Subcategory: Gadget. Price: 1,062৳1,180৳.

Product: Awei T29 Pro Gaming Earbuds. ",194,892961,893155
6482,sentence,"
Product: Awei T29 Pro Gaming Earbuds. Category: Earbuds. Subcategory: Gadget. Price: 1,083৳1,190৳.

Product: Hoco EQ3 True Wireless Earbuds. Category: Earbuds. Subcategory: Gadget. ",182,893116,893298
6483,sentence,"Category: Earbuds. Subcategory: Gadget. Price: 1,120৳1,200৳.

Product: Choetech BH-T24 TWS Wireless Earbuds. Category: Earbuds. Subcategory: Gadget. Price: 1,150৳1,235৳.
",170,893258,893428
6484,sentence,"Subcategory: Gadget. Price: 1,150৳1,235৳.

Product: Awei T29P True Wireless Earbuds. Category: Earbuds. Subcategory: Gadget. Price: 1,130৳1,240৳.

Product: Awei T28 Pro TWS Gaming Earbuds. ",189,893386,893575
6485,sentence,"
Product: Awei T28 Pro TWS Gaming Earbuds. Category: Earbuds. Subcategory: Gadget. Price: 1,140৳1,250৳.

Product: Xiaomi Mi Band 8 Smart Bracelet. Category: Smart Band. Subcategory: Gadget. ",190,893532,893722
6486,sentence,"Category: Smart Band. Subcategory: Gadget. Price: 3,902৳4,590৳.

Product: Huawei Band 10 (Global Variant). Category: Smart Band. Subcategory: Gadget. Price: 4,999৳.
",165,893679,893844
6487,sentence,"Subcategory: Gadget. Price: 4,999৳.

Product: Huawei Band 6 All-Day SpO2 Monitoring with FullView Display. Category: Smart Band. Subcategory: Gadget. Price: 5,190৳5,999৳.
",171,893808,893979
6488,sentence,"Subcategory: Gadget. Price: 5,190৳5,999৳.

Product: Xiaomi Smart Band 8 Pro. Category: Smart Band. Subcategory: Gadget. Price: 7,109৳7,899৳.

Product: Xiaomi Smart Band 9 Active. ",179,893937,894116
6489,sentence,"
Product: Xiaomi Smart Band 9 Active. Category: Smart Band. Subcategory: Gadget. Price: Out Of Stock.

Product: Xiaomi Smart Band 9 Pro. Category: Smart Band. Subcategory: Gadget. ",180,894078,894258
6490,sentence,"Category: Smart Band. Subcategory: Gadget. Price: Out Of Stock.

Product: Amazfit Band 7. Category: Smart Band. Subcategory: Gadget. Price: Out Of Stock.
",154,894215,894369
6491,sentence,"Subcategory: Gadget. Price: Out Of Stock.

Product: Xiaomi Smart Band 7 AMOLED Display Fitness Tracker (CN Variant). Category: Smart Band. Subcategory: Gadget. Price: Out Of Stock.
",181,894327,894508
6492,sentence,"Subcategory: Gadget. Price: Out Of Stock.

Product: Honor CHOICE MOECEN Band AMOLED Bluetooth Calling Smart band. Category: Smart Band. Subcategory: Gadget. Price: Out Of Stock.
",178,894466,894644
6493,sentence,"Subcategory: Gadget. Price: Out Of Stock.

Product: Xiaomi Mi Smart Band 9 AMOLED Fitness Tracker (CN Variant). Category: Smart Band. Subcategory: Gadget. Price: Out Of Stock.
",176,894602,894778
6494,sentence,"Subcategory: Gadget. Price: Out Of Stock.

Product: HUAWEI Band 8 AMOLED Display Fitness Tracker Smart Band. Category: Smart Band. Subcategory: Gadget. Price: Out Of Stock.

Product: Huawei Band 9. ",198,894736,894934
6495,sentence,"Price: Out Of Stock.

Product: Huawei Band 9. Category: Smart Band. Subcategory: Gadget. Price: Out Of Stock.

Product: Honor Band 9 AMOLED Fitness Tracker Smart Band (CN Variant). ",181,894888,895069
6496,sentence,"Category: Smart Band. Subcategory: Gadget. Price: Out Of Stock.

Product: Xiaomi Mi Band 7 Pro (CN Edition). Category: Smart Band. Subcategory: Gadget. Price: Out Of Stock.
",173,895069,895242
6497,sentence,"Subcategory: Gadget. Price: Out Of Stock.

Product: Ray-Ban Meta Wayfarer Smart Glasses. Category: Smart Glasses. Subcategory: Gadget. Price: Pre Order.

Product: Ray-Ban Meta Skyler Smart Glasses. ",198,895200,895398
6498,sentence,"
Product: Ray-Ban Meta Skyler Smart Glasses. Category: Smart Glasses. Subcategory: Gadget. Price: Pre Order.

Product: Ray-Ban Meta Headliner Smart Glasses. Category: Smart Glasses. ",182,895353,895535
6499,sentence,"Category: Smart Glasses. Subcategory: Gadget. Price: Pre Order.

Product: COLMI G06 Smart Glasses. Category: Smart Glasses. Subcategory: Gadget. Price: Out Of Stock.
",166,895510,895676
6500,sentence,"Subcategory: Gadget. Price: Out Of Stock.

Product: Lenovo HE05X Bluetooth Neckband Earphone Black. Category: Neckband. Subcategory: Gadget. Price: 450৳490৳.
",158,895634,895792
6501,sentence,"Subcategory: Gadget. Price: 450৳490৳.

Product: Lenovo HE05 Bluetooth Neckband Earphone Black. Category: Neckband. Subcategory: Gadget. Price: 450৳490৳.
",153,895754,895907
6502,sentence,"Subcategory: Gadget. Price: 450৳490৳.

Product: XTRA N25 In-Ear Stereo Wireless Neckband. Category: Neckband. Subcategory: Gadget. Price: 540৳590৳.
",148,895869,896017
6503,sentence,"Subcategory: Gadget. Price: 540৳590৳.

Product: Hoco ES64 Ultra Sports Bluetooth Wireless Neckband Earphone. Category: Neckband. Subcategory: Gadget. Price: 650৳699৳.
",167,895979,896146
6504,sentence,"Subcategory: Gadget. Price: 650৳699৳.

Product: Lenovo HE05X II (New Edition) Bluetooth Neckband Earphone Black. Category: Neckband. Subcategory: Gadget. Price: 640৳699৳.
",171,896108,896279
6505,sentence,"Subcategory: Gadget. Price: 640৳699৳.

Product: Hoco ES64 Sports Bluetooth Wireless Neckband Earphone. Category: Neckband. Subcategory: Gadget. Price: 640৳699৳.
",161,896241,896402
6506,sentence,"Subcategory: Gadget. Price: 640৳699৳.

Product: FONENG BL40 Bluetooth Neckband. Category: Neckband. Subcategory: Gadget. Price: 850৳930৳.

Product: FONENG BL34 Wireless Bluetooth Neckband Earphone. ",198,896364,896562
6507,sentence,"Category: Neckband. Subcategory: Gadget. Price: 699৳750৳.

Product: Hoco ES67 Bluetooth Wireless Neckband. Category: Neckband. Subcategory: Gadget. Price: 585৳640৳.
",165,896562,896727
6508,sentence,"Subcategory: Gadget. Price: 585৳640৳.

Product: Hoco ES61 Manner Wireless Earphones with Mic. Category: Neckband. Subcategory: Gadget. Price: 750৳820৳.

Product: Hoco ES69 In-ear Bluetooth Neckband. ",199,896689,896888
6509,sentence,"
Product: Hoco ES69 In-ear Bluetooth Neckband. Category: Neckband. Subcategory: Gadget. Price: 750৳820৳.

Product: Hoco ES70 Armour Bluetooth Wireless Neckband Earphone. Category: Neckband. ",190,896841,897031
6510,sentence,"Category: Neckband. Subcategory: Gadget. Price: 749৳820৳.

Product: Hoco ES65 Crystal Sports Bluetooth Wireless Neckband. Category: Neckband. Subcategory: Gadget. Price: 783৳880৳.
",180,897011,897191
6511,sentence,"Subcategory: Gadget. Price: 783৳880৳.

Product: XTRA N40 Wireless Bluetooth Neckband. Category: Neckband. Subcategory: Gadget. Price: 790৳850৳.

Product: CHARG CL8 Type C Neckband. ",181,897153,897334
6512,sentence,"
Product: CHARG CL8 Type C Neckband. Category: Neckband. Subcategory: Gadget. Price: 610৳660৳.

Product: Riversong EA65 Stream N+ Bluetooth Neckband. Category: Neckband. Subcategory: Gadget. ",191,897297,897488
6513,sentence,"Category: Neckband. Subcategory: Gadget. Price: 790৳850৳.

Product: Hoco ES63 Graceful Air Conduction Wireless Neckband. Category: Neckband. Subcategory: Gadget. Price: 1,050৳1,150৳.
",183,897447,897630
6514,sentence,"Subcategory: Gadget. Price: 1,050৳1,150৳.

Product: WiWU GB01 Wireless Neckband. Category: Neckband. Subcategory: Gadget. Price: 916৳1,030৳.

Product: Yison E17 Waterproof Wireless In Ear Neckband. ",198,897588,897786
6515,sentence,"Category: Neckband. Subcategory: Gadget. Price: 890৳950৳.

Product: Hoco ES72 Bluetooth Neckband. Category: Neckband. Subcategory: Gadget. Price: 1,050৳1,134৳.

Product: Ximax R02 Smart Ring. ",192,897786,897978
6516,sentence,"
Product: Ximax R02 Smart Ring. Category: Smart Ring. Subcategory: Gadget. Price: 2,549৳2,990৳.

Product: COLMI R02 Smart Ring. Category: Smart Ring. Subcategory: Gadget. Price: 2,850৳3,099৳.
",192,897946,898138
6517,sentence,"Subcategory: Gadget. Price: 2,850৳3,099৳.

Product: COLMI R12 Smart Ring. Category: Smart Ring. Subcategory: Gadget. Price: 3,650৳3,942৳.

Product: Amazfit Helio Smart Ring. Category: Smart Ring. ",196,898096,898292
6518,sentence,"Category: Smart Ring. Subcategory: Gadget. Price: Out Of Stock.

Product: Oraimo Halo 2S OEP-E21P in-ear Earphone. Category: Earphone. Subcategory: Gadget. Price: 255৳.
",169,898270,898439
6519,sentence,"Subcategory: Gadget. Price: 255৳.

Product: CHARG DME61 Type C Wired Earphone. Category: Earphone. Subcategory: Gadget. Price: 260৳.

Product: TX10 Pro 4K Android TV Box with Voice Control Remote. ",197,898405,898602
6520,sentence,"Category: TV Box. Subcategory: Gadget. Price: 2,450৳2,650৳.

Product: Xiaomi TV Box S (2nd Gen) with Google TV. Category: TV Box. Subcategory: Gadget. Price: Out Of Stock.
",172,898602,898774
6521,sentence,"Subcategory: Gadget. Price: Out Of Stock.

Product: Xiaomi TV Box S 3rd Gen Android TV Box. Category: TV Box. Subcategory: Gadget. Price: 6,999৳8,000৳.
",152,898732,898884
6522,sentence,"Subcategory: Gadget. Price: 6,999৳8,000৳.

Product: Apple TV 4K 128GB 3rd Generation TV Box. Category: TV Box. Subcategory: Gadget. Price: 25,000৳30,000৳.
",155,898842,898997
6523,sentence,"Subcategory: Gadget. Price: 25,000৳30,000৳.

Product: TX3 Mini-A Android 7.1 2GB RAM 16GB ROM TV Box. Category: TV Box. Subcategory: Gadget. Price: Out Of Stock.
",162,898953,899115
6524,sentence,"Subcategory: Gadget. Price: Out Of Stock.

Product: TX60 Pro 14K Ultra HD Smart Android TV Box with Voice Control Remote. Category: TV Box. Subcategory: Gadget. Price: Out Of Stock.
",182,899073,899255
6525,sentence,"Subcategory: Gadget. Price: Out Of Stock.

Product: Xiaomi Mi MDZ-27-EU HDMI Android 4K TV Stick. Category: TV Box. Subcategory: Gadget. Price: 4,999৳6,000৳.
",158,899213,899371
6526,sentence,"Subcategory: Gadget. Price: 4,999৳6,000৳.

Product: Google Chromecast with Google TV 4K. Category: TV Box. Subcategory: Gadget. Price: Out Of Stock.
",149,899329,899478
6527,sentence,"Subcategory: Gadget. Price: Out Of Stock.

Product: Apple TV HD A1625 32GB 4th Generation TV Box (MHY93ZP/A). Category: TV Box. Subcategory: Gadget. Price: Out Of Stock.
",170,899436,899606
6528,sentence,"Subcategory: Gadget. Price: Out Of Stock.

Product: Apple TV 4K 32GB 6th Generation TV Box 2021 (MXGY2). Category: TV Box. Subcategory: Gadget. Price: Out Of Stock.
",165,899564,899729
6529,sentence,"Subcategory: Gadget. Price: Out Of Stock.

Product: Apple TV 4K 64GB 6th Generation TV Box 2021 (MXH02). Category: TV Box. Subcategory: Gadget. Price: Out Of Stock.
",165,899687,899852
6530,sentence,"Subcategory: Gadget. Price: Out Of Stock.

Product: Lewitt LCT 440 PURE Large-Diaphragm Cardioid Condenser Microphone. Category: Studio Microphones. Subcategory: Studio Equipment. ",180,899810,899990
6531,sentence,"Subcategory: Studio Equipment. Price: 50,000৳55,000৳.

Product: Maono AU-A03 Professional Condenser Studio Microphone Kit. Category: Studio Microphones. Subcategory: Studio Equipment. ",184,899959,900143
6532,sentence,"Subcategory: Studio Equipment. Price: 3,800৳4,500৳.

Product: RODE SM6 Studio Microphone Shock Mount With Detachable Pop Filter. Category: Studio Microphones. Subcategory: Studio Equipment. ",190,900112,900302
6533,sentence,"Subcategory: Studio Equipment. Price: 9,300৳.

Product: RODE VideoMicro II Ultracompact Camera-Mount Shotgun Microphone for Cameras and Smartphones. Category: Studio Microphones. ",179,900271,900450
6534,sentence,"Category: Studio Microphones. Subcategory: Studio Equipment. Price: 12,500৳15,000৳.

Product: RODE Lavalier II Omnidirectional Lavalier Microphone. Category: Studio Microphones. ",178,900420,900598
6535,sentence,"Category: Studio Microphones. Subcategory: Studio Equipment. Price: 13,500৳16,000৳.

Product: RODE VideoMic GO II Ultracompact Analog/USB Camera-Mount Shotgun Microphone. ",171,900568,900739
6536,sentence,"Category: Studio Microphones. Subcategory: Studio Equipment. Price: 15,500৳17,000৳.

Product: Audio Technica AT2020 Cardioid Condenser Microphone. Category: Studio Microphones. ",177,900739,900916
6537,sentence,"Category: Studio Microphones. Subcategory: Studio Equipment. Price: 17,000৳20,000৳.

Product: Audio Technica AT2040 Hypercardioid Dynamic Podcast Microphone. Category: Studio Microphones. ",188,900886,901074
6538,sentence,"Category: Studio Microphones. Subcategory: Studio Equipment. Price: 19,000৳23,000৳.

Product: Lewitt LCT-240 Pro Condenser Microphone. Category: Studio Microphones. Subcategory: Studio Equipment. ",196,901044,901240
6539,sentence,"Subcategory: Studio Equipment. Price: 20,500৳25,000৳.

Product: RODE PSA1+ Professional Studio Arm. Category: Studio Microphones. Subcategory: Studio Equipment. Price: 23,000৳26,000৳.
",184,901209,901393
6540,sentence,"Price: 23,000৳26,000৳.

Product: RODE M3 Versatile End-Address Condenser Microphone. Category: Studio Microphones. Subcategory: Studio Equipment. Price: 22,000৳27,000৳.
",169,901370,901539
6541,sentence,"Price: 22,000৳27,000৳.

Product: RODE X XCM-50 Compact USB-C Condenser Microphone. Category: Studio Microphones. Subcategory: Studio Equipment. Price: 25,000৳28,000৳.
",167,901516,901683
6542,sentence,"Price: 25,000৳28,000৳.

Product: Audio Technica AT2050 Multi-pattern Condenser Microphone. Category: Studio Microphones. Subcategory: Studio Equipment. Price: 25,000৳29,000৳.
",175,901660,901835
6543,sentence,"Price: 25,000৳29,000৳.

Product: RODE X XDM-100 Dynamic USB-C Microphone. Category: Studio Microphones. Subcategory: Studio Equipment. Price: 33,000৳37,000৳.
",158,901812,901970
6544,sentence,"Price: 33,000৳37,000৳.

Product: RODE Wireless PRO Clip-On Wireless Microphone. Category: Studio Microphones. Subcategory: Studio Equipment. Price: 43,500৳47,000৳.
",164,901947,902111
6545,sentence,"Price: 43,500৳47,000৳.

Product: Audio Technica AT4040 Cardioid Condenser Microphone. Category: Studio Microphones. Subcategory: Studio Equipment. Price: 49,500৳57,000৳.
",170,902088,902258
6546,sentence,"Price: 49,500৳57,000৳.

Product: Shure SM7B Cardioid Dynamic Vocal Microphone. Category: Studio Microphones. Subcategory: Studio Equipment. Price: 67,000৳75,000৳.
",163,902235,902398
6547,sentence,"Price: 67,000৳75,000৳.

Product: Lewitt RAY Large-Diaphragm Condenser Microphone. Category: Studio Microphones. Subcategory: Studio Equipment. Price: 67,000৳75,000৳.
",166,902375,902541
6548,sentence,"Price: 67,000৳75,000৳.

Product: Shure SM7dB Vocal Microphone with Built-In Preamp. Category: Studio Microphones. Subcategory: Studio Equipment. Price: 77,000৳85,000৳.
",168,902518,902686
6549,sentence,"Price: 77,000৳85,000৳.

Product: Audio Technica AT4050 Multi-pattern Condenser Microphone. Category: Studio Microphones. Subcategory: Studio Equipment. Price: 86,000৳95,000৳.
",175,902663,902838
6550,sentence,"Price: 86,000৳95,000৳.

Product: M-Audio BX4 BT 4.5"" Bluetooth Studio Monitor Speaker. Category: Studio Monitors. Subcategory: Studio Equipment. Price: 26,500৳33,000৳.
",168,902815,902983
6551,sentence,"Price: 26,500৳33,000৳.

Product: M-Audio BX5 D3 5"" Studio Monitor Speaker. Category: Studio Monitors. Subcategory: Studio Equipment. Price: 39,000৳44,000৳.
",156,902960,903116
6552,sentence,"Price: 39,000৳44,000৳.

Product: JBL 305P MKII Studio Monitor Speaker. Category: Studio Monitors. Subcategory: Studio Equipment. Price: 41,000৳47,000৳.
",152,903093,903245
6553,sentence,"Price: 41,000৳47,000৳.

Product: JBL 306P MKII Studio Monitor Speaker. Category: Studio Monitors. Subcategory: Studio Equipment. Price: 52,000৳60,000৳.
",152,903222,903374
6554,sentence,"Price: 52,000৳60,000৳.

Product: Yamaha HS5 5"" Powered Studio Monitor Speaker. Category: Studio Monitors. Subcategory: Studio Equipment. Price: 56,000৳62,000৳.
",160,903351,903511
6555,sentence,"Price: 56,000৳62,000৳.

Product: KRK ROKIT 5 G5 5"" 2-Way Active Studio Monitor. Category: Studio Monitors. Subcategory: Studio Equipment. Price: 58,000৳66,000৳.
",161,903488,903649
6556,sentence,"Price: 58,000৳66,000৳.

Product: JBL 308P MKII Studio Monitor Speaker. Category: Studio Monitors. Subcategory: Studio Equipment. Price: 63,000৳72,000৳.
",152,903626,903778
6557,sentence,"Price: 63,000৳72,000৳.

Product: Yamaha HS7 6.5"" Powered Studio Monitor Speaker. Category: Studio Monitors. Subcategory: Studio Equipment. Price: 82,000৳90,000৳.
",162,903755,903917
6558,sentence,"Price: 82,000৳90,000৳.

Product: Focal Alpha 50 EVO Active 2-way Studio Monitor Speaker. Category: Studio Monitors. Subcategory: Studio Equipment. Price: 115,000৳127,000৳.
",172,903894,904066
6559,sentence,"Price: 115,000৳127,000৳.

Product: Genelec 8030C 5"" 2-Way 100W Active Studio Monitor Speaker. Category: Studio Monitors. Subcategory: Studio Equipment. Price: 157,000৳173,000৳.
",177,904041,904218
6560,sentence,"Price: 157,000৳173,000৳.

Product: Focal Alpha 65 EVO Studio Monitor Speaker. Category: Studio Monitors. Subcategory: Studio Equipment. Price: 165,000৳180,000৳.
",161,904193,904354
6561,sentence,"Price: 165,000৳180,000৳.

Product: Genelec 8040B 6.5"" 2-Way 180W Active Studio Monitor Speaker. Category: Studio Monitors. Subcategory: Studio Equipment. Price: 253,000৳273,000৳.
",179,904329,904508
6562,sentence,"Price: 253,000৳273,000৳.

Product: M-Audio BX4 4.5"" Studio Monitor Speaker. Category: Studio Monitors. Subcategory: Studio Equipment. Price: Out Of Stock.
",155,904483,904638
6563,sentence,"Price: Out Of Stock.

Product: Edifier R2750DB Active 2.0 Tri-Amp Bluetooth Bookshelf Speaker. Category: Studio Monitors. Subcategory: Studio Equipment. Price: 24,999৳25,500৳.
",176,904617,904793
6564,sentence,"Price: 24,999৳25,500৳.

Product: Microlab SOLO 16 2.0 Two-Way Stereo Bluetooth Monitor Speaker. Category: Studio Monitors. Subcategory: Studio Equipment. Price: 26,999৳.
",170,904770,904940
6565,sentence,"Subcategory: Studio Equipment. Price: 26,999৳.

Product: Microlab SOLO 29 2.0 Bluetooth Hi-Fi Monitor Speaker. Category: Studio Monitors. Subcategory: Studio Equipment. Price: 31,500৳32,500৳.
",192,904893,905085
6566,sentence,"Price: 31,500৳32,500৳.

Product: Neumann NDH 30 Open-Back Professsional Studio Headphone. Category: Studio Headphones. Subcategory: Studio Equipment. Price: 90,000৳95,000৳.
",173,905062,905235
6567,sentence,"Price: 90,000৳95,000৳.

Product: JTS HP-535 Professional Studio Monitor Headphones. Category: Studio Headphones. Subcategory: Studio Equipment. Price: Out Of Stock.
",165,905212,905377
6568,sentence,"Price: Out Of Stock.

Product: AKG Pro Audio K72 Closed-Back Studio Headphone. Category: Studio Headphones. Subcategory: Studio Equipment. Price: 7,800৳8,900৳.
",160,905356,905516
6569,sentence,"Price: 7,800৳8,900৳.

Product: Audio Technica ATH-M20x Professional Studio Monitor Headphone. Category: Studio Headphones. Subcategory: Studio Equipment. Price: 9,000৳11,000৳.
",176,905495,905671
6570,sentence,"Price: 9,000৳11,000৳.

Product: Audio-Technica ATH-M20xBT Over-Ear Bluetooth Headphone. Category: Studio Headphones. Subcategory: Studio Equipment. Price: 11,000৳13,000৳.
",171,905649,905820
6571,sentence,"Price: 11,000৳13,000৳.

Product: Audio Technica ATH-M30x Professional Studio Monitor Headphone. Category: Studio Headphones. Subcategory: Studio Equipment. Price: 10,500৳14,000৳.
",179,905797,905976
6572,sentence,"Price: 10,500৳14,000৳.

Product: Sennheiser HD 200 PRO Wireless Studio Headphone. Category: Studio Headphones. Subcategory: Studio Equipment. Price: 10,500৳14,000৳.
",165,905953,906118
6573,sentence,"Price: 10,500৳14,000৳.

Product: AKG K240 STUDIO Professional Headphone. Category: Studio Headphones. Subcategory: Studio Equipment. Price: 13,500৳15,000৳.
",156,906095,906251
6574,sentence,"Price: 13,500৳15,000৳.

Product: Audio technica ATH-M40x Professional Studio Monitor Headphone. Category: Studio Headphones. Subcategory: Studio Equipment. Price: 15,000৳18,000৳.
",179,906228,906407
6575,sentence,"Price: 15,000৳18,000৳.

Product: AKG K240 MKII Professional Studio Headphone. Category: Studio Headphones. Subcategory: Studio Equipment. Price: 15,500৳18,000৳.
",161,906384,906545
6576,sentence,"Price: 15,500৳18,000৳.

Product: Sennheiser HD 25 Wired Studio Headphone. Category: Studio Headphones. Subcategory: Studio Equipment. Price: 16,000৳19,500৳.
",157,906522,906679
6577,sentence,"Price: 16,000৳19,500৳.

Product: Audio technica ATH-M50x Professional Studio Monitor Headphone. Category: Studio Headphones. Subcategory: Studio Equipment. Price: 19,200৳22,000৳.
",179,906656,906835
6578,sentence,"Price: 19,200৳22,000৳.

Product: Audio Technica ATH-M50xSTS USB StreamSet Streaming Headset. Category: Studio Headphones. Subcategory: Studio Equipment. Price: 28,000৳33,000৳.
",176,906812,906988
6579,sentence,"Price: 28,000৳33,000৳.

Product: Audio Technica ATH-M70x Professional Studio Monitor Headphone. Category: Studio Headphones. Subcategory: Studio Equipment. Price: 33,000৳36,000৳.
",179,906965,907144
6580,sentence,"Price: 33,000৳36,000৳.

Product: Beyerdynamic DT 770 PRO 250 Ohm Over-Ear Studio Headphone. Category: Studio Headphones. Subcategory: Studio Equipment. Price: 33,000৳38,000৳.
",175,907121,907296
6581,sentence,"Price: 33,000৳38,000৳.

Product: Beyerdynamic DT 990 Pro Open-back Studio Headphone. Category: Studio Headphones. Subcategory: Studio Equipment. Price: 35,500৳38,500৳.
",168,907273,907441
6582,sentence,"Price: 35,500৳38,500৳.

Product: AKG K52 Professional Closed Back Studio Monitor Headphone. Category: Studio Headphones. Subcategory: Studio Equipment. Price: Out Of Stock.
",173,907418,907591
6583,sentence,"Price: Out Of Stock.

Product: Sennheiser HD280 Pro Studio Monitoring Headphone. Category: Studio Headphones. Subcategory: Studio Equipment. Price: Out Of Stock.
",162,907570,907732
6584,sentence,"Price: Out Of Stock.

Product: Takstar MX1 Mini Portable Webcast Sound Card. Category: Studio Equipment. Subcategory: Gadget. Price: 4,200৳4,500৳.
",147,907711,907858
6585,sentence,"Subcategory: Gadget. Price: 4,200৳4,500৳.

Product: Maono Maonocaster AMC2 NEO One-Stop Streaming Audio Mixer & Sound Card. Category: Studio Equipment. Subcategory: Gadget. Price: 5,700৳5,900৳.
",194,907816,908010
6586,sentence,"Subcategory: Gadget. Price: 5,700৳5,900৳.

Product: M-Audio SP-2 Professional Piano Style Pedal. Category: Studio Equipment. Subcategory: Gadget. Price: 4,500৳6,000৳.
",167,907968,908135
6587,sentence,"Subcategory: Gadget. Price: 4,500৳6,000৳.

Product: Takstar SC-M1 Portable Live Broadcast Sound Card. Category: Studio Equipment. Subcategory: Gadget. Price: 9,700৳10,500৳.
",173,908093,908266
6588,sentence,"Subcategory: Gadget. Price: 9,700৳10,500৳.

Product: BOYA BY-AM4 Dual-Channel Type-C Audio Interface. Category: Studio Equipment. Subcategory: Gadget. Price: 9,000৳11,000৳.
",173,908223,908396
6589,sentence,"Subcategory: Gadget. Price: 9,000৳11,000৳.

Product: Takstar MX1 Set Live Broadcast Sound Card Set with Earphone & Microphone. Category: Studio Equipment. Subcategory: Gadget. Price: 18,990৳20,990৳.
",199,908353,908552
6590,sentence,"Subcategory: Gadget. Price: 18,990৳20,990৳.

Product: Focusrite Scarlett 2i2 3rd Generation PC Audio Interface. Category: Studio Equipment. Subcategory: Gadget. Price: 19,000৳23,000৳.
",184,908508,908692
6591,sentence,"Subcategory: Gadget. Price: 19,000৳23,000৳.

Product: Focusrite Scarlett 4i4 3rd Gen USB Recording Interface. Category: Studio Equipment. Subcategory: Gadget. Price: 25,000৳25,500৳.
",182,908648,908830
6592,sentence,"Subcategory: Gadget. Price: 25,000৳25,500৳.

Product: Focusrite Scarlett Solo 4th Gen Type-C Audio Interface. Category: Studio Equipment. Subcategory: Gadget. Price: 20,500৳26,000৳.
",182,908786,908968
6593,sentence,"Subcategory: Gadget. Price: 20,500৳26,000৳.

Product: Focusrite Scarlett Solo Studio 3rd Gen USB Audio Interface and Recording Bundle. Category: Studio Equipment. Subcategory: Gadget. ",184,908924,909108
6594,sentence,"Subcategory: Gadget. Price: 26,000৳30,000৳.

Product: Universal Audio Volt 2 USB-C Audio Interface. Category: Studio Equipment. Subcategory: Gadget. Price: 27,000৳30,000৳.
",172,909087,909259
6595,sentence,"Subcategory: Gadget. Price: 27,000৳30,000৳.

Product: Focusrite Scarlett 2i2 4th Gen Type-C Audio Interface. Category: Studio Equipment. Subcategory: Gadget. Price: 26,500৳30,000৳.
",181,909215,909396
6596,sentence,"Subcategory: Gadget. Price: 26,500৳30,000৳.

Product: M-Audio AIR 192|6 USB Audio Interface. Category: Studio Equipment. Subcategory: Gadget. Price: 27,000৳30,500৳.
",165,909352,909517
6597,sentence,"Subcategory: Gadget. Price: 27,000৳30,500৳.

Product: Focusrite Vocaster One Studio 1-Person Podcasting Kit. Category: Studio Equipment. Subcategory: Gadget. Price: 29,000৳32,000৳.
",181,909473,909654
6598,sentence,"Subcategory: Gadget. Price: 29,000৳32,000৳.

Product: M-Audio 4 Vocal Studio Pro air 192| Audio Interface. Category: Studio Equipment. Subcategory: Gadget. Price: 28,000৳33,000৳.
",179,909610,909789
6599,sentence,"Subcategory: Gadget. Price: 28,000৳33,000৳.

Product: Apogee One Audio Interface for MAC and PC. Category: Studio Equipment. Subcategory: Gadget. Price: 29,000৳34,500৳.
",169,909745,909914
6600,sentence,"Subcategory: Gadget. Price: 29,000৳34,500৳.

Product: Focusrite Scarlett 2i2 Studio 3rd Gen USB Audio Interface and Recording Bundle. Category: Studio Equipment. Subcategory: Gadget. ",183,909870,910053
6601,sentence,"Subcategory: Gadget. Price: 30,000৳35,000৳.

Product: Focusrite Scarlett 8i6 3rd Gen USB Audio Interface. Category: Studio Equipment. Subcategory: Gadget. Price: 33,000৳36,000৳.
",178,910032,910210
6602,sentence,"Subcategory: Gadget. Price: 33,000৳36,000৳.

Product: RODE X Streamer X Audio and Video Streaming Console. Category: Studio Equipment. Subcategory: Gadget. Price: 35,000৳38,000৳.
",179,910166,910345
6603,sentence,"Subcategory: Gadget. Price: 35,000৳38,000৳.

Product: Yison Celebrat PB-11 10000mAh Portable Power Bank. Category: Power Bank. Subcategory: Gadget. Price: 990৳1,049৳.
",167,910301,910468
6604,sentence,"Subcategory: Gadget. Price: 990৳1,049৳.

Product: Awei P20K 10000mah Power Bank. Category: Power Bank. Subcategory: Gadget. Price: 890৳1,090৳.

Product: Awei P37K 10000mAh Fast Charging Power Bank. ",198,910428,910626
6605,sentence,"Category: Power Bank. Subcategory: Gadget. Price: 830৳1,150৳.

Product: Hoco J101 Astute 10000mAh 22.5W Fast Charging Power Bank. Category: Power Bank. Subcategory: Gadget. Price: 1,050৳1,200৳.
",194,910626,910820
6606,sentence,"Subcategory: Gadget. Price: 1,050৳1,200৳.

Product: Joyroom JR-PBF12 10000mAh 12W 2.4A LED Power Bank. Category: Power Bank. Subcategory: Gadget. Price: 800৳1,200৳.
",165,910778,910943
6607,sentence,"Subcategory: Gadget. Price: 800৳1,200৳.

Product: Fantech S2 10000mAh Power Bank. Category: Power Bank. Subcategory: Gadget. Price: 890৳1,200৳.

Product: Awei P5K 10000mAh Fast Charging Power Bank. ",198,910903,911101
6608,sentence,"Category: Power Bank. Subcategory: Gadget. Price: 800৳1,250৳.

Product: Hoco J89 10000mAh 20W Fast Charging Digital Display Power Bank. Category: Power Bank. Subcategory: Gadget. ",179,911101,911280
6609,sentence,"Category: Power Bank. Subcategory: Gadget. Price: 1,070৳1,250৳.

Product: Foneng PX101 10000mAh 22.5W Power Bank. Category: Power Bank. Subcategory: Gadget. Price: 1,180৳1,349৳.
",178,911237,911415
6610,sentence,"Subcategory: Gadget. Price: 1,180৳1,349৳.

Product: Remax RPP-296 20000mah Fast Charging Power Bank. Category: Power Bank. Subcategory: Gadget. Price: 1,250৳1,350৳.
",165,911373,911538
6611,sentence,"Subcategory: Gadget. Price: 1,250৳1,350৳.

Product: Awei P10K 10000mah 22.5W Fast Charging Digital Display Power Bank. Category: Power Bank. Subcategory: Gadget. Price: 940৳1,350৳.
",181,911496,911677
6612,sentence,"Subcategory: Gadget. Price: 940৳1,350৳.

Product: Oraimo Toast 15 Flash OPB-1100 10000mAh 15W Type C Power Bank. Category: Power Bank. Subcategory: Gadget. Price: 1,160৳1,380৳.
",177,911637,911814
6613,sentence,"Subcategory: Gadget. Price: 1,160৳1,380৳.

Product: Remax RPP-26 Lango 2 Series 20000mah Fast Charging Power Bank. Category: Power Bank. Subcategory: Gadget. Price: 1,400৳.
",173,911772,911945
6614,sentence,"Subcategory: Gadget. Price: 1,400৳.

Product: Fantech S3 10000mAh Portable Power Bank. Category: Power Bank. Subcategory: Gadget. Price: 1,150৳1,400৳.
",151,911909,912060
6615,sentence,"Subcategory: Gadget. Price: 1,150৳1,400৳.

Product: MKB PK10 10000mAh Fast Charging Power Bank. Category: Power Bank. Subcategory: Gadget. Price: 1,400৳.
",154,912018,912172
6616,sentence,"Subcategory: Gadget. Price: 1,400৳.

Product: Remax RPP-626 20000mAh 2.1A Power Bank. Category: Power Bank. Subcategory: Gadget. Price: 1,250৳1,450৳.
",150,912136,912286
6617,sentence,"Subcategory: Gadget. Price: 1,250৳1,450৳.

Product: Hoco J105 10000mAh 22.5W Fast Charging Digital Display Power Bank. Category: Power Bank. Subcategory: Gadget. Price: 1,399৳1,450৳.
",183,912244,912427
6618,sentence,"Subcategory: Gadget. Price: 1,399৳1,450৳.

Product: CHARG CP03 10000mAh 10W Power Bank. Category: Power Bank. Subcategory: Gadget. Price: 999৳1,470৳.
",150,912385,912535
6619,sentence,"Subcategory: Gadget. Price: 999৳1,470৳.

Product: Foneng PX106 10000mAh 22.5W Power Bank With Built-in Type-C and IP Cables. Category: Power Bank. Subcategory: Gadget. Price: 1,299৳1,499৳.
",189,912495,912684
6620,sentence,"Subcategory: Gadget. Price: 1,299৳1,499৳.

Product: Awei P6K 20000mAh Double USB Power Bank. Category: Power Bank. Subcategory: Gadget. Price: 1,199৳1,500৳.
",157,912642,912799
6621,sentence,"Subcategory: Gadget. Price: 1,199৳1,500৳.

Product: Blackmagic Design ATEM Mini Pro HDMI Live Stream Switcher. Category: Switcher. Subcategory: Studio Equipment. Price: 53,000৳58,000৳.
",185,912757,912942
6622,sentence,"Price: 53,000৳58,000৳.

Product: Casio EMI External AC Power Adaptor +9.0v /2amp (LP). Category: Musical Keyboard. Subcategory: Studio Equipment. Price: 600৳900৳.
",163,912919,913082
6623,sentence,"Subcategory: Studio Equipment. Price: 600৳900৳.

Product: Casio SA-50 32-Keys Portable Musical Mini Keyboard Without Adapter. Category: Musical Keyboard. Subcategory: Studio Equipment. ",185,913034,913219
6624,sentence,"Subcategory: Studio Equipment. Price: 6,700৳8,000৳.

Product: Casio SA-51 32-Keys Portable Musical Mini Keyboard Without Adapter. Category: Musical Keyboard. Subcategory: Studio Equipment. ",189,913188,913377
6625,sentence,"Subcategory: Studio Equipment. Price: 6,700৳8,000৳.

Product: Casio SA-80 44-Keys Portable Musical Mini Keyboard Without Adapter. Category: Musical Keyboard. Subcategory: Studio Equipment. ",189,913346,913535
6626,sentence,"Subcategory: Studio Equipment. Price: 7,700৳9,000৳.

Product: Casio SA-81 44-Keys Portable Musical Mini Keyboard Without Adapter. Category: Musical Keyboard. Subcategory: Studio Equipment. ",189,913504,913693
6627,sentence,"Subcategory: Studio Equipment. Price: 8,500৳10,000৳.

Product: Casio CT-S100 Portable Musical Keyboard Piano Without Adapter. Category: Musical Keyboard. Subcategory: Studio Equipment. ",185,913662,913847
6628,sentence,"Subcategory: Studio Equipment. Price: 14,000৳17,000৳.

Product: CASIO CTK-2550 61-key Standard Musical Keyboard Without Adapter. Category: Musical Keyboard. Subcategory: Studio Equipment. ",188,913816,914004
6629,sentence,"Subcategory: Studio Equipment. Price: 15,500৳17,000৳.

Product: Casio CT-S200WE 61-Key Portable Musical Keyboard Piano Without Adapter. Category: Musical Keyboard. Subcategory: Studio Equipment. ",195,913973,914168
6630,sentence,"Subcategory: Studio Equipment. Price: 16,000৳18,000৳.

Product: Casio CT-S200BK 61-Key Portable Musical Keyboard Piano without Adapter. Category: Musical Keyboard. Subcategory: Studio Equipment. ",195,914137,914332
6631,sentence,"Subcategory: Studio Equipment. Price: 16,200৳19,000৳.

Product: CASIO CTK-3500 61-key Standard Musical Keyboard Without Adapter. Category: Musical Keyboard. Subcategory: Studio Equipment. ",188,914301,914489
6632,sentence,"Subcategory: Studio Equipment. Price: 21,000৳26,000৳.

Product: M-Audio Oxygen 49 49-Key MIDI Keyboard. Category: Musical Keyboard. Subcategory: Studio Equipment. Price: 25,500৳28,500৳.
",186,914458,914644
6633,sentence,"Price: 25,500৳28,500৳.

Product: CASIO CT-X870IN 61-key Portable Musical Keyboard Without Adapter. Category: Musical Keyboard. Subcategory: Studio Equipment. Price: 26,500৳29,000৳.
",181,914621,914802
6634,sentence,"Price: 26,500৳29,000৳.

Product: CASIO CT-X8000IN 61-key Portable Musical Keyboard With Adapter. Category: Musical Keyboard. Subcategory: Studio Equipment. Price: 33,000৳37,000৳.
",179,914779,914958
6635,sentence,"Price: 33,000৳37,000৳.

Product: Novation Impulse 49 49-key MIDI Keyboard Controller. Category: Musical Keyboard. Subcategory: Studio Equipment. Price: 40,000৳43,500৳.
",168,914935,915103
6636,sentence,"Price: 40,000৳43,500৳.

Product: Casio CT-S400 61-Keys Portable Musical Keyboard Without Adapter. Category: Musical Keyboard. Subcategory: Studio Equipment. Price: 38,000৳44,000৳.
",180,915080,915260
6637,sentence,"Price: 38,000৳44,000৳.

Product: Casio CT-S1RD 61-Key Portable Musical Keyboard Piano Without Adapter. Category: Musical Keyboard. Subcategory: Studio Equipment. Price: 39,000৳44,000৳.
",185,915237,915422
6638,sentence,"Price: 39,000৳44,000৳.

Product: Casio CT-S1WE 61-Key Portable Musical Keyboard Piano Without Adapter. Category: Musical Keyboard. Subcategory: Studio Equipment. Price: 39,000৳44,000৳.
",185,915399,915584
6639,sentence,"Price: 39,000৳44,000৳.

Product: Casio CT-S1BK 61-Key Portable Musical Keyboard Piano Without Adapter. Category: Musical Keyboard. Subcategory: Studio Equipment. Price: 39,000৳44,000৳.
",185,915561,915746
6640,sentence,"Price: 39,000৳44,000৳.

Product: Casio CT-X9000IN 61-key Standard Musical Keyboard With Adapter. Category: Musical Keyboard. Subcategory: Studio Equipment. Price: 57,000৳63,000৳.
",179,915723,915902
6641,sentence,"Price: 57,000৳63,000৳.

Product: Casio CT-S500 61-Keys Portable Musical Keyboard With Adapter. Category: Musical Keyboard. Subcategory: Studio Equipment. Price: 60,500৳66,000৳.
",177,915879,916056
6642,sentence,"Price: 60,500৳66,000৳.

Product: DJI Neo Standard. Category: DJI. Subcategory: Drones. Price: 26,000৳29,500৳.

Product: DJI Neo Fly More Combo Drone. Category: DJI. Subcategory: Drones. ",186,916033,916219
6643,sentence,"Category: DJI. Subcategory: Drones. Price: 39,900৳48,000৳.

Product: DJI Mini 4K Stardard. Category: DJI. Subcategory: Drones. Price: 43,500৳44,000৳.
",150,916183,916333
6644,sentence,"Subcategory: Drones. Price: 43,500৳44,000৳.

Product: DJI Mini 4K Fly More Combo Drone (Global Version). Category: DJI. Subcategory: Drones. Price: 54,000৳55,400৳.

Product: DJI Flip N3 Drone. ",193,916289,916482
6645,sentence,"
Product: DJI Flip N3 Drone. Category: DJI. Subcategory: Drones. Price: 50,600৳55,000৳.

Product: DJI Neo Motion Fly More Combo Drone. Category: DJI. Subcategory: Drones. Price: 55,900৳58,000৳.
",194,916453,916647
6646,sentence,"Subcategory: Drones. Price: 55,900৳58,000৳.

Product: DJI Flip Standard With RC2 Controller. Category: DJI. Subcategory: Drones. Price: 66,000৳72,000৳.
",152,916603,916755
6647,sentence,"Subcategory: Drones. Price: 66,000৳72,000৳.

Product: DJI Mini 3 Drone Fly More Combo with DJI RC Remote Controller. Category: DJI. Subcategory: Drones. Price: 73,800৳79,000৳.
",176,916711,916887
6648,sentence,"Subcategory: Drones. Price: 73,800৳79,000৳.

Product: DJI Flip Drone Fly More Combo. Category: DJI. Subcategory: Drones. Price: 79,999৳91,400৳.

Product: DJI MINI 4 PRO Fly More Combo + DJI RC2. ",195,916843,917038
6649,sentence,"Category: DJI. Subcategory: Drones. Price: 111,800৳120,000৳.

Product: DJI MINI 4 PRO Fly More Combo Plus + DJI RC2 (Global Version). Category: DJI. Subcategory: Drones. Price: Up Coming.
",188,917038,917226
6650,sentence,"Subcategory: Drones. Price: Up Coming.

Product: DJI Avata 2 Fly More Combo Drone with Goggles 3 & RC Motion 3 Controller. Category: DJI. Subcategory: Drones. Price: 124,499৳134,000৳.
",184,917187,917371
6651,sentence,"Subcategory: Drones. Price: 124,499৳134,000৳.

Product: DJI Air 3S Fly More Combo With DJI RC 2 Remote Controller. Category: DJI. Subcategory: Drones. Price: 157,999৳170,000৳.
",176,917325,917501
6652,sentence,"Subcategory: Drones. Price: 157,999৳170,000৳.

Product: DJI Mavic 4 Pro Fly More Combo. Category: DJI. Subcategory: Drones. Price: 279,900৳315,000৳.
",149,917455,917604
6653,sentence,"Subcategory: Drones. Price: 279,900৳315,000৳.

Product: DJI Mavic 3 Pro Fly More Combo 4K Drone with Remote Controller. Category: DJI. Subcategory: Drones. Price: 316,000৳385,000৳.
",181,917558,917739
6654,sentence,"Subcategory: Drones. Price: 316,000৳385,000৳.

Product: DJI Mavic 4 Pro Creator Combo With RC Pro 2. Category: DJI. Subcategory: Drones. Price: 379,900৳409,000৳.

Product: DJI Matrice 350 RTK Drone. ",199,917693,917892
6655,sentence,"
Product: DJI Matrice 350 RTK Drone. Category: DJI. Subcategory: Drones. Price: Call for Price.

Product: DJI P4 Multispectral Drone. Category: DJI. Subcategory: Drones. Price: Call for Price.
",193,917855,918048
6656,sentence,"Subcategory: Drones. Price: Call for Price.

Product: DJI Mavic 2 Enterprise Dual Edition Drone. Category: DJI. Subcategory: Drones. Price: Call for Price.
",156,918004,918160
6657,sentence,"Subcategory: Drones. Price: Call for Price.

Product: DJI Mavic 2 Enterprise Zoom Edition Drone. Category: DJI. Subcategory: Drones. Price: Call for Price.
",156,918116,918272
6658,sentence,"Subcategory: Drones. Price: Call for Price.

Product: Focusrite Scarlett 2i2 Studio 4th Gen USB Audio Interface Combo. Category: Audio Interfaces. Subcategory: Studio Equipment. ",178,918228,918406
6659,sentence,"Subcategory: Studio Equipment. Price: 39,000৳43,000৳.

Product: Focusrite Scarlett 18i8 3rd Gen USB Audio Interface. Category: Audio Interfaces. Subcategory: Studio Equipment. Price: 40,500৳45,000৳.
",199,918375,918574
6660,sentence,"Price: 40,500৳45,000৳.

Product: Focusrite Vocaster Two Studio 2-Person Podcasting Kit. Category: Audio Interfaces. Subcategory: Studio Equipment. Price: 41,000৳45,000৳.
",170,918551,918721
6661,sentence,"Price: 41,000৳45,000৳.

Product: Universal Audio Volt 276 USB-C Audio Interface. Category: Audio Interfaces. Subcategory: Studio Equipment. Price: 42,000৳48,000৳.
",163,918698,918861
6662,sentence,"Price: 42,000৳48,000৳.

Product: Yamaha MG10XU 10-Input Mixer with Built-In FX and USB. Category: Audio Interfaces. Subcategory: Studio Equipment. Price: 44,000৳50,000৳.
",170,918838,919008
6663,sentence,"Price: 44,000৳50,000৳.

Product: Solid State Logic SSL 2+ USB Audio Interface. Category: Audio Interfaces. Subcategory: Studio Equipment. Price: 45,000৳50,000৳.
",161,918985,919146
6664,sentence,"Price: 45,000৳50,000৳.

Product: Yamaha MG12XU 12-channel Mixer with USB and Effects. Category: Audio Interfaces. Subcategory: Studio Equipment. Price: 58,000৳61,000৳.
",168,919123,919291
6665,sentence,"Price: 58,000৳61,000৳.

Product: DK W1 Pro Folding 4K Toy Drone. Category: Mini Toy Drone. Subcategory: Drones. Price: 7,490৳11,000৳.

Product: DK W1 ProS 4K Toy Drone. Category: Mini Toy Drone. ",195,919268,919463
6666,sentence,"Category: Mini Toy Drone. Subcategory: Drones. Price: 7,990৳11,500৳.

Product: DK S6 Mini Dual Camera 6K Toy Drone With Wi-Fi & GPS. Category: Mini Toy Drone. Subcategory: Drones. ",180,919437,919617
6667,sentence,"Category: Mini Toy Drone. Subcategory: Drones. Price: 9,500৳17,000৳.

Product: DK W7 GPS 4K Toy Drone With RC Toy Remote. Category: Mini Toy Drone. Subcategory: Drones. Price: 16,500৳23,000৳.
",192,919570,919762
6668,sentence,"Subcategory: Drones. Price: 16,500৳23,000৳.

Product: DK W7 GPS 4K Toy Drone Without RC. Category: Mini Toy Drone. Subcategory: Drones. Price: 12,800৳18,000৳.

Product: DK U2 ProS 4K Toy Drone. ",194,919718,919912
6669,sentence,"
Product: DK U2 ProS 4K Toy Drone. Category: Mini Toy Drone. Subcategory: Drones. Price: 4,900৳7,500৳.

Product: DJI Inspire 3 Drone. Category: Enterprise Drone. Subcategory: Drones. ",183,919877,920060
6670,sentence,"Subcategory: Drones. Price: Out Of Stock.

Product: DJI Matrice 4E Enterprise Drone. Category: Enterprise Drone. Subcategory: Drones. Price: 860,000৳1,000,000৳.
",161,920039,920200
6671,sentence,"Subcategory: Drones. Price: 860,000৳1,000,000৳.

Product: Zhiyun SMOOTH-X2 Smartphone Gimbal. Category: Zhiyun. Subcategory: Gimbal. Price: 7,600৳9,100৳.
",154,920152,920306
6672,sentence,"Subcategory: Gimbal. Price: 7,600৳9,100৳.

Product: Zhiyun Smooth-Q3 3-Axis Gimbal Stabilizer. Category: Zhiyun. Subcategory: Gimbal. Price: 8,999৳9,600৳.
",155,920264,920419
6673,sentence,"Subcategory: Gimbal. Price: 8,999৳9,600৳.

Product: Zhiyun Smooth-Q3 Combo 3-Axis Gimbal Stabilizer. Category: Zhiyun. Subcategory: Gimbal. Price: 10,500৳11,000৳.
",163,920377,920540
6674,sentence,"Subcategory: Gimbal. Price: 10,500৳11,000৳.

Product: Zhiyun Smooth Q4 Handheld Gimbal Stabilizer. Category: Zhiyun. Subcategory: Gimbal. Price: 9,900৳10,600৳.
",160,920496,920656
6675,sentence,"Subcategory: Gimbal. Price: 9,900৳10,600৳.

Product: Zhiyun Smooth-X2 COMBO Smartphone Gimbal. Category: Zhiyun. Subcategory: Gimbal. Price: 10,400৳11,500৳.
",157,920613,920770
6676,sentence,"Subcategory: Gimbal. Price: 10,400৳11,500৳.

Product: Zhiyun SMOOTH 5 Smartphone Gimbal. Category: Zhiyun. Subcategory: Gimbal. Price: 13,690৳14,700৳.
",151,920726,920877
6677,sentence,"Subcategory: Gimbal. Price: 13,690৳14,700৳.

Product: Zhiyun Smooth 5S 3-Axis Smartphone Handheld Gimbal Combo. Category: Zhiyun. Subcategory: Gimbal. Price: 20,500৳22,100৳.
",174,920833,921007
6678,sentence,"Subcategory: Gimbal. Price: 20,500৳22,100৳.

Product: Zhiyun Crane-M2S Smartphone and Camera Handheld Stabilizer Gimbal. Category: Zhiyun. Subcategory: Gimbal. Price: 18,500৳21,400৳.
",183,920963,921146
6679,sentence,"Subcategory: Gimbal. Price: 18,500৳21,400৳.

Product: Zhiyun CRANE-M3 3-Axis Handheld Gimbal Stabilizer. Category: Zhiyun. Subcategory: Gimbal. Price: 23,999৳25,900৳.
",167,921102,921269
6680,sentence,"Subcategory: Gimbal. Price: 23,999৳25,900৳.

Product: Zhiyun CRANE-M3 COMBO 3-Axis Handheld Gimbal Stabilizer. Category: Zhiyun. Subcategory: Gimbal. Price: 28,800৳31,000৳.
",173,921225,921398
6681,sentence,"Subcategory: Gimbal. Price: 28,800৳31,000৳.

Product: Zhiyun Smooth-XS 2-Axis Gimbal for Smartphone. Category: Zhiyun. Subcategory: Gimbal. Price: Out Of Stock.
",161,921354,921515
6682,sentence,"Subcategory: Gimbal. Price: Out Of Stock.

Product: Zhiyun Smooth X Foldable Smartphone Gimbal. Category: Zhiyun. Subcategory: Gimbal. Price: Out Of Stock.
",156,921473,921629
6683,sentence,"Subcategory: Gimbal. Price: Out Of Stock.

Product: Zhiyun Smooth Q4 Combo Gimbal Stabilizer. Category: Zhiyun. Subcategory: Gimbal. Price: Out Of Stock.
",154,921587,921741
6684,sentence,"Subcategory: Gimbal. Price: Out Of Stock.

Product: Zhiyun Smooth 5S 3-Axis Smartphone Handheld Gimbal. Category: Zhiyun. Subcategory: Gimbal. Price: Out Of Stock.
",164,921699,921863
6685,sentence,"Subcategory: Gimbal. Price: Out Of Stock.

Product: Zhiyun Weebill S 3-Axis Gimbal Stabilizer for Cameras. Category: Zhiyun. Subcategory: Gimbal. Price: Out Of Stock.
",167,921821,921988
6686,sentence,"Subcategory: Gimbal. Price: Out Of Stock.

Product: Zhiyun Crane 2S 3-Axis Handheld Gimbal Stabilizer. Category: Zhiyun. Subcategory: Gimbal. Price: Out Of Stock.
",163,921946,922109
6687,sentence,"Subcategory: Gimbal. Price: Out Of Stock.

Product: Zhiyun WEEBILL-2 handheld 3-Axis Gimbal Stabilizer. Category: Zhiyun. Subcategory: Gimbal. Price: Out Of Stock.
",164,922067,922231
6688,sentence,"Subcategory: Gimbal. Price: Out Of Stock.

Product: Zhiyun Weebill 2S 3-Axis Handheld Gimbal Stabilizer. Category: Zhiyun. Subcategory: Gimbal. Price: Out Of Stock.
",165,922189,922354
6689,sentence,"Subcategory: Gimbal. Price: Out Of Stock.

Product: Zhiyun WEEBILL 3 Handheld Gimbal Stabilizer. Category: Zhiyun. Subcategory: Gimbal. Price: Out Of Stock.
",157,922312,922469
6690,sentence,"Subcategory: Gimbal. Price: Out Of Stock.

Product: Zhiyun Crane 3S 3-Axis Handheld Gimbal Stabilizer. Category: Zhiyun. Subcategory: Gimbal. Price: Out Of Stock.
",163,922427,922590
6691,sentence,"Subcategory: Gimbal. Price: Out Of Stock.

Product: DJI Osmo Pocket Waterproof Case. Category: DJI. Subcategory: Gimbal. Price: 7,000৳.
",136,922548,922684
6692,sentence,"Subcategory: Gimbal. Price: 7,000৳.

Product: DJI Osmo Mobile SE Smartphone Gimbal with 3-Axis Stabilization. Category: DJI. Subcategory: Gimbal. Price: 7,500৳9,500৳.
",167,922648,922815
6693,sentence,"Subcategory: Gimbal. Price: 7,500৳9,500৳.

Product: DJI Osmo Mobile 7 Smartphone Gimbal. Category: DJI. Subcategory: Gimbal. Price: 10,900৳11,700৳.
",148,922773,922921
6694,sentence,"Subcategory: Gimbal. Price: 10,900৳11,700৳.

Product: DJI Osmo Mobile 6 Foldable Smartphone Gimbal. Category: DJI. Subcategory: Gimbal. Price: 13,999৳15,000৳.
",159,922877,923036
6695,sentence,"Subcategory: Gimbal. Price: 13,999৳15,000৳.

Product: DJI Osmo Mobile 7P Smartphone Gimbal. Category: DJI. Subcategory: Gimbal. Price: 15,490৳16,700৳.
",151,922992,923143
6696,sentence,"Subcategory: Gimbal. Price: 15,490৳16,700৳.

Product: DJI RS 4 Mini Handheld Camera Gimbal Stabilizer. Category: DJI. Subcategory: Gimbal. Price: 31,990৳34,500৳.
",162,923099,923261
6697,sentence,"Subcategory: Gimbal. Price: 31,990৳34,500৳.

Product: DJI RS 3 Mini Gimbal Stabilizer. Category: DJI. Subcategory: Gimbal. Price: 26,900৳28,000৳.
",146,923217,923363
6698,sentence,"Subcategory: Gimbal. Price: 26,900৳28,000৳.

Product: DJI RS 4 Mini Handheld Camera Gimbal Stabilizer Combo. Category: DJI. Subcategory: Gimbal. Price: 39,900৳43,000৳.
",168,923319,923487
6699,sentence,"Subcategory: Gimbal. Price: 39,900৳43,000৳.

Product: DJI RS 4 Handheld Camera Gimbal Stabilizer. Category: DJI. Subcategory: Gimbal. Price: 48,990৳52,900৳.
",157,923443,923600
6700,sentence,"Subcategory: Gimbal. Price: 48,990৳52,900৳.

Product: DJI RS 3 Gimbal Stabilizer Combo. Category: DJI. Subcategory: Gimbal. Price: 48,900৳53,800৳.

Product: DJI OM 5 3 Axis Stable Gimbal. ",188,923556,923744
6701,sentence,"
Product: DJI OM 5 3 Axis Stable Gimbal. Category: DJI. Subcategory: Gimbal. Price: Out Of Stock.

Product: DJI Ronin-SC Handheld 3-Axis Camera Gimbal Stabilizer. Category: DJI. Subcategory: Gimbal. ",199,923703,923902
6702,sentence,"Category: DJI. Subcategory: Gimbal. Price: Out Of Stock.

Product: DJI RSC 2 3-Axis Gimbal Stabilizer. Category: DJI. Subcategory: Gimbal. Price: Out Of Stock.

Product: DJI RS 3 Gimbal Stabilizer. ",198,923866,924064
6703,sentence,"
Product: DJI RS 3 Gimbal Stabilizer. Category: DJI. Subcategory: Gimbal. Price: Out Of Stock.

Product: DJI RSC 2 Pro Combo Gimbal Stabilizer. Category: DJI. Subcategory: Gimbal. ",180,924026,924206
6704,sentence,"Category: DJI. Subcategory: Gimbal. Price: Out Of Stock.

Product: DJI RS 4 Handheld Camera Gimbal Stabilizer Combo. Category: DJI. Subcategory: Gimbal. Price: Out Of Stock.
",174,924170,924344
6705,sentence,"Subcategory: Gimbal. Price: Out Of Stock.

Product: K&F Concept DJI Drone Mini 3 Pro & Mini 3 Drone Filter Set (CPL+ND8+ND16) With a Set of Propellers. Category: Drone Accessories. ",181,924302,924483
6706,sentence,"Category: Drone Accessories. Subcategory: Drones. Price: 3,500৳4,000৳.

Product: K&F Concept DJI Avata Drone HD Filter Set (CPL+ND8+ND16). Category: Drone Accessories. Subcategory: Drones. ",189,924454,924643
6707,sentence,"Subcategory: Drones. Price: 4,000৳4,200৳.

Product: K&F Concept DJI Osmo Action3 HD Filter Set(CPL+ND8+ND16). Category: Drone Accessories. Subcategory: Drones. Price: 4,000৳4,500৳.
",181,924622,924803
6708,sentence,"Subcategory: Drones. Price: 4,000৳4,500৳.

Product: K&F Concept DJI Mavic 3 Classic HD Filter Set (CPL+ND8+ND16). Category: Drone Accessories. Subcategory: Drones. Price: 5,000৳5,300৳.
",185,924761,924946
6709,sentence,"Subcategory: Drones. Price: 5,000৳5,300৳.

Product: K&F Concept DJI Drone AIR 2S HD Filter Set (ND8/PL+ND16/PL+ND32/PL+ND64/PL) with a Set of Propellers. Category: Drone Accessories. ",183,924904,925087
6710,sentence,"Category: Drone Accessories. Subcategory: Drones. Price: 6,500৳6,800৳.

Product: K&F Concept DJI Mavic 3 PRO Drone (CPL+ND8+ND16) Filter Set. Category: Drone Accessories. Subcategory: Drones. ",192,925058,925250
6711,sentence,"Subcategory: Drones. Price: 6,500৳7,000৳.

Product: DJI Mini 3 Pro Fly More Kit. Category: Drone Accessories. Subcategory: Drones. Price: 30,000৳.
",147,925229,925376
6712,sentence,"Subcategory: Drones. Price: 30,000৳.

Product: DJI D-RTK 2 High-Precision GNSS Mobile Station Tripod. Category: Drone Accessories. Subcategory: Drones. Price: 30,000৳.
",168,925339,925507
6713,sentence,"Subcategory: Drones. Price: 30,000৳.

Product: DJI Mini 3 Pro Fly More Kit Plus. Category: Drone Accessories. Subcategory: Drones. Price: 29,000৳35,000৳.

Product: DJI RC Drone Remote Controller. ",196,925470,925666
6714,sentence,"
Product: DJI RC Drone Remote Controller. Category: Drone Accessories. Subcategory: Drones. Price: 34,500৳35,000৳.

Product: DJI Zenmuse H20 Triple-Sensor Drone Camera. Category: Drone Accessories. ",198,925624,925822
6715,sentence,"Category: Drone Accessories. Subcategory: Drones. Price: Call for Price.

Product: DJI Matrice 300 TB60 Intelligent Flight Battery. Category: Drone Accessories. Subcategory: Drones. ",182,925793,925975
6716,sentence,"Subcategory: Drones. Price: Out Of Stock.

Product: DJI RC Pro Drone Remote Controller. Category: Drone Accessories. Subcategory: Drones. Price: Call for Price.
",161,925954,926115
6717,sentence,"Subcategory: Drones. Price: Call for Price.

Product: DJI ZENMUSE P1 Drone Camera. Category: Drone Accessories. Subcategory: Drones. Price: Call for Price.
",156,926071,926227
6718,sentence,"Subcategory: Drones. Price: Call for Price.

Product: DJI Zenmuse H20N UAV Load Gimbal Camera. Category: Drone Accessories. Subcategory: Drones. Price: Call for Price.
",168,926183,926351
6719,sentence,"Subcategory: Drones. Price: Call for Price.

Product: DJI Zenmuse H20T Quad-Sensor Drone Camera. Category: Drone Accessories. Subcategory: Drones. Price: Call for Price.
",170,926307,926477
6720,sentence,"Subcategory: Drones. Price: Call for Price.

Product: DJI Zenmuse L1 Drone Camera. Category: Drone Accessories. Subcategory: Drones. Price: Call for Price.
",156,926433,926589
6721,sentence,"Subcategory: Drones. Price: Call for Price.

Product: DJI Mavic Air 2 Intelligent Flight Battery. Category: Drone Accessories. Subcategory: Drones. Price: Out Of Stock.
",169,926545,926714
6722,sentence,"Subcategory: Drones. Price: Out Of Stock.

Product: DJI Avata Fly More Kit. Category: Drone Accessories. Subcategory: Drones. Price: Out Of Stock.
",147,926672,926819
6723,sentence,"Subcategory: Drones. Price: Out Of Stock.

Product: DJI D-RTK 2 High Precision GNSS Mobile Station. Category: Drone Accessories. Subcategory: Drones. Price: Out Of Stock.
",171,926777,926948
6724,sentence,"Subcategory: Drones. Price: Out Of Stock.

Product: Hohem iSteady XE Kit Smartphone Gimbal Stabilizer. Category: Gimbal. Subcategory: Gadget. Price: 6,900৳7,500৳.
",163,926906,927069
6725,sentence,"Subcategory: Gadget. Price: 6,900৳7,500৳.

Product: Hohem iSteady X3 SE Foldable Gimbal Stabilizer. Category: Gimbal. Subcategory: Gadget. Price: 7,900৳8,800৳.
",160,927027,927187
6726,sentence,"Subcategory: Gadget. Price: 7,900৳8,800৳.

Product: Baseus SUYT-D0G Control Smartphone Handheld Folding Gimbal Stabilizer. Category: Gimbal. Subcategory: Gadget. Price: 7,800৳9,100৳.
",183,927145,927328
6727,sentence,"Subcategory: Gadget. Price: 7,800৳9,100৳.

Product: Hohem iSteady Pro4 3-Axis Action Camera Gimbal Stabilizer. Category: Gimbal. Subcategory: Gadget. Price: 10,900৳11,800৳.
",173,927286,927459
6728,sentence,"Subcategory: Gadget. Price: 10,900৳11,800৳.

Product: Hohem iSteady V3 Foldable AI Gimbal Stabilizer. Category: Gimbal. Subcategory: Gadget. Price: 12,400৳13,600৳.
",164,927415,927579
6729,sentence,"Subcategory: Gadget. Price: 12,400৳13,600৳.

Product: FEIYU Vimble 3 Handheld Stabilizer. Category: Gimbal. Subcategory: Gadget. Price: 11,750৳12,600৳.

Product: FEIYU VB4 Handheld Stabilizer. ",193,927535,927728
6730,sentence,"
Product: FEIYU VB4 Handheld Stabilizer. Category: Gimbal. Subcategory: Gadget. Price: 13,900৳15,000৳.

Product: Hohem iSteady M6 Kit AI Gimbal Stabilizer. Category: Gimbal. Subcategory: Gadget. ",195,927687,927882
6731,sentence,"Category: Gimbal. Subcategory: Gadget. Price: 19,600৳21,200৳.

Product: Insta360 Flow Pro AI Tracking Smartphone Gimbal Stabilizer. Category: Gimbal. Subcategory: Gadget. Price: 18,490৳19,900৳.
",194,927843,928037
6732,sentence,"Subcategory: Gadget. Price: 18,490৳19,900৳.

Product: FEIYU SCORP-Mini P Handheld Stabilizer. Category: Gimbal. Subcategory: Gadget. Price: 18,900৳20,400৳.
",156,927993,928149
6733,sentence,"Subcategory: Gadget. Price: 18,900৳20,400৳.

Product: DJI Matrice 300 RTK Commercial Drone. Category: Professional Drone. Subcategory: Drones. Price: Call for Price.
",166,928105,928271
6734,sentence,"Subcategory: Drones. Price: Call for Price.

Product: DJI Mavic 4 Pro Standard With RC 2 Controller. Category: Professional Drone. Subcategory: Drones. Price: Up Coming.
",170,928227,928397
6735,sentence,"Subcategory: Drones. Price: Up Coming.

Product: DJI Mini 2 SE Fly More Combo Drone. Category: Professional Drone. Subcategory: Drones. Price: Up Coming.
",154,928358,928512
6736,sentence,"Subcategory: Drones. Price: Up Coming.

Product: Insta360 Flow Standalone AI Tracking Smartphone Gimbal Stabilizer. Category: Insta360. Subcategory: Gimbal. Price: Out Of Stock.
",178,928473,928651
6737,sentence,"Subcategory: Gimbal. Price: Out Of Stock.

Product: Insta360 Flow 2 Pro Smartphone Gimbal Stabilizer. Category: Insta360. Subcategory: Gimbal. Price: Out Of Stock.
",164,928609,928773
6738,sentence,"Subcategory: Gimbal. Price: Out Of Stock.

Product: Hohem iSteady M7 AI Gimbal Stabilizer. Category: Hohem. Subcategory: Gimbal. Price: 24,990৳27,000৳.

Product: Hohem iSteady MT2 Kit Camera Gimbal. ",199,928731,928930
6739,sentence,"
Product: Hohem iSteady MT2 Kit Camera Gimbal. Category: Hohem. Subcategory: Gimbal. Price: 32,500৳35,000৳.

Product: Hohem iSteady Mobile+ Kit Gimbal Stabilizer. Category: Hohem. ",180,928883,929063
6740,sentence,"Category: Hohem. Subcategory: Gimbal. Price: Up Coming.

Product: DJI Mini 3 Drone Fly More Combo. Category: 4K Drone. Subcategory: Drones. Price: Out Of Stock.
",161,929046,929207
6741,sentence,"Subcategory: Drones. Price: Out Of Stock.

Product: DJI Mini 3 Pro Drone with RC Controller (Standard Version). Category: 4K Drone. Subcategory: Drones. Price: Out Of Stock.
",174,929165,929339
6742,sentence,"Subcategory: Drones. Price: Out Of Stock.

Product: DJI Mini 3 Drone Fly More Combo with DJI RC Remote Controller (Global Version). Category: 4K Drone. Subcategory: Drones. Price: Out Of Stock.
",194,929297,929491
6743,sentence,"Subcategory: Drones. Price: Out Of Stock.

Product: DJI Avata Fly Smart Drone Combo with FPV Goggles V2. Category: 4K Drone. Subcategory: Drones. Price: Out Of Stock.
",167,929449,929616
6744,sentence,"Subcategory: Drones. Price: Out Of Stock.

Product: UGREEN LP252 Car Mount Hook #80199. Category: Daily Lifestyle. Subcategory: Gadget. Price: 240৳340৳.

Product: VENTION KBJB0 Storage Case. ",191,929574,929765
6745,sentence,"
Product: VENTION KBJB0 Storage Case. Category: Daily Lifestyle. Subcategory: Gadget. Price: 420৳475৳.

Product: RBC DMT-4333 Flex Tip Digital Thermometer. Category: Daily Lifestyle. ",183,929727,929910
6746,sentence,"Category: Daily Lifestyle. Subcategory: Gadget. Price: 490৳.

Product: Mosalogic Sticky Glue Cards Refills-5 Pack. Category: Daily Lifestyle. Subcategory: Gadget. Price: 490৳530৳.
",180,929883,930063
6747,sentence,"Subcategory: Gadget. Price: 490৳530৳.

Product: Philips HD2582/00 800 Watt Pop Up Toaster. Category: Daily Lifestyle. Subcategory: Gadget. Price: 6,290৳8,390৳.
",160,930025,930185
6748,sentence,"Subcategory: Gadget. Price: 6,290৳8,390৳.

Product: Baseus Rainproof Film for Car Rear-View Mirror. Category: Daily Lifestyle. Subcategory: Gadget. Price: 570৳634৳.
",165,930143,930308
6749,sentence,"Subcategory: Gadget. Price: 570৳634৳.

Product: Mosalogic Sticky Glue Cards Refills-10 Pack. Category: Daily Lifestyle. Subcategory: Gadget. Price: 690৳750৳.
",158,930270,930428
6750,sentence,"Subcategory: Gadget. Price: 690৳750৳.

Product: Hoco GM231 Hidden Spy Camera Detector. Category: Daily Lifestyle. Subcategory: Gadget. Price: 750৳810৳.
",152,930390,930542
6751,sentence,"Subcategory: Gadget. Price: 750৳810৳.

Product: Xiaomi Qualitell C1 Lite Powerful Electric Mosquito Swatter Bat. Category: Daily Lifestyle. Subcategory: Gadget. Price: 770৳840৳.
",178,930504,930682
6752,sentence,"Subcategory: Gadget. Price: 770৳840৳.

Product: Xiaomi K1405 Kaco Lemo Stapler Machine. Category: Daily Lifestyle. Subcategory: Gadget. Price: 830৳910৳.

Product: Xiaomi Mijia Mi Gel Ink Pen 10pcs. ",198,930644,930842
6753,sentence,"
Product: Xiaomi Mijia Mi Gel Ink Pen 10pcs. Category: Daily Lifestyle. Subcategory: Gadget. Price: 830৳910৳.

Product: VivaChek Bree Blood Glucose Test Strips (50 Pcs). Category: Daily Lifestyle. ",197,930797,930994
6754,sentence,"Category: Daily Lifestyle. Subcategory: Gadget. Price: 1,000৳.

Product: Hoco E91 Smart GPS Tracker. Category: Daily Lifestyle. Subcategory: Gadget. Price: 950৳1,040৳.
",168,930967,931135
6755,sentence,"Subcategory: Gadget. Price: 950৳1,040৳.

Product: Baseus T2 Intelligent Rope Type Anti-loss Device. Category: Daily Lifestyle. Subcategory: Gadget. Price: 950৳1,050৳.
",167,931095,931262
6756,sentence,"Subcategory: Gadget. Price: 950৳1,050৳.

Product: ENCHEN N3 Mini Electric Ear and Nose Hair Trimmer. Category: Daily Lifestyle. Subcategory: Gadget. Price: 990৳1,080৳.
",168,931222,931390
6757,sentence,"Subcategory: Gadget. Price: 990৳1,080৳.

Product: Baseus Heyo hidden camera detector. Category: Daily Lifestyle. Subcategory: Gadget. Price: 1,030৳1,096৳.
",155,931350,931505
6758,sentence,"Subcategory: Gadget. Price: 1,030৳1,096৳.

Product: Baseus Quick to take cycling Holder for bicycle and Motorcycle. Category: Daily Lifestyle. Subcategory: Gadget. Price: 1,000৳1,099৳.
",185,931463,931648
6759,sentence,"Subcategory: Gadget. Price: 1,000৳1,099৳.

Product: FEIYU SCORP-Mini P Handheld Stabilizer Kit. Category: Feiyu. Subcategory: Gimbal. Price: 23,900৳25,800৳.
",157,931606,931763
6760,sentence,"Subcategory: Gimbal. Price: 23,900৳25,800৳.

Product: Superpower 2000W Electric Blower. Category: Blower Machine. Subcategory: Gadget. Price: 1,013৳1,350৳.
",156,931719,931875
6761,sentence,"Subcategory: Gadget. Price: 1,013৳1,350৳.

Product: Orin EB005 1600W Electric Blower. Category: Blower Machine. Subcategory: Gadget. Price: Out Of Stock.

Product: Super 0023 1000W Blower Machine. ",197,931833,932030
6762,sentence,"
Product: Super 0023 1000W Blower Machine. Category: Blower Machine. Subcategory: Gadget. Price: 1,105৳1,700৳.

Product: WELLOO EBW32400 400W Electric Blower. Category: Blower Machine. ",185,931987,932172
6763,sentence,"Category: Blower Machine. Subcategory: Gadget. Price: 1,900৳.

Product: Prescott PT2240001 400W Electric Blower Machine. Category: Blower Machine. Subcategory: Gadget. Price: 1,500৳2,000৳.
",189,932146,932335
6764,sentence,"Subcategory: Gadget. Price: 1,500৳2,000৳.

Product: Maxtol PB600 600W Electric Blower. Category: Blower Machine. Subcategory: Gadget. Price: 2,100৳2,400৳.
",155,932293,932448
6765,sentence,"Subcategory: Gadget. Price: 2,100৳2,400৳.

Product: INGCO AB4018 650W Aspirator Blower Machine. Category: Blower Machine. Subcategory: Gadget. Price: 2,795৳2,800৳.
",164,932406,932570
6766,sentence,"Subcategory: Gadget. Price: 2,795৳2,800৳.

Product: DCK KQF3 680W Electric Blower. Category: Blower Machine. Subcategory: Gadget. Price: 2,706৳3,300৳.

Product: INGCO AB8008 800W Aspirator Blower. ",197,932528,932725
6767,sentence,"
Product: INGCO AB8008 800W Aspirator Blower. Category: Blower Machine. Subcategory: Gadget. Price: 5,400৳.

Product: INGCO AB6008 600W Aspirator Blower. Category: Blower Machine. ",180,932679,932859
6768,sentence,"Category: Blower Machine. Subcategory: Gadget. Price: Up Coming.

Product: ONI EB005 1600W Electric Blower. Category: Blower Machine. Subcategory: Gadget. Price: Out Of Stock.
",176,932833,933009
6769,sentence,"Subcategory: Gadget. Price: Out Of Stock.

Product: AK EB005 1600W Power Dust Electric Blower Machine. Category: Blower Machine. Subcategory: Gadget. Price: Out Of Stock.
",171,932967,933138
6770,sentence,"Subcategory: Gadget. Price: Out Of Stock.

Product: Orin 1200W Blower Machine. Category: Blower Machine. Subcategory: Gadget. Price: Out Of Stock.

Product: Cromnn 1200W Blower Machine. ",186,933096,933282
6771,sentence,"
Product: Cromnn 1200W Blower Machine. Category: Blower Machine. Subcategory: Gadget. Price: Out Of Stock.

Product: Mexico 600W Electric Blower. Category: Blower Machine. Subcategory: Gadget. ",193,933243,933436
6772,sentence,"Category: Blower Machine. Subcategory: Gadget. Price: Out Of Stock.

Product: Maxwell MAX 600W Electric Blower. Category: Blower Machine. Subcategory: Gadget. Price: Out Of Stock.
",180,933389,933569
6773,sentence,"Subcategory: Gadget. Price: Out Of Stock.

Product: Boss 1250W Electric Blower Machine. Category: Blower Machine. Subcategory: Gadget. Price: Out Of Stock.
",156,933527,933683
6774,sentence,"Subcategory: Gadget. Price: Out Of Stock.

Product: Boss BOSS0022 1250W Electric Blower Machine. Category: Blower Machine. Subcategory: Gadget. Price: Out Of Stock.
",165,933641,933806
6775,sentence,"Subcategory: Gadget. Price: Out Of Stock.

Product: XCORT 650W Electric Blower. Category: Blower Machine. Subcategory: Gadget. Price: Out Of Stock.

Product: INGCO AB4018 400W Aspirator Blower. ",194,933764,933958
6776,sentence,"
Product: INGCO AB4018 400W Aspirator Blower. Category: Blower Machine. Subcategory: Gadget. Price: Out Of Stock.

Product: Casio HL-4A Portable Basic Calculator. Category: Casio. ",180,933912,934092
6777,sentence,"Category: Casio. Subcategory: Calculator. Price: 300৳.

Product: Casio LC-160LV Portable Basic Calculator. Category: Casio. Subcategory: Calculator. Price: 310৳.
",162,934075,934237
6778,sentence,"Subcategory: Calculator. Price: 310৳.

Product: Casio MZ-12Sa Basic Calculator. Category: Casio. Subcategory: Calculator. Price: 583৳.

Product: Casio MJ-12DA Check & Correct Basic Calculator. ",193,934199,934392
6779,sentence,"Category: Casio. Subcategory: Calculator. Price: 730৳.

Product: Casio MJ-120D Calculator. Category: Casio. Subcategory: Calculator. Price: 849৳900৳.
",150,934392,934542
6780,sentence,"Subcategory: Calculator. Price: 849৳900৳.

Product: Casio SX-220-W Portable Basic Calculator. Category: Casio. Subcategory: Calculator. Price: 935৳.
",149,934500,934649
6781,sentence,"Subcategory: Calculator. Price: 935৳.

Product: Casio MJ-100D Plus Check & Recheck Basic Calculator. Category: Casio. Subcategory: Calculator. Price: 990৳.
",156,934611,934767
6782,sentence,"Subcategory: Calculator. Price: 990৳.

Product: Casio FX-82MS 2nd Edition Non Programmable Scientific Calculator. Category: Casio. Subcategory: Calculator. Price: 1,100৳.
",171,934729,934900
6783,sentence,"Subcategory: Calculator. Price: 1,100৳.

Product: Casio Fx-100MS-2 Non-programmable Scientific Calculator. Category: Casio. Subcategory: Calculator. Price: 1,678৳.
",164,934860,935024
6784,sentence,"Subcategory: Calculator. Price: 1,678৳.

Product: CASIO GX-16B Basic Calculator. Category: Casio. Subcategory: Calculator. Price: 1,870৳.
",138,934984,935122
6785,sentence,"Subcategory: Calculator. Price: 1,870৳.

Product: Casio FX-570ES PLUS 2nd Edition Non Programmable Scientific Calculator. Category: Casio. Subcategory: Calculator. Price: 1,949৳2,024৳.
",185,935082,935267
6786,sentence,"Subcategory: Calculator. Price: 1,949৳2,024৳.

Product: Casio FX-991MS-2 Scientific Calculator. Category: Casio. Subcategory: Calculator. Price: 2,049৳2,100৳.
",159,935221,935380
6787,sentence,"Subcategory: Calculator. Price: 2,049৳2,100৳.

Product: Casio FX-991ES Plus 2nd Edition Non-Programmable Scientific Calculator. Category: Casio. Subcategory: Calculator. Price: 1,999৳2,200৳.
",191,935334,935525
6788,sentence,"Subcategory: Calculator. Price: 1,999৳2,200৳.

Product: Casio HL-820LV Portable Basic Calculator. Category: Casio. Subcategory: Calculator. Price: Out Of Stock.
",161,935479,935640
6789,sentence,"Subcategory: Calculator. Price: Out Of Stock.

Product: Casio HL-815L Portable Basic Calculator. Category: Casio. Subcategory: Calculator. Price: Out Of Stock.
",160,935594,935754
6790,sentence,"Subcategory: Calculator. Price: Out Of Stock.

Product: Casio HL-100LB Portable Basic Calculator. Category: Casio. Subcategory: Calculator. Price: Out Of Stock.
",161,935708,935869
6791,sentence,"Subcategory: Calculator. Price: Out Of Stock.

Product: Casio SX-300-W Portable Basic Calculator. Category: Casio. Subcategory: Calculator. Price: Out Of Stock.
",161,935823,935984
6792,sentence,"Subcategory: Calculator. Price: Out Of Stock.

Product: Casio SX-300P-W Portable Basic Calculator. Category: Casio. Subcategory: Calculator. Price: Out Of Stock.
",162,935938,936100
6793,sentence,"Subcategory: Calculator. Price: Out Of Stock.

Product: CASIO MW-8V Basic Calculator. Category: Casio. Subcategory: Calculator. Price: Out Of Stock.
",149,936054,936203
6794,sentence,"Subcategory: Calculator. Price: Out Of Stock.

Product: Casio SX-320P-W Portable Basic Calculator. Category: Casio. Subcategory: Calculator. Price: Out Of Stock.

Product: Elgato Stream Deck Neo. ",196,936157,936353
6795,sentence,"
Product: Elgato Stream Deck Neo. Category: Stream Deck. Subcategory: Gadget. Price: 11,400৳12,500৳.

Product: Elgato Stream Deck MK2. Category: Stream Deck. Subcategory: Gadget. Price: 16,300৳.
",195,936319,936514
6796,sentence,"Subcategory: Gadget. Price: 16,300৳.

Product: Elgato Stream Deck Live Content Creation Controller. Category: Stream Deck. Subcategory: Gadget. Price: Out Of Stock.
",165,936477,936642
6797,sentence,"Subcategory: Gadget. Price: Out Of Stock.

Product: Loupedeck+ The Photo and Video Editing Console. Category: Stream Deck. Subcategory: Gadget. Price: Out Of Stock.
",165,936600,936765
6798,sentence,"Subcategory: Gadget. Price: Out Of Stock.

Product: Loupedeck Live Console for Content Creators & Streamers. Category: Stream Deck. Subcategory: Gadget. Price: Out Of Stock.
",174,936723,936897
6799,sentence,"Subcategory: Gadget. Price: Out Of Stock.

Product: Loupedeck CT Custom Editing Console for Photo Video Music and Design. Category: Stream Deck. Subcategory: Gadget. Price: Out Of Stock.
",187,936855,937042
6800,sentence,"Subcategory: Gadget. Price: Out Of Stock.

Product: Casio FX-570MS-2 2nd Edition Non Programmable Scientific Calculator. Category: Scientific Calculator. Subcategory: Calculator. ",179,937000,937179
6801,sentence,"Subcategory: Calculator. Price: 1,600৳1,750৳.

Product: Casio FX-82ES Plus 2nd Edition Non Programmable Scientific Calculator. Category: Scientific Calculator. Subcategory: Calculator. ",185,937154,937339
6802,sentence,"Subcategory: Calculator. Price: Out Of Stock.

Product: Casio FX-82EX Non Programmable Scientific Calculator. Category: Scientific Calculator. Subcategory: Calculator. Price: Out Of Stock.
",189,937314,937503
6803,sentence,"Subcategory: Calculator. Price: Out Of Stock.

Product: Casio FX-991ES PLUS Non Programmable Scientific Calculator. Category: Scientific Calculator. Subcategory: Calculator. Price: Out Of Stock.
",195,937457,937652
6804,sentence,"Subcategory: Calculator. Price: Out Of Stock.

Product: Casio FX-100MS Scientific Calculator. Category: Scientific Calculator. Subcategory: Calculator. Price: Out Of Stock.
",173,937606,937779
6805,sentence,"Subcategory: Calculator. Price: Out Of Stock.

Product: Casio FX-570EX Non Programmable Scientific Calculator. Category: Scientific Calculator. Subcategory: Calculator. Price: Out Of Stock.
",190,937733,937923
6806,sentence,"Subcategory: Calculator. Price: Out Of Stock.

Product: Casio FX-991CW Scientific Calculator. Category: Scientific Calculator. Subcategory: Calculator. Price: Out Of Stock.
",173,937877,938050
6807,sentence,"Subcategory: Calculator. Price: Out Of Stock.

Product: Casio Fx-9860GII Graphical & Scientific Calculator. Category: Scientific Calculator. Subcategory: Calculator. Price: Out Of Stock.
",187,938004,938191
6808,sentence,"Subcategory: Calculator. Price: Out Of Stock.

Product: Casio FX-9860GIII Graphical & Scientific Calculator. Category: Scientific Calculator. Subcategory: Calculator. Price: Out Of Stock.
",188,938145,938333
6809,sentence,"Subcategory: Calculator. Price: Out Of Stock.

Product: Xiaomi Kaco Lemo Desktop Electronic Calculator. Category: Calculator. Subcategory: Gadget. Price: 1,150৳1,250৳.
",168,938287,938455
6810,sentence,"Subcategory: Gadget. Price: 1,150৳1,250৳.

Product: Phantom Edge Vortex CH25BB Gaming Chair. Category: Phantom Edge. Subcategory: Gaming Chair. Price: 17,999৳19,000৳.
",167,938413,938580
6811,sentence,"Price: 17,999৳19,000৳.

Product: Phantom Edge Vortex CH25BR Gaming Chair. Category: Phantom Edge. Subcategory: Gaming Chair. Price: 17,670৳19,000৳.

Product: Phantom Edge Vortex CH25BG Gaming Chair. ",199,938557,938756
6812,sentence,"Category: Phantom Edge. Subcategory: Gaming Chair. Price: 17,999৳19,000৳.

Product: Aolion ALXB201901 Xbox Gamepad Stand. Category: Gaming. Price: 750৳.
",153,938756,938909
6813,sentence,"Category: Gaming. Price: 750৳.

Product: Aolion ALXB201902 Xbox Gamepad Stand. Category: Gaming. Price: 750৳.

Product: Aolion ALXB201907 Xbox Gamepad Stand. Category: Gaming. Price: 750৳.
",189,938878,939067
6814,sentence,"Category: Gaming. Price: 750৳.

Product: Fantech ACGP02 Gamepad Accessories. Category: Gaming. Price: 820৳.

Product: Fantech ACGP01 Gamepad Holder Smartphone Gaming Grip. Category: Gaming. ",190,939036,939226
6815,sentence,"Category: Gaming. Price: 850৳.

Product: HAVIT HV-G92 Gamepad. Category: Gaming. Price: 799৳900৳.

Product: Fantech ACGP04 Grip Tape For Gamepad. Category: Gaming. Price: 999৳1,045৳.
",183,939208,939391
6816,sentence,"Category: Gaming. Price: 999৳1,045৳.

Product: Fantech ACGP03 EOS Gamepad Charging Dock for EOS PRO WGP15. Category: Gaming. Price: 1,320৳.

Product: Fantech GP12 Revolver Gaming Controller. ",191,939354,939545
6817,sentence,"Category: Gaming. Price: 1,699৳1,740৳.

Product: Onikuma C1 Dual-Mode Wireless Gaming Controller. Category: Gaming. Price: 1,899৳1,999৳.

Product: A4TECH Bloody GP30 USB Gaming Controller. ",189,939545,939734
6818,sentence,"Category: Gaming. Price: 1,799৳2,000৳.

Product: Aolion AL-NS2258-B Wireless Gaming Controller. Category: Gaming. Price: 2,099৳2,300৳.
",135,939734,939869
6819,sentence,"Category: Gaming. Price: 2,099৳2,300৳.

Product: Havit G180BT Transparent RGB Bluetooth Vibration Gamepad. Category: Gaming. Price: 2,199৳2,400৳.

Product: Logitech F310 USB Gamepad. ",183,939830,940013
6820,sentence,"
Product: Logitech F310 USB Gamepad. Category: Gaming. Price: 2,500৳.

Product: Aolion AL-NS2258-T Wireless Gaming Controller. Category: Gaming. Price: 2,299৳2,550৳.
",166,939976,940142
6821,sentence,"Category: Gaming. Price: 2,299৳2,550৳.

Product: A4Tech Bloody GPW50 Dual Mode Wireless Gaming Controller. Category: Gaming. Price: 2,399৳2,600৳.
",146,940103,940249
6822,sentence,"Category: Gaming. Price: 2,399৳2,600৳.

Product: Rapoo V600 Ergonomic Vibration Shock Controller Gamepad. Category: Gaming. Price: 2,650৳.
",139,940210,940349
6823,sentence,"Category: Gaming. Price: 2,650৳.

Product: Havit G158BT Pro Transparent RGB Bluetooth Vibration Gamepad. Category: Gaming. Price: 2,499৳2,650৳.
",144,940316,940460
6824,sentence,"Category: Gaming. Price: 2,499৳2,650৳.

Product: Aolion AL-NS2288PRO-WH Wireless Gaming Controller. Category: Gaming. Price: 2,399৳2,650৳.

Product: Gamemax GCR07 Gaming Chair Blue. ",182,940421,940603
6825,sentence,"
Product: Gamemax GCR07 Gaming Chair Blue. Category: GameMax. Subcategory: Gaming Chair. Price: 11,200৳14,000৳.

Product: Gamemax GCR07 Gaming Chair Green. Category: GameMax. ",175,940560,940735
6826,sentence,"Category: GameMax. Subcategory: Gaming Chair. Price: 11,200৳14,000৳.

Product: Gamemax GCR07 Gaming Chair Red. Category: GameMax. Subcategory: Gaming Chair. Price: 12,500৳16,000৳.
",180,940716,940896
6827,sentence,"Price: 12,500৳16,000৳.

Product: Gamemax GCR07 Gaming Chair Black. Category: GameMax. Subcategory: Gaming Chair. Price: Out Of Stock.
",134,940873,941007
6828,sentence,"Subcategory: Gaming Chair. Price: Out Of Stock.

Product: MeeTion MT-CHR16 Cute Pink Racing E-Sport Gaming Chair. Category: MeeTion. Subcategory: Gaming Chair. Price: Out Of Stock.
",181,940959,941140
6829,sentence,"Subcategory: Gaming Chair. Price: Out Of Stock.

Product: Cougar ARMOR EVO M Gaming Chair ORANGE. Category: Cougar. Subcategory: Gaming Chair. Price: 44,650৳47,000৳.
",166,941092,941258
6830,sentence,"Price: 44,650৳47,000৳.

Product: Cougar Terminator Elite Gaming Chair Gold. Category: Cougar. Subcategory: Gaming Chair. Price: 92,000৳95,000৳.

Product: Cougar Fusion S Gaming Chair. ",184,941235,941419
6831,sentence,"
Product: Cougar Fusion S Gaming Chair. Category: Cougar. Subcategory: Gaming Chair. Price: Out Of Stock.

Product: Cougar DEFENSOR S JET GRAY F Gaming Chair. Category: Cougar. ",177,941379,941556
6832,sentence,"Category: Cougar. Subcategory: Gaming Chair. Price: Up Coming.

Product: Cougar DEFENSOR S NAVY BLUE F Gaming Chair. Category: Cougar. Subcategory: Gaming Chair. Price: Up Coming.
",180,941538,941718
6833,sentence,"Subcategory: Gaming Chair. Price: Up Coming.

Product: Cougar DEFENSOR S ARMY GREEN F Gaming Chair. Category: Cougar. Subcategory: Gaming Chair. Price: Up Coming.
",163,941673,941836
6834,sentence,"Subcategory: Gaming Chair. Price: Up Coming.

Product: Cougar Explore Jet Gray F Gaming Chair. Category: Cougar. Subcategory: Gaming Chair. Price: Up Coming.
",158,941791,941949
6835,sentence,"Subcategory: Gaming Chair. Price: Up Coming.

Product: Cougar ARMOR ONE V2 BLACK F Gaming Chair. Category: Cougar. Subcategory: Gaming Chair. Price: Up Coming.
",160,941904,942064
6836,sentence,"Subcategory: Gaming Chair. Price: Up Coming.

Product: Cougar ARMOR ONE V2 GRAY F Gaming Chair. Category: Cougar. Subcategory: Gaming Chair. Price: Up Coming.
",159,942019,942178
6837,sentence,"Subcategory: Gaming Chair. Price: Up Coming.

Product: Cougar Stryder Gaming Chair Black. Category: Cougar. Subcategory: Gaming Chair. Price: Up Coming.

Product: Cougar Stryder Gaming Chair Grey. ",197,942133,942330
6838,sentence,"
Product: Cougar Stryder Gaming Chair Grey. Category: Cougar. Subcategory: Gaming Chair. Price: Up Coming.

Product: Cougar Stryder Gaming Chair White. Category: Cougar. Subcategory: Gaming Chair. ",197,942286,942483
6839,sentence,"Category: Cougar. Subcategory: Gaming Chair. Price: Up Coming.

Product: Cougar Fusion SF Gaming Chair. Category: Cougar. Subcategory: Gaming Chair. Price: Out Of Stock.
",170,942438,942608
6840,sentence,"Subcategory: Gaming Chair. Price: Out Of Stock.

Product: Cougar SPEEDER ONE Ergonomic Gaming Chair. Category: Cougar. Subcategory: Gaming Chair. Price: Out Of Stock.
",167,942560,942727
6841,sentence,"Subcategory: Gaming Chair. Price: Out Of Stock.

Product: Cougar SPEEDER Ergonomic Gaming Chair. Category: Cougar. Subcategory: Gaming Chair. Price: Out Of Stock.
",163,942679,942842
6842,sentence,"Subcategory: Gaming Chair. Price: Out Of Stock.

Product: Cougar Terminator Elite Gaming Chair Silver. Category: Cougar. Subcategory: Gaming Chair. Price: Out Of Stock.
",169,942794,942963
6843,sentence,"Subcategory: Gaming Chair. Price: Out Of Stock.

Product: Cougar ARMOR EVO M Gaming Chair GOLD. Category: Cougar. Subcategory: Gaming Chair. Price: Out Of Stock.
",162,942915,943077
6844,sentence,"Subcategory: Gaming Chair. Price: Out Of Stock.

Product: Corsair T3 RUSH Gaming Chair Grey Charcol. Category: Corsair. Subcategory: Gaming Chair. Price: 29,000৳30,000৳.
",170,943029,943199
6845,sentence,"Price: 29,000৳30,000৳.

Product: Corsair T3 RUSH Gaming Chair Charcol. Category: Corsair. Subcategory: Gaming Chair. Price: 28,999৳30,000৳.

Product: Corsair TC100 RELAXED Fabric Gaming Chair Grey. ",198,943176,943374
6846,sentence,"Category: Corsair. Subcategory: Gaming Chair. Price: 27,500৳.

Product: Corsair TC500 LUXE Gaming Chair Shadow. Category: Corsair. Subcategory: Gaming Chair. Price: 58,000৳60,000৳.
",181,943374,943555
6847,sentence,"Price: 58,000৳60,000৳.

Product: Corsair TC500 LUXE Gaming Chair Frost. Category: Corsair. Subcategory: Gaming Chair. Price: 58,000৳.

Product: Corsair TC100 RELAXED Leatherette Gaming Chair. ",192,943532,943724
6848,sentence,"Category: Corsair. Subcategory: Gaming Chair. Price: Out Of Stock.

Product: Corsair TC100 RELAXED Fabric Gaming Chair. Category: Corsair. Subcategory: Gaming Chair. Price: 27,500৳.
",182,943724,943906
6849,sentence,"Subcategory: Gaming Chair. Price: 27,500৳.

Product: Corsair TC500 LUXE Gaming Chair Sherwood. Category: Corsair. Subcategory: Gaming Chair. Price: Out Of Stock.
",162,943863,944025
6850,sentence,"Subcategory: Gaming Chair. Price: Out Of Stock.

Product: Fantech TIGRIS GD210 RGB Gaming Desk Table. Category: Gaming Desk. Subcategory: Gaming. Price: 22,000৳23,000৳.
",169,943977,944146
6851,sentence,"Subcategory: Gaming. Price: 22,000৳23,000৳.

Product: Xtrike Me DK-02 Gaming Desk Table. Category: Gaming Desk. Subcategory: Gaming. Price: Out Of Stock.
",154,944102,944256
6852,sentence,"Subcategory: Gaming. Price: Out Of Stock.

Product: Xtrike Me DK-05 RGB Gaming Desk Table. Category: Gaming Desk. Subcategory: Gaming. Price: Out Of Stock.
",156,944214,944370
6853,sentence,"Subcategory: Gaming. Price: Out Of Stock.

Product: Xtrike Me DK-04 L-shape Gaming Desk Table. Category: Gaming Desk. Subcategory: Gaming. Price: Out Of Stock.
",160,944328,944488
6854,sentence,"Subcategory: Gaming. Price: Out Of Stock.

Product: Cougar E-STAR 140 Gaming Desk. Category: Gaming Desk. Subcategory: Gaming. Price: Up Coming.

Product: FURGLE ET Series Gaming Desk Table. ",191,944446,944637
6855,sentence,"
Product: FURGLE ET Series Gaming Desk Table. Category: Gaming Desk. Subcategory: Gaming. Price: Out Of Stock.

Product: Fantech TIGRIS GD214 RGB Gaming Desk Table. Category: Gaming Desk. ",188,944591,944779
6856,sentence,"Category: Gaming Desk. Subcategory: Gaming. Price: Out Of Stock.

Product: Fantech WS414 Height Adjustable Rising Gaming Desk Table. Category: Gaming Desk. Subcategory: Gaming. Price: Out Of Stock.
",198,944756,944954
6857,sentence,"Subcategory: Gaming. Price: Out Of Stock.

Product: Fantech GD914 Height Adjustable Rising Gaming Desk Table. Category: Gaming Desk. Subcategory: Gaming. Price: Out Of Stock.
",175,944912,945087
6858,sentence,"Subcategory: Gaming. Price: Out Of Stock.

Product: Fantech GD914 Height Adjustable Rising White Gaming Desk Table. Category: Gaming Desk. Subcategory: Gaming. Price: Out Of Stock.
",181,945045,945226
6859,sentence,"Subcategory: Gaming. Price: Out Of Stock.

Product: GIGABYTE AORUS AGC310 Gaming Chair. Category: Gaming Chair. Subcategory: Gaming. Price: 27,550৳29,000৳.
",156,945184,945340
6860,sentence,"Subcategory: Gaming. Price: 27,550৳29,000৳.

Product: Thermaltake U Fit Black-Red Gaming Chair. Category: Gaming Chair. Subcategory: Gaming. Price: 32,800৳.
",157,945296,945453
6861,sentence,"Subcategory: Gaming. Price: 32,800৳.

Product: Fantech Korsi GC-191 Red Gaming Chair. Category: Gaming Chair. Subcategory: Gaming. Price: 29,800৳35,000৳.
",154,945416,945570
6862,sentence,"Subcategory: Gaming. Price: 29,800৳35,000৳.

Product: Thermaltake V Comfort Black-Red Gaming Chair. Category: Gaming Chair. Subcategory: Gaming. Price: 37,000৳.
",161,945526,945687
6863,sentence,"Subcategory: Gaming. Price: 37,000৳.

Product: Thermaltake V Comfort Blue-White Gaming Chair. Category: Gaming Chair. Subcategory: Gaming. Price: 37,000৳.
",155,945650,945805
6864,sentence,"Subcategory: Gaming. Price: 37,000৳.

Product: Thermaltake CyberChair E500 White Edition Gaming Chair. Category: Gaming Chair. Subcategory: Gaming. Price: 90,000৳.
",164,945768,945932
6865,sentence,"Subcategory: Gaming. Price: 90,000৳.

Product: Thermaltake CyberChair E500 Black Gaming Chair. Category: Gaming Chair. Subcategory: Gaming. Price: 90,000৳.
",156,945895,946051
6866,sentence,"Subcategory: Gaming. Price: 90,000৳.

Product: Thermaltake ARGENT E700 Real Leather Space Gray Gaming Chair. Category: Gaming Chair. Subcategory: Gaming. Price: 115,000৳.
",171,946014,946185
6867,sentence,"Subcategory: Gaming. Price: 115,000৳.

Product: Thermaltake ARGENT E700 Real Leather Glacier White Gaming Chair. Category: Gaming Chair. Subcategory: Gaming. Price: 115,000৳.
",175,946147,946322
6868,sentence,"Subcategory: Gaming. Price: 115,000৳.

Product: Havit HV-MS1027 USB Gaming Mouse. Category: Mouse. Subcategory: Gaming. Price: 399৳500৳.

Product: Havit HV-MS1010 RGB Backlit Gaming Mouse. ",189,946284,946473
6869,sentence,"Category: Mouse. Subcategory: Gaming. Price: 550৳.

Product: Hoco GM37 USB Gaming Mouse. Category: Mouse. Subcategory: Gaming. Price: 450৳550৳.

Product: Xtrike Me GM-217 RGB Gaming Mouse. ",189,946473,946662
6870,sentence,"
Product: Xtrike Me GM-217 RGB Gaming Mouse. Category: Mouse. Subcategory: Gaming. Price: 549৳650৳.

Product: Xtrike Me GM-227 Wired Gaming Mouse. Category: Mouse. Subcategory: Gaming. ",185,946617,946802
6871,sentence,"Category: Mouse. Subcategory: Gaming. Price: 499৳650৳.

Product: Onikuma CW917 Wired Gaming Mouse. Category: Mouse. Subcategory: Gaming. Price: 699৳.
",150,946764,946914
6872,sentence,"Subcategory: Gaming. Price: 699৳.

Product: Xtrfy M4 Lizard Skins Dsp Mouse Grip Tape Black. Category: Mouse. Subcategory: Gaming. Price: 250৳700৳.
",148,946880,947028
6873,sentence,"Subcategory: Gaming. Price: 250৳700৳.

Product: Xtrfy M42 Lizard Skins Dsp Mouse Grip Tape Black. Category: Mouse. Subcategory: Gaming. Price: 250৳700৳.
",153,946990,947143
6874,sentence,"Subcategory: Gaming. Price: 250৳700৳.

Product: Xtrfy MZ1 Lizard Skins Dsp Mouse Grip Tape Black. Category: Mouse. Subcategory: Gaming. Price: 250৳700৳.

Product: Fantech Kanata VX9 Gaming Mouse. ",196,947105,947301
6875,sentence,"
Product: Fantech Kanata VX9 Gaming Mouse. Category: Mouse. Subcategory: Gaming. Price: 715৳.

Product: Xtrike Me GM-226 RGB Gaming Mouse. Category: Mouse. Subcategory: Gaming. Price: 670৳770৳.
",194,947258,947452
6876,sentence,"Subcategory: Gaming. Price: 670৳770৳.

Product: AULA F805 Wired Programmable Gaming Mouse. Category: Mouse. Subcategory: Gaming. Price: 850৳.

Product: Fantech Raigor III WG12 Gaming Mouse. ",190,947414,947604
6877,sentence,"
Product: Fantech Raigor III WG12 Gaming Mouse. Category: Mouse. Subcategory: Gaming. Price: 750৳850৳.

Product: Fantech WG10 Raigor II Wirless Gaming Mouse. Category: Mouse. Subcategory: Gaming. ",196,947556,947752
6878,sentence,"Category: Mouse. Subcategory: Gaming. Price: 790৳870৳.

Product: Havit Gamenote HV-MS1001S RGB Backlit Programmable Gaming Mouse. Category: Mouse. Subcategory: Gaming. Price: 799৳900৳.
",185,947714,947899
6879,sentence,"Subcategory: Gaming. Price: 799৳900৳.

Product: PC Power PGC801A105 RGB Wired Gaming Keyboard Mouse Combo with Bangla. Category: Mouse. Subcategory: Gaming. Price: 950৳.
",170,947861,948031
6880,sentence,"Subcategory: Gaming. Price: 950৳.

Product: PC Power PGC801TA01 RGB Wired Gaming Keyboard Mouse Combo with Bangla. Category: Mouse. Subcategory: Gaming. Price: 950৳.
",166,947997,948163
6881,sentence,"Subcategory: Gaming. Price: 950৳.

Product: PC Power PGC801BG13 RGB Wired Gaming Keyboard Mouse Combo with Bangla. Category: Mouse. Subcategory: Gaming. Price: 850৳950৳.
",170,948129,948299
6882,sentence,"Subcategory: Gaming. Price: 850৳950৳.

Product: Havit MS1014 Wired RGB Gaming Mouse. Category: Mouse. Subcategory: Gaming. Price: 850৳950৳.

Product: Havit HV-KB275L USB Gaming Keyboard with Bangla. ",199,948261,948460
6883,sentence,"Category: Keyboard. Subcategory: Gaming. Price: 799৳900৳.

Product: Havit KB866L Multi-function Backlit Membrane Gaming Keyboard. Category: Keyboard. Subcategory: Gaming. Price: 850৳950৳.
",188,948460,948648
6884,sentence,"Subcategory: Gaming. Price: 850৳950৳.

Product: Fantech KM100 USB Keyboard Mouse Combo Black. Category: Keyboard. Subcategory: Gaming. Price: 970৳.

Product: Fantech Shikari K515 Gaming Keyboard. ",196,948610,948806
6885,sentence,"
Product: Fantech Shikari K515 Gaming Keyboard. Category: Keyboard. Subcategory: Gaming. Price: 945৳1,045৳.

Product: T-Wolf TF600 RGB Gaming Keyboard Mouse Combo. Category: Keyboard. ",184,948758,948942
6886,sentence,"Category: Keyboard. Subcategory: Gaming. Price: 950৳1,050৳.

Product: Fantech K511 Hunter PRO Backlit Gaming Keyboard. Category: Keyboard. Subcategory: Gaming. Price: 1,050৳1,150৳.
",181,948922,949103
6887,sentence,"Subcategory: Gaming. Price: 1,050৳1,150৳.

Product: Havit KB488L Multi-Function Backlit Gaming Keyboard. Category: Keyboard. Subcategory: Gaming. Price: 1,030৳1,150৳.
",167,949061,949228
6888,sentence,"Subcategory: Gaming. Price: 1,030৳1,150৳.

Product: PC Power Silent-98 Gaming Keyboard with Bangla. Category: Keyboard. Subcategory: Gaming. Price: 1,200৳.
",156,949186,949342
6889,sentence,"Subcategory: Gaming. Price: 1,200৳.

Product: T-Wolf TF770 Wireless Keyboard Mouse Combo. Category: Keyboard. Subcategory: Gaming. Price: 1,099৳1,250৳.
",152,949306,949458
6890,sentence,"Subcategory: Gaming. Price: 1,099৳1,250৳.

Product: Redragon K521-Rainbow Netherbane RGB Gaming Keyboard. Category: Keyboard. Subcategory: Gaming. Price: 1,275৳.
",162,949416,949578
6891,sentence,"Subcategory: Gaming. Price: 1,275৳.

Product: Havit KB487L Multi-Function USB Backlit Gaming Keyboard. Category: Keyboard. Subcategory: Gaming. Price: 1,150৳1,300৳.
",165,949542,949707
6892,sentence,"Subcategory: Gaming. Price: 1,150৳1,300৳.

Product: Havit KB838L Multi-function RGB Backlit Gaming Keyboard. Category: Keyboard. Subcategory: Gaming. Price: 1,199৳1,300৳.
",171,949665,949836
6893,sentence,"Subcategory: Gaming. Price: 1,199৳1,300৳.

Product: Redragon K521-RGB Netherbane Gaming Keyboard. Category: Keyboard. Subcategory: Gaming. Price: 1,475৳.
",154,949794,949948
6894,sentence,"Subcategory: Gaming. Price: 1,475৳.

Product: Fantech K614L Fighter III RGB Gaming Keyboard. Category: Keyboard. Subcategory: Gaming. Price: 1,380৳1,500৳.
",155,949912,950067
6895,sentence,"Subcategory: Gaming. Price: 1,380৳1,500৳.

Product: T-Wolf TF350 Wireless Keyboard Mouse Combo. Category: Keyboard. Subcategory: Gaming. Price: 1,299৳1,550৳.
",158,950025,950183
6896,sentence,"Subcategory: Gaming. Price: 1,299৳1,550৳.

Product: T-Wolf TF610 RGB Gaming Keyboard Mouse Combo. Category: Keyboard. Subcategory: Gaming. Price: 1,499৳1,650৳.
",160,950141,950301
6897,sentence,"Subcategory: Gaming. Price: 1,499৳1,650৳.

Product: T-WOLF TF100 Wired Keyboard Mouse Gaming Combo. Category: Keyboard. Subcategory: Gaming. Price: 1,650৳.
",156,950259,950415
6898,sentence,"Subcategory: Gaming. Price: 1,650৳.

Product: Hoco W106 Tiger Gaming Headphone. Category: Headphone. Subcategory: Gaming. Price: 940৳1,190৳.

Product: Redragon H130 Pelias Wired Gaming Headset. ",194,950379,950573
6899,sentence,"Category: Headphone. Subcategory: Gaming. Price: 1,150৳1,250৳.

Product: Onikuma X7 Pro Wired RGB Gaming Headphone. Category: Headphone. Subcategory: Gaming. Price: 1,250৳.
",173,950573,950746
6900,sentence,"Subcategory: Gaming. Price: 1,250৳.

Product: Havit H2230d 3.5mm Wired Gaming Headphone. Category: Headphone. Subcategory: Gaming. Price: 1,280৳.
",146,950710,950856
6901,sentence,"Subcategory: Gaming. Price: 1,280৳.

Product: Fantech FLASH HQ53 Lightweight Gaming Headset. Category: Headphone. Subcategory: Gaming. Price: 1,180৳1,300৳.
",156,950820,950976
6902,sentence,"Subcategory: Gaming. Price: 1,180৳1,300৳.

Product: Havit H2040D Wired Gaming Headphone. Category: Headphone. Subcategory: Gaming. Price: 1,300৳.

Product: HAVIT HV-H2232d RGB Gaming Headphone. ",194,950934,951128
6903,sentence,"
Product: HAVIT HV-H2232d RGB Gaming Headphone. Category: Headphone. Subcategory: Gaming. Price: 1,350৳.

Product: Xtrike Me GH-510 RGB Stereo Gaming Headset. Category: Headphone. ",180,951080,951260
6904,sentence,"Category: Headphone. Subcategory: Gaming. Price: 1,150৳1,350৳.

Product: Onikuma X29 RGB Gaming Headphone. Category: Headphone. Subcategory: Gaming. Price: 1,350৳.
",164,951239,951403
6905,sentence,"Subcategory: Gaming. Price: 1,350৳.

Product: Xtrike Me GH-509 RGB Stereo Gaming Headphone. Category: Headphone. Subcategory: Gaming. Price: 1,199৳1,400৳.
",155,951367,951522
6906,sentence,"Subcategory: Gaming. Price: 1,199৳1,400৳.

Product: Xtrike Me GH-511 RGB Translucent Gaming Headphone. Category: Headphone. Subcategory: Gaming. Price: 1,250৳1,450৳.
",166,951480,951646
6907,sentence,"Subcategory: Gaming. Price: 1,250৳1,450৳.

Product: Havit Gamenote H2042d RGB Wired Gaming Headphone. Category: Headphone. Subcategory: Gaming. Price: 1,299৳1,500৳.
",165,951604,951769
6908,sentence,"Subcategory: Gaming. Price: 1,299৳1,500৳.

Product: Razer Kishi V2 Mobile Gaming Controller for iPhone. Category: Razer. Subcategory: Gamepad. Price: 9,999৳15,000৳.
",165,951727,951892
6909,sentence,"Subcategory: Gamepad. Price: 9,999৳15,000৳.

Product: Razer Kishi Universal Gaming Controller for Android. Category: Razer. Subcategory: Gamepad. Price: Out Of Stock.
",167,951848,952015
6910,sentence,"Subcategory: Gamepad. Price: Out Of Stock.

Product: Razer Wolverine Tournament Edition Chroma - Customizable Gamepad Controller (Global). Category: Razer. Subcategory: Gamepad. Price: Out Of Stock.
",199,951972,952171
6911,sentence,"Subcategory: Gamepad. Price: Out Of Stock.

Product: Razer Kishi V2 Universal Gaming Controller for Android. Category: Razer. Subcategory: Gamepad. Price: Out Of Stock.
",169,952128,952297
6912,sentence,"Subcategory: Gamepad. Price: Out Of Stock.

Product: Logitech F710 Wireless Gamepad. Category: Logitech. Subcategory: Gamepad. Price: 4,800৳5,000৳.
",148,952254,952402
6913,sentence,"Subcategory: Gamepad. Price: 4,800৳5,000৳.

Product: Logitech Joystick Extreme 3D PRO (942-000008). Category: Logitech. Subcategory: Gamepad. Price: 5,500৳.

Product: Logitech Driving Force Shifter. ",199,952359,952558
6914,sentence,"
Product: Logitech Driving Force Shifter. Category: Logitech. Subcategory: Gamepad. Price: 7,000৳.

Product: Logitech Driving Force G29 Racing Gaming Wheel for PlayStation and PC. ",180,952516,952696
6915,sentence,"Category: Logitech. Subcategory: Gamepad. Price: 40,000৳.

Product: Logitech G923 TRUEFORCE Gaming Racing Wheel for PlayStation and PC. Category: Logitech. Subcategory: Gamepad. Price: 48,500৳.
",194,952696,952890
6916,sentence,"Subcategory: Gamepad. Price: 48,500৳.

Product: Nintendo Switch Pro Controller Splatoon 2 Edition. Category: Nintendo. Subcategory: Gamepad. Price: 6,500৳.
",156,952852,953008
6917,sentence,"Subcategory: Gamepad. Price: 6,500৳.

Product: Nintendo Switch Pro Controller Xenoblade Chronicles 2 Edition. Category: Nintendo. Subcategory: Gamepad. Price: 6,500৳.
",167,952971,953138
6918,sentence,"Subcategory: Gamepad. Price: 6,500৳.

Product: Nintendo Switch Pro Controller. Category: Nintendo. Subcategory: Gamepad. Price: 5,999৳6,700৳.
",142,953101,953243
6919,sentence,"Subcategory: Gamepad. Price: 5,999৳6,700৳.

Product: Aolion AL-NS2288PRO-PI Wireless Gaming Controller. Category: Gamepad. Subcategory: Gaming. Price: 2,399৳2,650৳.
",165,953200,953365
6920,sentence,"Subcategory: Gaming. Price: 2,399৳2,650৳.

Product: SteelSeries Stratus Duo Tri-Mode Gaming Controller. Category: SteelSeries. Subcategory: Gamepad. Price: 5,999৳6,300৳.
",170,953323,953493
6921,sentence,"Subcategory: Gamepad. Price: 5,999৳6,300৳.

Product: SteelSeries Nimbus Plus Wireless Gamepad. Category: SteelSeries. Subcategory: Gamepad. Price: 8,299৳9,000৳.
",161,953450,953611
6922,sentence,"Subcategory: Gamepad. Price: 8,299৳9,000৳.

Product: SteelSeries Stratus Plus Wireless Gamepad. Category: SteelSeries. Subcategory: Gamepad. Price: 11,999৳13,000৳.
",164,953568,953732
6923,sentence,"Subcategory: Gamepad. Price: 11,999৳13,000৳.

Product: Xbox Wireless Controller 1914. Category: Xbox. Subcategory: Gamepad. Price: 6,900৳8,500৳.

Product: Xbox Wireless Controller Shock Blue. ",192,953687,953879
6924,sentence,"
Product: Xbox Wireless Controller Shock Blue. Category: Xbox. Subcategory: Gamepad. Price: 6,900৳8,500৳.

Product: Microsoft Xbox Wireless Controller - Electric Volt. Category: Xbox. ",184,953832,954016
6925,sentence,"Category: Xbox. Subcategory: Gamepad. Price: 6,999৳8,100৳.

Product: Microsoft Xbox Wireless Controller - Daystrike Camo Special Edition. Category: Xbox. Subcategory: Gamepad. Price: 8,800৳.
",191,954000,954191
6926,sentence,"Subcategory: Gamepad. Price: 8,800৳.

Product: Xbox Wireless Controller 1914 White. Category: Xbox. Subcategory: Gamepad. Price: 6,799৳8,800৳.
",143,954154,954297
6927,sentence,"Subcategory: Gamepad. Price: 6,799৳8,800৳.

Product: Xbox Wireless Controller Arctic Camo Special Edition. Category: Xbox. Subcategory: Gamepad. Price: 8,800৳.
",160,954254,954414
6928,sentence,"Subcategory: Gamepad. Price: 8,800৳.

Product: Microsoft Xbox Wireless Controller - Stormcloud Vapor Special Edition. Category: Xbox. Subcategory: Gamepad. Price: 8,800৳.
",171,954377,954548
6929,sentence,"Subcategory: Gamepad. Price: 8,800৳.

Product: Xbox Wireless Controller Red. Category: Xbox. Subcategory: Gamepad. Price: 7,449৳8,040৳.

Product: Microsoft Xbox Wireless Controller - Velocity Green. ",199,954511,954710
6930,sentence,"Category: Xbox. Subcategory: Gamepad. Price: 7,700৳9,000৳.

Product: Microsoft Xbox Wireless Controller - Mineral Camo Special Edition. Category: Xbox. Subcategory: Gamepad. Price: 8,800৳9,200৳.
",195,954710,954905
6931,sentence,"Subcategory: Gamepad. Price: 8,800৳9,200৳.

Product: Xbox Wireless Controller Nocturnal Vapor Special Edition. Category: Xbox. Subcategory: Gamepad. Price: 8,500৳9,800৳.
",170,954862,955032
6932,sentence,"Subcategory: Gamepad. Price: 8,500৳9,800৳.

Product: Xbox Elite Series 2 Wireless Controller. Category: Xbox. Subcategory: Gamepad. Price: 19,900৳25,000৳.
",155,954989,955144
6933,sentence,"Subcategory: Gamepad. Price: 19,900৳25,000৳.

Product: Xbox Wireless Controller Dream Vapor Special Edition. Category: Xbox. Subcategory: Gamepad. Price: Up Coming.
",165,955099,955264
6934,sentence,"Subcategory: Gamepad. Price: Up Coming.

Product: Xbox Wireless Controller Astral Purple. Category: Xbox. Subcategory: Gamepad. Price: Up Coming.
",146,955224,955370
6935,sentence,"Subcategory: Gamepad. Price: Up Coming.

Product: Xbox One Wireless Controller (Without Wireless & Bluetooth Dongle ). Category: Xbox. Subcategory: Gamepad. Price: Up Coming.
",175,955330,955505
6936,sentence,"Subcategory: Gamepad. Price: Up Coming.

Product: Xbox Night Ops Camo Special Edition Wireless Controller. Category: Xbox. Subcategory: Gamepad. Price: Out Of Stock.
",166,955465,955631
6937,sentence,"Subcategory: Gamepad. Price: Out Of Stock.

Product: Microsoft Xbox One Armed Forces Camo Controller. Category: Xbox. Subcategory: Gamepad. Price: Out Of Stock.
",161,955588,955749
6938,sentence,"Subcategory: Gamepad. Price: Out Of Stock.

Product: Xbox Midnight Forces II Special Edition Wireless Controller. Category: Xbox. Subcategory: Gamepad. Price: Out Of Stock.
",173,955706,955879
6939,sentence,"Subcategory: Gamepad. Price: Out Of Stock.

Product: Microsoft Xbox Wireless Controller - Lunar Shift Special Edition. Category: Xbox. Subcategory: Gamepad. Price: Out Of Stock.
",178,955836,956014
6940,sentence,"Subcategory: Gamepad. Price: Out Of Stock.

Product: Microsoft Xbox Wireless Controller - Aqua Shift Special Edition. Category: Xbox. Subcategory: Gamepad. Price: Out Of Stock.
",177,955971,956148
6941,sentence,"Subcategory: Gamepad. Price: Out Of Stock.

Product: Xtrike Me GP-51 Wireless Gamepad. Category: Xtrike Me. Subcategory: Gamepad. Price: 1,899৳2,700৳.

Product: Xtrike Me GP-52 RGB Wireless Gamepad. ",199,956105,956304
6942,sentence,"
Product: Xtrike Me GP-52 RGB Wireless Gamepad. Category: Xtrike Me. Subcategory: Gamepad. Price: 1,999৳2,800৳.

Product: Xtrike Me GP-50 Wireless Gamepad. Category: Xtrike Me. Subcategory: Gamepad. ",199,956256,956455
6943,sentence,"Category: Xtrike Me. Subcategory: Gamepad. Price: Out Of Stock.

Product: Xtrike Me GP-43 Wireless Gamepad. Category: Xtrike Me. Subcategory: Gamepad. Price: Out Of Stock.
",172,956412,956584
6944,sentence,"Subcategory: Gamepad. Price: Out Of Stock.

Product: Xtrike Me GP-903 Gaming Racing Wheel. Category: Xtrike Me. Subcategory: Gamepad. Price: Out Of Stock.
",155,956541,956696
6945,sentence,"Subcategory: Gamepad. Price: Out Of Stock.

Product: Redragon G815 Blue Dual-Mode Wireless Gamepad. Category: Redragon. Subcategory: Gamepad. Price: 4,449৳4,800৳.
",163,956653,956816
6946,sentence,"Subcategory: Gamepad. Price: 4,449৳4,800৳.

Product: Redragon G815 Pink Dual-Mode Wireless Gamepad. Category: Redragon. Subcategory: Gamepad. Price: 4,399৳4,800৳.
",163,956773,956936
6947,sentence,"Subcategory: Gamepad. Price: 4,399৳4,800৳.

Product: Redragon Saturn G807 Wired Gamepad. Category: Redragon. Subcategory: Gamepad. Price: 1,650৳1,750৳.

Product: Redragon RIFT G710 Wired Gamepad. ",196,956893,957089
6948,sentence,"
Product: Redragon RIFT G710 Wired Gamepad. Category: Redragon. Subcategory: Gamepad. Price: 1,850৳.

Product: Redragon G711 Wireless Gamepad. Category: Redragon. Subcategory: Gamepad. ",185,957045,957230
6949,sentence,"Category: Redragon. Subcategory: Gamepad. Price: 2,899৳3,050৳.

Product: Redragon HARROW G808 Wireless Gamepad. Category: Redragon. Subcategory: Gamepad. Price: Out Of Stock.
",175,957188,957363
6950,sentence,"Subcategory: Gamepad. Price: Out Of Stock.

Product: Redragon G808-PR0 HARROW Gamepad. Category: Redragon. Subcategory: Gamepad. Price: Out Of Stock.

Product: Redragon Ceres G812 Wireless Gamepad. ",198,957320,957518
6951,sentence,"
Product: Redragon Ceres G812 Wireless Gamepad. Category: Redragon. Subcategory: Gamepad. Price: Out Of Stock.

Product: Sony PlayStation 5 DualSense Charging Station. Category: PlayStation. ",191,957470,957661
6952,sentence,"Category: PlayStation. Subcategory: Gamepad. Price: 2,750৳5,000৳.

Product: PlayStation 5 DualSense Wireless Controller - Galactic Purple. Category: PlayStation. Subcategory: Gamepad. Price: 8,500৳.
",199,957638,957837
6953,sentence,"Subcategory: Gamepad. Price: 8,500৳.

Product: PlayStation 5 DualSense Wireless Controller - Grey Camouflage. Category: PlayStation. Subcategory: Gamepad. Price: 8,500৳.
",170,957800,957970
6954,sentence,"Subcategory: Gamepad. Price: 8,500৳.

Product: PlayStation 5 DualSense Wireless Controller. Category: PlayStation. Subcategory: Gamepad. Price: 8,400৳9,000৳.
",158,957933,958091
6955,sentence,"Subcategory: Gamepad. Price: 8,400৳9,000৳.

Product: PlayStation 5 DualSense Wireless Controller - Starlight Blue. Category: PlayStation. Subcategory: Gamepad. Price: 8,500৳9,000৳.
",181,958048,958229
6956,sentence,"Subcategory: Gamepad. Price: 8,500৳9,000৳.

Product: PlayStation 5 DualSense Wireless Controller Cosmic Red. Category: PlayStation. Subcategory: Gamepad. Price: 8,400৳9,200৳.
",175,958186,958361
6957,sentence,"Subcategory: Gamepad. Price: 8,400৳9,200৳.

Product: PlayStation 5 DualSense Wireless Controller - Midnight Black. Category: PlayStation. Subcategory: Gamepad. Price: 8,350৳9,800৳.
",181,958318,958499
6958,sentence,"Subcategory: Gamepad. Price: 8,350৳9,800৳.

Product: PlayStation 5 DualSense Wireless Controller Cobalt Blue. Category: PlayStation. Subcategory: Gamepad. Price: 8,800৳9,800৳.
",176,958456,958632
6959,sentence,"Subcategory: Gamepad. Price: 8,800৳9,800৳.

Product: PlayStation 5 DualSense Wireless Controller Chroma Teal. Category: PlayStation. Subcategory: Gamepad. Price: 9,500৳10,700৳.
",177,958589,958766
6960,sentence,"Subcategory: Gamepad. Price: 9,500৳10,700৳.

Product: PlayStation 5 DualSense Wireless Controller Chroma Indigo. Category: PlayStation. Subcategory: Gamepad. Price: 9,500৳10,800৳.
",180,958722,958902
6961,sentence,"Subcategory: Gamepad. Price: 9,500৳10,800৳.

Product: PlayStation 5 DualSense Wireless Controller Spider-Man 2 Edition. Category: PlayStation. Subcategory: Gamepad. Price: 17,500৳.
",181,958858,959039
6962,sentence,"Subcategory: Gamepad. Price: 17,500৳.

Product: PlayStation 5 DualSense Wireless Controller DEATH STRANDING 2 ON THE BEACH Edition. Category: PlayStation. Subcategory: Gamepad. Price: 18,500৳.
",193,959001,959194
6963,sentence,"Subcategory: Gamepad. Price: 18,500৳.

Product: PlayStation 5 DualSense Wireless Controller Hogwarts Legacy Edition. Category: PlayStation. Subcategory: Gamepad. Price: 19,900৳.
",178,959156,959334
6964,sentence,"Subcategory: Gamepad. Price: 19,900৳.

Product: PXN V9 Racing Wheel With Shifter and Pedal. Category: PlayStation. Subcategory: Gamepad. Price: 23,990৳27,000৳.
",160,959296,959456
6965,sentence,"Subcategory: Gamepad. Price: 23,990৳27,000৳.

Product: PS4 Dualshock 4 Wireless Controller Green Camouflage (Original). Category: PlayStation. Subcategory: Gamepad. Price: Out Of Stock.
",186,959411,959597
6966,sentence,"Subcategory: Gamepad. Price: Out Of Stock.

Product: PS4 DualShock 4 Wireless Controller Magma Red (Original). Category: PlayStation. Subcategory: Gamepad. Price: Out Of Stock.
",177,959554,959731
6967,sentence,"Subcategory: Gamepad. Price: Out Of Stock.

Product: PS4 Dualshock 4 Wireless Controller Steel Glacier White (Original). Category: PlayStation. Subcategory: Gamepad. Price: Out Of Stock.
",187,959688,959875
6968,sentence,"Subcategory: Gamepad. Price: Out Of Stock.

Product: PS4 DualShock 4 Wireless Controller Black (Original). Category: PlayStation. Subcategory: Gamepad. Price: Out Of Stock.
",173,959832,960005
6969,sentence,"Subcategory: Gamepad. Price: Out Of Stock.

Product: HAVIT HV-G83 Gamepad. Category: Havit. Subcategory: Gamepad. Price: Out Of Stock.

Product: Havit G85 USB Gaming Pad. Category: Havit. ",188,959962,960150
6970,sentence,"Category: Havit. Subcategory: Gamepad. Price: Out Of Stock.

Product: Havit HV-G69 USB with Vibration Gamepad. Category: Havit. Subcategory: Gamepad. Price: Out Of Stock.
",171,960133,960304
6971,sentence,"Subcategory: Gamepad. Price: Out Of Stock.

Product: Havit G61 USB Vibration Double Gamepad. Category: Havit. Subcategory: Gamepad. Price: Out Of Stock.
",153,960261,960414
6972,sentence,"Subcategory: Gamepad. Price: Out Of Stock.

Product: Havit G171 Wired Gamepad With Vibration. Category: Havit. Subcategory: Gamepad. Price: Out Of Stock.
",154,960371,960525
6973,sentence,"Subcategory: Gamepad. Price: Out Of Stock.

Product: Havit G145BT Bluetooth Vibration Android Gamepad. Category: Havit. Subcategory: Gamepad. Price: Out Of Stock.
",163,960482,960645
6974,sentence,"Subcategory: Gamepad. Price: Out Of Stock.

Product: Havit G176 Wired Gamepad With Vibration. Category: Havit. Subcategory: Gamepad. Price: Out Of Stock.
",154,960602,960756
6975,sentence,"Subcategory: Gamepad. Price: Out Of Stock.

Product: Havit G89W 2.4GHZ Wireless Vibration GamePad. Category: Havit. Subcategory: Gamepad. Price: Out Of Stock.
",159,960713,960872
6976,sentence,"Subcategory: Gamepad. Price: Out Of Stock.

Product: Havit G158BT Bluetooth Vibration Android Gamepad. Category: Havit. Subcategory: Gamepad. Price: Out Of Stock.
",163,960829,960992
6977,sentence,"Subcategory: Gamepad. Price: Out Of Stock.

Product: Rapoo V600S Wired & Wireless Dual Vibration Motors Gamepad With Nano USB Receiver. Category: Rapoo. Subcategory: Gamepad. Price: 3,250৳.
",190,960949,961139
6978,sentence,"Subcategory: Gamepad. Price: 3,250৳.

Product: Rapoo V600SE Dual Mode Wireless Gamepad. Category: Rapoo. Subcategory: Gamepad. Price: 3,199৳3,350৳.

Product: Corsair SCUF ENVISION Gamepad. ",189,961102,961291
6979,sentence,"
Product: Corsair SCUF ENVISION Gamepad. Category: Corsair. Subcategory: Gamepad. Price: 7,499৳7,700৳.

Product: Corsair SCUF NOMAD Mobile Gaming Controller for iPhone. Category: Corsair. ",188,961250,961438
6980,sentence,"Category: Corsair. Subcategory: Gamepad. Price: 8,599৳8,800৳.

Product: Corsair SCUF ENVISION PRO Wireless Gamepad. Category: Corsair. Subcategory: Gamepad. Price: 14,500৳.
",173,961419,961592
6981,sentence,"Subcategory: Gamepad. Price: 14,500৳.

Product: Fantech EOS LITE GP15L Wired Gamepad. Category: Fantech. Subcategory: Gamepad. Price: 2,599৳2,750৳.
",148,961554,961702
6982,sentence,"Subcategory: Gamepad. Price: 2,599৳2,750৳.

Product: Fantech GP15 EOS Vega Multiplatform Wired Gamepad. Category: Fantech. Subcategory: Gamepad. Price: 2,899৳3,050৳.
",166,961659,961825
6983,sentence,"Subcategory: Gamepad. Price: 2,899৳3,050৳.

Product: Fantech Revolver WGP12 Wireless Gaming Controller. Category: Fantech. Subcategory: Gamepad. Price: 2,999৳3,200৳.
",166,961782,961948
6984,sentence,"Subcategory: Gamepad. Price: 2,999৳3,200৳.

Product: Fantech Revolver III WGP12S Wireless Controller. Category: Fantech. Subcategory: Gamepad. Price: 3,675৳.
",158,961905,962063
6985,sentence,"Subcategory: Gamepad. Price: 3,675৳.

Product: Fantech NOVA PRO WGP14V2 Multiplatform Wireless Gamepad. Category: Fantech. Subcategory: Gamepad. Price: 4,049৳4,250৳.
",166,962026,962192
6986,sentence,"Subcategory: Gamepad. Price: 4,049৳4,250৳.

Product: Fantech EOS PRO WGP15 Multiplatform Tri-Mode Wireless Gamepad. Category: Fantech. Subcategory: Gamepad. Price: 4,199৳4,250৳.
",178,962149,962327
6987,sentence,"Subcategory: Gamepad. Price: 4,199৳4,250৳.

Product: Fantech NOVA WGP14 Wireless Gaming Controller. Category: Fantech. Subcategory: Gamepad. Price: 3,999৳4,345৳.
",162,962284,962446
6988,sentence,"Subcategory: Gamepad. Price: 3,999৳4,345৳.

Product: Fantech Nova II WGP16 Wireless Controller Black. Category: Fantech. Subcategory: Gamepad. Price: 4,450৳.
",158,962403,962561
6989,sentence,"Subcategory: Gamepad. Price: 4,450৳.

Product: Fantech Nova II WGP16 Wireless Controller. Category: Fantech. Subcategory: Gamepad. Price: 4,500৳.
",146,962524,962670
6990,sentence,"Subcategory: Gamepad. Price: 4,500৳.

Product: Fantech Nova II WGP16 Wireless Controller White. Category: Fantech. Subcategory: Gamepad. Price: 4,500৳.

Product: Fantech GP11 Shooter USB Gamepad. ",196,962633,962829
6991,sentence,"
Product: Fantech GP11 Shooter USB Gamepad. Category: Fantech. Subcategory: Gamepad. Price: Out Of Stock.

Product: Fantech GP13 Shooter II Gaming Controller. Category: Fantech. ",178,962785,962963
6992,sentence,"Category: Fantech. Subcategory: Gamepad. Price: 1,799৳1,925৳.

Product: Fantech WGP13 Shooter II Wireless Gaming Controller. Category: Fantech. Subcategory: Gamepad. Price: Out Of Stock.
",187,962944,963131
6993,sentence,"Subcategory: Gamepad. Price: Out Of Stock.

Product: Fantech WGP13S Shooter III Wireless Gamepad. Category: Fantech. Subcategory: Gamepad. Price: 2,985৳3,135৳.
",160,963088,963248
6994,sentence,"Subcategory: Gamepad. Price: 2,985৳3,135৳.

Product: Pico Neo 3 Link Standalone 6GB RAM 128GB Storage All-in-One VR Headset. Category: VR. Subcategory: Gaming. Price: 41,500৳45,000৳.
",183,963205,963388
6995,sentence,"Subcategory: Gaming. Price: 41,500৳45,000৳.

Product: Meta Quest 3s VR Headset with Batman Arkham Shadow (3 month trail). Category: VR. Subcategory: Gaming. Price: 47,400৳55,000৳.
",180,963344,963524
6996,sentence,"Subcategory: Gaming. Price: 47,400৳55,000৳.

Product: Pico Neo 3 Link Standalone 6GB RAM 256GB Storage All-in-One VR Headset. Category: VR. Subcategory: Gaming. Price: 51,500৳58,000৳.
",184,963480,963664
6997,sentence,"Subcategory: Gaming. Price: 51,500৳58,000৳.

Product: Meta Quest 2 256 GB All-in-One VR System. Category: VR. Subcategory: Gaming. Price: 59,900৳64,000৳.
",154,963620,963774
6998,sentence,"Subcategory: Gaming. Price: 59,900৳64,000৳.

Product: PICO 4 All-in-One 128GB VR Headset. Category: VR. Subcategory: Gaming. Price: 57,400৳64,000৳.

Product: PICO 4 All-in-One 256GB VR Headset. ",194,963730,963924
6999,sentence,"
Product: PICO 4 All-in-One 256GB VR Headset. Category: VR. Subcategory: Gaming. Price: 59,500৳65,000৳.

Product: Meta Quest 3s 128GB All-in-One VR Headset. Category: VR. Subcategory: Gaming. ",192,963878,964070
7000,sentence,"Category: VR. Subcategory: Gaming. Price: 44,900৳65,000৳.

Product: Sony PlayStation VR2. Category: VR. Subcategory: Gaming. Price: 58,500৳65,500৳.
",148,964035,964183
7001,sentence,"Subcategory: Gaming. Price: 58,500৳65,500৳.

Product: Meta Quest 3s 256GB All-in-One VR Headset. Category: VR. Subcategory: Gaming. Price: 58,500৳67,500৳.
",155,964139,964294
7002,sentence,"Subcategory: Gaming. Price: 58,500৳67,500৳.

Product: Meta Quest 3 512GB All-in-One VR Headset. Category: VR. Subcategory: Gaming. Price: 74,900৳83,500৳.
",154,964250,964404
7003,sentence,"Subcategory: Gaming. Price: 74,900৳83,500৳.

Product: Apple Vision Pro 256GB Storage Spatial Computer VR Headset. Category: VR. Subcategory: Gaming. Price: 445,000৳.
",166,964360,964526
7004,sentence,"Subcategory: Gaming. Price: 445,000৳.

Product: Apple Vision Pro 1TB Storage Spatial Computer VR Headset. Category: VR. Subcategory: Gaming. Price: 529,000৳545,000৳.
",166,964488,964654
7005,sentence,"Subcategory: Gaming. Price: 529,000৳545,000৳.

Product: Sony Playstation Move Virtual Reality Motion Controller. Category: VR. Subcategory: Gaming. Price: Up Coming.
",166,964608,964774
7006,sentence,"Subcategory: Gaming. Price: Up Coming.

Product: Meta Quest Pro 256 GB All-in-One VR Headset. Category: VR. Subcategory: Gaming. Price: Up Coming.
",147,964735,964882
7007,sentence,"Subcategory: Gaming. Price: Up Coming.

Product: Pico Neo 3 8GB RAM 128GB ROM 3D Advanced All-In-One VR Headset. Category: VR. Subcategory: Gaming. Price: Out Of Stock.
",169,964843,965012
7008,sentence,"Subcategory: Gaming. Price: Out Of Stock.

Product: Meta Quest 2 128 GB All-in-One VR System. Category: VR. Subcategory: Gaming. Price: Out Of Stock.
",150,964970,965120
7009,sentence,"Subcategory: Gaming. Price: Out Of Stock.

Product: Pico Neo 3 8GB RAM 256GB ROM 3D Advanced All-In-One VR Headset. Category: VR. Subcategory: Gaming. Price: Out Of Stock.
",172,965078,965250
7010,sentence,"Subcategory: Gaming. Price: Out Of Stock.

Product: Meta Quest 2 128GB All-in-One VR System with Resident Evil 4 Game Bundle. Category: VR. Subcategory: Gaming. Price: Out Of Stock.
",182,965208,965390
7011,sentence,"Subcategory: Gaming. Price: Out Of Stock.

Product: Sony PlayStation VR2 Horizon Call of the Mountain Bundle. Category: VR. Subcategory: Gaming. Price: Out Of Stock.
",166,965348,965514
7012,sentence,"Subcategory: Gaming. Price: Out Of Stock.

Product: Meta Quest 3 128GB All-in-One VR Headset. Category: VR. Subcategory: Gaming. Price: Out Of Stock.

Product: Sony Vertical Console Stand for PS5. ",197,965472,965669
7013,sentence,"
Product: Sony Vertical Console Stand for PS5. Category: PlayStation. Subcategory: Gaming Console. Price: 2,800৳4,200৳.

Product: PlayStation 5 Console Cover. Category: PlayStation. ",182,965622,965804
7014,sentence,"Category: PlayStation. Subcategory: Gaming Console. Price: 4,990৳6,900৳.

Product: PlayStation 5 Console Cover God of War Edition. Category: PlayStation. Subcategory: Gaming Console. Price: 7,500৳.
",198,965781,965979
7015,sentence,"Subcategory: Gaming Console. Price: 7,500৳.

Product: Sony PlayStation HD Camera for PS5. Category: PlayStation. Subcategory: Gaming Console. Price: 7,000৳7,500৳.
",163,965935,966098
7016,sentence,"Price: 7,000৳7,500৳.

Product: Sony Console Disc Drive for PS5 Digital Edition Slim. Category: PlayStation. Subcategory: Gaming Console. Price: 21,500৳29,000৳.
",160,966077,966237
7017,sentence,"Price: 21,500৳29,000৳.

Product: Sony PlayStation 5 Media Remote. Category: PlayStation. Subcategory: Gaming Console. Price: Out Of Stock.
",139,966214,966353
7018,sentence,"Price: Out Of Stock.

Product: PlayStation 5 Console Cover Marvel’s Spider-Man 2 Limited Edition. Category: PlayStation. Subcategory: Gaming Console. Price: Out Of Stock.
",171,966332,966503
7019,sentence,"Price: Out Of Stock.

Product: Valve Steam Deck OLED Handheld Gaming Console. Category: Steam Deck. Subcategory: Gaming Console. Price: 79,500৳90,000৳.
",152,966482,966634
7020,sentence,"Price: 79,500৳90,000৳.

Product: Valve Steam Deck OLED 1TB Handheld Gaming Console. Category: Steam Deck. Subcategory: Gaming Console. Price: 93,500৳115,000৳.
",159,966611,966770
7021,sentence,"Price: 93,500৳115,000৳.

Product: ASUS ROG Ally X Gaming Console. Category: Asus. Subcategory: Gaming Console. Price: 122,900৳144,000৳.

Product: Asus ROG Ally Gaming Console. Category: Asus. ",192,966746,966938
7022,sentence,"Category: Asus. Subcategory: Gaming Console. Price: Out Of Stock.

Product: Lenovo Legion Go Handheld PC Gaming Console. Category: Lenovo. Subcategory: Gaming Console. Price: 96,700৳119,000৳.
",192,966922,967114
7023,sentence,"Price: 96,700৳119,000৳.

Product: Uncharted 4 A Thief's End for PlayStation 4. Category: Games. Subcategory: Gaming. Price: 2,700৳.

Product: The Witcher 3: Wild Hunt for PS4 and PS5. ",184,967090,967274
7024,sentence,"Category: Games. Subcategory: Gaming. Price: 2,800৳.

Product: Gran Turismo Sport for PS4 and PS5. Category: Games. Subcategory: Gaming. Price: 2,800৳.
",152,967274,967426
7025,sentence,"Subcategory: Gaming. Price: 2,800৳.

Product: Tom Clancy's The Division 2 for PS4 and PS5. Category: Games. Subcategory: Gaming. Price: 2,800৳.

Product: Gran Turismo Sport for PlayStation 4 VR. ",195,967390,967585
7026,sentence,"Category: Games. Subcategory: Gaming. Price: 2,890৳.

Product: WWE 2K20 for PS4 and PS5. Category: Games. Subcategory: Gaming. Price: 3,000৳.

Product: Need for Speed Payback for PS4 and PS5. ",192,967585,967777
7027,sentence,"Category: Games. Subcategory: Gaming. Price: 3,000৳.

Product: Mortal Kombat XL for PS4 and PS5. Category: Games. Subcategory: Gaming. Price: 3,000৳.

Product: Watch Dogs: Legion for PS4 and PS5. ",196,967777,967973
7028,sentence,"
Product: Watch Dogs: Legion for PS4 and PS5. Category: Games. Subcategory: Gaming. Price: 3,100৳.

Product: Red Dead Redemption 2 Sony PS4 Game. Category: Games. Subcategory: Gaming. Price: 3,200৳.
",199,967927,968126
7029,sentence,"Subcategory: Gaming. Price: 3,200৳.

Product: Battlefield V Year 2 Edition for PS4 and PS5. Category: Games. Subcategory: Gaming. Price: 3,200৳.

Product: Need for Speed Heat for PS4 and PS5. ",192,968090,968282
7030,sentence,"
Product: Need for Speed Heat for PS4 and PS5. Category: Games. Subcategory: Gaming. Price: 3,200৳.

Product: God of War for PS4 and PS5. Category: Games. Subcategory: Gaming. Price: 2,990৳3,300৳.
",197,968235,968432
7031,sentence,"Subcategory: Gaming. Price: 2,990৳3,300৳.

Product: Call of Duty: Infinite Warfare for PS4 and PS5. Category: Games. Subcategory: Gaming. Price: 3,500৳.
",153,968390,968543
7032,sentence,"Subcategory: Gaming. Price: 3,500৳.

Product: Assassin's Creed Valhalla for PS4 and PS5. Category: Games. Subcategory: Gaming. Price: 3,700৳.

Product: Mafia: Definitive Edition for PlayStation 4. ",197,968507,968704
7033,sentence,"Category: Games. Subcategory: Gaming. Price: 4,200৳.

Product: FAR CRY 6 Game for PS4 and PS5. Category: Games. Subcategory: Gaming. Price: 4,500৳.
",148,968704,968852
7034,sentence,"Subcategory: Gaming. Price: 4,500৳.

Product: Grand Theft Auto V (GTA 5) for PS4 and PS5. Category: Games. Subcategory: Gaming. Price: 4,500৳.

Product: The Last of Us Part II for PS4 and PS5. ",193,968816,969009
7035,sentence,"Category: Games. Subcategory: Gaming. Price: 4,500৳.

Product: Resident Evil Village Game for PS4 and PS5. Category: Games. Subcategory: Gaming. Price: 4,500৳.
",160,969009,969169
7036,sentence,"Subcategory: Gaming. Price: 4,500৳.

Product: Nintendo Switch Lite Gaming Console. Category: Nintendo. Subcategory: Gaming Console. Price: 21,900৳25,500৳.
",155,969133,969288
7037,sentence,"Price: 21,900৳25,500৳.

Product: Nintendo Switch OLED Gaming Console. Category: Nintendo. Subcategory: Gaming Console. Price: 36,500৳38,000৳.
",142,969265,969407
7038,sentence,"Price: 36,500৳38,000৳.

Product: Nintendo Switch OLED Model Neon Blue/Neon Red set Gaming Console. Category: Nintendo. Subcategory: Gaming Console. Price: 36,500৳38,000৳.
",171,969384,969555
7039,sentence,"Price: 36,500৳38,000৳.

Product: Nintendo Switch OLED Model The Legend of Zelda Tears of the Kingdom Edition Gaming Console. Category: Nintendo. Subcategory: Gaming Console. Price: 41,000৳.
",190,969532,969722
7040,sentence,"Subcategory: Gaming Console. Price: 41,000৳.

Product: Nintendo Switch 2 Gaming Console. Category: Nintendo. Subcategory: Gaming Console. Price: 75,000৳82,000৳.
",161,969677,969838
7041,sentence,"Price: 75,000৳82,000৳.

Product: Nintendo Switch 2 With Mario Kart World Bundle. Category: Nintendo. Subcategory: Gaming Console. Price: 87,000৳95,000৳.
",153,969815,969968
7042,sentence,"Price: 87,000৳95,000৳.

Product: Nintendo Switch OLED Model Pokemon Scarlet & Violet Edition Gaming Console. Category: Nintendo. Subcategory: Gaming Console. Price: Up Coming.
",176,969945,970121
7043,sentence,"Subcategory: Gaming Console. Price: Up Coming.

Product: Nintendo Switch OLED Model Splatoon 3 Edition Gaming Console. Category: Nintendo. Subcategory: Gaming Console. Price: Up Coming.
",186,970074,970260
7044,sentence,"Subcategory: Gaming Console. Price: Up Coming.

Product: Nintendo Switch OLED Model Mario Red Edition Gaming Console. Category: Nintendo. Subcategory: Gaming Console. Price: Out Of Stock.
",188,970213,970401
7045,sentence,"Price: Out Of Stock.

Product: Nintendo Switch Fortnite Wildcat Bundle Gaming Console. Category: Nintendo. Subcategory: Gaming Console. Price: Out Of Stock.
",157,970380,970537
7046,sentence,"Price: Out Of Stock.

Product: Microsoft Xbox Series S Gaming Console. Category: Xbox. Subcategory: Gaming Console. Price: 42,500৳46,300৳.

Product: Microsoft Xbox One X Gaming Console. ",186,970516,970702
7047,sentence,"
Product: Microsoft Xbox One X Gaming Console. Category: Xbox. Subcategory: Gaming Console. Price: 65,000৳.

Product: Microsoft Xbox Series X Gaming Console White. Category: Xbox. ",180,970655,970835
7048,sentence,"Category: Xbox. Subcategory: Gaming Console. Price: 81,000৳92,000৳.

Product: Microsoft Xbox One S Gaming Console. Category: Xbox. Subcategory: Gaming Console. Price: Up Coming.
",178,970819,970997
7049,sentence,"Subcategory: Gaming Console. Price: Up Coming.

Product: Haier H32D2M 32 Inch Miracast HD LED TV. Category: Haier. Subcategory: All TV. Price: 16,500৳20,900৳.
",159,970950,971109
7050,sentence,"Subcategory: All TV. Price: 16,500৳20,900৳.

Product: Haier H32K85FX 32"" DLED HD Google TV. Category: Haier. Subcategory: All TV. Price: 22,300৳26,900৳.
",153,971065,971218
7051,sentence,"Subcategory: All TV. Price: 22,300৳26,900৳.

Product: Haier H32S80EFX 32"" QLED FHD Android Google TV. Category: Haier. Subcategory: All TV. Price: 22,990৳29,900৳.
",163,971174,971337
7052,sentence,"Subcategory: All TV. Price: 22,990৳29,900৳.

Product: Haier Candy C40K6FG 40"" DLED FHD Smart Android TV. Category: Haier. Subcategory: All TV. Price: 27,900৳30,900৳.
",166,971293,971459
7053,sentence,"Subcategory: All TV. Price: 27,900৳30,900৳.

Product: Haier H43K85FFX 43"" DLED FHD Google TV. Category: Haier. Subcategory: All TV. Price: 30,990৳39,900৳.
",155,971415,971570
7054,sentence,"Subcategory: All TV. Price: 30,990৳39,900৳.

Product: Haier H43S80EUX 43"" QLED 4K Android Google TV. Category: Haier. Subcategory: All TV. Price: 35,990৳46,900৳.
",162,971526,971688
7055,sentence,"Subcategory: All TV. Price: 35,990৳46,900৳.

Product: Haier H43P7UX 43 Inch Voice Control HQLED 4K Smart Google TV. Category: Haier. Subcategory: All TV. Price: 38,300৳49,900৳.
",177,971644,971821
7056,sentence,"Subcategory: All TV. Price: 38,300৳49,900৳.

Product: Haier H50P7UX 50 Inch Voice Control HQLED 4K Smart Google TV. Category: Haier. Subcategory: All TV. Price: 49,990৳64,900৳.
",177,971777,971954
7057,sentence,"Subcategory: All TV. Price: 49,990৳64,900৳.

Product: Haier H55P7UX 55 Inch Voice Control HQLED 4K Smart Google TV. Category: Haier. Subcategory: All TV. Price: 57,684৳75,900৳.
",177,971910,972087
7058,sentence,"Subcategory: All TV. Price: 57,684৳75,900৳.

Product: Haier H65P7UX 65 Inch Voice Control HQLED 4K Smart Google TV. Category: Haier. Subcategory: All TV. Price: 76,400৳99,900৳.
",177,972043,972220
7059,sentence,"Subcategory: All TV. Price: 76,400৳99,900৳.

Product: Haier H75P7UX 75 Inch Voice Control HQLED 4K Smart Google TV. Category: Haier. Subcategory: All TV. Price: 121,900৳159,900৳.
",179,972176,972355
7060,sentence,"Subcategory: All TV. Price: 121,900৳159,900৳.

Product: Haier Candy C32K7G 32"" DLED HD Smart Android TV. Category: Haier. Subcategory: All TV. Price: Out Of Stock.
",164,972309,972473
7061,sentence,"Subcategory: All TV. Price: Out Of Stock.

Product: Haier H32K800X 32 Inch Bezel Less HD Google TV. Category: Haier. Subcategory: All TV. Price: Out Of Stock.
",159,972431,972590
7062,sentence,"Subcategory: All TV. Price: Out Of Stock.

Product: Haier H43K800FX 43 Inch Bezel Less Full HD Google Smart TV. Category: Haier. Subcategory: All TV. Price: Out Of Stock.
",171,972548,972719
7063,sentence,"Subcategory: All TV. Price: Out Of Stock.

Product: Haier H43K800UX 43 Inch Bezel Less 4K Google TV. Category: Haier. Subcategory: All TV. Price: Out Of Stock.
",160,972677,972837
7064,sentence,"Subcategory: All TV. Price: Out Of Stock.

Product: Smart SEL-32B24K 32"" HD Basic LED TV. Category: TV. Price: 13,800৳18,500৳.

Product: Rangs RG32HX 32"" HD LED Android Google TV. Category: TV. ",194,972795,972989
7065,sentence,"Category: TV. Price: 22,705৳23,900৳.

Product: Smart SEL-32S22KS 32"" HD LED Android TV. Category: TV. Price: 25,500৳.

Product: SINGER S32 SLE32E3AGOTV 32 Inch HD Android Google TV. Category: TV. ",196,972975,973171
7066,sentence,"Category: TV. Price: 23,900৳23,990৳.

Product: Samsung 32H5000F 32"" HD LED Smart TV. Category: TV. Price: 23,800৳29,500৳.

Product: Daewoo 32DE54HLB 32 Inch HD Android Google Smart TV. Category: TV. ",199,973157,973356
7067,sentence,"Category: TV. Price: 22,900৳30,900৳.

Product: Samsung 32T4450 32"" HD LED Smart TV. Category: TV. Price: 22,900৳30,900৳.

Product: Rangs RG43HX 43"" HD LED Android Google TV. Category: TV. ",188,973342,973530
7068,sentence,"Category: TV. Price: 34,105৳35,900৳.

Product: LG LQ63 32 Inch HD Smart LED TV. Category: TV. Price: 33,900৳38,900৳.

Product: Hisense 43A4F4 43"" Bezelless Smart Android FHD TV. Category: TV. ",192,973516,973708
7069,sentence,"Category: TV. Price: 31,990৳39,900৳.

Product: ROWA 43S52 43 Inch Full HD Android Smart TV. Category: TV. Price: 30,500৳40,900৳.

Product: Smart SEL-43V24K 43"" Voice Control Android LED Smart TV. ",196,973694,973890
7070,sentence,"Category: TV. Price: 31,900৳41,900৳.

Product: Rangs RG43ZX 43"" 4K Android Google TV. Category: TV. Price: 39,805৳41,900৳.

Product: Samsung 43F6000F 43"" FHD LED Smart TV. Category: TV. ",186,973890,974076
7071,sentence,"Category: TV. Price: 34,900৳41,900৳.

Product: Daewoo 43DM54UAB 43"" 4K Android Google Smart TV. Category: TV. Price: 35,990৳43,900৳.
",133,974062,974195
7072,sentence,"Category: TV. Price: 35,990৳43,900৳.

Product: Hisense 43A6F3 43"" Bezelless Smart Android 4K UHD Google TV. Category: Hisense. Subcategory: All TV. Price: 34,900৳47,900৳.
",171,974158,974329
7073,sentence,"Subcategory: All TV. Price: 34,900৳47,900৳.

Product: Hisense 50A6F3 50"" Bezelless Smart Android 4K UHD Google TV. Category: Hisense. Subcategory: All TV. Price: 47,663৳61,900৳.
",178,974285,974463
7074,sentence,"Subcategory: All TV. Price: 47,663৳61,900৳.

Product: Hisense 65A6N 65"" 4K UHD Smart Android Google TV. Category: Hisense. Subcategory: All TV. Price: 78,990৳99,900৳.
",167,974419,974586
7075,sentence,"Subcategory: All TV. Price: 78,990৳99,900৳.

Product: Hisense 65Q6N 65"" 4K QLED Voice Control Smart Google TV. Category: Hisense. Subcategory: All TV. Price: 101,000৳124,900৳.
",176,974542,974718
7076,sentence,"Subcategory: All TV. Price: 101,000৳124,900৳.

Product: Hisense 75A6N 75"" 4K UHD Smart Android Google TV. Category: Hisense. Subcategory: All TV. Price: 124,000৳149,900৳.
",171,974672,974843
7077,sentence,"Subcategory: All TV. Price: 124,000৳149,900৳.

Product: Hisense 75Q6N 75"" 4K QLED Voice Control Smart Google TV. Category: Hisense. Subcategory: All TV. Price: 146,000৳179,900৳.
",178,974797,974975
7078,sentence,"Subcategory: All TV. Price: 146,000৳179,900৳.

Product: Hisense 85Q6N 85"" 4K QLED Voice Control Smart Google TV. Category: Hisense. Subcategory: All TV. Price: 245,000৳299,900৳.
",178,974929,975107
7079,sentence,"Subcategory: All TV. Price: 245,000৳299,900৳.

Product: Hisense 43U6F3 43"" Bezelless Smart Android 4K ULED Google TV. Category: Hisense. Subcategory: All TV. Price: Out Of Stock.
",179,975061,975240
7080,sentence,"Subcategory: All TV. Price: Out Of Stock.

Product: Hisense 55A6F3 55"" Bezelless Smart Android 4K UHD Google TV. Category: Hisense. Subcategory: All TV. Price: Out Of Stock.
",174,975198,975372
7081,sentence,"Subcategory: All TV. Price: Out Of Stock.

Product: Hisense 65A6F3 65"" Bezelless Smart Android 4K UHD Google TV. Category: Hisense. Subcategory: All TV. Price: Out Of Stock.
",174,975330,975504
7082,sentence,"Subcategory: All TV. Price: Out Of Stock.

Product: Hisense 100Q7N 100"" QLED 4K Smart Android Google TV. Category: Hisense. Subcategory: All TV. Price: Out Of Stock.
",166,975462,975628
7083,sentence,"Subcategory: All TV. Price: Out Of Stock.

Product: Hisense 32A4F4 32"" Bezelless Smart Android HD TV. Category: Hisense. Subcategory: All TV. Price: Out Of Stock.
",163,975586,975749
7084,sentence,"Subcategory: All TV. Price: Out Of Stock.

Product: Hisense 75A6F3 75"" Bezelless Smart Android 4K UHD Google TV. Category: Hisense. Subcategory: All TV. Price: Out Of Stock.
",174,975707,975881
7085,sentence,"Subcategory: All TV. Price: Out Of Stock.

Product: SINGER Primax S55-SLE55GU5000TV 55"" 4K Android Google TV. Category: SINGER. Subcategory: All TV. Price: 75,000৳86,900৳.
",172,975839,976011
7086,sentence,"Subcategory: All TV. Price: 75,000৳86,900৳.

Product: SINGER Primax S50-SLE50GU5000TV 50"" 4K Android Google TV. Category: SINGER. Subcategory: All TV. Price: 59,000৳68,990৳.
",174,975967,976141
7087,sentence,"Subcategory: All TV. Price: 59,000৳68,990৳.

Product: SINGER Primax S43-SLE43GU5000TV 43"" 4K Android Google TV. Category: SINGER. Subcategory: All TV. Price: 42,400৳51,990৳.
",174,976097,976271
7088,sentence,"Subcategory: All TV. Price: 42,400৳51,990৳.

Product: SINGER Frameless S43-SLE43G22GOTV 43"" 4K Android Google TV. Category: SINGER. Subcategory: All TV. Price: 41,500৳42,990৳.
",176,976227,976403
7089,sentence,"Subcategory: All TV. Price: 41,500৳42,990৳.

Product: SINGER SLE43GP5000TV 43"" FHD Android Google TV. Category: SINGER. Subcategory: All TV. Price: 36,000৳36,990৳.
",164,976359,976523
7090,sentence,"Subcategory: All TV. Price: 36,000৳36,990৳.

Product: SINGER Frameless E43-SLE43GA5000TV 43"" FHD Android Google TV. Category: SINGER. Subcategory: All TV. Price: Out Of Stock.
",176,976479,976655
7091,sentence,"Subcategory: All TV. Price: Out Of Stock.

Product: SINGER SLE32GP6100TV 32"" HD Android Google TV. Category: SINGER. Subcategory: All TV. Price: 25,500৳25,990৳.
",161,976613,976774
7092,sentence,"Subcategory: All TV. Price: 25,500৳25,990৳.

Product: Xiaomi A Pro 55 Inch QLED 4K UHD Smart Android Google TV (Global Version). Category: XIAOMI. Subcategory: All TV. Price: 67,000৳90,990৳.
",191,976730,976921
7093,sentence,"Subcategory: All TV. Price: 67,000৳90,990৳.

Product: Xiaomi A 65 2025 65"" 4K UHD Smart Android Google TV (Global Version). Category: XIAOMI. Subcategory: All TV. Price: 80,000৳109,990৳.
",187,976877,977064
7094,sentence,"Subcategory: All TV. Price: 80,000৳109,990৳.

Product: Xiaomi A Pro 65 Inch QLED 4K UHD Smart Android Google TV (Global Version). Category: XIAOMI. Subcategory: All TV. Price: 86,990৳129,990৳.
",193,977019,977212
7095,sentence,"Subcategory: All TV. Price: 86,990৳129,990৳.

Product: Xiaomi A Pro 32 Inch HD Smart Android Google TV (Global Version). Category: XIAOMI. Subcategory: All TV. Price: Out Of Stock.
",181,977167,977348
7096,sentence,"Subcategory: All TV. Price: Out Of Stock.

Product: Xiaomi A Pro 43 Inch 4K UHD Smart Android Google TV (Global Version). Category: XIAOMI. Subcategory: All TV. Price: Out Of Stock.
",182,977306,977488
7097,sentence,"Subcategory: All TV. Price: Out Of Stock.

Product: Xiaomi A Pro 43 Inch QLED 4K UHD Smart Android Google TV (Global Version). Category: XIAOMI. Subcategory: All TV. Price: Out Of Stock.
",187,977446,977633
7098,sentence,"Subcategory: All TV. Price: Out Of Stock.

Product: Xiaomi A Pro 55 Inch 4K UHD Smart Android Google TV (Global Version). Category: XIAOMI. Subcategory: All TV. Price: Out Of Stock.
",182,977591,977773
7099,sentence,"Subcategory: All TV. Price: Out Of Stock.

Product: Xiaomi A 55 2025  55"" 4K UHD Smart Android Google TV (Global Version). Category: XIAOMI. Subcategory: All TV. Price: Out Of Stock.
",183,977731,977914
7100,sentence,"Subcategory: All TV. Price: Out Of Stock.

Product: Xiaomi A Pro 65 Inch 4K UHD Smart Android Google TV (Global Version). Category: XIAOMI. Subcategory: All TV. Price: Out Of Stock.
",182,977872,978054
7101,sentence,"Subcategory: All TV. Price: Out Of Stock.

Product: Xiaomi A Pro 75 Inch QLED 4K UHD Smart Android Google TV (Global Version). Category: XIAOMI. Subcategory: All TV. Price: Out Of Stock.
",187,978012,978199
7102,sentence,"Subcategory: All TV. Price: Out Of Stock.

Product: Samsung 50U8000F 50"" Crystal 4K UHD LED Smart TV. Category: Samsung. Subcategory: All TV. Price: 59,990৳79,900৳.
",165,978157,978322
7103,sentence,"Subcategory: All TV. Price: 59,990৳79,900৳.

Product: Samsung 43U8000F 43"" 4K UHD LED Smart TV. Category: Samsung. Subcategory: All TV. Price: 43,900৳51,900৳.
",159,978278,978437
7104,sentence,"Subcategory: All TV. Price: 43,900৳51,900৳.

Product: Samsung 43U8510F 43"" 4K UHD LED Smart TV. Category: Samsung. Subcategory: All TV. Price: 44,900৳59,900৳.
",159,978393,978552
7105,sentence,"Subcategory: All TV. Price: 44,900৳59,900৳.

Product: Samsung 43DU8000 43"" Crystal 4K UHD HDR Smart TV. Category: Samsung. Subcategory: All TV. Price: 57,000৳69,900৳.
",167,978508,978675
7106,sentence,"Subcategory: All TV. Price: 57,000৳69,900৳.

Product: Samsung 55DU7700 55 Inch Crystal 4K UHD Smart TV (Unofficial). Category: Samsung. Subcategory: All TV. Price: 68,800৳75,000৳.
",180,978631,978811
7107,sentence,"Subcategory: All TV. Price: 68,800৳75,000৳.

Product: Samsung 50DU7700 50 Inch Crystal 4K UHD Smart TV. Category: Samsung. Subcategory: All TV. Price: 59,334৳89,900৳.
",167,978767,978934
7108,sentence,"Subcategory: All TV. Price: 59,334৳89,900৳.

Product: Samsung 55AU9000 55 Inch Crystal 4K UHD HDR Smart TV. Category: Samsung. Subcategory: All TV. Price: 88,800৳94,000৳.
",171,978890,979061
7109,sentence,"Subcategory: All TV. Price: 88,800৳94,000৳.

Product: Samsung 55U8500F 55"" 4K UHD LED Smart TV. Category: Samsung. Subcategory: All TV. Price: 72,000৳95,900৳.
",159,979017,979176
7110,sentence,"Subcategory: All TV. Price: 72,000৳95,900৳.

Product: Samsung 55Q70C 55 Inch QLED 4K UHD Smart TV. Category: Samsung. Subcategory: All TV. Price: 90,900৳97,000৳.
",162,979132,979294
7111,sentence,"Subcategory: All TV. Price: 90,900৳97,000৳.

Product: Samsung 65Q65D 65"" QLED 4K UHD Smart TV (Unofficial). Category: Samsung. Subcategory: All TV. Price: 120,000৳130,000৳.
",173,979250,979423
7112,sentence,"Subcategory: All TV. Price: 120,000৳130,000৳.

Product: Samsung 65Q70C 65 Inch QLED 4K UHD Smart TV. Category: Samsung. Subcategory: All TV. Price: 125,500৳140,000৳.
",166,979377,979543
7113,sentence,"Subcategory: All TV. Price: 125,500৳140,000৳.

Product: Samsung 65Q70D 65"" QLED 4K UHD Smart TV. Category: Samsung. Subcategory: All TV. Price: 135,000৳145,000৳.
",162,979497,979659
7114,sentence,"Subcategory: All TV. Price: 135,000৳145,000৳.

Product: Samsung 98DU9000 98"" 4K Smart LED TV. Category: Samsung. Subcategory: All TV. Price: 870,000৳1,199,000৳.
",161,979613,979774
7115,sentence,"Subcategory: All TV. Price: 870,000৳1,199,000৳.

Product: Samsung 75Q7F 75"" QLED 4K UHD Vision AI Smart TV. Category: Samsung. Subcategory: All TV. Price: 195,000৳249,900৳.
",173,979726,979899
7116,sentence,"Subcategory: All TV. Price: 195,000৳249,900৳.

Product: Samsung 65S85F 65"" OLED 4K UHD Vision AI Smart TV. Category: Samsung. Subcategory: All TV. Price: 285,000৳359,900৳.
",172,979853,980025
7117,sentence,"Subcategory: All TV. Price: 285,000৳359,900৳.

Product: Samsung 55QN85D 55"" Neo QLED UHD 4K Smart TV (Unofficial). Category: Samsung. Subcategory: All TV. Price: 130,000৳145,000৳.
",180,979979,980159
7118,sentence,"Subcategory: All TV. Price: 130,000৳145,000৳.

Product: Samsung 65DU7700 65 Inch Crystal 4K UHD Smart TV. Category: Samsung. Subcategory: All TV. Price: 95,936৳149,900৳.
",170,980113,980283
7119,sentence,"Subcategory: All TV. Price: 95,936৳149,900৳.

Product: Sony Bravia KD-43X75K 43 Inch 4K Ultra HD Smart Android LED TV (Unofficial). Category: Sony. Subcategory: All TV. Price: 53,800৳57,000৳.
",192,980238,980430
7120,sentence,"Subcategory: All TV. Price: 53,800৳57,000৳.

Product: Sony Bravia KD-50X75 50 Inch 4K Ultra HD Smart Android LED TV. Category: Sony. Subcategory: All TV. Price: 66,900৳72,000৳.
",177,980386,980563
7121,sentence,"Subcategory: All TV. Price: 66,900৳72,000৳.

Product: Sony Bravia KD-43X75K 43 Inch 4K Ultra HD Smart Android LED TV. Category: Sony. Subcategory: All TV. Price: 59,430৳84,900৳.
",178,980519,980697
7122,sentence,"Subcategory: All TV. Price: 59,430৳84,900৳.

Product: Sony Bravia KD-55X75K 55 Inch 4K Ultra HD Smart Android TV (Unofficial). Category: Sony. Subcategory: All TV. Price: 77,500৳82,000৳.
",187,980653,980840
7123,sentence,"Subcategory: All TV. Price: 77,500৳82,000৳.

Product: Sony Bravia KD-50X75K 50 Inch 4K Ultra HD Smart TV. Category: Sony. Subcategory: All TV. Price: 70,902৳99,900৳.
",166,980796,980962
7124,sentence,"Subcategory: All TV. Price: 70,902৳99,900৳.

Product: Sony Bravia KD-55X77L 55 Inch 4K Ultra HD Smart LED Google TV. Category: Sony. Subcategory: All TV. Price: 93,000৳97,000৳.
",177,980918,981095
7125,sentence,"Subcategory: All TV. Price: 93,000৳97,000৳.

Product: Sony Bravia 3 K-55S30 55"" 4K UHD Google Smart TV (Unofficial). Category: Sony. Subcategory: All TV. Price: 107,900৳112,000৳.
",179,981051,981230
7126,sentence,"Subcategory: All TV. Price: 107,900৳112,000৳.

Product: Sony Bravia KD-55X75K 55 Inch 4K Ultra HD Smart Android TV. Category: Sony. Subcategory: All TV. Price: 89,530৳127,900৳.
",177,981184,981361
7127,sentence,"Subcategory: All TV. Price: 89,530৳127,900৳.

Product: Sony Bravia KD-43X80L 43 Inch 4K Ultra HD Smart TV. Category: Sony. Subcategory: All TV. Price: 83,900৳133,900৳.
",168,981316,981484
7128,sentence,"Subcategory: All TV. Price: 83,900৳133,900৳.

Product: Sony Bravia 3 K-43S30 43 Inch 4K UHD Google TV. Category: Sony. Subcategory: All TV. Price: 84,630৳120,900৳.
",164,981439,981603
7129,sentence,"Subcategory: All TV. Price: 84,630৳120,900৳.

Product: Sony Bravia 3 K-65S30 65"" 4K UHD Google Smart TV (Unofficial). Category: Sony. Subcategory: All TV. Price: 127,000৳135,000৳.
",180,981558,981738
7130,sentence,"Subcategory: All TV. Price: 127,000৳135,000৳.

Product: Sony Bravia XR-55X90L 55 Inch 4K UHD Smart TV (Unofficial). Category: Sony. Subcategory: All TV. Price: 159,900৳167,000৳.
",178,981692,981870
7131,sentence,"Subcategory: All TV. Price: 159,900৳167,000৳.

Product: Sony Bravia KD-65X75K 65 Inch 4K Ultra HD Smart LED Android TV. Category: Sony. Subcategory: All TV. Price: 123,469৳173,900৳.
",182,981824,982006
7132,sentence,"Subcategory: All TV. Price: 123,469৳173,900৳.

Product: Sony Bravia 3 K-50S30 50 Inch 4K UHD Google TV. Category: Sony. Subcategory: All TV. Price: 101,430৳144,900৳.
",166,981960,982126
7133,sentence,"Subcategory: All TV. Price: 101,430৳144,900৳.

Product: Sony Bravia KD-75X77L 75 Inch 4K Ultra HD Smart LED Google TV (Unofficial). Category: Sony. Subcategory: All TV. Price: 190,500৳205,000৳.
",194,982080,982274
7134,sentence,"Subcategory: All TV. Price: 190,500৳205,000৳.

Product: Sony Bravia KD-75X80L 75 Inch 4K Ultra HD Smart LED Android TV (Unofficial). Category: Sony. Subcategory: All TV. Price: 207,900৳215,000৳.
",195,982228,982423
7135,sentence,"Subcategory: All TV. Price: 207,900৳215,000৳.

Product: Sony Bravia 3 K-55S30 55 Inch 4K UHD Google TV. Category: Sony. Subcategory: All TV. Price: 116,254৳164,900৳.
",166,982377,982543
7136,sentence,"Subcategory: All TV. Price: 116,254৳164,900৳.

Product: Sony Bravia 3 K-75S30 75"" 4K UHD Google Smart TV (Unofficial). Category: Sony. Subcategory: All TV. Price: 210,000৳220,000৳.
",181,982497,982678
7137,sentence,"Subcategory: All TV. Price: 210,000৳220,000৳.

Product: Sony Bravia XR-65X90L 65-inch 4K Ultra HD Smart TV (Unofficial). Category: Sony. Subcategory: All TV. Price: 219,900৳230,000৳.
",183,982632,982815
7138,sentence,"Subcategory: All TV. Price: 219,900৳230,000৳.

Product: Sony Bravia XR 55A80L 55"" 4K Ultra HD OLED Android Smart TV (Unofficial). Category: Sony. Subcategory: All TV. Price: 231,900৳240,000৳.
",192,982769,982961
7139,sentence,"Subcategory: All TV. Price: 231,900৳240,000৳.

Product: ROWA 50U62 50 Inch 4K Android Smart Voice Control Google TV. Category: ROWA. Subcategory: All TV. Price: Up Coming.
",172,982915,983087
7140,sentence,"Subcategory: All TV. Price: Up Coming.

Product: ROWA 65U62 65 Inch 4K Android Smart Voice Control Google TV. Category: ROWA. Subcategory: All TV. Price: Up Coming.
",165,983048,983213
7141,sentence,"Subcategory: All TV. Price: Up Coming.

Product: ROWA 32S52 32 Inch HD Android Smart TV. Category: ROWA. Subcategory: All TV. Price: Out Of Stock.
",147,983174,983321
7142,sentence,"Subcategory: All TV. Price: Out Of Stock.

Product: ROWA 43U62 43 Inch 4K Android Smart Google TV. Category: ROWA. Subcategory: All TV. Price: Out Of Stock.
",157,983279,983436
7143,sentence,"Subcategory: All TV. Price: Out Of Stock.

Product: ROWA 55U62 55 Inch 4K Android Smart Voice Control Google TV. Category: ROWA. Subcategory: All TV. Price: Out Of Stock.
",171,983394,983565
7144,sentence,"Subcategory: All TV. Price: Out Of Stock.

Product: LG UR75 43 Inch 4K UHD Smart LED TV. Category: LG. Subcategory: All TV. Price: 54,900৳59,900৳.

Product: LG UP7550 43 Inch 4K UHD Smart LED TV. ",196,983523,983719
7145,sentence,"
Product: LG UP7550 43 Inch 4K UHD Smart LED TV. Category: LG. Subcategory: All TV. Price: 62,000৳65,500৳.

Product: LG Nano75 43 Inch NanoCell 4K UHD Smart LED TV. Category: LG. ",179,983670,983849
7146,sentence,"Category: LG. Subcategory: All TV. Price: 61,900৳77,900৳.

Product: LG UP7750 50 Inch 4K UHD Smart LED TV. Category: LG. Subcategory: All TV. Price: 78,900৳82,900৳.
",165,983835,984000
7147,sentence,"Subcategory: All TV. Price: 78,900৳82,900৳.

Product: LG UR80 50 Inch 4K UHD Smart LED TV. Category: LG. Subcategory: All TV. Price: 76,900৳95,900৳.
",149,983956,984105
7148,sentence,"Subcategory: All TV. Price: 76,900৳95,900৳.

Product: LG NANO75 50 Inch NanoCell 4K UHD Smart LED TV. Category: LG. Subcategory: All TV. Price: 74,900৳105,900৳.
",161,984061,984222
7149,sentence,"Subcategory: All TV. Price: 74,900৳105,900৳.

Product: LG UR80 55 Inch 4K UHD Smart LED TV. Category: LG. Subcategory: All TV. Price: 89,900৳109,900৳.

Product: LG UR80 65 Inch 4K UHD Smart TV. ",194,984177,984371
7150,sentence,"
Product: LG UR80 65 Inch 4K UHD Smart TV. Category: LG. Subcategory: All TV. Price: 120,000৳125,000৳.

Product: LG Nano75 55 Inch NanoCell 4K UHD Smart LED TV. Category: LG. Subcategory: All TV. ",196,984328,984524
7151,sentence,"Category: LG. Subcategory: All TV. Price: 109,900৳132,900৳.

Product: LG UP77 70 Inch 4K UHD Smart LED TV. Category: LG. Subcategory: All TV. Price: 150,000৳160,000৳.
",167,984489,984656
7152,sentence,"Subcategory: All TV. Price: 150,000৳160,000৳.

Product: LG QNED86 65 Inch MiniLED 4K UHD Smart TV. Category: LG. Subcategory: All TV. Price: 166,900৳175,000৳.
",159,984610,984769
7153,sentence,"Subcategory: All TV. Price: 166,900৳175,000৳.

Product: LG NANO86 65 Inch NanoCell 4K UHD Smart LED TV. Category: LG. Subcategory: All TV. Price: 167,000৳175,900৳.
",164,984723,984887
7154,sentence,"Subcategory: All TV. Price: 167,000৳175,900৳.

Product: LG evo C3 55 Inch OLED 4K Smart TV. Category: LG. Subcategory: All TV. Price: 170,000৳190,000৳.
",152,984841,984993
7155,sentence,"Subcategory: All TV. Price: 170,000৳190,000৳.

Product: LG NANO81 65 Inch NanoCell 4K UHD Smart LED TV. Category: LG. Subcategory: All TV. Price: 172,900৳182,900৳.
",164,984947,985111
7156,sentence,"Subcategory: All TV. Price: 172,900৳182,900৳.

Product: LG evo C4 55"" 4K UHD OLED AI Smart TV (Unofficial). Category: LG. Subcategory: All TV. Price: 173,000৳185,000৳.
",168,985065,985233
7157,sentence,"Subcategory: All TV. Price: 173,000৳185,000৳.

Product: LG Nano75 65 Inch NanoCell 4K UHD Smart LED TV. Category: LG. Subcategory: All TV. Price: 159,900৳185,900৳.
",164,985187,985351
7158,sentence,"Subcategory: All TV. Price: 159,900৳185,900৳.

Product: LG QNED80 55'' 4K UHD Smart LED TV. Category: LG. Subcategory: All TV. Price: 119,900৳220,900৳.
",152,985305,985457
7159,sentence,"Subcategory: All TV. Price: 119,900৳220,900৳.

Product: LG evo C4 55 Inch 4K OLED AI Smart TV. Category: LG. Subcategory: All TV. Price: 210,000৳229,900৳.
",155,985411,985566
7160,sentence,"Subcategory: All TV. Price: 210,000৳229,900৳.

Product: LG evo C3 55 Inch 4K OLED Smart TV. Category: LG. Subcategory: All TV. Price: 220,305৳231,900৳.
",152,985520,985672
7161,sentence,"Subcategory: All TV. Price: 220,305৳231,900৳.

Product: Daewoo 50DM54UAB 50"" 4K Android Google Smart TV. Category: Daewoo. Subcategory: All TV. Price: 49,900৳59,900৳.
",167,985626,985793
7162,sentence,"Subcategory: All TV. Price: 49,900৳59,900৳.

Product: Daewoo 55DM55UQB 55"" 4K QLED Android Google Smart TV. Category: Daewoo. Subcategory: All TV. Price: 67,900৳82,900৳.
",170,985749,985919
7163,sentence,"Subcategory: All TV. Price: 67,900৳82,900৳.

Product: Daewoo 65DM55UQB 65"" 4K QLED Android Google Smart TV. Category: Daewoo. Subcategory: All TV. Price: 95,900৳109,900৳.
",171,985875,986046
7164,sentence,"Subcategory: All TV. Price: 95,900৳109,900৳.

Product: Daewoo 75DM55UQB 75"" 4K QLED Android Google Smart TV. Category: Daewoo. Subcategory: All TV. Price: 134,900৳152,900৳.
",173,986001,986174
7165,sentence,"Subcategory: All TV. Price: 134,900৳152,900৳.

Product: Smart SEL-43G25F 43"" 4K Voice Control Android Google TV. Category: SMART. Subcategory: All TV. Price: 44,000৳56,900৳.
",174,986128,986302
7166,sentence,"Subcategory: All TV. Price: 44,000৳56,900৳.

Product: Smart SEL-50G25F 50"" 4K Voice Control Android Google TV. Category: SMART. Subcategory: All TV. Price: 54,000৳68,900৳.
",172,986258,986430
7167,sentence,"Subcategory: All TV. Price: 54,000৳68,900৳.

Product: Smart SEL-50V24K 50"" 4K Voice Control Android LED Smart TV. Category: SMART. Subcategory: All TV. Price: 51,900৳69,900৳.
",175,986386,986561
7168,sentence,"Subcategory: All TV. Price: 51,900৳69,900৳.

Product: Smart SEL-55G25F 55"" 4K Voice Control Android Google TV. Category: SMART. Subcategory: All TV. Price: 64,000৳81,900৳.
",172,986517,986689
7169,sentence,"Subcategory: All TV. Price: 64,000৳81,900৳.

Product: Smart SEL-55V24K 55"" 4K Voice Control Android LED Smart TV. Category: SMART. Subcategory: All TV. Price: 61,900৳82,900৳.
",175,986645,986820
7170,sentence,"Subcategory: All TV. Price: 61,900৳82,900৳.

Product: Smart SEL-65S224KKS 65"" 4K Voice Control Android TV. Category: SMART. Subcategory: All TV. Price: 76,000৳104,900৳.
",169,986776,986945
7171,sentence,"Subcategory: All TV. Price: 76,000৳104,900৳.

Product: Smart SEL-65G25F 65"" 4K Voice Control Android Google TV. Category: SMART. Subcategory: All TV. Price: 84,000৳109,900৳.
",174,986900,987074
7172,sentence,"Subcategory: All TV. Price: 84,000৳109,900৳.

Product: Smart SEL-75G25F 75"" 4K Voice Control Android Google TV. Category: SMART. Subcategory: All TV. Price: 136,000৳182,900৳.
",175,987029,987204
7173,sentence,"Subcategory: All TV. Price: 136,000৳182,900৳.

Product: Smart SEL-85G25F 85"" 4K Voice Control Android Google TV. Category: SMART. Subcategory: All TV. Price: 185,000৳265,900৳.
",176,987158,987334
7174,sentence,"Subcategory: All TV. Price: 185,000৳265,900৳.

Product: Smart SEL-100G25F 100"" 4K Voice Control Android Google TV. Category: SMART. Subcategory: All TV. Price: 490,000৳669,900৳.
",178,987288,987466
7175,sentence,"Subcategory: All TV. Price: 490,000৳669,900৳.

Product: Rangs RG50ZX 50"" 4K Android Google TV. Category: 4K TV. Subcategory: TV. Price: 52,155৳54,900৳.
",152,987420,987572
7176,sentence,"Subcategory: TV. Price: 52,155৳54,900৳.

Product: Rangs RG55QX 55"" 4K QLED Android Google TV. Category: Rangs. Subcategory: All TV. Price: 74,955৳78,900৳.
",155,987532,987687
7177,sentence,"Subcategory: All TV. Price: 74,955৳78,900৳.

Product: Rangs RG65ZX 65"" 4K Android Google TV. Category: Rangs. Subcategory: All TV. Price: 80,655৳84,900৳.
",154,987643,987797
7178,sentence,"Subcategory: All TV. Price: 80,655৳84,900৳.

Product: Rangs RG75QX 75"" 4K QLED Android Google TV. Category: Rangs. Subcategory: All TV. Price: 131,900৳149,900৳.
",161,987753,987914
7179,sentence,"Subcategory: All TV. Price: 131,900৳149,900৳.

Product: Rangs RG86QX 86"" 4K QLED Android Google TV. Category: Rangs. Subcategory: All TV. Price: 274,900৳314,900৳.
",163,987868,988031
7180,sentence,"Subcategory: All TV. Price: 274,900৳314,900৳.

Product: Rangs RG100WX 100"" 4K webOS Smart TV. Category: Rangs. Subcategory: All TV. Price: 449,900৳549,900৳.
",157,987985,988142
7181,sentence,"Subcategory: All TV. Price: 449,900৳549,900৳.

Product: Rangs RL-65ASS750L 65"" 4K Android Google TV. Category: Rangs. Subcategory: All TV. Price: Out Of Stock.
",160,988096,988256
7182,sentence,"Subcategory: All TV. Price: Out Of Stock.

Product: Beko Crystal 9 OLED 120Hz 65"" 4K Android Google TV. Category: beko. Subcategory: All TV. Price: Up Coming.
",159,988214,988373
7183,sentence,"Subcategory: All TV. Price: Up Coming.

Product: Beko Crystal 9 120Hz 75"" 4K Android Google TV. Category: beko. Subcategory: All TV. Price: Up Coming.
",151,988334,988485
7184,sentence,"Subcategory: All TV. Price: Up Coming.

Product: TV Wall Mount Bracket For 24-32 Inch Support. Category: TV Stand & Wall Mount. Subcategory: TV. Price: 500৳.
",158,988446,988604
7185,sentence,"Subcategory: TV. Price: 500৳.

Product: TV Wall Mount Bracket For 40-55 Inch Support. Category: TV Stand & Wall Mount. Subcategory: TV. Price: 800৳1,000৳.
",155,988574,988729
7186,sentence,"Subcategory: TV. Price: 800৳1,000৳.

Product: TV Wall Mount Bracket For 55-75 Inch Support. Category: TV Stand & Wall Mount. Subcategory: TV. Price: 1,600৳1,800৳.
",163,988693,988856
7187,sentence,"Subcategory: TV. Price: 1,600৳1,800৳.

Product: TV Wall Mount Bracket For 75-85 Inch Support. Category: TV Stand & Wall Mount. Subcategory: TV. Price: 3,000৳.
",159,988818,988977
7188,sentence,"Subcategory: TV. Price: 3,000৳.

Product: TV Wall Mount Bracket For 75-100 Inch Support. Category: TV Stand & Wall Mount. Subcategory: TV. Price: 3,800৳.
",154,988945,989099
7189,sentence,"Subcategory: TV. Price: 3,800৳.

Product: Universal TV Stand For 32-70 Inch Television. Category: TV Stand & Wall Mount. Subcategory: TV. Price: 14,500৳15,000৳.
",161,989067,989228
7190,sentence,"Subcategory: TV. Price: 14,500৳15,000৳.

Product: Universal TV Stand For 43-100 Inch Television. Category: TV Stand & Wall Mount. Subcategory: TV. Price: 22,000৳23,000৳.
",170,989188,989358
7191,sentence,"Subcategory: TV. Price: 22,000৳23,000৳.

Product: ZENO T750 Ceiling Mount Kit 3 Feet for 32-80"" Television. Category: TV Stand & Wall Mount. Subcategory: TV. Price: Out Of Stock.
",179,989318,989497
7192,sentence,"Subcategory: TV. Price: Out Of Stock.

Product: AKASH DTH Full Setup (Basic) with 130+ Live TV Channel and 60+ Full HD Channel. Category: AKASH Digital TV. Subcategory: TV. Price: Out Of Stock.
",194,989459,989653
7193,sentence,"Subcategory: TV. Price: Out Of Stock.

Product: Midea 1 Ton Portable AC. Category: Midea. Subcategory: AC. Price: 40,000৳47,000৳.

Product: Midea 1 Ton Non-Inverter AC. Category: Midea. ",186,989615,989801
7194,sentence,"Category: Midea. Subcategory: AC. Price: 36,472৳47,990৳.

Product: Midea 1 Ton Inverter AC. Category: Midea. Subcategory: AC. Price: 41,433৳55,990৳.

Product: Midea 1.5 Ton Non-Inverter AC. ",190,989784,989974
7195,sentence,"
Product: Midea 1.5 Ton Non-Inverter AC. Category: Midea. Subcategory: AC. Price: 47,112৳61,990৳.

Product: Midea 1.5 Ton Inverter AC. Category: Midea. Subcategory: AC. Price: 54,686৳73,900৳.
",192,989933,990125
7196,sentence,"Subcategory: AC. Price: 54,686৳73,900৳.

Product: Midea 2 Ton Non-Inverter AC. Category: Midea. Subcategory: AC. Price: 57,752৳75,990৳.

Product: Midea 2 Ton Inverter AC. Category: Midea. ",188,990085,990273
7197,sentence,"Category: Midea. Subcategory: AC. Price: 64,793৳89,990৳.

Product: Hisense 1 Ton Non-Inverter AC. Category: Hisense. Subcategory: AC. Price: 37,990৳49,900৳.

Product: Hisense 1 Ton Inverter AC. ",194,990256,990450
7198,sentence,"
Product: Hisense 1 Ton Inverter AC. Category: Hisense. Subcategory: AC. Price: 43,390৳57,900৳.

Product: Hisense 1.5 Ton Non-Inverter AC. Category: Hisense. Subcategory: AC. Price: 49,500৳63,900৳.
",198,990413,990611
7199,sentence,"Subcategory: AC. Price: 49,500৳63,900৳.

Product: Hisense 2 Ton Non-Inverter AC. Category: Hisense. Subcategory: AC. Price: 59,990৳77,900৳.

Product: Hisense 1.5 Ton Inverter AC. Category: Hisense. ",198,990571,990769
7200,sentence,"Category: Hisense. Subcategory: AC. Price: 55,900৳79,900৳.

Product: Hisense 1.5 Ton WiFi Full DC Inverter AC. Category: Hisense. Subcategory: AC. Price: 64,701৳81,900৳.
",170,990750,990920
7201,sentence,"Subcategory: AC. Price: 64,701৳81,900৳.

Product: Hisense 2 Ton Inverter AC. Category: Hisense. Subcategory: AC. Price: 69,084৳90,900৳.

Product: Hisense 2 Ton WiFi Full DC Inverter AC. ",186,990880,991066
7202,sentence,"Category: Hisense. Subcategory: AC. Price: 83,000৳99,900৳.

Product: Hisense 2 Ton Cassette Inverter AC. Category: Hisense. Subcategory: AC. Price: 128,000৳139,900৳.
",166,991066,991232
7203,sentence,"Subcategory: AC. Price: 128,000৳139,900৳.

Product: Hisense 3 Ton Cassette Inverter AC. Category: Hisense. Subcategory: AC. Price: 152,000৳167,900৳.

Product: Hisense 4 Ton Cassette Inverter AC. ",195,991190,991385
7204,sentence,"
Product: Hisense 4 Ton Cassette Inverter AC. Category: Hisense. Subcategory: AC. Price: 202,000৳223,900৳.

Product: Hisense 5 Ton Cassette Inverter AC. Category: Hisense. Subcategory: AC. ",189,991339,991528
7205,sentence,"Category: Hisense. Subcategory: AC. Price: 215,000৳239,900৳.

Product: Hisense 1.5 Ton Smart Compact Inverter AC. Category: Hisense. Subcategory: AC. Price: Out Of Stock.
",171,991492,991663
7206,sentence,"Subcategory: AC. Price: Out Of Stock.

Product: Haier 1 Ton Non-Inverter AC. Category: AC. Subcategory: Appliance. Price: 38,900৳45,990৳.

Product: Xiaomi Viomi A2 1 Ton Non-Inverter AC. ",187,991625,991812
7207,sentence,"
Product: Xiaomi Viomi A2 1 Ton Non-Inverter AC. Category: AC. Subcategory: Appliance. Price: 37,493৳49,990৳.

Product: Haier 1 Ton AquaCool Non-Inverter AC. Category: AC. Subcategory: Appliance. ",196,991763,991959
7208,sentence,"Category: AC. Subcategory: Appliance. Price: 39,500৳49,990৳.

Product: Walton 1 Ton Frost Clean Inverter AC. Category: AC. Subcategory: Appliance. Price: 44,500৳51,990৳.
",170,991921,992091
7209,sentence,"Subcategory: Appliance. Price: 44,500৳51,990৳.

Product: Gree 1 Ton Muse-Split Non-Inverter AC. Category: AC. Subcategory: Appliance. Price: 42,640৳52,000৳.
",157,992044,992201
7210,sentence,"Subcategory: Appliance. Price: 42,640৳52,000৳.

Product: Gree 1 Ton Cosmo-Split Non-Inverter AC. Category: AC. Subcategory: Appliance. Price: 43,500৳52,000৳.

Product: Gree 1 Ton Portable AC. ",192,992154,992346
7211,sentence,"
Product: Gree 1 Ton Portable AC. Category: AC. Subcategory: Appliance. Price: 46,000৳52,500৳.

Product: Smart 1 Ton Non-Inverter AC. Category: AC. Subcategory: Appliance. Price: 41,262৳52,900৳.
",195,992312,992507
7212,sentence,"Subcategory: Appliance. Price: 41,262৳52,900৳.

Product: KELVINATOR 1 Ton Non Inverter AC. Category: AC. Subcategory: Appliance. Price: 48,668৳52,900৳.

Product: Haier 1 Ton EnergyCool Inverter AC. ",198,992460,992658
7213,sentence,"
Product: Haier 1 Ton EnergyCool Inverter AC. Category: AC. Subcategory: Appliance. Price: 43,990৳56,990৳.

Product: Haier 1 Ton CleanCool Inverter AC. Category: AC. Subcategory: Appliance. ",190,992612,992802
7214,sentence,"Category: AC. Subcategory: Appliance. Price: 43,900৳56,990৳.

Product: Walton 1 Ton Inverter AC. Category: AC. Subcategory: Appliance. Price: 46,900৳57,900৳.
",158,992764,992922
7215,sentence,"Subcategory: Appliance. Price: 46,900৳57,900৳.

Product: Gree 1 Ton Fairy-Split Inverter AC. Category: AC. Subcategory: Appliance. Price: 50,000৳59,290৳.

Product: Gree 1 Ton Lomo Split Inverter AC. ",199,992875,993074
7216,sentence,"
Product: Gree 1 Ton Lomo Split Inverter AC. Category: AC. Subcategory: Appliance. Price: 49,294৳59,390৳.

Product: Hyundai 1 Ton Inverter AC. Category: AC. Subcategory: Appliance. ",181,993029,993210
7217,sentence,"Category: AC. Subcategory: Appliance. Price: 52,000৳59,900৳.

Product: Gree 1 Ton Zeno-Split Inverter AC. Category: Gree. Subcategory: AC. Price: 52,000৳61,290৳.
",162,993172,993334
7218,sentence,"Subcategory: AC. Price: 52,000৳61,290৳.

Product: Gree 1 Ton Shimo-Split Inverter AC. Category: Gree. Subcategory: AC. Price: 52,000৳61,290৳.

Product: Gree 1 Ton Cosmo-Split Inverter AC. ",188,993294,993482
7219,sentence,"
Product: Gree 1 Ton Cosmo-Split Inverter AC. Category: Gree. Subcategory: AC. Price: 52,500৳61,790৳.

Product: Gree 1.5 Ton Non-Inverter AC. Category: Gree. Subcategory: AC. Price: 55,072৳67,990৳.
",198,993436,993634
7220,sentence,"Subcategory: AC. Price: 55,072৳67,990৳.

Product: Gree 1.5 Ton Cosmo-Split Non-Inverter AC. Category: Gree. Subcategory: AC. Price: 56,000৳67,990৳.

Product: Gree 1.5 Ton Inverter AC. ",184,993594,993778
7221,sentence,"
Product: Gree 1.5 Ton Inverter AC. Category: Gree. Subcategory: AC. Price: 65,100৳79,390৳.

Product: Gree 1.5 Ton Fairy-Split Inverter AC. Category: Gree. Subcategory: AC. Price: 65,100৳79,390৳.
",196,993742,993938
7222,sentence,"Subcategory: AC. Price: 65,100৳79,390৳.

Product: Gree 1.5 Ton Zeno-Split Inverter AC. Category: Gree. Subcategory: AC. Price: 67,000৳81,390৳.

Product: Gree 1.5 Ton Shimo-Split Inverter AC. ",191,993898,994089
7223,sentence,"
Product: Gree 1.5 Ton Shimo-Split Inverter AC. Category: Gree. Subcategory: AC. Price: 67,000৳81,390৳.

Product: Gree 1.5 Ton Cosmo-Split Inverter AC. Category: Gree. Subcategory: AC. ",185,994041,994226
7224,sentence,"Category: Gree. Subcategory: AC. Price: 67,500৳81,890৳.

Product: Gree 2 Ton Non-Inverter AC. Category: Gree. Subcategory: AC. Price: 70,000৳83,190৳.

Product: Gree 2 Ton Lomo Split Non-Inverter AC. ",199,994193,994392
7225,sentence,"
Product: Gree 2 Ton Lomo Split Non-Inverter AC. Category: Gree. Subcategory: AC. Price: 70,000৳83,190৳.

Product: Gree 2 Ton Muse-Split Non-Inverter AC. Category: Gree. Subcategory: AC. ",187,994343,994530
7226,sentence,"Category: Gree. Subcategory: AC. Price: 70,000৳83,190৳.

Product: Gree 2 Ton Fairy-Split Non-Inverter AC. Category: Gree. Subcategory: AC. Price: 70,000৳83,190৳.
",162,994497,994659
7227,sentence,"Subcategory: AC. Price: 70,000৳83,190৳.

Product: Gree 2 Ton Cosmo-Split Non-Inverter AC. Category: Gree. Subcategory: AC. Price: 70,500৳83,190৳.

Product: Awei F33 1800mAh Desktop Ultra Slim Fan. ",197,994619,994816
7228,sentence,"Category: Appliance. Price: 930৳1,030৳.

Product: Smart SEK-S18ES 1.8 Liter Electric Kettle. Category: Appliance. Price: 990৳1,290৳.

Product: Baseus Serenity Series Desktop Fan. ",179,994816,994995
7229,sentence,"
Product: Baseus Serenity Series Desktop Fan. Category: Appliance. Price: 1,090৳1,299৳.

Product: Vyvylabs D04 Mini Portable Desktop Fan with LED light. Category: Appliance. Price: 1,350৳1,450৳.
",195,994949,995144
7230,sentence,"Category: Appliance. Price: 1,350৳1,450৳.

Product: Vyvylabs D11 Mini Foldable Desktop Fan. Category: Appliance. Price: 1,350৳1,450৳.

Product: WiWU FS03 2 in 1 Table Clip Fan. Category: Appliance. ",198,995102,995300
7231,sentence,"Category: Appliance. Price: 1,450৳1,550৳.

Product: Smart SEK-P18ES 1.8 Ltr Electric Kettle. Category: Appliance. Price: 1,390৳1,790৳.

Product: Smart SEK-P20ES 1 Liter Black Electric Kettle. ",192,995279,995471
7232,sentence,"Category: Appliance. Price: 1,190৳1,790৳.

Product: Smart SEK-P23ES 2.3L Electric Kettle. Category: Appliance. Price: 1,490৳1,990৳.

Product: Xundd M321 Portable Charger Fan. Category: Appliance. ",196,995471,995667
7233,sentence,"Category: Appliance. Price: 1,890৳1,999৳.

Product: XIAOMI SOLOVE F5 Pro Desktop Fan. Category: Appliance. Price: 1,950৳2,099৳.

Product: Walton WRH-PTC007 Mini Room Heater. Category: Appliance. ",195,995646,995841
7234,sentence,"Category: Appliance. Price: 2,200৳2,290৳.

Product: XIAOMI SOLOVE F5 Desktop Charger Fan. Category: Appliance. Price: 1,750৳2,299৳.

Product: Awei F34 Air Circulation Wide Angle Fan. ",183,995820,996003
7235,sentence,"Category: Appliance. Price: 2,140৳2,340৳.

Product: Walton WRH-FH003 Room Heater. Category: Appliance. Price: 2,270৳2,370৳.

Product: Baseus SUXUN-WF0S Breeze Fan Air Freshener For Vehicles. ",191,996003,996194
7236,sentence,"Category: Appliance. Price: 2,350৳2,900৳.

Product: Walton WRH-PTC0X Mini Room Heater. Category: Appliance. Price: 2,900৳2,990৳.

Product: Xiaomi Solove F5P 4000mAh Desktop Stand Fan. ",184,996194,996378
7237,sentence,"Category: Appliance. Price: 2,490৳2,999৳.

Product: Xundd XDOT-024 Type-C Rechargeable Oscillating Fan. Category: Appliance. Price: 2,800৳3,050৳.
",146,996378,996524
7238,sentence,"Category: Appliance. Price: 2,800৳3,050৳.

Product: Xiaomi Solove F5 Pro Max 10000mAh Rechargeable Fan. Category: Appliance. Price: 2,850৳3,099৳.

Product: Smart 1 Ton Inverter AC. Category: SMART. ",198,996482,996680
7239,sentence,"Category: SMART. Subcategory: AC. Price: 46,546৳62,900৳.

Product: Smart 1.5 Ton Non-Inverter AC. Category: SMART. Subcategory: AC. Price: 52,000৳66,900৳.

Product: Smart 1.5 Ton Inverter AC. ",192,996663,996855
7240,sentence,"
Product: Smart 1.5 Ton Inverter AC. Category: SMART. Subcategory: AC. Price: 59,126৳79,900৳.

Product: Smart 2 Ton Non-Inverter AC. Category: SMART. Subcategory: AC. Price: 62,086৳83,900৳.
",190,996818,997008
7241,sentence,"Subcategory: AC. Price: 62,086৳83,900৳.

Product: Smart 2 Ton Inverter AC. Category: SMART. Subcategory: AC. Price: 69,486৳93,900৳.

Product: General 1.5 Ton Constant Speed Non-Inverter AC. ",190,996968,997158
7242,sentence,"Category: General. Subcategory: AC. Price: 114,000৳129,900৳.

Product: General 2 Ton Constant Speed Non-Inverter AC. Category: General. Subcategory: AC. Price: 124,000৳137,900৳.
",178,997158,997336
7243,sentence,"Subcategory: AC. Price: 124,000৳137,900৳.

Product: General 1.5 Ton Coanda Airflow Non-Inverter AC. Category: General. Subcategory: AC. Price: Up Coming.

Product: General 2.5 Ton Non-Inverter AC. ",197,997294,997491
7244,sentence,"
Product: General 2.5 Ton Non-Inverter AC. Category: General. Subcategory: AC. Price: Up Coming.

Product: General 1 Ton Non-Inverter AC. Category: General. Subcategory: AC. Price: Out Of Stock.
",195,997448,997643
7245,sentence,"Subcategory: AC. Price: Out Of Stock.

Product: General 1.5 Ton Non-Inverter AC. Category: General. Subcategory: AC. Price: Out Of Stock.

Product: General 1.5 Ton Inverter AC. Category: General. ",196,997605,997801
7246,sentence,"Category: General. Subcategory: AC. Price: Out Of Stock.

Product: General 2 Ton Inverter AC. Category: General. Subcategory: AC. Price: Out Of Stock.

Product: General 2 Ton Non-Inverter AC. ",192,997782,997974
7247,sentence,"
Product: General 2 Ton Non-Inverter AC. Category: General. Subcategory: AC. Price: Out Of Stock.

Product: General 2.5 Ton Inverter AC. Category: General. Subcategory: AC. Price: Out Of Stock.
",194,997933,998127
7248,sentence,"Subcategory: AC. Price: Out Of Stock.

Product: Sharp 1 Ton AC. Category: Sharp. Subcategory: AC. Price: 61,977৳84,900৳.

Product: Sharp 1.5 Ton AC. Category: Sharp. Subcategory: AC. ",183,998089,998272
7249,sentence,"Category: Sharp. Subcategory: AC. Price: 80,568৳111,900৳.

Product: Sharp 2 Ton AC. Category: Sharp. Subcategory: AC. Price: 101,448৳140,900৳.

Product: Haier 1 Ton UVCool WiFi Inverter AC. ",190,998238,998428
7250,sentence,"
Product: Haier 1 Ton UVCool WiFi Inverter AC. Category: Haier. Subcategory: AC. Price: 50,000৳59,990৳.

Product: Haier 1.5 Ton Non-Inverter AC. Category: Haier. Subcategory: AC. ",179,998381,998560
7251,sentence,"Category: Haier. Subcategory: AC. Price: 48,000৳61,990৳.

Product: Haier 1.5 Ton AquaCool Non-Inverter AC. Category: Haier. Subcategory: AC. Price: 49,000৳63,990৳.
",164,998526,998690
7252,sentence,"Subcategory: AC. Price: 49,000৳63,990৳.

Product: Haier 1.6 Ton CleanCool Inverter AC. Category: Haier. Subcategory: AC. Price: 55,493৳74,990৳.

Product: Haier 1.6 Ton EnergyCool Inverter AC. ",192,998650,998842
7253,sentence,"
Product: Haier 1.6 Ton EnergyCool Inverter AC. Category: Haier. Subcategory: AC. Price: 54,990৳74,990৳.

Product: Haier 2 Ton Non-Inverter AC. Category: Haier. Subcategory: AC. ",178,998794,998972
7254,sentence,"Category: Haier. Subcategory: AC. Price: 60,000৳75,990৳.

Product: Haier 1.6 Ton UVCool WiFi Inverter AC. Category: Haier. Subcategory: AC. Price: 62,990৳77,990৳.
",163,998938,999101
7255,sentence,"Subcategory: AC. Price: 62,990৳77,990৳.

Product: Haier 2 Ton AquaCool Non-Inverter AC. Category: Haier. Subcategory: AC. Price: 60,000৳77,990৳.

Product: Haier 1.5 Ton Wi-Fi Hot & Cool Inverter AC. ",199,999061,999260
7256,sentence,"Category: Haier. Subcategory: AC. Price: 64,772৳78,990৳.

Product: Haier 1.6 Ton UltimateCool Inverter AC. Category: Haier. Subcategory: AC. Price: 70,461৳80,990৳.
",164,999260,999424
7257,sentence,"Subcategory: AC. Price: 70,461৳80,990৳.

Product: Haier 2 Ton CleanCool Inverter AC. Category: Haier. Subcategory: AC. Price: 70,512৳85,990৳.

Product: Haier 1.5 Ton EnergyCool Inverter AC. ",190,999384,999574
7258,sentence,"
Product: Haier 1.5 Ton EnergyCool Inverter AC. Category: Haier. Subcategory: AC. Price: Out Of Stock.

Product: Haier 1.5 Ton CleanCool Inverter AC. Category: Haier. Subcategory: AC. ",184,999526,999710
7259,sentence,"Category: Haier. Subcategory: AC. Price: Out Of Stock.

Product: Haier 1.5 Ton WiFi Inverter AC. Category: Haier. Subcategory: AC. Price: Out Of Stock.

Product: Haier 2 Ton EnergyCool Inverter AC. ",198,999676,999874
7260,sentence,"
Product: Haier 2 Ton EnergyCool Inverter AC. Category: Haier. Subcategory: AC. Price: Out Of Stock.

Product: Samsung 1 Ton Inverter AC. Category: Samsung. Subcategory: AC. Price: Up Coming.
",192,999828,1000020
7261,sentence,"Subcategory: AC. Price: Up Coming.

Product: Samsung 1.5 Ton Digital Inverter AC. Category: Samsung. Subcategory: AC. Price: Up Coming.

Product: Samsung 2 Ton Digital Inverter AC. ",181,999985,1000166
7262,sentence,"
Product: Samsung 2 Ton Digital Inverter AC. Category: Samsung. Subcategory: AC. Price: Up Coming.

Product: Samsung 1 Ton Digital Inverter AC. Category: Samsung. Subcategory: AC. Price: Up Coming.
",198,1000121,1000319
7263,sentence,"Subcategory: AC. Price: Up Coming.

Product: Samsung 2 Ton Inverter AC. Category: Samsung. Subcategory: AC. Price: Up Coming.

Product: Samsung 1.5 Ton Inverter AC. Category: Samsung. ",184,1000284,1000468
7264,sentence,"Category: Samsung. Subcategory: AC. Price: Up Coming.

Product: Panasonic 1.5 Ton Inverter AC. Category: Panasonic. Subcategory: AC. Price: 115,526৳122,900৳.
",158,1000449,1000607
7265,sentence,"Subcategory: AC. Price: 115,526৳122,900৳.

Product: Panasonic 1.5 Ton WiFi Inverter AC. Category: Panasonic. Subcategory: AC. Price: 119,587৳127,900৳.

Product: Panasonic 2 Ton Inverter AC. ",190,1000565,1000755
7266,sentence,"
Product: Panasonic 2 Ton Inverter AC. Category: Panasonic. Subcategory: AC. Price: 127,481৳134,900৳.

Product: Xiaomi Viomi A2 1.5 Ton Non-Inverter AC. Category: Xiaomi. Subcategory: AC. ",188,1000716,1000904
7267,sentence,"Category: Xiaomi. Subcategory: AC. Price: 47,392৳59,990৳.

Product: Xiaomi Viomi A2 2 Ton Non-Inverter AC. Category: Xiaomi. Subcategory: AC. Price: 59,415৳69,900৳.
",165,1000869,1001034
7268,sentence,"Subcategory: AC. Price: 59,415৳69,900৳.

Product: SINGER 1 Ton Inverter AC. Category: SINGER. Subcategory: AC. Price: 55,683৳61,870৳.

Product: SINGER 1.5 Ton Inverter AC. Category: SINGER. ",190,1000994,1001184
7269,sentence,"Category: SINGER. Subcategory: AC. Price: 74,565৳82,850৳.

Product: SINGER 1.8 Ton Inverter AC. Category: SINGER. Subcategory: AC. Price: 88,542৳98,380৳.

Product: Walton 1.25 Ton Inverter AC. ",193,1001166,1001359
7270,sentence,"
Product: Walton 1.25 Ton Inverter AC. Category: Walton. Subcategory: AC. Price: 49,900৳59,990৳.

Product: Walton 1.5 Ton Frost Clean Inverter AC. Category: Walton. Subcategory: AC. ",182,1001320,1001502
7271,sentence,"Category: Walton. Subcategory: AC. Price: 55,400৳66,990৳.

Product: Walton 1.5 Ton Inverter AC. Category: Walton. Subcategory: AC. Price: 62,000৳76,990৳.
",154,1001467,1001621
7272,sentence,"Subcategory: AC. Price: 62,000৳76,990৳.

Product: Walton 2 Ton Frost Clean Inverter AC. Category: Walton. Subcategory: AC. Price: 66,500৳80,990৳.

Product: Walton 2 Ton Inverter AC. ",182,1001581,1001763
7273,sentence,"
Product: Walton 2 Ton Inverter AC. Category: Walton. Subcategory: AC. Price: 75,000৳92,600৳.

Product: LG 1.5 Ton Dual Inverter AC. Category: LG. Subcategory: AC. Price: 117,087৳125,900৳.
",189,1001727,1001916
7274,sentence,"Subcategory: AC. Price: 117,087৳125,900৳.

Product: LG 2 Ton Dual Inverter AC. Category: LG. Subcategory: AC. Price: 135,687৳145,900৳.

Product: ELITE 2 Ton AC. Category: Elite. Subcategory: AC. ",195,1001874,1002069
7275,sentence,"Category: Elite. Subcategory: AC. Price: 57,500৳65,000৳.

Product: ELITE 1 Ton AC. Category: Elite. Subcategory: AC. Price: Up Coming.

Product: ELITE 1.5 Ton AC. Category: Elite. Subcategory: AC. ",197,1002035,1002232
7276,sentence,"Category: Elite. Subcategory: AC. Price: Up Coming.

Product: Beko 1.5 Ton Inverter AC. Category: beko. Subcategory: AC. Price: 75,186৳83,540৳.

Product: Beko 2 Ton Inverter AC. Category: beko. ",194,1002198,1002392
7277,sentence,"Category: beko. Subcategory: AC. Price: 89,280৳99,200৳.

Product: Hyundai 1.5 Ton Inverter AC. Category: Hyundai. Subcategory: AC. Price: 57,990৳78,900৳.

Product: Hyundai 2 Ton Inverter AC. ",191,1002376,1002567
7278,sentence,"
Product: Hyundai 2 Ton Inverter AC. Category: Hyundai. Subcategory: AC. Price: 71,990৳94,900৳.

Product: LG GT-T5107BM 506 Liters Refrigerator. Category: LG. Subcategory: Fridge. ",180,1002530,1002710
7279,sentence,"Category: LG. Subcategory: Fridge. Price: 156,000৳164,900৳.

Product: LG GS-Q6472NS 647L Side By Side In Door Refrigerator. Category: LG. Subcategory: Fridge. Price: 288,000৳303,900৳.
",184,1002675,1002859
7280,sentence,"Subcategory: Fridge. Price: 288,000৳303,900৳.

Product: Daewoo 1 Ton Inverter AC. Category: Daewoo. Subcategory: AC. Price: 47,900৳67,900৳.

Product: Daewoo 1.5 Ton Inverter AC. Category: Daewoo. ",196,1002813,1003009
7281,sentence,"Category: Daewoo. Subcategory: AC. Price: 56,900৳82,900৳.

Product: Daewoo 2 Ton Inverter AC. Category: Daewoo. Subcategory: AC. Price: 74,900৳104,900৳.
",153,1002991,1003144
7282,sentence,"Subcategory: AC. Price: 74,900৳104,900৳.

Product: Kelvinator KCCF-168DF 168 Litre Deep Freezer. Category: Fridge. Subcategory: Appliance. Price: 28,500৳33,500৳.
",162,1003103,1003265
7283,sentence,"Subcategory: Appliance. Price: 28,500৳33,500৳.

Product: Rangs RCF-175GD 175L Glass Door Deep Freezer. Category: Fridge. Subcategory: Appliance. Price: 33,535৳35,300৳.
",168,1003218,1003386
7284,sentence,"Subcategory: Appliance. Price: 33,535৳35,300৳.

Product: Rangs RCF-175GD 175L Glass Door Deep Freezer Yellow. Category: Fridge. Subcategory: Appliance. Price: 33,535৳35,300৳.
",175,1003339,1003514
7285,sentence,"Subcategory: Appliance. Price: 33,535৳35,300৳.

Product: Rangs RCF-175GD 175L Glass Door Deep Freezer Blue. Category: Fridge. Subcategory: Appliance. Price: 33,535৳35,300৳.
",173,1003467,1003640
7286,sentence,"Subcategory: Appliance. Price: 33,535৳35,300৳.

Product: SMART SER-150TS 150 Ltr Top Mount Refrigerator. Category: Fridge. Subcategory: Appliance. Price: 27,900৳36,900৳.
",170,1003593,1003763
7287,sentence,"Subcategory: Appliance. Price: 27,900৳36,900৳.

Product: Kelvinator KCCF-230DFV 230 Litre Deep Freezer. Category: Fridge. Subcategory: Appliance. Price: 32,900৳38,500৳.
",169,1003716,1003885
7288,sentence,"Subcategory: Appliance. Price: 32,900৳38,500৳.

Product: Kelvinator KCCF-225DFG 225 Litre Glass Door Deep Freezer White. Category: Fridge. Subcategory: Appliance. Price: 37,905৳39,900৳.
",186,1003838,1004024
7289,sentence,"Subcategory: Appliance. Price: 37,905৳39,900৳.

Product: Kelvinator KCCF-225DFG 225 Litre Glass Door Deep Freezer Black. Category: Fridge. Subcategory: Appliance. Price: 37,905৳39,900৳.
",186,1003977,1004163
7290,sentence,"Subcategory: Appliance. Price: 37,905৳39,900৳.

Product: Kelvinator KCCF-225DFG 225 Litre Glass Door Deep Freezer Dark Gray. Category: Fridge. Subcategory: Appliance. Price: 37,905৳39,900৳.
",190,1004116,1004306
7291,sentence,"Subcategory: Appliance. Price: 37,905৳39,900৳.

Product: Haier HCF-175SG 142L Deep Freezer. Category: Fridge. Subcategory: Appliance. Price: 33,500৳40,400৳.
",157,1004259,1004416
7292,sentence,"Subcategory: Appliance. Price: 33,500৳40,400৳.

Product: Rangs RCF-223GD 223L Glass Door Deep Freezer. Category: Fridge. Subcategory: Appliance. Price: 38,570৳40,600৳.
",168,1004369,1004537
7293,sentence,"Subcategory: Appliance. Price: 38,570৳40,600৳.

Product: Rangs RCF-223GD 223L Glass Door Deep Freezer Blue. Category: Fridge. Subcategory: Appliance. Price: 38,570৳40,600৳.
",173,1004490,1004663
7294,sentence,"Subcategory: Appliance. Price: 38,570৳40,600৳.

Product: Whirlpool Fresh Magic Pro 236L Chromium Steel Refrigerator. Category: Fridge. Subcategory: Appliance. Price: 39,000৳41,490৳.
",182,1004616,1004798
7295,sentence,"Subcategory: Appliance. Price: 39,000৳41,490৳.

Product: Hisense RTDG236NASR/BD3 238L Glass Door Refrigerator. Category: Fridge. Subcategory: Appliance. Price: 38,000৳41,900৳.
",176,1004751,1004927
7296,sentence,"Subcategory: Appliance. Price: 38,000৳41,900৳.

Product: Hisense RTDG236NADP/BD3 238L Glass Door Refrigerator. Category: Fridge. Subcategory: Appliance. Price: 38,000৳41,900৳.
",176,1004880,1005056
7297,sentence,"Subcategory: Appliance. Price: 38,000৳41,900৳.

Product: Hisense RTDG236NAAB/BD3 238L Glass Door Refrigerator. Category: Fridge. Subcategory: Appliance. Price: 38,000৳41,900৳.
",176,1005009,1005185
7298,sentence,"Subcategory: Appliance. Price: 38,000৳41,900৳.

Product: Hisense RTDG236NAMB/BD3 238L Glass Door Refrigerator. Category: Fridge. Subcategory: Appliance. Price: 38,000৳41,900৳.
",176,1005138,1005314
7299,sentence,"Subcategory: Appliance. Price: 38,000৳41,900৳.

Product: Hisense RT1G236NAB/BD3 238L Glass Door Refrigerator. Category: Fridge. Subcategory: Appliance. Price: 38,000৳41,900৳.
",175,1005267,1005442
7300,sentence,"Subcategory: Appliance. Price: 38,000৳41,900৳.

Product: Hisense BD189BLK 189L Deep Freezer. Category: Fridge. Subcategory: Appliance. Price: 38,000৳43,900৳.
",158,1005395,1005553
7301,sentence,"Subcategory: Appliance. Price: 38,000৳43,900৳.

Product: Hisense BD189BLU 189L Deep Freezer. Category: Fridge. Subcategory: Appliance. Price: 38,000৳43,900৳.
",158,1005506,1005664
7302,sentence,"Subcategory: Appliance. Price: 38,000৳43,900৳.

Product: KELVINATOR 1 Ton Inverter AC Golden. Category: Kelvinator. Subcategory: AC. Price: 57,868৳62,900৳.

Product: KELVINATOR 1 Ton Inverter AC. ",196,1005617,1005813
7303,sentence,"
Product: KELVINATOR 1 Ton Inverter AC. Category: Kelvinator. Subcategory: AC. Price: 59,708৳64,900৳.

Product: KELVINATOR 1.5 Ton Non Inverter AC. Category: Kelvinator. Subcategory: AC. ",187,1005773,1005960
7304,sentence,"Category: Kelvinator. Subcategory: AC. Price: 61,548৳66,900৳.

Product: KELVINATOR 1.5 Ton WIFI Inverter AC. Category: Kelvinator. Subcategory: AC. Price: 75,900৳.
",164,1005921,1006085
7305,sentence,"Subcategory: AC. Price: 75,900৳.

Product: KELVINATOR 1 Ton Heat & Cool WIFI Inverter AC. Category: Kelvinator. Subcategory: AC. Price: 47,900৳78,900৳.

Product: KELVINATOR 1.5 Ton Inverter AC. ",194,1006052,1006246
7306,sentence,"
Product: KELVINATOR 1.5 Ton Inverter AC. Category: Kelvinator. Subcategory: AC. Price: 72,588৳78,900৳.

Product: KELVINATOR 1.5 Ton Heat & Cool WIFI Inverter AC. Category: Kelvinator. ",185,1006204,1006389
7307,sentence,"Category: Kelvinator. Subcategory: AC. Price: 79,900৳.

Product: KELVINATOR 2 Ton Non Inverter AC. Category: Kelvinator. Subcategory: AC. Price: 74,428৳80,900৳.
",161,1006367,1006528
7308,sentence,"Subcategory: AC. Price: 74,428৳80,900৳.

Product: KELVINATOR 1.5 Ton Inverter AC Golden. Category: Kelvinator. Subcategory: AC. Price: 64,900৳85,900৳.

Product: KELVINATOR 2 Ton WIFI Inverter AC. ",196,1006488,1006684
7309,sentence,"
Product: KELVINATOR 2 Ton WIFI Inverter AC. Category: Kelvinator. Subcategory: AC. Price: 90,900৳.

Product: KELVINATOR 2 Ton Inverter AC Golden. Category: Kelvinator. Subcategory: AC. ",186,1006639,1006825
7310,sentence,"Category: Kelvinator. Subcategory: AC. Price: 85,468৳92,900৳.

Product: KELVINATOR 2 Ton Inverter AC. Category: Kelvinator. Subcategory: AC. Price: 87,308৳94,900৳.
",164,1006786,1006950
7311,sentence,"Subcategory: AC. Price: 87,308৳94,900৳.

Product: KELVINATOR 2 Ton Heat & Cool WIFI Inverter AC. Category: Kelvinator. Subcategory: AC. Price: 95,900৳.

Product: KELVINATOR 1 Ton WIFI Inverter AC. ",197,1006910,1007107
7312,sentence,"
Product: KELVINATOR 1 Ton WIFI Inverter AC. Category: Kelvinator. Subcategory: AC. Price: 46,900৳105,900৳.

Product: KELVINATOR 1.5 Ton Split Non Inverter AC. Category: Kelvinator. Subcategory: AC. ",199,1007062,1007261
7313,sentence,"Category: Kelvinator. Subcategory: AC. Price: Up Coming.

Product: KELVINATOR 2 Ton Split Non Inverter AC. Category: Kelvinator. Subcategory: AC. Price: Up Coming.
",164,1007222,1007386
7314,sentence,"Subcategory: AC. Price: Up Coming.

Product: Sharp SJC-118-WH 110 Liters Deep Freezer. Category: Sharp. Subcategory: Fridge. Price: 36,900৳48,900৳.
",148,1007351,1007499
7315,sentence,"Subcategory: Fridge. Price: 36,900৳48,900৳.

Product: Sharp SJC-118-GY 110 Liters Deep Freezer. Category: Sharp. Subcategory: Fridge. Price: 36,900৳48,900৳.
",157,1007455,1007612
7316,sentence,"Subcategory: Fridge. Price: 36,900৳48,900৳.

Product: Sharp SJC-168-WH 160 Liters Deep Freezer. Category: Sharp. Subcategory: Fridge. Price: 49,900৳65,900৳.
",157,1007568,1007725
7317,sentence,"Subcategory: Fridge. Price: 49,900৳65,900৳.

Product: Sharp SJC-178-GY 160 Liters Deep Freezer. Category: Sharp. Subcategory: Fridge. Price: 51,900৳68,900৳.
",157,1007681,1007838
7318,sentence,"Subcategory: Fridge. Price: 51,900৳68,900৳.

Product: Sharp SJC-228-GY 220 Liters Deep Freezer. Category: Sharp. Subcategory: Fridge. Price: 63,900৳84,900৳.
",157,1007794,1007951
7319,sentence,"Subcategory: Fridge. Price: 63,900৳84,900৳.

Product: Sharp SJ-EX455P-BR 397 Liters Inverter Refrigerator. Category: Sharp. Subcategory: Fridge. Price: 121,900৳162,500৳.
",170,1007907,1008077
7320,sentence,"Subcategory: Fridge. Price: 121,900৳162,500৳.

Product: Sharp SJ-EX585P-BK 508 Liters Inverter Refrigerator. Category: Sharp. Subcategory: Fridge. Price: 151,900৳202,500৳.
",172,1008031,1008203
7321,sentence,"Subcategory: Fridge. Price: 151,900৳202,500৳.

Product: Sharp SJ-EFD589X-BK 473 Liters 4-Door Inverter Refrigerator. Category: Sharp. Subcategory: Fridge. Price: 152,900৳203,800৳.
",180,1008157,1008337
7322,sentence,"Subcategory: Fridge. Price: 152,900৳203,800৳.

Product: Sharp SJ-EX655-BK 570 Liters Inverter Refrigerator. Category: Sharp. Subcategory: Fridge. Price: 188,900৳251,900৳.
",171,1008291,1008462
7323,sentence,"Subcategory: Fridge. Price: 188,900৳251,900৳.

Product: Sharp SJ-EX735-BK 656 Liters Inverter Refrigerator. Category: Sharp. Subcategory: Fridge. Price: 214,900৳286,500৳.
",171,1008416,1008587
7324,sentence,"Subcategory: Fridge. Price: 214,900৳286,500৳.

Product: Sharp SJ-EX315E-SL 253 Liters Inverter Refrigerator. Category: Sharp. Subcategory: Fridge. Price: Out Of Stock.
",168,1008541,1008709
7325,sentence,"Subcategory: Fridge. Price: Out Of Stock.

Product: SHARP SJ-ESB631XN 521 Liters 2-Door Inverter Refrigerator. Category: Sharp. Subcategory: Fridge. Price: Out Of Stock.
",170,1008667,1008837
7326,sentence,"Subcategory: Fridge. Price: Out Of Stock.

Product: SHARP SJ-ESB691X-DX 599 Liters 2 Door Refrigerator. Category: Sharp. Subcategory: Fridge. Price: Out Of Stock.
",163,1008795,1008958
7327,sentence,"Subcategory: Fridge. Price: Out Of Stock.

Product: Hisense RTDG276NARG/BD3 277L Glass Door Refrigerator. Category: Hisense. Subcategory: Fridge. Price: 39,000৳43,900৳.
",169,1008916,1009085
7328,sentence,"Subcategory: Fridge. Price: 39,000৳43,900৳.

Product: Hisense RTDG276NAGS/BD3 277L Top Mount Door Refrigerator. Category: Hisense. Subcategory: Fridge. Price: 39,000৳43,900৳.
",175,1009041,1009216
7329,sentence,"Subcategory: Fridge. Price: 39,000৳43,900৳.

Product: Hisense RTDG276NAFB/BD3 277L Glass Door Refrigerator. Category: Hisense. Subcategory: Fridge. Price: 39,000৳43,900৳.
",171,1009172,1009343
7330,sentence,"Subcategory: Fridge. Price: 39,000৳43,900৳.

Product: Hisense RBDG266NARG/BD3 270L Glass Door Refrigerator. Category: Hisense. Subcategory: Fridge. Price: 43,000৳45,900৳.
",171,1009299,1009470
7331,sentence,"Subcategory: Fridge. Price: 43,000৳45,900৳.

Product: Hisense RBDG266NAFB/BD3 270L Glass Door Refrigerator. Category: Hisense. Subcategory: Fridge. Price: 43,000৳45,900৳.
",171,1009426,1009597
7332,sentence,"Subcategory: Fridge. Price: 43,000৳45,900৳.

Product: Hisense RBDG266NAAR/BD3 270L Glass Door Refrigerator. Category: Hisense. Subcategory: Fridge. Price: 43,000৳45,900৳.
",171,1009553,1009724
7333,sentence,"Subcategory: Fridge. Price: 43,000৳45,900৳.

Product: Hisense RB1G266NAB/BD3 270L Bottom Mount Inverter Refrigerator. Category: Hisense. Subcategory: Fridge. Price: 43,000৳47,900৳.
",181,1009680,1009861
7334,sentence,"Subcategory: Fridge. Price: 43,000৳47,900৳.

Product: Hisense BD240 240 L Deep Freezer. Category: Hisense. Subcategory: Fridge. Price: 43,500৳48,900৳.
",151,1009817,1009968
7335,sentence,"Subcategory: Fridge. Price: 43,500৳48,900৳.

Product: Hisense RD31DC4SHA 259 L Inverter Refrigerator. Category: Hisense. Subcategory: Fridge. Price: 47,500৳49,900৳.
",165,1009924,1010089
7336,sentence,"Subcategory: Fridge. Price: 47,500৳49,900৳.

Product: Hisense RT1G276NAB/BD3 277L Top Mount Inverter Refrigerator. Category: Hisense. Subcategory: Fridge. Price: 41,000৳49,900৳.
",178,1010045,1010223
7337,sentence,"Subcategory: Fridge. Price: 41,000৳49,900৳.

Product: Hisense RT42W4AK 346 L Refrigerator. Category: Hisense. Subcategory: Fridge. Price: 64,000৳72,900৳.
",154,1010179,1010333
7338,sentence,"Subcategory: Fridge. Price: 64,000৳72,900৳.

Product: Hisense RS67W4NV 566 L Inverter Refrigerator. Category: Hisense. Subcategory: Fridge. Price: 102,000৳119,900৳.
",165,1010289,1010454
7339,sentence,"Subcategory: Fridge. Price: 102,000৳119,900৳.

Product: Hisense RS3G558NAB/BD3 580 L Refrigerator. Category: Hisense. Subcategory: Fridge. Price: 102,000৳119,900৳.
",164,1010408,1010572
7340,sentence,"Subcategory: Fridge. Price: 102,000৳119,900৳.

Product: Beko BOREF-B5RCNS37HUG 375 Liter Refrigerator. Category: beko. Subcategory: Fridge. Price: Up Coming.
",158,1010526,1010684
7341,sentence,"Subcategory: Fridge. Price: Up Coming.

Product: Beko BOREF-B3RGNS46HGBI 466L Refrigerator. Category: beko. Subcategory: Fridge. Price: Up Coming.
",147,1010645,1010792
7342,sentence,"Subcategory: Fridge. Price: Up Coming.

Product: Beko BOREF-B3RCNS37HXB 375 Liter Refrigerator. Category: beko. Subcategory: Fridge. Price: Up Coming.
",151,1010753,1010904
7343,sentence,"Subcategory: Fridge. Price: Up Coming.

Product: Beko BOREF-B5RCNS34HUG 340 Liter Refrigerator. Category: beko. Subcategory: Fridge. Price: Up Coming.
",151,1010865,1011016
7344,sentence,"Subcategory: Fridge. Price: Up Coming.

Product: Beko BOREF-B3RCNS34HXB 340 Liter Refrigerator. Category: beko. Subcategory: Fridge. Price: Up Coming.
",151,1010977,1011128
7345,sentence,"Subcategory: Fridge. Price: Up Coming.

Product: Beko BOREF-B3RGNS46HXPI 466 Liters 4-Door Inverter Refrigerator. Category: beko. Subcategory: Fridge. Price: Up Coming.
",169,1011089,1011258
7346,sentence,"Subcategory: Fridge. Price: Up Coming.

Product: Beko BOREF-RDNE295DSE 275 Liter Refrigerator. Category: beko. Subcategory: Fridge. Price: Up Coming.
",150,1011219,1011369
7347,sentence,"Subcategory: Fridge. Price: Up Coming.

Product: Beko BOREF-RDNE295DWBE-EX 275 Liter Refrigerator. Category: beko. Subcategory: Fridge. Price: Up Coming.

Product: Haier HCF-175GE 142L Deep Freezer. ",199,1011330,1011529
7348,sentence,"
Product: Haier HCF-175GE 142L Deep Freezer. Category: Haier. Subcategory: Fridge. Price: 38,000৳43,900৳.

Product: Haier HCF-230SG 200L Deep Freezer. Category: Haier. Subcategory: Fridge. ",189,1011484,1011673
7349,sentence,"Category: Haier. Subcategory: Fridge. Price: 39,000৳47,400৳.

Product: Haier HCF-230GE 200L Deep Freezer. Category: Haier. Subcategory: Fridge. Price: 45,000৳51,400৳.
",167,1011635,1011802
7350,sentence,"Subcategory: Fridge. Price: 45,000৳51,400৳.

Product: Haier HCF-290N 251L Deep Freezer. Category: Haier. Subcategory: Fridge. Price: 45,500৳52,400৳.

Product: Haier HRF-362TBG 342L Refrigerator. ",195,1011758,1011953
7351,sentence,"
Product: Haier HRF-362TBG 342L Refrigerator. Category: Haier. Subcategory: Fridge. Price: 68,500৳75,900৳.

Product: Haier HRF-386TBG 366L Refrigerator. Category: Haier. Subcategory: Fridge. ",191,1011907,1012098
7352,sentence,"Category: Haier. Subcategory: Fridge. Price: 70,500৳79,900৳.

Product: Haier HRF-395PBG 375L Refrigerator. Category: Haier. Subcategory: Fridge. Price: 76,900৳85,900৳.
",168,1012060,1012228
7353,sentence,"Subcategory: Fridge. Price: 76,900৳85,900৳.

Product: Haier HRF-578TBG 522L French T-Door Refrigerator. Category: Haier. Subcategory: Fridge. Price: 132,905৳139,900৳.
",167,1012184,1012351
7354,sentence,"Subcategory: Fridge. Price: 132,905৳139,900৳.

Product: Haier HRF-622ICG 600L Side-by-Side Refrigerator. Category: Haier. Subcategory: Fridge. Price: 135,999৳144,900৳.
",168,1012305,1012473
7355,sentence,"Subcategory: Fridge. Price: 135,999৳144,900৳.

Product: Haier HRF-622IBG 600L Side-by-Side Refrigerator. Category: Haier. Subcategory: Fridge. Price: 136,999৳145,900৳.
",168,1012427,1012595
7356,sentence,"Subcategory: Fridge. Price: 136,999৳145,900৳.

Product: Haier HRF-680BG 630L Side-by-Side Refrigerator. Category: Haier. Subcategory: Fridge. Price: 140,000৳155,900৳.
",167,1012549,1012716
7357,sentence,"Subcategory: Fridge. Price: 140,000৳155,900৳.

Product: Haier HRF-680MG 630L Side-by-Side Refrigerator. Category: Haier. Subcategory: Fridge. Price: 134,900৳155,900৳.
",167,1012670,1012837
7358,sentence,"Subcategory: Fridge. Price: 134,900৳155,900৳.

Product: Haier HRF-266EPMC 246L Refrigerator. Category: Haier. Subcategory: Fridge. Price: Up Coming.

Product: Haier HRF-234EPPW 214L Refrigerator. ",196,1012791,1012987
7359,sentence,"
Product: Haier HRF-234EPPW 214L Refrigerator. Category: Haier. Subcategory: Fridge. Price: Up Coming.

Product: Haier HRF-234EPDA 214L Refrigerator. Category: Haier. Subcategory: Fridge. ",188,1012940,1013128
7360,sentence,"Category: Haier. Subcategory: Fridge. Price: Up Coming.

Product: Haier HRF-200EPMB 180L Refrigerator. Category: Haier. Subcategory: Fridge. Price: Up Coming.
",159,1013090,1013249
7361,sentence,"Subcategory: Fridge. Price: Up Coming.

Product: Haier HRF-200EPGL 180L Refrigerator. Category: Haier. Subcategory: Fridge. Price: Up Coming.

Product: Haier HCF-175 146L Deep Freezer. ",185,1013210,1013395
7362,sentence,"
Product: Haier HCF-175 146L Deep Freezer. Category: Haier. Subcategory: Fridge. Price: Out Of Stock.

Product: Haier HCF-230 203L Deep Freezer. Category: Haier. Subcategory: Fridge. ",183,1013352,1013535
7363,sentence,"Category: Haier. Subcategory: Fridge. Price: Out Of Stock.

Product: Rangs RCF-275GD 275L Glass Door Deep Freezer Blue. Category: Rangs. Subcategory: Fridge. Price: 43,985৳46,300৳.
",181,1013497,1013678
7364,sentence,"Subcategory: Fridge. Price: 43,985৳46,300৳.

Product: Rangs RCF-275GD 275L Glass Door Deep Freezer. Category: Rangs. Subcategory: Fridge. Price: 43,985৳46,300৳.
",161,1013634,1013795
7365,sentence,"Subcategory: Fridge. Price: 43,985৳46,300৳.

Product: Rangs RCF-335DFV 335L Deep Freezer. Category: Rangs. Subcategory: Fridge. Price: 46,170৳48,600৳.
",151,1013751,1013902
7366,sentence,"Subcategory: Fridge. Price: 46,170৳48,600৳.

Product: Whirlpool Fresh Magic Pro 236L GD Florina Red Refrigerator. Category: Whirlpool. Subcategory: Fridge. Price: 35,000৳44,990৳.
",179,1013858,1014037
7367,sentence,"Subcategory: Fridge. Price: 35,000৳44,990৳.

Product: Whirlpool Fresh Magic Pro 236L GD Florina Blue Refrigerator. Category: Whirlpool. Subcategory: Fridge. Price: 35,000৳44,990৳.
",180,1013993,1014173
7368,sentence,"Subcategory: Fridge. Price: 35,000৳44,990৳.

Product: Whirlpool Fresh Magic Pro 236L Crystal Black Refrigerator. Category: Whirlpool. Subcategory: Fridge. Price: 42,000৳45,490৳.
",178,1014129,1014307
7369,sentence,"Subcategory: Fridge. Price: 42,000৳45,490৳.

Product: Whirlpool Fresh Magic Pro 257L GD Florina Red Refrigerator. Category: Whirlpool. Subcategory: Fridge. Price: 37,000৳47,490৳.
",179,1014263,1014442
7370,sentence,"Subcategory: Fridge. Price: 37,000৳47,490৳.

Product: Whirlpool Fresh Magic Pro 257L GD Florina Purple Refrigerator. Category: Whirlpool. Subcategory: Fridge. Price: 37,000৳47,490৳.
",182,1014398,1014580
7371,sentence,"Subcategory: Fridge. Price: 37,000৳47,490৳.

Product: Whirlpool Fresh Magic Pro 257L Crystal Black Refrigerator. Category: Whirlpool. Subcategory: Fridge. Price: 45,000৳47,990৳.
",178,1014536,1014714
7372,sentence,"Subcategory: Fridge. Price: 45,000৳47,990৳.

Product: Whirlpool Fresh Magic Pro 236L GD Inv Mirror Refrigerator. Category: Whirlpool. Subcategory: Fridge. Price: 47,000৳48,690৳.
",178,1014670,1014848
7373,sentence,"Subcategory: Fridge. Price: 47,000৳48,690৳.

Product: Whirlpool Fresh Magic Pro 278L GD Florina Red Refrigerator. Category: Whirlpool. Subcategory: Fridge. Price: 38,500৳49,490৳.
",179,1014804,1014983
7374,sentence,"Subcategory: Fridge. Price: 38,500৳49,490৳.

Product: Whirlpool Fresh Magic Pro 278L GD Florina Blue Refrigerator. Category: Whirlpool. Subcategory: Fridge. Price: 38,500৳49,490৳.
",180,1014939,1015119
7375,sentence,"Subcategory: Fridge. Price: 38,500৳49,490৳.

Product: Whirlpool Fresh Magic Pro 278L Crystal Black Refrigerator. Category: Whirlpool. Subcategory: Fridge. Price: 46,900৳49,690৳.
",178,1015075,1015253
7376,sentence,"Subcategory: Fridge. Price: 46,900৳49,690৳.

Product: Whirlpool Fresh Magic Pro 278L GD Inv Mirror Refrigerator. Category: Whirlpool. Subcategory: Fridge. Price: 49,500৳52,990৳.
",178,1015209,1015387
7377,sentence,"Subcategory: Fridge. Price: 49,500৳52,990৳.

Product: Whirlpool Neo Fresh Inverter 257L Crystal Black Refrigerator. Category: Whirlpool. Subcategory: Fridge. Price: 57,000৳59,890৳.
",181,1015343,1015524
7378,sentence,"Subcategory: Fridge. Price: 57,000৳59,890৳.

Product: Whirlpool Intellifresh Inverter 278L Steel Onyx Refrigerator. Category: Whirlpool. Subcategory: Fridge. Price: 58,000৳61,990৳.
",181,1015480,1015661
7379,sentence,"Subcategory: Fridge. Price: 58,000৳61,990৳.

Product: Whirlpool Neo Inv 278GD PRM Crystal Black BD Refrigerator. Category: Whirlpool. Subcategory: Fridge. Price: 60,500৳64,890৳.
",178,1015617,1015795
7380,sentence,"Subcategory: Fridge. Price: 60,500৳64,890৳.

Product: Kelvinator KRF-230T0G1AX 230 Liter Top Mount Refrigerator. Category: Kelvinator. Subcategory: Fridge. Price: 45,490৳.
",172,1015751,1015923
7381,sentence,"Subcategory: Fridge. Price: 45,490৳.

Product: Kelvinator KRF-268T0G1AX 268 Liter Top Mount Refrigerator. Category: Kelvinator. Subcategory: Fridge. Price: 48,900৳.
",165,1015886,1016051
7382,sentence,"Subcategory: Fridge. Price: 48,900৳.

Product: Kelvinator KHV-333FF 333L Refrigerator. Category: Kelvinator. Subcategory: Fridge. Price: 49,350৳.
",146,1016014,1016160
7383,sentence,"Subcategory: Fridge. Price: 49,350৳.

Product: Kelvinator KRF-265B0G1AX 265 Litre Glass Door Refrigerator. Category: Kelvinator. Subcategory: Fridge. Price: 49,490৳.
",166,1016123,1016289
7384,sentence,"Subcategory: Fridge. Price: 49,490৳.

Product: Kelvinator KHV-365FF 365 Litre Defrost Refrigerator. Category: Kelvinator. Subcategory: Fridge. Price: 50,600৳.
",159,1016252,1016411
7385,sentence,"Subcategory: Fridge. Price: 50,600৳.

Product: Kelvinator KHV-279GDF 279L Glass Door Refrigerator. Category: Kelvinator. Subcategory: Fridge. Price: 39,900৳58,000৳.
",165,1016374,1016539
7386,sentence,"Subcategory: Fridge. Price: 39,900৳58,000৳.

Product: Kelvinator KHV-590NFSBS2DBG 590 Liters Inverter Refrigerator. Category: Kelvinator. Subcategory: Fridge. Price: 104,405৳109,900৳.
",184,1016495,1016679
7387,sentence,"Subcategory: Fridge. Price: 104,405৳109,900৳.

Product: Kelvinator KRS-537SBX 537 Liter Inverter Double Door Refrigerator. Category: Kelvinator. Subcategory: Fridge. Price: 120,000৳141,500৳.
",191,1016633,1016824
7388,sentence,"Subcategory: Fridge. Price: 120,000৳141,500৳.

Product: Kelvinator KRS-537SGX 537 Liter Inverter Double Door Refrigerator. Category: Kelvinator. Subcategory: Fridge. Price: 120,000৳141,500৳.
",191,1016778,1016969
7389,sentence,"Subcategory: Fridge. Price: 120,000৳141,500৳.

Product: Kelvinator KRS-537SBW 537 Liter Inverter Double Door Refrigerator with Water Dispenser. Category: Kelvinator. Subcategory: Fridge. ",187,1016923,1017110
7390,sentence,"Category: Kelvinator. Subcategory: Fridge. Price: 124,500৳146,500৳.

Product: Kelvinator KRS-537SGW 537 Liter Inverter Double Door Refrigerator with Water Dispenser. Category: Kelvinator. ",188,1017067,1017255
7391,sentence,"Category: Kelvinator. Subcategory: Fridge. Price: 124,500৳146,500৳.

Product: Kelvinator KRS-663TBX 663 Liter Twin Eco-Inverter Double Door Refrigerator. Category: Kelvinator. Subcategory: Fridge. ",197,1017233,1017430
7392,sentence,"Category: Kelvinator. Subcategory: Fridge. Price: 158,900৳.

Product: Hisense WTJA8012US/BD3 8KG Top Load Washing Machine. Category: Hisense. Subcategory: Washing Machine. Price: 26,990৳31,900৳.
",195,1017387,1017582
7393,sentence,"Price: 26,990৳31,900৳.

Product: Hisense WTJA8012UT/BD3 8KG Top Load Washing Machine. Category: Hisense. Subcategory: Washing Machine. Price: 27,490৳33,900৳.
",158,1017559,1017717
7394,sentence,"Price: 27,490৳33,900৳.

Product: Hisense WT5J1013DT 10.5 kg Top Load Washing Machine. Category: Hisense. Subcategory: Washing Machine. Price: 36,990৳43,900৳.
",158,1017694,1017852
7395,sentence,"Price: 36,990৳43,900৳.

Product: Hisense WT5J9513DS/BD3 9.5 kg Top Load Washing Machine. Category: Hisense. Subcategory: Washing Machine. Price: 36,700৳41,900৳.
",161,1017829,1017990
7396,sentence,"Price: 36,700৳41,900৳.

Product: Hisense WTJA801T 8 kg Top Load Washing Machine. Category: Hisense. Subcategory: Washing Machine. Price: Out Of Stock.
",151,1017967,1018118
7397,sentence,"Price: Out Of Stock.

Product: Hisense WF3S9043BT 9KG Front Load Washing Machine. Category: Hisense. Subcategory: Washing Machine. Price: Out Of Stock.
",152,1018097,1018249
7398,sentence,"Price: Out Of Stock.

Product: Hisense WT5J9513DT/BD3 9.5 kg Top Load Washing Machine. Category: Hisense. Subcategory: Washing Machine. Price: Out Of Stock.
",157,1018228,1018385
7399,sentence,"Price: Out Of Stock.

Product: Hisense WF3S8043BW 8kg Inverter Front Load Washing Machine. Category: Hisense. Subcategory: Washing Machine. Price: Out Of Stock.
",161,1018364,1018525
7400,sentence,"Price: Out Of Stock.

Product: Hisense WF3S1043BT 10.5 kg Front Load Washing Machine. Category: Hisense. Subcategory: Washing Machine. Price: Out Of Stock.
",156,1018504,1018660
7401,sentence,"Price: Out Of Stock.

Product: SMART SER-196BS 196 Ltr Glass Door Refrigerator. Category: Smart. Subcategory: Fridge. Price: 34,900৳46,900৳.

Product: SMART SER-217TS 217 Ltr Top Mount Refrigerator. ",199,1018639,1018838
7402,sentence,"Category: Smart. Subcategory: Fridge. Price: 35,900৳47,900৳.

Product: SMART SER-240TS 240 Ltr Top Mount Refrigerator. Category: Smart. Subcategory: Fridge. Price: 37,900৳50,900৳.
",180,1018838,1019018
7403,sentence,"Subcategory: Fridge. Price: 37,900৳50,900৳.

Product: SMART SER-238BS 238 Ltr Bottom Mount Refrigerator. Category: Smart. Subcategory: Fridge. Price: 37,900৳50,900৳.
",166,1018974,1019140
7404,sentence,"Subcategory: Fridge. Price: 37,900৳50,900৳.

Product: SMART SER-250CS 250 Ltr Glass Door Deep Freezer. Category: Smart. Subcategory: Fridge. Price: 37,900৳50,900৳.
",164,1019096,1019260
7405,sentence,"Subcategory: Fridge. Price: 37,900৳50,900৳.

Product: SMART SER-305TS 305 Ltr Top Mount Refrigerator. Category: Smart. Subcategory: Fridge. Price: 44,900৳59,900৳.
",163,1019216,1019379
7406,sentence,"Subcategory: Fridge. Price: 44,900৳59,900৳.

Product: SMART SER-330BS 330 Liter Refrigerator. Category: Smart. Subcategory: Fridge. Price: 48,900৳64,900৳.
",155,1019335,1019490
7407,sentence,"Subcategory: Fridge. Price: 48,900৳64,900৳.

Product: SMART SER-356TS 356 Liter Refrigerator. Category: Smart. Subcategory: Fridge. Price: 49,900৳66,900৳.
",155,1019446,1019601
7408,sentence,"Subcategory: Fridge. Price: 49,900৳66,900৳.

Product: SMART SER-150CS 150 Ltr Glass Door Deep Freezer. Category: Smart. Subcategory: Fridge. Price: Up Coming.
",159,1019557,1019716
7409,sentence,"Subcategory: Fridge. Price: Up Coming.

Product: SMART SER-216BS 216 Ltr Bottom Mount Refrigerator. Category: Smart. Subcategory: Fridge. Price: Up Coming.
",156,1019677,1019833
7410,sentence,"Subcategory: Fridge. Price: Up Coming.

Product: Singer S300ATL70ISMJG1 7KG Top Loading Washing Machine. Category: Singer. Subcategory: Washing Machine. Price: 31,490৳33,490৳.
",176,1019794,1019970
7411,sentence,"Price: 31,490৳33,490৳.

Product: Singer SRWM-S300ATL90ISMJG1 9 KG Top Loading Washing Machine. Category: Singer. Subcategory: Washing Machine. Price: 35,990৳38,990৳.
",166,1019947,1020113
7412,sentence,"Price: 35,990৳38,990৳.

Product: Singer S300ATL100ISMJG1 10 KG Top Load Washing Machine. Category: Singer. Subcategory: Washing Machine. Price: 43,900৳44,990৳.
",160,1020090,1020250
7413,sentence,"Price: 43,900৳44,990৳.

Product: Whirlpool SW Royal Plus 7.5 KG Top Load Washing Machine. Category: Whirlpool. Subcategory: Washing Machine. Price: 39,000৳40,490৳.
",164,1020227,1020391
7414,sentence,"Price: 39,000৳40,490৳.

Product: Whirlpool SW PRO 8.0 KG Top Load Washing Machine. Category: Whirlpool. Subcategory: Washing Machine. Price: 40,000৳41,990৳.
",157,1020368,1020525
7415,sentence,"Price: 40,000৳41,990৳.

Product: Whirlpool PRO H 9.5 KG Top Load Washing Machine. Category: Whirlpool. Subcategory: Washing Machine. Price: 41,990৳50,490৳.
",156,1020502,1020658
7416,sentence,"Price: 41,990৳50,490৳.

Product: Whirlpool WFC90604RT-D 9 KG Front Load Washing Machine. Category: Whirlpool. Subcategory: Washing Machine. Price: 57,690৳67,990৳.
",163,1020635,1020798
7417,sentence,"Price: 57,690৳67,990৳.

Product: Whirlpool WFC105604RT-D 10.5 KG Front Load Washing Machine. Category: Whirlpool. Subcategory: Washing Machine. Price: 58,990৳73,990৳.
",167,1020775,1020942
7418,sentence,"Price: 58,990৳73,990৳.

Product: Walton WWM-ATP70 7 KG Top Load Fully Automatic Washing Machine. Category: Walton. Subcategory: Washing Machine. Price: 20,900৳23,900৳.
",168,1020919,1021087
7419,sentence,"Price: 20,900৳23,900৳.

Product: Beko BOWM-WTL80IH12PB 8 KG Top Loading Washing Machine. Category: beko. Subcategory: Washing Machine. Price: 37,990৳41,990৳.
",158,1021064,1021222
7420,sentence,"Price: 37,990৳41,990৳.

Product: Beko BOWM-WCV8636XB0M 8 KG Front Loading Washing Machine. Category: beko. Subcategory: Washing Machine. Price: 57,990৳67,990৳.
",160,1021199,1021359
7421,sentence,"Price: 57,990৳67,990৳.

Product: Beko BOWM-WCV9736XB0M 9 KG Front Loading Washing Machine. Category: beko. Subcategory: Washing Machine. Price: 60,990৳70,990৳.
",160,1021336,1021496
7422,sentence,"Price: 60,990৳70,990৳.

Product: Beko BOWM-WCV10746XC0M 10 KG Front Loading Washing Machine. Category: beko. Subcategory: Washing Machine. Price: 66,990৳76,990৳.
",162,1021473,1021635
7423,sentence,"Price: 66,990৳76,990৳.

Product: Sharp ES-X858 8.0 KG Full Auto Washing Machine. Category: Sharp. Subcategory: Washing Machine. Price: 41,690৳58,500৳.
",151,1021612,1021763
7424,sentence,"Price: 41,690৳58,500৳.

Product: Sharp ES-W80EW-H 8 KG Full Auto Washing Machine. Category: Sharp. Subcategory: Washing Machine. Price: 47,900৳63,900৳.
",152,1021740,1021892
7425,sentence,"Price: 47,900৳63,900৳.

Product: Sharp ES-W85TWXT-SA 8.5 KG Full Auto J-Tech Inverter Washing Machine. Category: Sharp. Subcategory: Washing Machine. Price: 52,900৳70,500৳.
",173,1021869,1022042
7426,sentence,"Price: 52,900৳70,500৳.

Product: Sharp ES-F120G 12 KG Full Auto Inverter Washing Machine. Category: Sharp. Subcategory: Washing Machine. Price: 61,900৳82,500৳.
",160,1022019,1022179
7427,sentence,"Price: 61,900৳82,500৳.

Product: Sharp ES-FW85SG 8.5 KG  Full Auto Front Loading Inverter Washing Machine. Category: Sharp. Subcategory: Washing Machine. Price: 76,900৳106,900৳.
",178,1022156,1022334
7428,sentence,"Price: 76,900৳106,900৳.

Product: Sharp ES-718X 7.0 KG Full Auto Washing Machine. Category: Sharp. Subcategory: Washing Machine. Price: Out Of Stock.
",150,1022310,1022460
7429,sentence,"Price: Out Of Stock.

Product: Sharp ES-W95TWXT-SA 9.5 KG Full Auto J-Tech Inverter Washing Machine. Category: Sharp. Subcategory: Washing Machine. Price: Out Of Stock.
",169,1022439,1022608
7430,sentence,"Price: Out Of Stock.

Product: Haier HWM70-1269S5 7 KG Top Load Fully Automatic Washing Machine. Category: Washing Machine. Subcategory: Appliance. Price: 23,990৳29,900৳.
",171,1022587,1022758
7431,sentence,"Subcategory: Appliance. Price: 23,990৳29,900৳.

Product: Haier HWM80-316S6 8 KG Top Load Washing Machine. Category: Washing Machine. Subcategory: Appliance. Price: 28,990৳34,900৳.
",180,1022711,1022891
7432,sentence,"Subcategory: Appliance. Price: 28,990৳34,900৳.

Product: Haier HWM90-316S6 9 KG Top Load Washing Machine. Category: Washing Machine. Subcategory: Appliance. Price: 32,590৳39,400৳.
",180,1022844,1023024
7433,sentence,"Subcategory: Appliance. Price: 32,590৳39,400৳.

Product: Haier HWM100-316S6 10 KG Top Load Washing Machine. Category: Washing Machine. Subcategory: Appliance. Price: 36,690৳43,900৳.
",182,1022977,1023159
7434,sentence,"Subcategory: Appliance. Price: 36,690৳43,900৳.

Product: Haier HWM120-316S6 12 KG Top Load Washing Machine. Category: Washing Machine. Subcategory: Appliance. Price: 41,990৳49,900৳.
",182,1023112,1023294
7435,sentence,"Subcategory: Appliance. Price: 41,990৳49,900৳.

Product: Haier HW80-BP12929S6 8 KG Front Load Washing Machine. Category: Washing Machine. Subcategory: Appliance. Price: 52,990৳62,900৳.
",185,1023247,1023432
7436,sentence,"Subcategory: Appliance. Price: 52,990৳62,900৳.

Product: Haier HW90-BP14959S8 9 KG Front Load Washing Machine. Category: Washing Machine. Subcategory: Appliance. Price: 57,690৳68,900৳.
",185,1023385,1023570
7437,sentence,"Subcategory: Appliance. Price: 57,690৳68,900৳.

Product: LG T2108VSAB 8KG Top Load Inverter Washing Machine. Category: LG. Subcategory: Washing Machine. Price: 51,990৳56,900৳.
",176,1023523,1023699
7438,sentence,"Price: 51,990৳56,900৳.

Product: LG T2310VSAB 10KG Top Load Inverter Washing Machine. Category: LG. Subcategory: Washing Machine. Price: 63,690৳68,900৳.
",153,1023676,1023829
7439,sentence,"Price: 63,690৳68,900৳.

Product: LG FB1209S6M 9.0KG Front Load Inverter Washing Machine. Category: LG. Subcategory: Washing Machine. Price: 91,000৳95,900৳.
",156,1023806,1023962
7440,sentence,"Price: 91,000৳95,900৳.

Product: LG FV1411S2B 11KG Front Load Inverter Washing Machine. Category: LG. Subcategory: Washing Machine. Price: 109,590৳121,900৳.
",157,1023939,1024096
7441,sentence,"Price: 109,590৳121,900৳.

Product: LG FV1410H3BA 10KG Front Load Inverter Washing Machine. Category: LG. Subcategory: Washing Machine. Price: 124,000৳130,900৳.
",160,1024071,1024231
7442,sentence,"Price: 124,000৳130,900৳.

Product: Haier HW105-B14959S8U1 10.5 KG AI Front Load Washing Machine. Category: Haier. Subcategory: Washing Machine. Price: 69,900৳79,900৳.
",167,1024206,1024373
7443,sentence,"Price: 69,900৳79,900৳.

Product: Haier HW120-BP14959S8 12 KG Front Load Washing Machine. Category: Haier. Subcategory: Washing Machine. Price: 74,900৳84,900৳.
",159,1024350,1024509
7444,sentence,"Price: 74,900৳84,900৳.

Product: Haier HWD105-B14959S8U1 10.5 KG AI Front Load Washing Machine. Category: Haier. Subcategory: Washing Machine. Price: 84,999৳98,900৳.
",166,1024486,1024652
7445,sentence,"Price: 84,999৳98,900৳.

Product: Samsung WW90TA047AX 9KG Inverter Front Loading Washing Machine. Category: Samsung. Subcategory: Washing Machine. Price: Up Coming.
",164,1024629,1024793
7446,sentence,"Subcategory: Washing Machine. Price: Up Coming.

Product: Samsung WA75H4200SY 7.5KG Top Load Fully Automatic Washing Machine. Category: Samsung. Subcategory: Washing Machine. Price: Out Of Stock.
",196,1024745,1024941
7447,sentence,"Price: Out Of Stock.

Product: Samsung WA90T5260BY 9KG Top Load Fully Automatic Washing Machine. Category: Samsung. Subcategory: Washing Machine. Price: Out Of Stock.
",167,1024920,1025087
7448,sentence,"Price: Out Of Stock.

Product: Samsung WW80T534DAX 8KG Front Load Inverter Washing Machine. Category: Samsung. Subcategory: Washing Machine. Price: Out Of Stock.
",162,1025066,1025228
7449,sentence,"Price: Out Of Stock.

Product: Havells Enticer 56"" Ceiling Fan. Category: Ceiling Fan. Subcategory: Fan. Price: 8,300৳10,500৳.

Product: Havells ENTICER WOOD 56"" Ceiling Fan. Category: Ceiling Fan. ",198,1025207,1025405
7450,sentence,"Category: Ceiling Fan. Subcategory: Fan. Price: 8,500৳11,500৳.

Product: Havells Enticer Hues 56"" Ceiling Fan. Category: Ceiling Fan. Subcategory: Fan. Price: 8,500৳11,500৳.
",174,1025382,1025556
7451,sentence,"Subcategory: Fan. Price: 8,500৳11,500৳.

Product: Usha Bloom Daffodil 50"" Decorative Ceiling Fan. Category: Ceiling Fan. Subcategory: Fan. Price: 6,999৳11,550৳.
",161,1025516,1025677
7452,sentence,"Subcategory: Fan. Price: 6,999৳11,550৳.

Product: Havells Crew Deco 56'' Ceiling Fan. Category: Ceiling Fan. Subcategory: Fan. Price: 7,200৳12,000৳.

Product: Hindware Magnum 56"" Ceiling Fan. ",192,1025637,1025829
7453,sentence,"
Product: Hindware Magnum 56"" Ceiling Fan. Category: Ceiling Fan. Subcategory: Fan. Price: 6,300৳12,000৳.

Product: Atomberg Studio+ 48"" Ceiling Fan With Remote. Category: Ceiling Fan. ",185,1025786,1025971
7454,sentence,"Category: Ceiling Fan. Subcategory: Fan. Price: 10,000৳12,500৳.

Product: Atomberg Renesa+ 56"" Ceiling Fan With Remote. Category: Ceiling Fan. Subcategory: Fan. Price: 10,000৳12,500৳.
",184,1025948,1026132
7455,sentence,"Subcategory: Fan. Price: 10,000৳12,500৳.

Product: Hindware Magnum Art 56"" Ceiling Fan. Category: Ceiling Fan. Subcategory: Fan. Price: 6,500৳12,500৳.

Product: Hindware Eleganza 48"" Ceiling Fan. ",196,1026091,1026287
7456,sentence,"
Product: Hindware Eleganza 48"" Ceiling Fan. Category: Ceiling Fan. Subcategory: Fan. Price: 7,499৳13,500৳.

Product: Orient AeroQuite 48"" Ceiling Fan. Category: Ceiling Fan. Subcategory: Fan. ",193,1026242,1026435
7457,sentence,"Category: Ceiling Fan. Subcategory: Fan. Price: 15,500৳17,500৳.

Product: Atomberg Studio Smart+ 48"" Ceiling Fan With Remote. Category: Ceiling Fan. Subcategory: Fan. Price: 12,000৳19,000৳.
",190,1026394,1026584
7458,sentence,"Subcategory: Fan. Price: 12,000৳19,000৳.

Product: Havells YORKER 53"" Ceiling Fan. Category: Ceiling Fan. Subcategory: Fan. Price: 16,499৳20,800৳.

Product: Orient AeroStorm 53"" Ceiling Fan. ",191,1026543,1026734
7459,sentence,"
Product: Orient AeroStorm 53"" Ceiling Fan. Category: Ceiling Fan. Subcategory: Fan. Price: 15,999৳22,400৳.

Product: Hindware Royal 48"" Ceiling Fan. Category: Ceiling Fan. Subcategory: Fan. ",191,1026690,1026881
7460,sentence,"Category: Ceiling Fan. Subcategory: Fan. Price: 10,900৳22,750৳.

Product: Atomberg Aris 48"" Ceiling Fan With Remote. Category: Ceiling Fan. Subcategory: Fan. Price: 17,500৳22,800৳.
",181,1026840,1027021
7461,sentence,"Subcategory: Fan. Price: 17,500৳22,800৳.

Product: Atomberg Aris Starlight 48"" Ceiling Fan With Light and Remote. Category: Ceiling Fan. Subcategory: Fan. Price: 18,500৳23,800৳.
",178,1026980,1027158
7462,sentence,"Subcategory: Fan. Price: 18,500৳23,800৳.

Product: Havells Elio Prime UL 56"" Ceiling Fan With Remote. Category: Ceiling Fan. Subcategory: Fan. Price: 17,499৳24,499৳.
",166,1027117,1027283
7463,sentence,"Subcategory: Fan. Price: 17,499৳24,499৳.

Product: Havells Inox UL 48"" Ceiling Fan With Light and Remote. Category: Ceiling Fan. Subcategory: Fan. Price: 21,499৳25,499৳.
",170,1027242,1027412
7464,sentence,"Subcategory: Fan. Price: 21,499৳25,499৳.

Product: Luminous Jaipur Mahal 52"" Decorative Engergy Saving Ceiling Fan. Category: Ceiling Fan. Subcategory: Fan. Price: 14,500৳25,900৳.
",180,1027371,1027551
7465,sentence,"Subcategory: Fan. Price: 14,500৳25,900৳.

Product: Baseus Refreshing Monitor Clip On and Stand-Up Bladeless Air Desk Fan. Category: Fan. Subcategory: Appliance. Price: 2,890৳3,348৳.
",182,1027510,1027692
7466,sentence,"Subcategory: Appliance. Price: 2,890৳3,348৳.

Product: WIWU FS05 Carter Circulating Foldable Rechargeable Table Fan. Category: Fan. Subcategory: Appliance. Price: 3,190৳3,490৳.
",177,1027647,1027824
7467,sentence,"Subcategory: Appliance. Price: 3,190৳3,490৳.

Product: Arctic Summair Plus Portable Rechargeable Fan. Category: Fan. Subcategory: Appliance. Price: 3,400৳3,699৳.
",162,1027779,1027941
7468,sentence,"Subcategory: Appliance. Price: 3,400৳3,699৳.

Product: Remax F21 Water Cooling Oscillating Fan with Display. Category: Fan. Subcategory: Appliance. Price: 3,500৳3,790৳.
",169,1027896,1028065
7469,sentence,"Subcategory: Appliance. Price: 3,500৳3,790৳.

Product: SMART SEH-RT12 12” LED Rechargeable Table Fan. Category: Fan. Subcategory: Appliance. Price: 3,900৳5,190৳.
",162,1028020,1028182
7470,sentence,"Subcategory: Appliance. Price: 3,900৳5,190৳.

Product: Xiaomi Mi Smart Standing Fan 1C Lite. Category: Fan. Subcategory: Appliance. Price: 5,690৳6,199৳.
",153,1028137,1028290
7471,sentence,"Subcategory: Appliance. Price: 5,690৳6,199৳.

Product: Orient Super Deluxe Supreme 16"" Table Fan. Category: Fan. Subcategory: Appliance. Price: 4,999৳6,500৳.
",158,1028245,1028403
7472,sentence,"Subcategory: Appliance. Price: 4,999৳6,500৳.

Product: SMART SEH-RS86 16” LED Rechargeable Table Fan. Category: Charger Fan. Subcategory: Fan. Price: 5,900৳7,900৳.
",164,1028358,1028522
7473,sentence,"Subcategory: Fan. Price: 5,900৳7,900৳.

Product: Awei F23 Rechargeable Desk Fan. Category: Charger Fan. Subcategory: Fan. Price: Up Coming.
",140,1028483,1028623
7474,sentence,"Subcategory: Fan. Price: Up Coming.

Product: ZOJE ZJ9513 Direct Drive Industrial Sewing Machine. Category: ZOJE. Subcategory: Sewing Machine. Price: 33,455৳34,490৳.
",166,1028587,1028753
7475,sentence,"Price: 33,455৳34,490৳.

Product: ZOJE A6000R Industrial Sewing Machine. Category: ZOJE. Subcategory: Sewing Machine. Price: 34,425৳35,490৳.

Product: ZOJE A6000-D-G Industrial Sewing Machine. ",192,1028730,1028922
7476,sentence,"Category: ZOJE. Subcategory: Sewing Machine. Price: 38,870৳40,490৳.

Product: ZOJE B9000-13 Industrial Sewing Machine. Category: ZOJE. Subcategory: Sewing Machine. Price: 46,541৳48,990৳.
",187,1028922,1029109
7477,sentence,"Price: 46,541৳48,990৳.

Product: Vision Evaporative Super Cool 35L Air Cooler. Category: Air Cooler. Subcategory: Appliance. Price: 13,000৳13,400৳.
",148,1029086,1029234
7478,sentence,"Subcategory: Appliance. Price: 13,000৳13,400৳.

Product: Vision Evaporative Super Cool 45L Air Cooler. Category: Air Cooler. Subcategory: Appliance. Price: 14,000৳14,400৳.
",172,1029187,1029359
7479,sentence,"Subcategory: Appliance. Price: 14,000৳14,400৳.

Product: Gree KSWK-04S66RDG Hot & Cool Portable Air Cooler. Category: Air Cooler. Subcategory: Appliance. Price: 14,000৳14,490৳.
",177,1029312,1029489
7480,sentence,"Subcategory: Appliance. Price: 14,000৳14,490৳.

Product: Gree KSWK06S61DG 3-in-1 Tower Portable Air Cooler. Category: Air Cooler. Subcategory: Appliance. Price: 15,500৳15,990৳.
",177,1029442,1029619
7481,sentence,"Subcategory: Appliance. Price: 15,500৳15,990৳.

Product: Gree KSWK-2001DGL 20L Portable Air Cooler. Category: Air Cooler. Subcategory: Appliance. Price: 17,500৳17,990৳.
",169,1029572,1029741
7482,sentence,"Subcategory: Appliance. Price: 17,500৳17,990৳.

Product: Gree KSWK-4001DGL 40L Air Cooler. Category: Air Cooler. Subcategory: Appliance. Price: 19,500৳19,990৳.
",160,1029694,1029854
7483,sentence,"Subcategory: Appliance. Price: 19,500৳19,990৳.

Product: Gree KSWK-6001DGL 60L Air Cooler. Category: Air Cooler. Subcategory: Appliance. Price: 21,000৳21,990৳.
",160,1029807,1029967
7484,sentence,"Subcategory: Appliance. Price: 21,000৳21,990৳.

Product: Pakhtun PK-127 16"" High Speed Ceiling Mount Fan. Category: Stand Fan. Subcategory: Fan. Price: 6,500৳7,500৳.
",166,1029920,1030086
7485,sentence,"Subcategory: Fan. Price: 6,500৳7,500৳.

Product: Pakhtun Zefiro 18"" High Speed Stand Fan. Category: Stand Fan. Subcategory: Fan. Price: 8,500৳11,500৳.
",151,1030047,1030198
7486,sentence,"Subcategory: Fan. Price: 8,500৳11,500৳.

Product: Gree FXDZ-2305BG5 Remote Control Turbo Speed Stand Fan. Category: Stand Fan. Subcategory: Fan. Price: 12,000৳12,500৳.
",168,1030158,1030326
7487,sentence,"Subcategory: Fan. Price: 12,000৳12,500৳.

Product: Pakhtun Zefiro 20"" High Speed Stand Fan. Category: Stand Fan. Subcategory: Fan. Price: 9,500৳12,500৳.
",153,1030285,1030438
7488,sentence,"Subcategory: Fan. Price: 9,500৳12,500৳.

Product: Pakhtun Zefiro 18"" Stand Fan With Remote. Category: Stand Fan. Subcategory: Fan. Price: 9,500৳12,500৳.
",153,1030398,1030551
7489,sentence,"Subcategory: Fan. Price: 9,500৳12,500৳.

Product: Pakhtun Tezra 18"" High Speed Stand Fan. Category: Stand Fan. Subcategory: Fan. Price: 8,000৳12,500৳.
",151,1030511,1030662
7490,sentence,"Subcategory: Fan. Price: 8,000৳12,500৳.

Product: Pakhtun Tezra 18"" High Speed Stand Fan With Remote Control. Category: Stand Fan. Subcategory: Fan. Price: 9,000৳12,500৳.
",171,1030622,1030793
7491,sentence,"Subcategory: Fan. Price: 9,000৳12,500৳.

Product: Orient Floor Supreme 16"" Stand Fan. Category: Stand Fan. Subcategory: Fan. Price: Out Of Stock.

Product: Orient Stand 38 18"" Stand Fan. ",187,1030753,1030940
7492,sentence,"
Product: Orient Stand 38 18"" Stand Fan. Category: Stand Fan. Subcategory: Fan. Price: Out Of Stock.

Product: Orient Stand 39 16"" Stand Fan. Category: Stand Fan. Subcategory: Fan. ",181,1030899,1031080
7493,sentence,"Category: Stand Fan. Subcategory: Fan. Price: Out Of Stock.

Product: Orient Tornado Pedestal 18"" Stand Fan. Category: Stand Fan. Subcategory: Fan. Price: Out Of Stock.
",169,1031041,1031210
7494,sentence,"Subcategory: Fan. Price: Out Of Stock.

Product: Pakhtun Zefiro 20"" Stand Fan With Remote. Category: Stand Fan. Subcategory: Fan. Price: Out Of Stock.
",151,1031171,1031322
7495,sentence,"Subcategory: Fan. Price: Out Of Stock.

Product: Jack F5 Single Needle Direct Drive Lockstitch Industrial Sewing Machine. Category: JACK. Subcategory: Sewing Machine. Price: 31,500৳35,000৳.
",190,1031283,1031473
7496,sentence,"Price: 31,500৳35,000৳.

Product: Jack A2B-C Auto Trimmer Direct Drive Single Needle Lock Sewing Machine. Category: JACK. Subcategory: Sewing Machine. Price: 36,800৳40,000৳.
",173,1031450,1031623
7497,sentence,"Price: 36,800৳40,000৳.

Product: Jack A4B-A-C Computerized Lockstitch Sewing Machine With Auto Foot Lifter. Category: JACK. Subcategory: Sewing Machine. Price: 47,000৳50,000৳.
",176,1031600,1031776
7498,sentence,"Price: 47,000৳50,000৳.

Product: Jack E4S-M03/333 Direct Drive 4 Thread Overlock Machine. Category: JACK. Subcategory: Sewing Machine. Price: 47,500৳50,000৳.
",158,1031753,1031911
7499,sentence,"Price: 47,500৳50,000৳.

Product: SINGER PK-SM-15CH1-WT-ST-NEW Sewing Machine Without Cover. Category: SINGER. Subcategory: Sewing Machine. Price: 12,000৳12,910৳.
",162,1031888,1032050
7500,sentence,"Price: 12,000৳12,910৳.

Product: SINGER PK-SM-15CH1-WT-ST-NEW Sewing Machine With Cover. Category: SINGER. Subcategory: Sewing Machine. Price: 12,700৳13,660৳.
",159,1032027,1032186
7501,sentence,"Price: 12,700৳13,660৳.

Product: SINGER SRSM-SM1412 Electric Sewing Machine. Category: SINGER. Subcategory: Sewing Machine. Price: 14,990৳15,990৳.
",147,1032163,1032310
7502,sentence,"Price: 14,990৳15,990৳.

Product: SINGER SRSM-SM024 Electric Sewing Machine. Category: SINGER. Subcategory: Sewing Machine. Price: 16,990৳17,490৳.
",146,1032287,1032433
7503,sentence,"Price: 16,990৳17,490৳.

Product: SINGER SRSM-SME-1408 Electric Sewing Machine. Category: SINGER. Subcategory: Sewing Machine. Price: Out Of Stock.
",147,1032410,1032557
7504,sentence,"Price: Out Of Stock.

Product: Whirlpool Magicook 20L Classic Knob Solo Microwave Oven. Category: Whirlpool. Subcategory: Oven. Price: 10,990৳11,990৳.
",151,1032536,1032687
7505,sentence,"Subcategory: Oven. Price: 10,990৳11,990৳.

Product: Whirlpool MWO Pro 20 SE 20L Solo Microwave Oven. Category: Whirlpool. Subcategory: Oven. Price: 11,999৳12,990৳.
",164,1032645,1032809
7506,sentence,"Subcategory: Oven. Price: 11,999৳12,990৳.

Product: Whirlpool Supreme Chef 35L Microwave Oven. Category: Whirlpool. Subcategory: Oven. Price: 47,990৳54,990৳.
",158,1032767,1032925
7507,sentence,"Subcategory: Oven. Price: 47,990৳54,990৳.

Product: Whirlpool Magicook Pro 30 GE Grill 30 Litre Microwave Oven. Category: Whirlpool. Subcategory: Oven. Price: 17,890৳19,990৳.
",175,1032883,1033058
7508,sentence,"Subcategory: Oven. Price: 17,890৳19,990৳.

Product: Whirlpool Magicook Convection 30L Microwave Oven. Category: Whirlpool. Subcategory: Oven. Price: 22,990৳26,990৳.
",165,1033016,1033181
7509,sentence,"Subcategory: Oven. Price: 22,990৳26,990৳.

Product: Walton WAF-KB04L 4L Air Fryer. Category: Air Fryer. Subcategory: Appliance. Price: 7,000৳7,550৳.

Product: Singer 2447-BB Air Fryer. ",185,1033139,1033324
7510,sentence,"
Product: Singer 2447-BB Air Fryer. Category: Air Fryer. Subcategory: Appliance. Price: 8,490৳9,900৳.

Product: Walton WAF-AN06L 6L Air Fryer. Category: Air Fryer. Subcategory: Appliance. ",188,1033288,1033476
7511,sentence,"Category: Air Fryer. Subcategory: Appliance. Price: 11,000৳11,990৳.

Product: Mi 3.5L Smart Air Fryer. Category: Air Fryer. Subcategory: Appliance. Price: 9,499৳13,490৳.
",170,1033431,1033601
7512,sentence,"Subcategory: Appliance. Price: 9,499৳13,490৳.

Product: Sharp KF-AF50 5L Air Fryer. Category: Air Fryer. Subcategory: Appliance. Price: 13,000৳16,000৳.

Product: Tefal EY2018 Air Fryer. ",186,1033555,1033741
7513,sentence,"
Product: Tefal EY2018 Air Fryer. Category: Air Fryer. Subcategory: Appliance. Price: 15,500৳18,000৳.

Product: Sharp KF-AF70RT-S3 7L Air Fryer. Category: Air Fryer. Subcategory: Appliance. ",190,1033707,1033897
7514,sentence,"Category: Air Fryer. Subcategory: Appliance. Price: 14,500৳18,000৳.

Product: Xiaomi 4L Smart Air Fryer Pro. Category: Air Fryer. Subcategory: Appliance. Price: Out Of Stock.
",175,1033852,1034027
7515,sentence,"Subcategory: Appliance. Price: Out Of Stock.

Product: Xiaomi 6L Air Fryer. Category: Air Fryer. Subcategory: Appliance. Price: Out Of Stock.

Product: Panasonic MC-CL601 Bagless Vacuum Cleaner. ",195,1033982,1034177
7516,sentence,"Category: Vacuum Cleaner. Subcategory: Appliance. Price: 13,290৳16,500৳.

Product: Sharp EC-CA1820 20 Ltr 1800W Tank Vacuum Cleaner. Category: Vacuum Cleaner. Subcategory: Appliance. ",183,1034177,1034360
7517,sentence,"Subcategory: Appliance. Price: 13,700৳16,900৳.

Product: Panasonic MC-CL603 Bagless Canister Vacuum Cleaner. Category: Vacuum Cleaner. Subcategory: Appliance. Price: 14,990৳17,500৳.
",182,1034336,1034518
7518,sentence,"Subcategory: Appliance. Price: 14,990৳17,500৳.

Product: Sharp EC-CA2422-Z 22 Ltr 2400W Vacuum Cleaner. Category: Vacuum Cleaner. Subcategory: Appliance. Price: 14,390৳17,500৳.
",177,1034471,1034648
7519,sentence,"Subcategory: Appliance. Price: 14,390৳17,500৳.

Product: Panasonic MC-CL605 Bagless Vacuum Cleaner. Category: Vacuum Cleaner. Subcategory: Appliance. Price: 18,500৳22,000৳.
",173,1034601,1034774
7520,sentence,"Subcategory: Appliance. Price: 18,500৳22,000৳.

Product: Sharp EC-BG2405A-G 5 Liter 2400W Vacuum Cleaner. Category: Vacuum Cleaner. Subcategory: Appliance. Price: 18,800৳22,000৳.
",179,1034727,1034906
7521,sentence,"Subcategory: Appliance. Price: 18,800৳22,000৳.

Product: Panasonic MC-YL633 Tank Vacuum Cleaner. Category: Vacuum Cleaner. Subcategory: Appliance. Price: 21,300৳23,000৳.
",170,1034859,1035029
7522,sentence,"Subcategory: Appliance. Price: 21,300৳23,000৳.

Product: Hitachi CV-950F 2100W Vacuum Cleaner 18 Ltr. Category: Vacuum Cleaner. Subcategory: Appliance. Price: 22,000৳24,000৳.
",175,1034982,1035157
7523,sentence,"Subcategory: Appliance. Price: 22,000৳24,000৳.

Product: Panasonic MC-CL607 2.2L 2100W Bagless Vacuum Cleaner. Category: Vacuum Cleaner. Subcategory: Appliance. Price: 21,500৳25,900৳.
",184,1035110,1035294
7524,sentence,"Subcategory: Appliance. Price: 21,500৳25,900৳.

Product: Hitachi CV-960F 21L 2200W Vacuum Cleaner. Category: Vacuum Cleaner. Subcategory: Appliance. Price: 19,000৳26,500৳.
",172,1035247,1035419
7525,sentence,"Subcategory: Appliance. Price: 19,000৳26,500৳.

Product: Panasonic MC-YL635 Tank Vacuum Cleaner. Category: Vacuum Cleaner. Subcategory: Appliance. Price: 23,500৳29,000৳.
",170,1035372,1035542
7526,sentence,"Subcategory: Appliance. Price: 23,500৳29,000৳.

Product: Anker Eufy G50 Hybrid Robot Vacuum Cleaner. Category: Vacuum Cleaner. Subcategory: Appliance. Price: 27,990৳29,990৳.
",174,1035495,1035669
7527,sentence,"Subcategory: Appliance. Price: 27,990৳29,990৳.

Product: Hitachi CV-9800YJ 21L 2300W Vacuum Cleaner. Category: Vacuum Cleaner. Subcategory: Appliance. Price: 28,000৳33,000৳.
",174,1035622,1035796
7528,sentence,"Subcategory: Appliance. Price: 28,000৳33,000৳.

Product: Panasonic MC-YL799 21L 2400W Tank Vacuum Cleaner. Category: Vacuum Cleaner. Subcategory: Appliance. Price: 33,000৳37,000৳.
",180,1035749,1035929
7529,sentence,"Subcategory: Appliance. Price: 33,000৳37,000৳.

Product: JONR P20 Pro Robot Vacuum Cleaner. Category: Vacuum Cleaner. Subcategory: Appliance. Price: 104,990৳114,999৳.
",167,1035882,1036049
7530,sentence,"Price: 104,990৳114,999৳.

Product: Baseus A2 Pro Car Vacuum Cleaner. Category: Vacuum Cleaner. Subcategory: Appliance. Price: Out Of Stock.

Product: Panasonic MC-YL620 Drum Vacuum Cleaner. ",190,1036024,1036214
7531,sentence,"Category: Vacuum Cleaner. Subcategory: Appliance. Price: Out Of Stock.

Product: Panasonic MC-YL631 Tank Vacuum Cleaner. Category: Vacuum Cleaner. Subcategory: Appliance. Price: Out Of Stock.
",192,1036214,1036406
7532,sentence,"Subcategory: Appliance. Price: Out Of Stock.

Product: AirRobo T20+ Smart Cleaning Robot Vacuum Cleaner. Category: Vacuum Cleaner. Subcategory: Appliance. Price: Out Of Stock.
",176,1036361,1036537
7533,sentence,"Subcategory: Appliance. Price: Out Of Stock.

Product: Xiaomi Smart Air Purifier 4 Lite Filter (CN Variant). Category: Air Purifier. Subcategory: Appliance. Price: 17,990৳21,999৳.
",180,1036492,1036672
7534,sentence,"Subcategory: Appliance. Price: 17,990৳21,999৳.

Product: Sharp FP-J30E-B Air Purifier. Category: Air Purifier. Subcategory: Appliance. Price: 18,290৳23,000৳.
",158,1036625,1036783
7535,sentence,"Subcategory: Appliance. Price: 18,290৳23,000৳.

Product: Sharp FPJM30LB Air Purifier with Mosquito Catcher. Category: Air Purifier. Subcategory: Appliance. Price: 26,500৳28,000৳.
",179,1036736,1036915
7536,sentence,"Subcategory: Appliance. Price: 26,500৳28,000৳.

Product: Sharp FP-JM30E-B Air Purifier With Mosquito Catcher. Category: Air Purifier. Subcategory: Appliance. Price: 28,500৳33,000৳.
",181,1036868,1037049
7537,sentence,"Subcategory: Appliance. Price: 28,500৳33,000৳.

Product: Sharp FP-GM30L-B Air Purifier with Mosquito Catcher. Category: Air Purifier. Subcategory: Appliance. Price: 27,500৳33,000৳.
",181,1037002,1037183
7538,sentence,"Subcategory: Appliance. Price: 27,500৳33,000৳.

Product: Sharp FP-J40E-W Air Purifier. Category: Air Purifier. Subcategory: Appliance. Price: 33,000৳37,000৳.

Product: Sharp FP-J50E-H Air Purifier. ",198,1037136,1037334
7539,sentence,"
Product: Sharp FP-J50E-H Air Purifier. Category: Air Purifier. Subcategory: Appliance. Price: 32,500৳40,000৳.

Product: Sharp FP-J60E-W Air Purifier. Category: Air Purifier. Subcategory: Appliance. ",199,1037294,1037493
7540,sentence,"Category: Air Purifier. Subcategory: Appliance. Price: 45,000৳55,000৳.

Product: Sharp FP-J80E-H Air Purifier. Category: Air Purifier. Subcategory: Appliance. Price: 49,000৳56,000৳.
",182,1037445,1037627
7541,sentence,"Subcategory: Appliance. Price: 49,000৳56,000৳.

Product: Walton WMWO-M23CDS 23L Convection Microwave Oven. Category: Walton. Subcategory: Oven. Price: 16,800৳17,500৳.
",167,1037580,1037747
7542,sentence,"Subcategory: Oven. Price: 16,800৳17,500৳.

Product: Walton WMWO-M28EGN 28L Convection Microwave Oven. Category: Walton. Subcategory: Oven. Price: 17,500৳17,990৳.
",162,1037705,1037867
7543,sentence,"Subcategory: Oven. Price: 17,500৳17,990৳.

Product: Walton WMWO-M25SCD 25L Convection Microwave Oven. Category: Walton. Subcategory: Oven. Price: 18,150৳18,500৳.
",162,1037825,1037987
7544,sentence,"Subcategory: Oven. Price: 18,150৳18,500৳.

Product: Walton WMWO-M25CDS 25L Convection Microwave Oven. Category: Walton. Subcategory: Oven. Price: 18,250৳18,700৳.
",162,1037945,1038107
7545,sentence,"Subcategory: Oven. Price: 18,250৳18,700৳.

Product: Walton WMWO-G30SCT 30L Convection Microwave Oven. Category: Walton. Subcategory: Oven. Price: 21,550৳22,000৳.
",162,1038065,1038227
7546,sentence,"Subcategory: Oven. Price: 21,550৳22,000৳.

Product: Hisense H20MOBS2H 20L Solo Microwave Oven. Category: Hisense. Subcategory: Oven. Price: 9,690৳10,900৳.
",155,1038185,1038340
7547,sentence,"Subcategory: Oven. Price: 9,690৳10,900৳.

Product: Hisense H20MOBS5H 20L Solo Microwave Oven. Category: Hisense. Subcategory: Oven. Price: 10,590৳11,900৳.
",155,1038299,1038454
7548,sentence,"Subcategory: Oven. Price: 10,590৳11,900৳.

Product: Hisense H25MOBS5H 25L Solo Microwave Oven. Category: Hisense. Subcategory: Oven. Price: 12,990৳15,400৳.
",156,1038412,1038568
7549,sentence,"Subcategory: Oven. Price: 12,990৳15,400৳.

Product: Hisense H28MOBS10HC 28L Convection Microwave Oven. Category: Hisense. Subcategory: Oven. Price: 20,890৳24,900৳.
",164,1038526,1038690
7550,sentence,"Subcategory: Oven. Price: 20,890৳24,900৳.

Product: Hisense HMBC2809DSC 28L Convection Microwave Oven. Category: Hisense. Subcategory: Oven. Price: 21,590৳25,900৳.
",164,1038648,1038812
7551,sentence,"Subcategory: Oven. Price: 21,590৳25,900৳.

Product: Hisense H26MOBS5HG 26L Grill Microwave Oven. Category: Hisense. Subcategory: Oven. Price: Out Of Stock.
",156,1038770,1038926
7552,sentence,"Subcategory: Oven. Price: Out Of Stock.

Product: Xiaomi MIJIA MJZZB01PL 300ml Portable Juicer Cup. Category: Xiaomi. Subcategory: Blender. Price: 3,190৳4,490৳.
",161,1038886,1039047
7553,sentence,"Subcategory: Blender. Price: 3,190৳4,490৳.

Product: Sharp EO-42K 42L Rotisserie Convection Electric Oven. Category: Oven. Subcategory: Appliance. Price: 13,000৳14,000৳.
",170,1039004,1039174
7554,sentence,"Subcategory: Appliance. Price: 13,000৳14,000৳.

Product: Sharp R-20A0(K)V 20 Liters Microwave Oven. Category: Oven. Subcategory: Appliance. Price: 12,400৳16,700৳.
",163,1039127,1039290
7555,sentence,"Subcategory: Appliance. Price: 12,400৳16,700৳.

Product: SHARP EO-60K 60L Rotisserie Convection Electric Oven. Category: Oven. Subcategory: Appliance. Price: 14,390৳16,900৳.
",174,1039243,1039417
7556,sentence,"Subcategory: Appliance. Price: 14,390৳16,900৳.

Product: SHARP R-32A0-SM-V 25L Microwave Oven. Category: Oven. Subcategory: Appliance. Price: 17,800৳18,800৳.
",158,1039370,1039528
7557,sentence,"Subcategory: Appliance. Price: 17,800৳18,800৳.

Product: Sharp R-72A1-SM-V 25L Grill Microwave Oven. Category: Oven. Subcategory: Appliance. Price: 19,000৳19,500৳.
",164,1039481,1039645
7558,sentence,"Subcategory: Appliance. Price: 19,000৳19,500৳.

Product: Sharp R-75MT-S 25L Grill Microwave Oven. Category: Oven. Subcategory: Appliance. Price: 18,000৳19,500৳.
",161,1039598,1039759
7559,sentence,"Subcategory: Appliance. Price: 18,000৳19,500৳.

Product: Panasonic NN-ST34NB 25L Solo Microwave Oven. Category: Oven. Subcategory: Appliance. Price: 20,000৳20,700৳.
",165,1039712,1039877
7560,sentence,"Subcategory: Appliance. Price: 20,000৳20,700৳.

Product: Sharp R-72E0(SM)V 25L Grill Microwave Oven. Category: Oven. Subcategory: Appliance. Price: 19,500৳22,000৳.
",164,1039830,1039994
7561,sentence,"Subcategory: Appliance. Price: 19,500৳22,000৳.

Product: Sharp R-28CT(S) 28L Grill Microwave Oven. Category: Oven. Subcategory: Appliance. Price: 18,790৳22,000৳.
",162,1039947,1040109
7562,sentence,"Subcategory: Appliance. Price: 18,790৳22,000৳.

Product: Sharp R-2235H(R) 24L Solo Microwave Oven. Category: Oven. Subcategory: Appliance. Price: 19,000৳24,700৳.
",162,1040062,1040224
7563,sentence,"Subcategory: Appliance. Price: 19,000৳24,700৳.

Product: Panasonic NN-CT645 27L Convection Grill Microwave Oven. Category: Panasonic. Subcategory: Oven. Price: 26,890৳29,500৳.
",176,1040177,1040353
7564,sentence,"Subcategory: Oven. Price: 26,890৳29,500৳.

Product: Panasonic NN-CD684 27L Convection Grill Microwave Oven. Category: Panasonic. Subcategory: Oven. Price: 31,000৳31,500৳.
",171,1040311,1040482
7565,sentence,"Subcategory: Oven. Price: 31,000৳31,500৳.

Product: Panasonic NN-CT69 30L Convection Grill Microwave Oven. Category: Panasonic. Subcategory: Oven. Price: 34,500৳35,000৳.
",170,1040440,1040610
7566,sentence,"Subcategory: Oven. Price: 34,500৳35,000৳.

Product: Panasonic NN-CT68 30L Convection Grill Microwave Oven. Category: Panasonic. Subcategory: Oven. Price: 36,000৳37,000৳.
",170,1040568,1040738
7567,sentence,"Subcategory: Oven. Price: 36,000৳37,000৳.

Product: Midea 30 Liter Geyser (D30-15A6). Category: Midea. Subcategory: Geyser. Price: 11,300৳16,000৳.

Product: Midea 40 Liter Geyser (D40-20A). ",190,1040696,1040886
7568,sentence,"
Product: Midea 40 Liter Geyser (D40-20A). Category: Midea. Subcategory: Geyser. Price: 13,700৳17,000৳.

Product: Midea 50 Liter Geyser (D50-20A). Category: Midea. Subcategory: Geyser. ",185,1040843,1041028
7569,sentence,"Category: Midea. Subcategory: Geyser. Price: 15,300৳19,500৳.

Product: Sharp R-77AT(ST) 34L Grill Microwave Oven. Category: Sharp. Subcategory: Oven. Price: 22,000৳28,000৳.
",173,1040990,1041163
7570,sentence,"Subcategory: Oven. Price: 22,000৳28,000৳.

Product: SHARP R-28CN(K) 28L Convection Grill Microwave Oven. Category: Sharp. Subcategory: Oven. Price: 28,000৳30,500৳.
",164,1041121,1041285
7571,sentence,"Subcategory: Oven. Price: 28,000৳30,500৳.

Product: Sharp R-84AO(ST)V 25L Convection Microwave Oven. Category: Sharp. Subcategory: Oven. Price: 29,500৳32,700৳.
",160,1041243,1041403
7572,sentence,"Subcategory: Oven. Price: 29,500৳32,700৳.

Product: Sharp R-92A0-ST-V 32L Convection Microwave Oven. Category: Sharp. Subcategory: Oven. Price: 31,390৳41,200৳.
",160,1041361,1041521
7573,sentence,"Subcategory: Oven. Price: 31,390৳41,200৳.

Product: Philips HL1606/03 500W Mixer Grinder. Category: Philips. Subcategory: Blender. Price: 7,000৳9,590৳.
",152,1041479,1041631
7574,sentence,"Subcategory: Blender. Price: 7,000৳9,590৳.

Product: Philips HL7505/00 500W Mixer Grinder. Category: Philips. Subcategory: Blender. Price: 7,490৳9,900৳.
",153,1041588,1041741
7575,sentence,"Subcategory: Blender. Price: 7,490৳9,900৳.

Product: Philips HL7757 750W 3 Jar Mixer Grinder. Category: Philips. Subcategory: Blender. Price: 9,290৳12,490৳.
",157,1041698,1041855
7576,sentence,"Subcategory: Blender. Price: 9,290৳12,490৳.

Product: Philips HL7756/00 750 Watt Mixer Grinder. Category: Philips. Subcategory: Blender. Price: 9,950৳13,290৳.
",159,1041811,1041970
7577,sentence,"Subcategory: Blender. Price: 9,950৳13,290৳.

Product: Panasonic MX-M200 1L Durable & Lightweight Blender. Category: Panasonic. Subcategory: Blender. Price: 5,200৳5,500৳.
",170,1041926,1042096
7578,sentence,"Subcategory: Blender. Price: 5,200৳5,500৳.

Product: Panasonic MX-EX1081 1.35L Blender. Category: Panasonic. Subcategory: Blender. Price: 6,500৳7,000৳.

Product: Panasonic MX-900M 1L Blender. ",192,1042053,1042245
7579,sentence,"
Product: Panasonic MX-900M 1L Blender. Category: Panasonic. Subcategory: Blender. Price: 6,500৳8,000৳.

Product: Panasonic MX-GX1511W 1500ml Blender. Category: Panasonic. Subcategory: Blender. ",194,1042205,1042399
7580,sentence,"Category: Panasonic. Subcategory: Blender. Price: 6,500৳8,000৳.

Product: Panasonic MX-EX1561 1.5L Blender. Category: Panasonic. Subcategory: Blender. Price: 7,000৳8,300৳.
",172,1042356,1042528
7581,sentence,"Subcategory: Blender. Price: 7,000৳8,300৳.

Product: Panasonic MX-AC300 3 Jar Mixer Grinder. Category: Panasonic. Subcategory: Blender. Price: 12,000৳11,500৳.
",159,1042485,1042644
7582,sentence,"Subcategory: Blender. Price: 12,000৳11,500৳.

Product: Panasonic MX-AC400 4 Jar Mixer Grinder. Category: Panasonic. Subcategory: Blender. Price: 13,400৳14,000৳.
",161,1042599,1042760
7583,sentence,"Subcategory: Blender. Price: 13,400৳14,000৳.

Product: Panasonic MX-AV425 4 Jar Mixer Grinder. Category: Panasonic. Subcategory: Blender. Price: 14,400৳15,000৳.
",161,1042715,1042876
7584,sentence,"Subcategory: Blender. Price: 14,400৳15,000৳.

Product: Panasonic MJ-CB100 2L Juicer Blender. Category: Panasonic. Subcategory: Blender. Price: 13,500৳15,000৳.
",159,1042831,1042990
7585,sentence,"Subcategory: Blender. Price: 13,500৳15,000৳.

Product: Panasonic MJ-H300K Juicer Blender. Category: Panasonic. Subcategory: Blender. Price: 14,600৳15,500৳.
",156,1042945,1043101
7586,sentence,"Subcategory: Blender. Price: 14,600৳15,500৳.

Product: Panasonic MX-AC460 Mixer Grinder. Category: Panasonic. Subcategory: Blender. Price: 13,500৳15,800৳.
",155,1043056,1043211
7587,sentence,"Subcategory: Blender. Price: 13,500৳15,800৳.

Product: Panasonic MX-AE375 Super Mixer Grinder. Category: Panasonic. Subcategory: Blender. Price: 14,000৳16,500৳.
",161,1043166,1043327
7588,sentence,"Subcategory: Blender. Price: 14,000৳16,500৳.

Product: Panasonic MX-AE475 2000W Mixer Grinder. Category: Panasonic. Subcategory: Blender. Price: 15,500৳16,500৳.
",161,1043282,1043443
7589,sentence,"Subcategory: Blender. Price: 15,500৳16,500৳.

Product: PANASONIC MX-AC560 5 Jar Mixer Grinder. Category: Panasonic. Subcategory: Blender. Price: 15,500৳17,500৳.
",161,1043398,1043559
7590,sentence,"Subcategory: Blender. Price: 15,500৳17,500৳.

Product: Panasonic MJ-CB600 2L Juicer Blender. Category: Panasonic. Subcategory: Blender. Price: 17,000৳20,000৳.
",159,1043514,1043673
7591,sentence,"Subcategory: Blender. Price: 17,000৳20,000৳.

Product: Panasonic MX-AC555 Super Mixer Grinder. Category: Panasonic. Subcategory: Blender. Price: 17,000৳20,500৳.
",161,1043628,1043789
7592,sentence,"Subcategory: Blender. Price: 17,000৳20,500৳.

Product: Panasonic MJ-DJ31 3 in 1 Juicer Blender. Category: Panasonic. Subcategory: Blender. Price: 20,500৳23,500৳.
",162,1043744,1043906
7593,sentence,"Subcategory: Blender. Price: 20,500৳23,500৳.

Product: Panasonic MX-M210SSL 1.35L Blender. Category: Panasonic. Subcategory: Blender. Price: Up Coming.
",152,1043861,1044013
7594,sentence,"Subcategory: Blender. Price: Up Coming.

Product: Panasonic MX-KM3070 1.5L Ice Crushing Blender. Category: Panasonic. Subcategory: Blender. Price: Out Of Stock.
",161,1043973,1044134
7595,sentence,"Subcategory: Blender. Price: Out Of Stock.

Product: Panasonic MX-AC310 Super Mixer Grinder. Category: Panasonic. Subcategory: Blender. Price: Out Of Stock.
",157,1044091,1044248
7596,sentence,"Subcategory: Blender. Price: Out Of Stock.

Product: Haier 30 Litre Water Heater Geyser - ES30H-CK3(BD). Category: Haier. Subcategory: Geyser. Price: 10,990৳14,500৳.
",166,1044205,1044371
7597,sentence,"Subcategory: Geyser. Price: 10,990৳14,500৳.

Product: Haier 50 Litre Water Heater Geyser - ES50H-CK3(BD). Category: Haier. Subcategory: Geyser. Price: 13,190৳18,900৳.
",167,1044327,1044494
7598,sentence,"Subcategory: Geyser. Price: 13,190৳18,900৳.

Product: Haier 40 Litre Water Heater Geyser - ES40H-CK3(BD). Category: Haier. Subcategory: Geyser. Price: 12,190৳15,300৳.
",167,1044450,1044617
7599,sentence,"Subcategory: Geyser. Price: 12,190৳15,300৳.

Product: Walton WRH-PTC205T Mini Room Heater. Category: Room Heater. Subcategory: Appliance. Price: 4,900৳4,990৳.
",159,1044573,1044732
7600,sentence,"Subcategory: Appliance. Price: 4,900৳4,990৳.

Product: Walton WRH-PTC302W Room Heater. Category: Room Heater. Subcategory: Appliance. Price: 7,000৳7,500৳.
",155,1044687,1044842
7601,sentence,"Subcategory: Appliance. Price: 7,000৳7,500৳.

Product: Xiaomi VIOMI VXNF01 Mini Portable Heater. Category: Room Heater. Subcategory: Appliance. Price: Up Coming.
",162,1044797,1044959
7602,sentence,"Subcategory: Appliance. Price: Up Coming.

Product: Xiaomi MI Mijia ZMNFJ01YM 600W Desktop Electric Heater. Category: Room Heater. Subcategory: Appliance. Price: Out Of Stock.
",176,1044917,1045093
7603,sentence,"Subcategory: Appliance. Price: Out Of Stock.

Product: Xiaomi Mijia N1 1.5L Electric Kettle. Category: Electric Kettle. Subcategory: Appliance. Price: 3,199৳3,699৳.
",165,1045048,1045213
7604,sentence,"Subcategory: Appliance. Price: 3,199৳3,699৳.

Product: Smart SEK-PC55SS 5.5 Liters Pressure Cooker. Category: Cooker. Subcategory: Appliance. Price: 2,790৳3,490৳.
",163,1045168,1045331
7605,sentence,"Subcategory: Appliance. Price: 2,790৳3,490৳.

Product: SMART SEK-RC18FS 1.8 Liter Rice Cooker. Category: Cooker. Subcategory: Appliance. Price: 2,990৳3,990৳.
",158,1045286,1045444
7606,sentence,"Subcategory: Appliance. Price: 2,990৳3,990৳.

Product: SMART SEK-PC65SS 6.5 Liter Pressure Cooker. Category: Cooker. Subcategory: Appliance. Price: 2,990৳3,990৳.
",162,1045399,1045561
7607,sentence,"Subcategory: Appliance. Price: 2,990৳3,990৳.

Product: SMART SEK-RC28FS 2.8 Ltr Rice Cooker. Category: Cooker. Subcategory: Appliance. Price: 3,590৳4,790৳.

Product: Panasonic SR-3NA Rice Cooker. ",196,1045516,1045712
7608,sentence,"
Product: Panasonic SR-3NA Rice Cooker. Category: Cooker. Subcategory: Appliance. Price: 4,500৳4,900৳.

Product: Xiaomi Mijia Induction Cooker Youth Edition. Category: Cooker. ",176,1045672,1045848
7609,sentence,"Category: Cooker. Subcategory: Appliance. Price: 8,000৳8,490৳.

Product: Shameem Tropica 30 Litre Geyser (7 Gallon Standard). Category: Geyser. Subcategory: Appliance. Price: 9,300৳11,000৳.
",190,1045830,1046020
7610,sentence,"Subcategory: Appliance. Price: 9,300৳11,000৳.

Product: Shameem Tropica 10 Gallon Standard Geyser (45 Litre). Category: Geyser. Subcategory: Appliance. Price: 9,190৳11,500৳.
",174,1045974,1046148
7611,sentence,"Subcategory: Appliance. Price: 9,190৳11,500৳.

Product: Shameem Tropica 10 Gallon Wall Hanging Standard Geyser (45 Litre). Category: Geyser. Subcategory: Appliance. Price: 9,900৳12,000৳.
",187,1046102,1046289
7612,sentence,"Subcategory: Appliance. Price: 9,900৳12,000৳.

Product: Shameem Tropica 30 Litre Geyser (7 Gallon Special). Category: Geyser. Subcategory: Appliance. Price: 8,990৳12,000৳.
",172,1046243,1046415
7613,sentence,"Subcategory: Appliance. Price: 8,990৳12,000৳.

Product: Shameem Tropica 15 Gallon Standard Geyser (67.5 Litre). Category: Geyser. Subcategory: Appliance. Price: 9,990৳12,500৳.
",176,1046369,1046545
7614,sentence,"Subcategory: Appliance. Price: 9,990৳12,500৳.

Product: Shameem Tropica 15 Gallon Wall Hanging Standard Geyser (67.5 Litre). Category: Geyser. Subcategory: Appliance. Price: 10,800৳13,000৳.
",190,1046499,1046689
7615,sentence,"Subcategory: Appliance. Price: 10,800৳13,000৳.

Product: Shameem Tropica 15 Gallon Special Geyser (67.5 Litre). Category: Geyser. Subcategory: Appliance. Price: 11,290৳13,500৳.
",177,1046642,1046819
7616,sentence,"Subcategory: Appliance. Price: 11,290৳13,500৳.

Product: Shameem Tropica 10 Gallon Special Geyser (45 Litre). Category: Geyser. Subcategory: Appliance. Price: 9,890৳14,500৳.
",174,1046772,1046946
7617,sentence,"Subcategory: Appliance. Price: 9,890৳14,500৳.

Product: Shameem Tropica 20 Gallon Standard Geyser (90 Liter). Category: Geyser. Subcategory: Appliance. Price: 15,000৳16,000৳.
",175,1046900,1047075
7618,sentence,"Subcategory: Appliance. Price: 15,000৳16,000৳.

Product: Shameem Tropica 20 Gallon Wall Hanging Standard Geyser (90 Liter). Category: Geyser. Subcategory: Appliance. Price: 13,950৳16,500৳.
",189,1047028,1047217
7619,sentence,"Subcategory: Appliance. Price: 13,950৳16,500৳.

Product: Shameem Tropica 20 Gallon Special Geyser (90 Liter). Category: Geyser. Subcategory: Appliance. Price: 16,500৳17,000৳.
",175,1047170,1047345
7620,sentence,"Subcategory: Appliance. Price: 16,500৳17,000৳.

Product: Shameem Tropica 25 Gallon Standard Geyser (112.5 Liter). Category: Geyser. Subcategory: Appliance. Price: 24,000৳25,000৳.
",179,1047298,1047477
7621,sentence,"Subcategory: Appliance. Price: 24,000৳25,000৳.

Product: Shameem Tropica 25 Gallon Special Geyser (112.5 Liter). Category: Geyser. Subcategory: Appliance. Price: 26,000৳28,000৳.
",178,1047430,1047608
7622,sentence,"Subcategory: Appliance. Price: 26,000৳28,000৳.

Product: Shameem Tropica 30 Gallon Standard Geyser (135 Litre). Category: Geyser. Subcategory: Appliance. Price: 29,500৳34,000৳.
",177,1047561,1047738
7623,sentence,"Subcategory: Appliance. Price: 29,500৳34,000৳.

Product: Shameem Tropica 40 Gallon Standard Geyser (180 Litre). Category: Geyser. Subcategory: Appliance. Price: 35,500৳40,000৳.
",177,1047691,1047868
7624,sentence,"Subcategory: Appliance. Price: 35,500৳40,000৳.

Product: Shameem Tropica 50 Gallon Standard Geyser (225 Litre). Category: Shameem. Subcategory: Geyser. Price: 42,500৳45,000৳.
",175,1047821,1047996
7625,sentence,"Subcategory: Geyser. Price: 42,500৳45,000৳.

Product: Shameem Tropica 60 Gallon Standard Geyser (270 Litre). Category: Shameem. Subcategory: Geyser. Price: 51,000৳55,000৳.
",172,1047952,1048124
7626,sentence,"Subcategory: Geyser. Price: 51,000৳55,000৳.

Product: Shameem Tropica 80 Gallon Standard Geyser (360 Litre). Category: Shameem. Subcategory: Geyser. Price: 63,500৳70,000৳.
",172,1048080,1048252
7627,sentence,"Subcategory: Geyser. Price: 63,500৳70,000৳.

Product: Shameem Tropica 100 Gallon Standard Geyser (450 Litre). Category: Shameem. Subcategory: Geyser. Price: 85,500৳90,000৳.
",173,1048208,1048381
7628,sentence,"Subcategory: Geyser. Price: 85,500৳90,000৳.

Product: Shameem Tropica 150 Gallon Standard Geyser (675 Litre). Category: Shameem. Subcategory: Geyser. Price: 125,000৳130,000৳.
",175,1048337,1048512
7629,sentence,"Subcategory: Geyser. Price: 125,000৳130,000৳.

Product: Panasonic NI-P300T Multi-Directional Steam Iron. Category: Iron. Subcategory: Appliance. Price: 3,500৳3,800৳.
",166,1048466,1048632
7630,sentence,"Subcategory: Appliance. Price: 3,500৳3,800৳.

Product: Panasonic NI-M250T Steam Iron. Category: Iron. Subcategory: Appliance. Price: 3,400৳3,900৳.

Product: Panasonic NI-E410T Steam Iron. ",188,1048587,1048775
7631,sentence,"
Product: Panasonic NI-E410T Steam Iron. Category: Iron. Subcategory: Appliance. Price: 4,500৳5,000৳.

Product: Philips GC181/80 1000 Watt Dry Iron. Category: Iron. Subcategory: Appliance. ",189,1048734,1048923
7632,sentence,"Category: Iron. Subcategory: Appliance. Price: 3,790৳5,090৳.

Product: Xiaomi Mijia 1200W Handheld Electric Ironing Machine. Category: Iron. Subcategory: Appliance. Price: 7,890৳9,990৳.
",186,1048883,1049069
7633,sentence,"Subcategory: Appliance. Price: 7,890৳9,990৳.

Product: Panasonic NI-GSE040PTH Garment Steamer Iron. Category: Iron. Subcategory: Appliance. Price: 14,200৳15,000৳.
",163,1049024,1049187
7634,sentence,"Subcategory: Appliance. Price: 14,200৳15,000৳.

Product: Panasonic NI-GSG060 Garment Steamer Iron. Category: Iron. Subcategory: Appliance. Price: 14,500৳17,000৳.
",162,1049140,1049302
7635,sentence,"Subcategory: Appliance. Price: 14,500৳17,000৳.

Product: Panasonic NI-GSE050ATH Garment Steamer Iron. Category: Iron. Subcategory: Appliance. Price: 16,500৳17,500৳.
",165,1049255,1049420
7636,sentence,"Subcategory: Appliance. Price: 16,500৳17,500৳.

Product: Panasonic NI-GWE080 2140W Garment Steamer. Category: Iron. Subcategory: Appliance. Price: 20,000৳25,000৳.",162,1049373,1049535
